100654,5020,2268,2752,1,4
100654,4051,1969,2082,2,1
100654,4051,1969,2082,3,1
100654,1103,541,562,4,1
100654,2948,1428,1520,5,1
100654,969,299,670,12,3
100654,166,77,89,19,1
100654,2782,1351,1431,20,1
100654,4439,2013,2426,21,4
100654,3799,1836,1963,22,1
100654,3799,1836,1963,23,1
100654,1088,532,556,24,1
100654,2711,1304,1407,25,1
100654,640,177,463,32,3
100654,152,72,80,39,1
100654,2559,1232,1327,40,1
100654,581,255,326,41,4
100654,252,133,119,42,1
100654,252,133,119,43,1
100654,15,9,6,44,1
100654,237,124,113,45,1
100654,329,122,207,52,3
100654,14,5,9,59,1
100654,223,119,104,60,1
100663,18568,7309,11259,1,4
100663,11502,4780,6722,2,1
100663,11200,4631,6569,3,1
100663,1773,717,1056,4,1
100663,9427,3914,5513,5,1
100663,302,149,153,11,1
100663,7066,2529,4537,12,3
100663,1397,550,847,19,1
100663,8030,3364,4666,20,1
100663,11961,5042,6919,21,4
100663,8357,3501,4856,22,1
100663,8312,3470,4842,23,1
100663,1732,697,1035,24,1
100663,6580,2773,3807,25,1
100663,45,31,14,31,1
100663,3604,1541,2063,32,3
100663,887,375,512,39,1
100663,5693,2398,3295,40,1
100663,6607,2267,4340,41,4
100663,3145,1279,1866,42,1
100663,2888,1161,1727,43,1
100663,41,20,21,44,1
100663,2847,1141,1706,45,1
100663,257,118,139,51,1
100663,3462,988,2474,52,3
100663,510,175,335,59,1
100663,2337,966,1371,60,1
100690,631,264,367,1,4
100690,322,126,196,2,1
100690,322,126,196,3,1
100690,7,2,5,4,1
100690,315,124,191,5,1
100690,309,138,171,12,3
100690,315,124,191,20,1
100690,323,133,190,21,4
100690,202,74,128,22,1
100690,202,74,128,23,1
100690,3,0,3,24,1
100690,199,74,125,25,1
100690,121,59,62,32,3
100690,199,74,125,40,1
100690,308,131,177,41,4
100690,120,52,68,42,1
100690,120,52,68,43,1
100690,4,2,2,44,1
100690,116,50,66,45,1
100690,188,79,109,52,3
100690,116,50,66,60,1
100706,7376,4136,3240,1,4
100706,5696,3177,2519,2,1
100706,5525,3083,2442,3,1
100706,651,396,255,4,1
100706,4874,2687,2187,5,1
100706,171,94,77,11,1
100706,1680,959,721,12,3
100706,705,380,325,19,1
100706,4169,2307,1862,20,1
100706,4802,2653,2149,21,4
100706,4237,2331,1906,22,1
100706,4202,2311,1891,23,1
100706,638,387,251,24,1
100706,3564,1924,1640,25,1
100706,35,20,15,31,1
100706,565,322,243,32,3
100706,546,285,261,39,1
100706,3018,1639,1379,40,1
100706,2574,1483,1091,41,4
100706,1459,846,613,42,1
100706,1323,772,551,43,1
100706,13,9,4,44,1
100706,1310,763,547,45,1
100706,136,74,62,51,1
100706,1115,637,478,52,3
100706,159,95,64,59,1
100706,1151,668,483,60,1
100724,6075,2399,3676,1,4
100724,5356,2188,3168,2,1
100724,5354,2187,3167,3,1
100724,1545,628,917,4,1
100724,3809,1559,2250,5,1
100724,2,1,1,11,1
100724,719,211,508,12,3
100724,223,95,128,19,1
100724,3586,1464,2122,20,1
100724,5182,2080,3102,21,4
100724,4872,1975,2897,22,1
100724,4871,1974,2897,23,1
100724,1520,621,899,24,1
100724,3351,1353,1998,25,1
100724,1,1,0,31,1
100724,310,105,205,32,3
100724,198,86,112,39,1
100724,3153,1267,1886,40,1
100724,893,319,574,41,4
100724,484,213,271,42,1
100724,483,213,270,43,1
100724,25,7,18,44,1
100724,458,206,252,45,1
100724,1,0,1,51,1
100724,409,106,303,52,3
100724,25,9,16,59,1
100724,433,197,236,60,1
100751,34752,15763,18989,1,4
100751,29440,13556,15884,2,1
100751,28692,13214,15478,3,1
100751,6454,2830,3624,4,1
100751,22238,10384,11854,5,1
100751,748,342,406,11,1
100751,5312,2207,3105,12,3
100751,1474,702,772,19,1
100751,20764,9682,11082,20,1
100751,29498,13662,15836,21,4
100751,26548,12353,14195,22,1
100751,26247,12160,14087,23,1
100751,6428,2820,3608,24,1
100751,19819,9340,10479,25,1
100751,301,193,108,31,1
100751,2950,1309,1641,32,3
100751,1144,586,558,39,1
100751,18675,8754,9921,40,1
100751,5254,2101,3153,41,4
100751,2892,1203,1689,42,1
100751,2445,1054,1391,43,1
100751,26,10,16,44,1
100751,2419,1044,1375,45,1
100751,447,149,298,51,1
100751,2362,898,1464,52,3
100751,330,116,214,59,1
100751,2089,928,1161,60,1
100760,1906,738,1168,1,4
100760,1906,738,1168,2,1
100760,1779,656,1123,3,1
100760,561,258,303,4,1
100760,1218,398,820,5,1
100760,127,82,45,11,1
100760,90,32,58,19,1
100760,1128,366,762,20,1
100760,953,421,532,21,4
100760,953,421,532,22,1
100760,950,419,531,23,1
100760,470,216,254,24,1
100760,480,203,277,25,1
100760,3,2,1,31,1
100760,45,24,21,39,1
100760,435,179,256,40,1
100760,953,317,636,41,4
100760,953,317,636,42,1
100760,829,237,592,43,1
100760,91,42,49,44,1
100760,738,195,543,45,1
100760,124,80,44,51,1
100760,45,8,37,59,1
100760,693,187,506,60,1
100812,3170,1107,2063,1,4
100812,3170,1107,2063,2,1
100812,2999,1049,1950,3,1
100812,2999,1049,1950,5,1
100812,171,58,113,11,1
100812,738,259,479,19,1
100812,2261,790,1471,20,1
100812,1350,419,931,21,4
100812,1350,419,931,22,1
100812,1349,419,930,23,1
100812,1349,419,930,25,1
100812,1,0,1,31,1
100812,421,143,278,39,1
100812,928,276,652,40,1
100812,1820,688,1132,41,4
100812,1820,688,1132,42,1
100812,1650,630,1020,43,1
100812,1650,630,1020,45,1
100812,170,58,112,51,1
100812,317,116,201,59,1
100812,1333,514,819,60,1
100830,5084,1884,3200,1,4
100830,4322,1645,2677,2,1
100830,4322,1645,2677,3,1
100830,671,264,407,4,1
100830,3651,1381,2270,5,1
100830,762,239,523,12,3
100830,434,156,278,19,1
100830,3217,1225,1992,20,1
100830,3223,1220,2003,21,4
100830,2999,1138,1861,22,1
100830,2999,1138,1861,23,1
100830,589,229,360,24,1
100830,2410,909,1501,25,1
100830,224,82,142,32,3
100830,315,121,194,39,1
100830,2095,788,1307,40,1
100830,1861,664,1197,41,4
100830,1323,507,816,42,1
100830,1323,507,816,43,1
100830,82,35,47,44,1
100830,1241,472,769,45,1
100830,538,157,381,52,3
100830,119,35,84,59,1
100830,1122,437,685,60,1
100858,24864,12628,12236,1,4
100858,19799,10108,9691,2,1
100858,19761,10091,9670,3,1
100858,3726,1791,1935,4,1
100858,16035,8300,7735,5,1
100858,38,17,21,11,1
100858,5065,2520,2545,12,3
100858,1052,610,442,19,1
100858,14983,7690,7293,20,1
100858,21093,10379,10714,21,4
100858,18011,8973,9038,22,1
100858,17978,8956,9022,23,1
100858,3696,1780,1916,24,1
100858,14282,7176,7106,25,1
100858,33,17,16,31,1
100858,3082,1406,1676,32,3
100858,942,549,393,39,1
100858,13340,6627,6713,40,1
100858,3771,2249,1522,41,4
100858,1788,1135,653,42,1
100858,1783,1135,648,43,1
100858,30,11,19,44,1
100858,1753,1124,629,45,1
100858,5,0,5,51,1
100858,1983,1114,869,52,3
100858,110,61,49,59,1
100858,1643,1063,580,60,1
100937,1188,643,545,1,4
100937,1188,643,545,2,1
100937,1181,641,540,3,1
100937,356,202,154,4,1
100937,825,439,386,5,1
100937,7,2,5,11,1
100937,27,8,19,19,1
100937,798,431,367,20,1
100937,1167,632,535,21,4
100937,1167,632,535,22,1
100937,1167,632,535,23,1
100937,356,202,154,24,1
100937,811,430,381,25,1
100937,27,8,19,39,1
100937,784,422,362,40,1
100937,21,11,10,41,4
100937,21,11,10,42,1
100937,14,9,5,43,1
100937,14,9,5,45,1
100937,7,2,5,51,1
100937,14,9,5,60,1
101028,1837,680,1157,1,4
101028,1837,680,1157,2,1
101028,1769,653,1116,3,1
101028,421,185,236,4,1
101028,1348,468,880,5,1
101028,68,27,41,11,1
101028,328,118,210,19,1
101028,1020,350,670,20,1
101028,1053,419,634,21,4
101028,1053,419,634,22,1
101028,1051,418,633,23,1
101028,333,141,192,24,1
101028,718,277,441,25,1
101028,2,1,1,31,1
101028,167,75,92,39,1
101028,551,202,349,40,1
101028,784,261,523,41,4
101028,784,261,523,42,1
101028,718,235,483,43,1
101028,88,44,44,44,1
101028,630,191,439,45,1
101028,66,26,40,51,1
101028,161,43,118,59,1
101028,469,148,321,60,1
101073,600,349,251,1,4
101073,600,349,251,2,1
101073,523,305,218,3,1
101073,149,105,44,4,1
101073,374,200,174,5,1
101073,77,44,33,11,1
101073,42,39,3,19,1
101073,332,161,171,20,1
101073,543,338,205,21,4
101073,543,338,205,22,1
101073,490,299,191,23,1
101073,147,105,42,24,1
101073,343,194,149,25,1
101073,53,39,14,31,1
101073,39,39,0,39,1
101073,304,155,149,40,1
101073,57,11,46,41,4
101073,57,11,46,42,1
101073,33,6,27,43,1
101073,2,0,2,44,1
101073,31,6,25,45,1
101073,24,5,19,51,1
101073,3,0,3,59,1
101073,28,6,22,60,1
101116,682,177,505,1,4
101116,599,160,439,2,1
101116,599,160,439,3,1
101116,43,11,32,4,1
101116,556,149,407,5,1
101116,83,17,66,12,3
101116,144,42,102,19,1
101116,412,107,305,20,1
101116,313,92,221,21,4
101116,311,92,219,22,1
101116,311,92,219,23,1
101116,27,7,20,24,1
101116,284,85,199,25,1
101116,2,0,2,32,3
101116,63,20,43,39,1
101116,221,65,156,40,1
101116,369,85,284,41,4
101116,288,68,220,42,1
101116,288,68,220,43,1
101116,16,4,12,44,1
101116,272,64,208,45,1
101116,81,17,64,52,3
101116,81,22,59,59,1
101116,191,42,149,60,1
101143,2333,1336,997,1,4
101143,2333,1336,997,2,1
101143,1984,1111,873,3,1
101143,414,234,180,4,1
101143,1570,877,693,5,1
101143,349,225,124,11,1
101143,329,172,157,19,1
101143,1241,705,536,20,1
101143,1318,771,547,21,4
101143,1318,771,547,22,1
111434,1403,589,814,11,1
111434,846,331,515,19,1
111434,3688,1253,2435,20,1
111434,1202,508,694,21,4
111434,1202,508,694,22,1
111434,1147,486,661,23,1
111434,279,134,145,24,1
111434,868,352,516,25,1
111434,55,22,33,31,1
111434,89,39,50,39,1
111434,779,313,466,40,1
111434,5418,1961,3457,41,4
111434,5418,1961,3457,42,1
111434,4070,1394,2676,43,1
111434,404,162,242,44,1
111434,3666,1232,2434,45,1
111434,1348,567,781,51,1
111434,757,292,465,59,1
111434,2909,940,1969,60,1
111461,18508,9658,8850,1,4
111461,18508,9658,8850,2,1
111461,16784,8735,8049,3,1
111461,3092,1605,1487,4,1
111461,13692,7130,6562,5,1
111461,1724,923,801,11,1
111461,1388,695,693,19,1
111461,12304,6435,5869,20,1
111461,6446,3332,3114,21,4
111461,6446,3332,3114,22,1
111461,6329,3266,3063,23,1
111461,1611,825,786,24,1
111461,4718,2441,2277,25,1
111461,117,66,51,31,1
111461,448,229,219,39,1
111461,4270,2212,2058,40,1
111461,12062,6326,5736,41,4
111461,12062,6326,5736,42,1
111461,10455,5469,4986,43,1
111461,1481,780,701,44,1
111461,8974,4689,4285,45,1
111461,1607,857,750,51,1
111461,940,466,474,59,1
111461,8034,4223,3811,60,1
111513,167,4,163,1,4
111513,167,4,163,2,1
111513,167,4,163,3,1
111513,79,1,78,4,1
111513,88,3,85,5,1
111513,88,3,85,20,1
111513,74,2,72,21,4
111513,74,2,72,22,1
111513,74,2,72,23,1
111513,44,1,43,24,1
111513,30,1,29,25,1
111513,30,1,29,40,1
111513,93,2,91,41,4
111513,93,2,91,42,1
111513,93,2,91,43,1
111513,35,0,35,44,1
111513,58,2,56,45,1
111513,58,2,56,60,1
111638,606,128,478,1,4
111638,606,128,478,2,1
111638,606,128,478,3,1
111638,46,7,39,4,1
111638,560,121,439,5,1
111638,79,18,61,19,1
111638,481,103,378,20,1
111638,606,128,478,21,4
111638,606,128,478,22,1
111638,606,128,478,23,1
111638,46,7,39,24,1
111638,560,121,439,25,1
111638,79,18,61,39,1
111638,481,103,378,40,1
111708,267,224,43,1,4
111708,267,224,43,2,1
111708,267,224,43,3,1
111708,73,59,14,4,1
111708,194,165,29,5,1
111708,194,165,29,20,1
111708,158,123,35,21,4
111708,158,123,35,22,1
111708,158,123,35,23,1
111708,41,29,12,24,1
111708,117,94,23,25,1
111708,117,94,23,40,1
111708,109,101,8,41,4
111708,109,101,8,42,1
111708,109,101,8,43,1
111708,32,30,2,44,1
111708,77,71,6,45,1
111708,77,71,6,60,1
111717,345,173,172,1,4
111717,345,173,172,2,1
111717,345,173,172,3,1
111717,103,45,58,4,1
111717,242,128,114,5,1
111717,242,128,114,20,1
111717,324,172,152,21,4
111717,324,172,152,22,1
111717,324,172,152,23,1
111717,103,45,58,24,1
111717,221,127,94,25,1
111717,221,127,94,40,1
111717,21,1,20,41,4
111717,21,1,20,42,1
111717,21,1,20,43,1
111717,21,1,20,45,1
111717,21,1,20,60,1
111726,234,151,83,1,4
111726,234,151,83,2,1
111726,234,151,83,3,1
111726,83,53,30,4,1
111726,151,98,53,5,1
111726,151,98,53,20,1
111726,234,151,83,21,4
111726,234,151,83,22,1
111726,234,151,83,23,1
111726,83,53,30,24,1
111726,151,98,53,25,1
111726,151,98,53,40,1
111744,103,100,3,1,4
111744,103,100,3,2,1
111744,103,100,3,3,1
111744,28,25,3,4,1
111744,75,75,0,5,1
111744,75,75,0,20,1
111744,103,100,3,21,4
111744,103,100,3,22,1
111744,103,100,3,23,1
111744,28,25,3,24,1
111744,75,75,0,25,1
111744,75,75,0,40,1
111762,88,45,43,1,4
111762,88,45,43,2,1
111762,88,45,43,3,1
111762,30,14,16,4,1
111762,58,31,27,5,1
111762,58,31,27,20,1
111762,88,45,43,21,4
111762,88,45,43,22,1
111762,88,45,43,23,1
111762,30,14,16,24,1
111762,58,31,27,25,1
111762,58,31,27,40,1
111771,104,67,37,1,4
111771,104,67,37,2,1
111771,104,67,37,3,1
111771,32,16,16,4,1
111771,72,51,21,5,1
111771,72,51,21,20,1
111771,104,67,37,21,4
111771,104,67,37,22,1
111771,104,67,37,23,1
111771,32,16,16,24,1
111771,72,51,21,25,1
111771,72,51,21,40,1
111799,65,18,47,1,4
111799,65,18,47,2,1
111799,65,18,47,3,1
111799,28,10,18,4,1
111799,37,8,29,5,1
111799,37,8,29,20,1
111799,65,18,47,21,4
111799,65,18,47,22,1
111799,65,18,47,23,1
111799,28,10,18,24,1
111799,37,8,29,25,1
111799,37,8,29,40,1
111887,21404,9717,11687,1,4
111887,21404,9717,11687,2,1
111887,20011,9127,10884,3,1
111887,3497,1768,1729,4,1
111887,16514,7359,9155,5,1
111887,1393,590,803,11,1
111887,1679,796,883,19,1
111887,14835,6563,8272,20,1
111887,6958,3298,3660,21,4
111887,6958,3298,3660,22,1
111887,6844,3246,3598,23,1
111887,1435,716,719,24,1
111887,5409,2530,2879,25,1
111887,114,52,62,31,1
111887,471,235,236,39,1
111887,4938,2295,2643,40,1
111887,14446,6419,8027,41,4
111887,14446,6419,8027,42,1
111887,13167,5881,7286,43,1
111887,2062,1052,1010,44,1
111887,11105,4829,6276,45,1
111887,1279,538,741,51,1
111887,1208,561,647,59,1
111887,9897,4268,5629,60,1
111896,4523,1631,2892,1,4
111896,4523,1631,2892,2,1
111896,4029,1461,2568,3,1
111896,594,272,322,4,1
111896,3435,1189,2246,5,1
111896,494,170,324,11,1
111896,815,262,553,19,1
111896,2620,927,1693,20,1
111896,944,396,548,21,4
111896,944,396,548,22,1
111896,933,390,543,23,1
111896,225,113,112,24,1
111896,708,277,431,25,1
111896,11,6,5,31,1
111896,97,53,44,39,1
111896,611,224,387,40,1
111896,3579,1235,2344,41,4
111896,3579,1235,2344,42,1
111896,3096,1071,2025,43,1
111896,369,159,210,44,1
111896,2727,912,1815,45,1
111896,483,164,319,51,1
111896,718,209,509,59,1
111896,2009,703,1306,60,1
111920,13142,6108,7034,1,4
111920,13142,6108,7034,2,1
111920,12082,5654,6428,3,1
111920,1961,1072,889,4,1
111920,10121,4582,5539,5,1
111920,1060,454,606,11,1
111920,1323,607,716,19,1
111920,8798,3975,4823,20,1
111920,3939,1920,2019,21,4
111920,3939,1920,2019,22,1
111920,3889,1897,1992,23,1
111920,823,450,373,24,1
111920,3066,1447,1619,25,1
111920,50,23,27,31,1
111920,236,100,136,39,1
111920,2830,1347,1483,40,1
111920,9203,4188,5015,41,4
111920,9203,4188,5015,42,1
111920,8193,3757,4436,43,1
111920,1138,622,516,44,1
111920,7055,3135,3920,45,1
111920,1010,431,579,51,1
111920,1087,507,580,59,1
111920,5968,2628,3340,60,1
111939,19211,8135,11076,1,4
111939,19211,8135,11076,2,1
111939,17217,7233,9984,3,1
111939,3656,1686,1970,4,1
111939,13561,5547,8014,5,1
111939,1994,902,1092,11,1
111939,1252,520,732,19,1
111939,12309,5027,7282,20,1
111939,5664,2483,3181,21,4
111939,5664,2483,3181,22,1
111939,5534,2428,3106,23,1
111939,1247,564,683,24,1
111939,4287,1864,2423,25,1
111939,130,55,75,31,1
111939,316,133,183,39,1
111939,3971,1731,2240,40,1
111939,13547,5652,7895,41,4
111939,13547,5652,7895,42,1
111939,11683,4805,6878,43,1
111939,2409,1122,1287,44,1
111939,9274,3683,5591,45,1
111939,1864,847,1017,51,1
111939,936,387,549,59,1
111939,8338,3296,5042,60,1
111948,7892,3269,4623,1,4
111948,6005,2473,3532,2,1
111948,5940,2442,3498,3,1
111948,1289,484,805,4,1
111948,4651,1958,2693,5,1
111948,65,31,34,11,1
111948,1887,796,1091,12,3
111948,394,164,230,19,1
111948,4257,1794,2463,20,1
111948,7071,2906,4165,21,4
111948,5753,2331,3422,22,1
111948,5733,2321,3412,23,1
111948,1284,480,804,24,1
111948,4449,1841,2608,25,1
111948,20,10,10,31,1
111948,1318,575,743,32,3
111948,382,158,224,39,1
111948,4067,1683,2384,40,1
111948,821,363,458,41,4
111948,252,142,110,42,1
111948,207,121,86,43,1
111948,5,4,1,44,1
111948,202,117,85,45,1
111948,45,21,24,51,1
111948,569,221,348,52,3
111948,12,6,6,59,1
111948,190,111,79,60,1
111966,515,167,348,1,4
111966,85,42,43,2,1
111966,83,41,42,3,1
111966,5,0,5,4,1
111966,78,41,37,5,1
111966,2,1,1,11,1
111966,430,125,305,12,3
111966,28,17,11,19,1
111966,50,24,26,20,1
111966,390,118,272,21,4
111966,41,20,21,22,1
111966,41,20,21,23,1
111966,4,0,4,24,1
111966,37,20,17,25,1
111966,349,98,251,32,3
111966,24,17,7,39,1
111966,13,3,10,40,1
111966,125,49,76,41,4
111966,44,22,22,42,1
111966,42,21,21,43,1
111966,1,0,1,44,1
111966,41,21,20,45,1
111966,2,1,1,51,1
111966,81,27,54,52,3
111966,4,0,4,59,1
111966,37,21,16,60,1
112075,4046,1730,2316,1,4
112075,1944,735,1209,2,1
112075,1916,723,1193,3,1
112075,373,137,236,4,1
112075,1543,586,957,5,1
112075,28,12,16,11,1
112075,2102,995,1107,12,3
112075,224,108,116,19,1
112075,1319,478,841,20,1
112075,3345,1361,1984,21,4
112075,1746,672,1074,22,1
112075,1742,672,1070,23,1
112075,373,137,236,24,1
112075,1369,535,834,25,1
112075,4,0,4,31,1
112075,1599,689,910,32,3
112075,220,106,114,39,1
112075,1149,429,720,40,1
112075,701,369,332,41,4
112075,198,63,135,42,1
112075,174,51,123,43,1
112075,174,51,123,45,1
112075,24,12,12,51,1
112075,503,306,197,52,3
112075,4,2,2,59,1
112075,170,49,121,60,1
112084,914,429,485,1,4
112084,892,422,470,2,1
112084,889,420,469,3,1
112084,125,53,72,4,1
112084,764,367,397,5,1
112084,3,2,1,11,1
112084,22,7,15,12,3
112084,155,61,94,19,1
112084,609,306,303,20,1
112084,817,385,432,21,4
112084,795,378,417,22,1
112084,795,378,417,23,1
112084,125,53,72,24,1
112084,670,325,345,25,1
112084,22,7,15,32,3
112084,131,50,81,39,1
112084,539,275,264,40,1
112084,97,44,53,41,4
112084,97,44,53,42,1
112084,94,42,52,43,1
112084,94,42,52,45,1
112084,3,2,1,51,1
112084,24,11,13,59,1
112084,70,31,39,60,1
112127,79,32,47,1,4
112127,79,32,47,12,3
112127,45,16,29,21,4
112127,45,16,29,32,3
112127,34,16,18,41,4
112127,34,16,18,52,3
112172,12920,6026,6894,1,4
112172,12920,6026,6894,2,1
112172,11494,5300,6194,3,1
112172,2312,1128,1184,4,1
112172,9182,4172,5010,5,1
112172,1426,726,700,11,1
112172,938,414,524,19,1
112172,8244,3758,4486,20,1
112172,4931,2328,2603,21,4
112172,4931,2328,2603,22,1
112172,4764,2233,2531,23,1
112172,1217,582,635,24,1
112172,3547,1651,1896,25,1
112172,167,95,72,31,1
112172,343,147,196,39,1
112172,3204,1504,1700,40,1
112172,7989,3698,4291,41,4
112172,7989,3698,4291,42,1
112172,6730,3067,3663,43,1
112172,1095,546,549,44,1
112172,5635,2521,3114,45,1
112172,1259,631,628,51,1
112172,595,267,328,59,1
112172,5040,2254,2786,60,1
112181,96,4,92,1,4
112181,96,4,92,2,1
112181,96,4,92,3,1
112181,28,0,28,4,1
112181,68,4,64,5,1
112181,68,4,64,20,1
112181,89,3,86,21,4
112181,89,3,86,22,1
112181,89,3,86,23,1
112181,28,0,28,24,1
112181,61,3,58,25,1
112181,61,3,58,40,1
112181,7,1,6,41,4
112181,7,1,6,42,1
112181,7,1,6,43,1
112181,7,1,6,45,1
112181,7,1,6,60,1
112190,26706,12917,13789,1,4
112190,26706,12917,13789,2,1
112190,24662,11917,12745,3,1
112190,3505,1759,1746,4,1
112190,21157,10158,10999,5,1
112190,2044,1000,1044,11,1
112190,1743,833,910,19,1
112190,19414,9325,10089,20,1
112190,9198,4703,4495,21,4
112190,9198,4703,4495,22,1
112190,9086,4636,4450,23,1
112190,1572,786,786,24,1
112190,7514,3850,3664,25,1
112190,112,67,45,31,1
112190,469,246,223,39,1
112190,7045,3604,3441,40,1
112190,17508,8214,9294,41,4
112190,17508,8214,9294,42,1
112190,15576,7281,8295,43,1
112190,1933,973,960,44,1
112190,13643,6308,7335,45,1
112190,1932,933,999,51,1
112190,1274,587,687,59,1
112190,12369,5721,6648,60,1
112251,2204,1036,1168,1,4
112251,2204,1036,1168,12,3
112251,1532,720,812,21,4
112251,1532,720,812,32,3
112251,672,316,356,41,4
112251,672,316,356,52,3
112260,1328,686,642,1,4
112260,1316,678,638,2,1
112260,1311,676,635,3,1
112260,337,165,172,4,1
112260,974,511,463,5,1
112260,5,2,3,11,1
112260,12,8,4,12,3
112260,18,9,9,19,1
112260,956,502,454,20,1
112260,1324,685,639,21,4
112260,1312,677,635,22,1
112260,1307,675,632,23,1
112260,337,165,172,24,1
112260,970,510,460,25,1
112260,5,2,3,31,1
112260,12,8,4,32,3
112260,18,9,9,39,1
112260,952,501,451,40,1
112260,4,1,3,41,4
112260,4,1,3,42,1
112260,4,1,3,43,1
112260,4,1,3,45,1
112260,4,1,3,60,1
112288,354,44,310,1,4
112288,354,44,310,2,1
112288,354,44,310,3,1
112288,126,17,109,4,1
112288,228,27,201,5,1
112288,228,27,201,20,1
112288,354,44,310,21,4
112288,354,44,310,22,1
112288,354,44,310,23,1
112288,126,17,109,24,1
112288,228,27,201,25,1
112288,228,27,201,40,1
112367,608,53,555,1,4
112367,608,53,555,2,1
112367,608,53,555,3,1
112367,446,40,406,4,1
112367,162,13,149,5,1
112367,162,13,149,20,1
112367,366,29,337,21,4
112367,366,29,337,22,1
112367,366,29,337,23,1
112367,251,21,230,24,1
112367,115,8,107,25,1
112367,115,8,107,40,1
112367,242,24,218,41,4
112367,242,24,218,42,1
112367,242,24,218,43,1
112367,195,19,176,44,1
112367,47,5,42,45,1
112367,47,5,42,60,1
112385,10378,5709,4669,1,4
112385,10378,5709,4669,2,1
112385,8999,4951,4048,3,1
112385,1279,883,396,4,1
112385,7720,4068,3652,5,1
112385,1379,758,621,11,1
112385,2177,1097,1080,19,1
112385,5543,2971,2572,20,1
112385,1476,716,760,21,4
112385,1476,716,760,22,1
112385,1381,669,712,23,1
112385,182,86,96,24,1
112385,1199,583,616,25,1
112385,95,47,48,31,1
112385,218,89,129,39,1
112385,981,494,487,40,1
112385,8902,4993,3909,41,4
112385,8902,4993,3909,42,1
112385,7618,4282,3336,43,1
112385,1097,797,300,44,1
112385,6521,3485,3036,45,1
112385,1284,711,573,51,1
112385,1959,1008,951,59,1
112385,4562,2477,2085,60,1
112394,472,354,118,1,4
112394,462,349,113,2,1
112394,457,346,111,3,1
112394,103,69,34,4,1
112394,354,277,77,5,1
112394,5,3,2,11,1
112394,10,5,5,12,3
112394,43,36,7,19,1
112394,311,241,70,20,1
112394,322,229,93,21,4
112394,315,225,90,22,1
112394,314,224,90,23,1
112394,73,44,29,24,1
112394,241,180,61,25,1
112394,1,1,0,31,1
112394,7,4,3,32,3
112394,31,25,6,39,1
112394,210,155,55,40,1
112394,150,125,25,41,4
112394,147,124,23,42,1
112394,143,122,21,43,1
112394,30,25,5,44,1
112394,113,97,16,45,1
112394,4,2,2,51,1
112394,3,1,2,52,3
112394,12,11,1,59,1
112394,101,86,15,60,1
112446,833,688,145,1,4
112446,532,489,43,2,1
112446,532,489,43,3,1
112446,65,54,11,4,1
112446,467,435,32,5,1
112446,301,199,102,12,3
112446,3,3,0,19,1
112446,464,432,32,20,1
112446,734,596,138,21,4
112446,433,397,36,22,1
112446,433,397,36,23,1
112446,65,54,11,24,1
112446,368,343,25,25,1
112446,301,199,102,32,3
112446,3,3,0,39,1
112446,365,340,25,40,1
112446,99,92,7,41,4
112446,99,92,7,42,1
112446,99,92,7,43,1
112446,99,92,7,45,1
112446,99,92,7,60,1
112455,40,3,37,1,4
112455,40,3,37,2,1
112455,40,3,37,3,1
112455,10,0,10,4,1
112455,30,3,27,5,1
112455,30,3,27,20,1
112455,40,3,37,21,4
112455,40,3,37,22,1
112455,40,3,37,23,1
112455,10,0,10,24,1
112455,30,3,27,25,1
112455,30,3,27,40,1
112525,3748,1440,2308,1,4
112525,3748,1440,2308,12,3
112525,3684,1424,2260,21,4
112525,3684,1424,2260,32,3
112525,64,16,48,41,4
112525,64,16,48,52,3
112561,2626,1153,1473,1,4
112561,2626,1153,1473,2,1
112561,2425,1055,1370,3,1
112561,592,269,323,4,1
112561,1833,786,1047,5,1
112561,201,98,103,11,1
112561,227,97,130,19,1
112561,1606,689,917,20,1
112561,843,406,437,21,4
112561,843,406,437,22,1
112561,834,401,433,23,1
112561,298,152,146,24,1
112561,536,249,287,25,1
112561,9,5,4,31,1
112561,47,21,26,39,1
112561,489,228,261,40,1
112561,1783,747,1036,41,4
112561,1783,747,1036,42,1
112561,1591,654,937,43,1
112561,294,117,177,44,1
112561,1297,537,760,45,1
112561,192,93,99,51,1
112561,180,76,104,59,1
112561,1117,461,656,60,1
112570,314,210,104,1,4
112570,314,210,104,2,1
112570,314,210,104,3,1
112570,44,30,14,4,1
112570,270,180,90,5,1
112570,26,19,7,19,1
112570,244,161,83,20,1
112570,285,190,95,21,4
112570,285,190,95,22,1
112570,285,190,95,23,1
112570,44,30,14,24,1
112570,241,160,81,25,1
112570,25,18,7,39,1
112570,216,142,74,40,1
112570,29,20,9,41,4
112570,29,20,9,42,1
112570,29,20,9,43,1
112570,29,20,9,45,1
112570,1,1,0,59,1
112570,28,19,9,60,1
112686,7693,2762,4931,1,4
112686,7693,2762,4931,2,1
112686,6846,2449,4397,3,1
112686,943,433,510,4,1
112686,5903,2016,3887,5,1
112686,847,313,534,11,1
112686,1204,447,757,19,1
112686,4699,1569,3130,20,1
112686,1896,748,1148,21,4
112686,1896,748,1148,22,1
112686,1858,733,1125,23,1
112686,412,194,218,24,1
112686,1446,539,907,25,1
112686,38,15,23,31,1
112686,220,92,128,39,1
112686,1226,447,779,40,1
112686,5797,2014,3783,41,4
112686,5797,2014,3783,42,1
112686,4988,1716,3272,43,1
112686,531,239,292,44,1
112686,4457,1477,2980,45,1
112686,809,298,511,51,1
112686,984,355,629,59,1
112686,3473,1122,2351,60,1
112783,268,120,148,1,4
112783,268,120,148,2,1
112783,268,120,148,3,1
112783,73,32,41,4,1
112783,195,88,107,5,1
112783,195,88,107,20,1
112783,266,119,147,21,4
112783,266,119,147,22,1
112783,266,119,147,23,1
112783,72,32,40,24,1
112783,194,87,107,25,1
112783,194,87,107,40,1
112783,2,1,1,41,4
112783,2,1,1,42,1
112783,2,1,1,43,1
112783,1,0,1,44,1
112783,1,1,0,45,1
112783,1,1,0,60,1
112826,6865,2853,4012,1,4
112826,6865,2853,4012,2,1
112826,5468,2278,3190,3,1
112826,683,350,333,4,1
112826,4785,1928,2857,5,1
112826,1397,575,822,11,1
112826,512,236,276,19,1
112826,4273,1692,2581,20,1
112826,2153,990,1163,21,4
112826,2153,990,1163,22,1
112826,1980,902,1078,23,1
112826,313,162,151,24,1
112826,1667,740,927,25,1
112826,173,88,85,31,1
112826,122,67,55,39,1
112826,1545,673,872,40,1
112826,4712,1863,2849,41,4
112826,4712,1863,2849,42,1
112826,3488,1376,2112,43,1
112826,370,188,182,44,1
112826,3118,1188,1930,45,1
112826,1224,487,737,51,1
112826,390,169,221,59,1
112826,2728,1019,1709,60,1
113096,13949,6173,7776,1,4
113096,13949,6173,7776,2,1
113096,12852,5707,7145,3,1
113096,2171,1074,1097,4,1
113096,10681,4633,6048,5,1
101143,1282,757,525,23,1
101143,340,190,150,24,1
101143,942,567,375,25,1
101143,36,14,22,31,1
101143,205,109,96,39,1
101143,737,458,279,40,1
101143,1015,565,450,41,4
101143,1015,565,450,42,1
101143,702,354,348,43,1
101143,74,44,30,44,1
101143,628,310,318,45,1
101143,313,211,102,51,1
101143,124,63,61,59,1
101143,504,247,257,60,1
101161,4362,1593,2769,1,4
101161,4362,1593,2769,2,1
101161,4182,1534,2648,3,1
101161,1288,518,770,4,1
101161,2894,1016,1878,5,1
101161,180,59,121,11,1
101161,498,177,321,19,1
101161,2396,839,1557,20,1
101161,2573,992,1581,21,4
101161,2573,992,1581,22,1
101161,2565,987,1578,23,1
101161,1078,426,652,24,1
101161,1487,561,926,25,1
101161,8,5,3,31,1
101161,292,111,181,39,1
101161,1195,450,745,40,1
101161,1789,601,1188,41,4
101161,1789,601,1188,42,1
101161,1617,547,1070,43,1
101161,210,92,118,44,1
101161,1407,455,952,45,1
101161,172,54,118,51,1
101161,206,66,140,59,1
101161,1201,389,812,60,1
101189,3193,1203,1990,1,4
101189,2617,962,1655,2,1
101189,2358,844,1514,3,1
101189,298,156,142,4,1
101189,2060,688,1372,5,1
101189,259,118,141,11,1
101189,576,241,335,12,3
101189,460,148,312,19,1
101189,1600,540,1060,20,1
101189,2321,925,1396,21,4
101189,1803,713,1090,22,1
101189,1803,713,1090,23,1
101189,287,152,135,24,1
101189,1516,561,955,25,1
101189,518,212,306,32,3
101189,303,107,196,39,1
101189,1213,454,759,40,1
101189,872,278,594,41,4
101189,814,249,565,42,1
101189,555,131,424,43,1
101189,11,4,7,44,1
101189,544,127,417,45,1
101189,259,118,141,51,1
101189,58,29,29,52,3
101189,157,41,116,59,1
101189,387,86,301,60,1
101240,5797,2364,3433,1,4
101240,5797,2364,3433,2,1
101240,5480,2223,3257,3,1
101240,1388,641,747,4,1
101240,4092,1582,2510,5,1
101240,317,141,176,11,1
101240,381,151,230,19,1
101240,3711,1431,2280,20,1
101240,3185,1480,1705,21,4
101240,3185,1480,1705,22,1
101240,3099,1428,1671,23,1
101240,1143,541,602,24,1
101240,1956,887,1069,25,1
101240,86,52,34,31,1
101240,209,93,116,39,1
101240,1747,794,953,40,1
101240,2612,884,1728,41,4
101240,2612,884,1728,42,1
101240,2381,795,1586,43,1
101240,245,100,145,44,1
101240,2136,695,1441,45,1
101240,231,89,142,51,1
101240,172,58,114,59,1
101240,1964,637,1327,60,1
101277,89,1,88,1,4
101277,89,1,88,2,1
101277,89,1,88,3,1
101277,32,0,32,4,1
101277,57,1,56,5,1
101277,57,1,56,20,1
101277,89,1,88,21,4
101277,89,1,88,22,1
101277,89,1,88,23,1
101277,32,0,32,24,1
101277,57,1,56,25,1
101277,57,1,56,40,1
101286,4686,1590,3096,1,4
101286,4686,1590,3096,2,1
101286,4293,1456,2837,3,1
101286,1044,450,594,4,1
101286,3249,1006,2243,5,1
101286,393,134,259,11,1
101286,352,131,221,19,1
101286,2897,875,2022,20,1
101286,2294,884,1410,21,4
101286,2294,884,1410,22,1
101286,2286,878,1408,23,1
101286,840,362,478,24,1
101286,1446,516,930,25,1
101286,8,6,2,31,1
101286,193,80,113,39,1
101286,1253,436,817,40,1
101286,2392,706,1686,41,4
101286,2392,706,1686,42,1
101286,2007,578,1429,43,1
101286,204,88,116,44,1
101286,1803,490,1313,45,1
101286,385,128,257,51,1
101286,159,51,108,59,1
101286,1644,439,1205,60,1
101295,5281,1998,3283,1,4
101295,5281,1998,3283,2,1
101295,4904,1847,3057,3,1
101295,1194,544,650,4,1
101295,3710,1303,2407,5,1
101295,377,151,226,11,1
101295,327,87,240,19,1
101295,3383,1216,2167,20,1
101295,2954,1250,1704,21,4
101295,2954,1250,1704,22,1
101295,2917,1241,1676,23,1
101295,997,456,541,24,1
101295,1920,785,1135,25,1
101295,37,9,28,31,1
101295,196,61,135,39,1
101295,1724,724,1000,40,1
101295,2327,748,1579,41,4
101295,2327,748,1579,42,1
101295,1987,606,1381,43,1
101295,197,88,109,44,1
101295,1790,518,1272,45,1
101295,340,142,198,51,1
101295,131,26,105,59,1
101295,1659,492,1167,60,1
101301,1745,590,1155,1,4
101301,1745,590,1155,2,1
101301,1604,551,1053,3,1
101301,408,195,213,4,1
101301,1196,356,840,5,1
101301,141,39,102,11,1
101301,178,52,126,19,1
101301,1018,304,714,20,1
101301,1068,406,662,21,4
101301,1068,406,662,22,1
101301,1067,405,662,23,1
101301,371,178,193,24,1
101301,696,227,469,25,1
101301,1,1,0,31,1
101301,110,34,76,39,1
101301,586,193,393,40,1
101301,677,184,493,41,4
101301,677,184,493,42,1
101301,537,146,391,43,1
101301,37,17,20,44,1
101301,500,129,371,45,1
101301,140,38,102,51,1
101301,68,18,50,59,1
101301,432,111,321,60,1
101365,320,100,220,1,4
101365,320,100,220,2,1
101365,318,98,220,3,1
101365,51,28,23,4,1
101365,267,70,197,5,1
101365,2,2,0,11,1
101365,65,7,58,19,1
101365,202,63,139,20,1
101365,160,38,122,21,4
101365,160,38,122,22,1
101365,160,38,122,23,1
101365,25,7,18,24,1
101365,135,31,104,25,1
101365,18,3,15,39,1
101365,117,28,89,40,1
101365,160,62,98,41,4
101365,160,62,98,42,1
101365,158,60,98,43,1
101365,26,21,5,44,1
101365,132,39,93,45,1
101365,2,2,0,51,1
101365,47,4,43,59,1
101365,85,35,50,60,1
101435,1110,553,557,1,4
101435,1110,553,557,2,1
101435,1100,545,555,3,1
101435,261,148,113,4,1
101435,839,397,442,5,1
101435,10,8,2,11,1
101435,51,30,21,19,1
101435,788,367,421,20,1
101435,902,491,411,21,4
101435,902,491,411,22,1
101435,898,487,411,23,1
101435,261,148,113,24,1
101435,637,339,298,25,1
101435,4,4,0,31,1
101435,51,30,21,39,1
101435,586,309,277,40,1
101435,208,62,146,41,4
101435,208,62,146,42,1
101435,202,58,144,43,1
101435,202,58,144,45,1
101435,6,4,2,51,1
101435,202,58,144,60,1
101453,94,81,13,1,4
101453,69,58,11,2,1
101453,67,57,10,3,1
101453,8,6,2,4,1
101453,59,51,8,5,1
101453,2,1,1,11,1
101453,25,23,2,12,3
101453,17,16,1,19,1
101453,42,35,7,20,1
101453,33,27,6,21,4
101453,32,26,6,22,1
101453,32,26,6,23,1
101453,7,5,2,24,1
101453,25,21,4,25,1
101453,1,1,0,32,3
101453,8,8,0,39,1
101453,17,13,4,40,1
101453,61,54,7,41,4
101453,37,32,5,42,1
101453,35,31,4,43,1
101453,1,1,0,44,1
101453,34,30,4,45,1
101453,2,1,1,51,1
101453,24,22,2,52,3
101453,9,8,1,59,1
101453,25,22,3,60,1
101462,1383,642,741,1,4
101462,1383,642,741,2,1
101462,1040,463,577,3,1
101462,213,115,98,4,1
101462,827,348,479,5,1
101462,343,179,164,11,1
101462,232,102,130,19,1
101462,595,246,349,20,1
101462,635,298,337,21,4
101462,635,298,337,22,1
101462,635,298,337,23,1
101462,142,78,64,24,1
101462,493,220,273,25,1
101462,144,66,78,39,1
101462,349,154,195,40,1
101462,748,344,404,41,4
101462,748,344,404,42,1
101462,405,165,240,43,1
101462,71,37,34,44,1
101462,334,128,206,45,1
101462,343,179,164,51,1
101462,88,36,52,59,1
101462,246,92,154,60,1
101471,513,385,128,1,4
101471,513,385,128,2,1
101471,504,385,119,3,1
101471,284,215,69,4,1
101471,220,170,50,5,1
101471,9,0,9,11,1
101471,1,1,0,19,1
101471,219,169,50,20,1
101471,421,301,120,21,4
101471,421,301,120,22,1
101471,412,301,111,23,1
101471,246,177,69,24,1
101471,166,124,42,25,1
101471,9,0,9,31,1
101471,166,124,42,40,1
101471,92,84,8,41,4
101471,92,84,8,42,1
101471,92,84,8,43,1
101471,38,38,0,44,1
101471,54,46,8,45,1
101471,1,1,0,59,1
101471,53,45,8,60,1
101480,8693,3632,5061,1,4
101480,7588,3207,4381,2,1
101480,7195,3001,4194,3,1
101480,1158,561,597,4,1
101480,6037,2440,3597,5,1
101480,393,206,187,11,1
101480,1105,425,680,12,3
101480,634,203,431,19,1
101480,5403,2237,3166,20,1
101480,5982,2602,3380,21,4
101480,5779,2522,3257,22,1
101480,5664,2425,3239,23,1
101480,1142,552,590,24,1
101480,4522,1873,2649,25,1
101480,115,97,18,31,1
101480,203,80,123,32,3
101480,409,147,262,39,1
101480,4113,1726,2387,40,1
101480,2711,1030,1681,41,4
101480,1809,685,1124,42,1
101480,1531,576,955,43,1
101480,16,9,7,44,1
101480,1515,567,948,45,1
101480,278,109,169,51,1
101480,902,345,557,52,3
101480,225,56,169,59,1
101480,1290,511,779,60,1
101499,1091,460,631,1,4
101499,1091,460,631,2,1
101499,1037,428,609,3,1
101499,299,154,145,4,1
101499,738,274,464,5,1
101499,54,32,22,11,1
101499,130,44,86,19,1
101499,608,230,378,20,1
101499,618,282,336,21,4
101499,618,282,336,22,1
101499,613,278,335,23,1
101499,246,120,126,24,1
101499,367,158,209,25,1
101499,5,4,1,31,1
101499,73,30,43,39,1
101499,294,128,166,40,1
101499,473,178,295,41,4
101499,473,178,295,42,1
101499,424,150,274,43,1
101499,53,34,19,44,1
101499,371,116,255,45,1
101499,49,28,21,51,1
101499,57,14,43,59,1
101499,314,102,212,60,1
101505,8542,3328,5214,1,4
101505,8542,3328,5214,2,1
101505,7494,2937,4557,3,1
101505,1658,710,948,4,1
101505,5836,2227,3609,5,1
101505,1048,391,657,11,1
101505,935,378,557,19,1
101505,4901,1849,3052,20,1
101505,2891,1229,1662,21,4
101505,2891,1229,1662,22,1
101505,2861,1211,1650,23,1
101505,1053,446,607,24,1
101505,1808,765,1043,25,1
101505,30,18,12,31,1
101505,385,170,215,39,1
101505,1423,595,828,40,1
101505,5651,2099,3552,41,4
101505,5651,2099,3552,42,1
101505,4633,1726,2907,43,1
101505,605,264,341,44,1
101505,4028,1462,2566,45,1
101505,1018,373,645,51,1
101505,550,208,342,59,1
101505,3478,1254,2224,60,1
101514,11186,4886,6300,1,4
101514,11186,4886,6300,2,1
101514,9970,4300,5670,3,1
101514,2081,954,1127,4,1
101514,7889,3346,4543,5,1
101514,1216,586,630,11,1
101514,839,322,517,19,1
101514,7050,3024,4026,20,1
101514,4254,2001,2253,21,4
101514,4254,2001,2253,22,1
101514,4202,1971,2231,23,1
101514,1225,559,666,24,1
101514,2977,1412,1565,25,1
101514,52,30,22,31,1
101514,346,157,189,39,1
101514,2631,1255,1376,40,1
101514,6932,2885,4047,41,4
101514,6932,2885,4047,42,1
101514,5768,2329,3439,43,1
101514,856,395,461,44,1
101514,4912,1934,2978,45,1
101514,1164,556,608,51,1
101514,493,165,328,59,1
101514,4419,1769,2650,60,1
101541,347,16,331,1,4
101541,347,16,331,2,1
101541,331,10,321,3,1
101541,67,0,67,4,1
101541,264,10,254,5,1
101541,16,6,10,11,1
101541,38,1,37,19,1
101541,226,9,217,20,1
101541,262,1,261,21,4
101541,262,1,261,22,1
101541,261,1,260,23,1
101541,66,0,66,24,1
101541,195,1,194,25,1
101541,1,0,1,31,1
101541,22,1,21,39,1
101541,173,0,173,40,1
101541,85,15,70,41,4
101541,85,15,70,42,1
101541,70,9,61,43,1
101541,1,0,1,44,1
101541,69,9,60,45,1
101541,15,6,9,51,1
101541,16,0,16,59,1
101541,53,9,44,60,1
101569,3028,1233,1795,1,4
101569,3028,1233,1795,2,1
101569,2894,1197,1697,3,1
101569,699,344,355,4,1
101569,2195,853,1342,5,1
101569,134,36,98,11,1
101569,318,154,164,19,1
101569,1877,699,1178,20,1
101569,1788,762,1026,21,4
101569,1788,762,1026,22,1
101569,1787,762,1025,23,1
101569,585,272,313,24,1
101569,1202,490,712,25,1
101569,1,0,1,31,1
101569,182,99,83,39,1
101569,1020,391,629,40,1
101569,1240,471,769,41,4
101569,1240,471,769,42,1
101569,1107,435,672,43,1
101569,114,72,42,44,1
101569,993,363,630,45,1
101569,133,36,97,51,1
101569,136,55,81,59,1
101569,857,308,549,60,1
101587,4427,1219,3208,1,4
101587,1999,857,1142,2,1
101587,1988,851,1137,3,1
101587,380,158,222,4,1
101587,1608,693,915,5,1
101587,11,6,5,11,1
101587,2428,362,2066,12,3
101587,252,114,138,19,1
101587,1356,579,777,20,1
101587,3890,1059,2831,21,4
101587,1696,749,947,22,1
101587,1694,748,946,23,1
101587,375,155,220,24,1
101587,1319,593,726,25,1
101587,2,1,1,31,1
101587,2194,310,1884,32,3
101587,219,104,115,39,1
101587,1100,489,611,40,1
101587,537,160,377,41,4
101587,303,108,195,42,1
101587,294,103,191,43,1
101587,5,3,2,44,1
101587,289,100,189,45,1
101587,9,5,4,51,1
101587,234,52,182,52,3
101587,33,10,23,59,1
101587,256,90,166,60,1
101602,1570,606,964,1,4
101602,1570,606,964,2,1
101602,1372,501,871,3,1
101602,464,194,270,4,1
101602,908,307,601,5,1
101602,198,105,93,11,1
101602,124,37,87,19,1
101602,784,270,514,20,1
101602,972,394,578,21,4
101602,972,394,578,22,1
101602,969,393,576,23,1
101602,410,173,237,24,1
101602,559,220,339,25,1
101602,3,1,2,31,1
101602,82,27,55,39,1
101602,477,193,284,40,1
101602,598,212,386,41,4
101602,598,212,386,42,1
101602,403,108,295,43,1
101602,54,21,33,44,1
101602,349,87,262,45,1
101602,195,104,91,51,1
101602,42,10,32,59,1
101602,307,77,230,60,1
101648,418,340,78,1,4
101648,418,340,78,2,1
101648,411,339,72,3,1
101648,249,205,44,4,1
101648,162,134,28,5,1
101648,7,1,6,11,1
101648,27,23,4,19,1
101648,135,111,24,20,1
101648,411,339,72,21,4
101648,411,339,72,22,1
101648,411,339,72,23,1
101648,249,205,44,24,1
101648,162,134,28,25,1
101648,27,23,4,39,1
101648,135,111,24,40,1
101648,7,1,6,41,4
101648,7,1,6,42,1
101648,7,1,6,51,1
101675,1666,874,792,1,4
101675,1666,874,792,2,1
101675,1663,873,790,3,1
101675,406,245,161,4,1
101675,1257,628,629,5,1
101675,3,1,2,11,1
101675,156,85,71,19,1
101675,1101,543,558,20,1
101675,1577,834,743,21,4
101675,1577,834,743,22,1
101675,1576,834,742,23,1
101675,404,243,161,24,1
101675,1172,591,581,25,1
101675,1,0,1,31,1
101675,147,80,67,39,1
101675,1025,511,514,40,1
101675,89,40,49,41,4
101675,89,40,49,42,1
101675,87,39,48,43,1
101675,2,2,0,44,1
101675,85,37,48,45,1
101675,2,1,1,51,1
101675,9,5,4,59,1
101675,76,32,44,60,1
101693,1610,513,1097,1,4
101693,1481,489,992,2,1
101693,1472,486,986,3,1
101693,259,106,153,4,1
101693,1213,380,833,5,1
101693,9,3,6,11,1
101693,129,24,105,12,3
101693,128,46,82,19,1
101693,1085,334,751,20,1
101693,1288,461,827,21,4
101693,1257,456,801,22,1
101693,1257,456,801,23,1
101693,258,106,152,24,1
101693,999,350,649,25,1
101693,31,5,26,32,3
101693,113,45,68,39,1
101693,886,305,581,40,1
101693,322,52,270,41,4
101693,224,33,191,42,1
101693,215,30,185,43,1
101693,1,0,1,44,1
101693,214,30,184,45,1
101693,9,3,6,51,1
101693,98,19,79,52,3
101693,15,1,14,59,1
101693,199,29,170,60,1
101709,3062,1003,2059,1,4
101709,2618,890,1728,2,1
101709,2610,886,1724,3,1
101709,531,176,355,4,1
101709,2079,710,1369,5,1
101709,8,4,4,11,1
101709,444,113,331,12,3
101709,173,65,108,19,1
101709,1906,645,1261,20,1
101709,2526,802,1724,21,4
101709,2350,770,1580,22,1
101709,2348,769,1579,23,1
101709,519,172,347,24,1
101709,1829,597,1232,25,1
101709,2,1,1,31,1
101709,176,32,144,32,3
101709,158,58,100,39,1
101709,1671,539,1132,40,1
101709,536,201,335,41,4
101709,268,120,148,42,1
101709,262,117,145,43,1
101709,12,4,8,44,1
101709,250,113,137,45,1
101709,6,3,3,51,1
101709,268,81,187,52,3
101709,15,7,8,59,1
101709,235,106,129,60,1
101736,3854,1667,2187,1,4
101736,3854,1667,2187,2,1
101736,3235,1320,1915,3,1
101736,811,370,441,4,1
101736,2424,950,1474,5,1
101736,619,347,272,11,1
101736,237,89,148,19,1
101736,2187,861,1326,20,1
101736,1840,856,984,21,4
101736,1840,856,984,22,1
101736,1834,851,983,23,1
101736,668,308,360,24,1
101736,1166,543,623,25,1
101736,6,5,1,31,1
101736,138,61,77,39,1
101736,1028,482,546,40,1
101736,2014,811,1203,41,4
101736,2014,811,1203,42,1
101736,1401,469,932,43,1
101736,143,62,81,44,1
101736,1258,407,851,45,1
101736,613,342,271,51,1
101736,99,28,71,59,1
101736,1159,379,780,60,1
101879,6931,2915,4016,1,4
101879,5881,2504,3377,2,1
101879,5536,2382,3154,3,1
101879,970,398,572,4,1
101879,4566,1984,2582,5,1
101879,345,122,223,11,1
101879,1050,411,639,12,3
101879,523,230,293,19,1
101879,4043,1754,2289,20,1
101879,5133,2192,2941,21,4
101879,4795,2043,2752,22,1
101879,4784,2040,2744,23,1
101879,953,388,565,24,1
101879,3831,1652,2179,25,1
101879,11,3,8,31,1
101879,338,149,189,32,3
101879,449,205,244,39,1
101879,3382,1447,1935,40,1
101879,1798,723,1075,41,4
101879,1086,461,625,42,1
101879,752,342,410,43,1
101879,17,10,7,44,1
101879,735,332,403,45,1
101879,334,119,215,51,1
101879,712,262,450,52,3
101879,74,25,49,59,1
101879,661,307,354,60,1
101897,2834,1113,1721,1,4
101897,2834,1113,1721,2,1
101897,2376,897,1479,3,1
101897,664,280,384,4,1
101897,1712,617,1095,5,1
101897,458,216,242,11,1
101897,102,42,60,19,1
101897,1610,575,1035,20,1
101897,1450,609,841,21,4
101897,1450,609,841,22,1
101897,1432,600,832,23,1
101897,538,223,315,24,1
101897,894,377,517,25,1
101897,18,9,9,31,1
101897,69,31,38,39,1
101897,825,346,479,40,1
101897,1384,504,880,41,4
101897,1384,504,880,42,1
101897,944,297,647,43,1
101897,126,57,69,44,1
101897,818,240,578,45,1
101897,440,207,233,51,1
101897,33,11,22,59,1
101897,785,229,556,60,1
101912,1903,807,1096,1,4
101912,1861,791,1070,2,1
101912,1854,789,1065,3,1
101912,365,151,214,4,1
101912,1489,638,851,5,1
101912,7,2,5,11,1
101912,42,16,26,12,3
101912,75,37,38,19,1
101912,1414,601,813,20,1
101912,1810,761,1049,21,4
101912,1771,747,1024,22,1
101912,1770,747,1023,23,1
101912,364,151,213,24,1
101912,1406,596,810,25,1
101912,1,0,1,31,1
101912,39,14,25,32,3
101912,74,36,38,39,1
101912,1332,560,772,40,1
101912,93,46,47,41,4
101912,90,44,46,42,1
101912,84,42,42,43,1
101912,1,0,1,44,1
101912,83,42,41,45,1
101912,6,2,4,51,1
101912,3,2,1,52,3
101912,1,1,0,59,1
101912,82,41,41,60,1
101949,1349,522,827,1,4
101949,1349,522,827,2,1
101949,1218,444,774,3,1
101949,469,220,249,4,1
101949,749,224,525,5,1
101949,131,78,53,11,1
101949,112,38,74,19,1
101949,637,186,451,20,1
101949,886,369,517,21,4
101949,886,369,517,22,1
101949,886,369,517,23,1
101949,427,207,220,24,1
101949,459,162,297,25,1
101949,79,29,50,39,1
101949,380,133,247,40,1
101949,463,153,310,41,4
101949,463,153,310,42,1
101949,332,75,257,43,1
101949,42,13,29,44,1
101949,290,62,228,45,1
101949,131,78,53,51,1
101949,33,9,24,59,1
101949,257,53,204,60,1
101958,102,4,98,1,4
101958,102,4,98,2,1
101958,102,4,98,3,1
101958,4,0,4,4,1
101958,98,4,94,5,1
101958,98,4,94,20,1
101958,102,4,98,21,4
101958,102,4,98,22,1
101958,102,4,98,23,1
101958,4,0,4,24,1
101958,98,4,94,25,1
101958,98,4,94,40,1
101994,517,196,321,1,4
101994,517,196,321,2,1
101994,414,138,276,3,1
101994,77,38,39,4,1
101994,337,100,237,5,1
101994,103,58,45,11,1
101994,74,23,51,19,1
101994,263,77,186,20,1
101994,260,100,160,21,4
101994,260,100,160,22,1
101994,260,100,160,23,1
101994,68,32,36,24,1
101994,192,68,124,25,1
101994,47,15,32,39,1
101994,145,53,92,40,1
101994,257,96,161,41,4
101994,257,96,161,42,1
101994,154,38,116,43,1
101994,9,6,3,44,1
101994,145,32,113,45,1
101994,103,58,45,51,1
101994,27,8,19,59,1
101994,118,24,94,60,1
102030,3896,1570,2326,1,4
102030,3896,1570,2326,2,1
102030,3363,1337,2026,3,1
102030,965,482,483,4,1
102030,2398,855,1543,5,1
102030,533,233,300,11,1
102030,399,152,247,19,1
102030,1999,703,1296,20,1
102030,2171,961,1210,21,4
102030,2171,961,1210,22,1
102030,2170,960,1210,23,1
102030,835,419,416,24,1
102030,1335,541,794,25,1
102030,1,1,0,31,1
102030,276,109,167,39,1
102030,1059,432,627,40,1
102030,1725,609,1116,41,4
102030,1725,609,1116,42,1
102030,1193,377,816,43,1
102030,130,63,67,44,1
102030,1063,314,749,45,1
102030,532,232,300,51,1
102030,123,43,80,59,1
102030,940,271,669,60,1
102049,4833,1826,3007,1,4
102049,3013,1047,1966,2,1
102049,2995,1039,1956,3,1
102049,765,267,498,4,1
102049,2230,772,1458,5,1
102049,18,8,10,11,1
102049,1820,779,1041,12,3
102049,148,47,101,19,1
102049,2082,725,1357,20,1
102049,4361,1688,2673,21,4
102049,2850,998,1852,22,1
102049,2844,996,1848,23,1
102049,755,263,492,24,1
102049,2089,733,1356,25,1
102049,6,2,4,31,1
102049,1511,690,821,32,3
102049,127,44,83,39,1
102049,1962,689,1273,40,1
102049,472,138,334,41,4
102049,163,49,114,42,1
102049,151,43,108,43,1
102049,10,4,6,44,1
102049,141,39,102,45,1
102049,12,6,6,51,1
102049,309,89,220,52,3
102049,21,3,18,59,1
102049,120,36,84,60,1
102058,611,336,275,1,4
102058,582,320,262,2,1
102058,447,255,192,3,1
102058,240,130,110,4,1
102058,207,125,82,5,1
102058,135,65,70,11,1
102058,29,16,13,12,3
102058,97,65,32,19,1
102058,110,60,50,20,1
102058,478,257,221,21,4
102058,455,245,210,22,1
102058,320,180,140,23,1
102058,190,100,90,24,1
102058,130,80,50,25,1
102058,135,65,70,31,1
102058,23,12,11,32,3
102058,60,40,20,39,1
102058,70,40,30,40,1
102058,133,79,54,41,4
102058,127,75,52,42,1
102058,127,75,52,43,1
102058,50,30,20,44,1
102058,77,45,32,45,1
102058,6,4,2,52,3
102058,37,25,12,59,1
102058,40,20,20,60,1
102067,5068,2209,2859,1,4
102067,5068,2209,2859,2,1
102067,4859,2122,2737,3,1
102067,1356,655,701,4,1
102067,3503,1467,2036,5,1
102067,209,87,122,11,1
102067,445,221,224,19,1
102067,3058,1246,1812,20,1
102067,2468,1211,1257,21,4
102067,2468,1211,1257,22,1
102067,2454,1203,1251,23,1
102067,877,447,430,24,1
102067,1577,756,821,25,1
102067,14,8,6,31,1
102067,227,128,99,39,1
102067,1350,628,722,40,1
102067,2600,998,1602,41,4
102067,2600,998,1602,42,1
102067,2405,919,1486,43,1
102067,479,208,271,44,1
102067,1926,711,1215,45,1
102067,195,79,116,51,1
102067,218,93,125,59,1
102067,1708,618,1090,60,1
102076,2295,907,1388,1,4
102076,2295,907,1388,2,1
102076,2161,846,1315,3,1
102076,716,298,418,4,1
102076,1445,548,897,5,1
102076,134,61,73,11,1
102076,177,65,112,19,1
102076,1268,483,785,20,1
102076,1541,648,893,21,4
102076,1541,648,893,22,1
102076,1538,647,891,23,1
102076,656,277,379,24,1
102076,882,370,512,25,1
102076,3,1,2,31,1
102076,111,46,65,39,1
102076,771,324,447,40,1
102076,754,259,495,41,4
102076,754,259,495,42,1
102076,623,199,424,43,1
102076,60,21,39,44,1
102076,563,178,385,45,1
102076,131,60,71,51,1
102076,66,19,47,59,1
102076,497,159,338,60,1
102094,15065,5806,9259,1,4
102094,11307,4896,6411,2,1
102094,11048,4787,6261,3,1
102094,1878,823,1055,4,1
102094,9170,3964,5206,5,1
102094,259,109,150,11,1
102094,3758,910,2848,12,3
102094,952,395,557,19,1
102094,8218,3569,4649,20,1
102094,12028,4633,7395,21,4
102094,8767,3838,4929,22,1
102094,8754,3830,4924,23,1
102094,1834,804,1030,24,1
102094,6920,3026,3894,25,1
102094,13,8,5,31,1
102094,3261,795,2466,32,3
102094,779,332,447,39,1
102094,6141,2694,3447,40,1
102094,3037,1173,1864,41,4
102094,2540,1058,1482,42,1
102094,2294,957,1337,43,1
102094,44,19,25,44,1
102094,2250,938,1312,45,1
102094,246,101,145,51,1
102094,497,115,382,52,3
102094,173,63,110,59,1
102094,2077,875,1202,60,1
102234,1422,563,859,1,4
102234,1292,520,772,2,1
102234,1269,504,765,3,1
102234,435,172,263,4,1
102234,834,332,502,5,1
102234,23,16,7,11,1
102234,130,43,87,12,3
102234,47,29,18,19,1
102234,787,303,484,20,1
102234,1210,488,722,21,4
102234,1205,488,717,22,1
102234,1205,488,717,23,1
102234,432,172,260,24,1
102234,773,316,457,25,1
102234,5,0,5,32,3
102234,44,28,16,39,1
102234,729,288,441,40,1
102234,212,75,137,41,4
102234,87,32,55,42,1
102234,64,16,48,43,1
102234,3,0,3,44,1
102234,61,16,45,45,1
102234,23,16,7,51,1
102234,125,43,82,52,3
102234,3,1,2,59,1
102234,58,15,43,60,1
102261,161,94,67,1,4
102261,161,94,67,2,1
102261,160,94,66,3,1
102261,17,8,9,4,1
102261,143,86,57,5,1
102261,1,0,1,11,1
102261,30,17,13,19,1
102261,113,69,44,20,1
102261,130,79,51,21,4
102261,130,79,51,22,1
102261,130,79,51,23,1
102261,16,8,8,24,1
102261,114,71,43,25,1
102261,25,15,10,39,1
102261,89,56,33,40,1
102261,31,15,16,41,4
102261,31,15,16,42,1
102261,30,15,15,43,1
102261,1,0,1,44,1
102261,29,15,14,45,1
102261,1,0,1,51,1
102261,5,2,3,59,1
102261,24,13,11,60,1
102270,863,443,420,1,4
102270,863,443,420,2,1
102270,863,443,420,3,1
102270,163,77,86,4,1
102270,700,366,334,5,1
102270,81,52,29,19,1
102270,619,314,305,20,1
102270,808,411,397,21,4
102270,808,411,397,22,1
102270,808,411,397,23,1
102270,163,77,86,24,1
102270,645,334,311,25,1
102270,62,40,22,39,1
102270,583,294,289,40,1
102270,55,32,23,41,4
102270,55,32,23,42,1
102270,55,32,23,43,1
102270,55,32,23,45,1
102270,19,12,7,59,1
102270,36,20,16,60,1
102298,932,440,492,1,4
102298,932,440,492,2,1
102298,894,411,483,3,1
102298,276,149,127,4,1
102298,618,262,356,5,1
102298,38,29,9,11,1
102298,5,0,5,19,1
102298,613,262,351,20,1
102298,849,386,463,21,4
102298,849,386,463,22,1
102298,849,386,463,23,1
102298,256,136,120,24,1
102298,593,250,343,25,1
102298,5,0,5,39,1
102298,588,250,338,40,1
102298,83,54,29,41,4
102298,83,54,29,42,1
102298,45,25,20,43,1
102298,20,13,7,44,1
102298,25,12,13,45,1
102298,38,29,9,51,1
102298,25,12,13,60,1
102313,1351,673,678,1,4
102313,1351,673,678,2,1
102313,1262,643,619,3,1
102313,270,149,121,4,1
102313,992,494,498,5,1
102313,89,30,59,11,1
102313,183,92,91,19,1
102313,809,402,407,20,1
102313,711,394,317,21,4
102313,711,394,317,22,1
102313,710,393,317,23,1
102313,201,110,91,24,1
102313,509,283,226,25,1
102313,1,1,0,31,1
102313,112,65,47,39,1
102313,397,218,179,40,1
102313,640,279,361,41,4
102313,640,279,361,42,1
102313,552,250,302,43,1
102313,69,39,30,44,1
102313,483,211,272,45,1
102313,88,29,59,51,1
102313,71,27,44,59,1
102313,412,184,228,60,1
102368,20573,7506,13067,1,4
102368,16316,6221,10095,2,1
102368,16208,6175,10033,3,1
102368,2121,862,1259,4,1
102368,14087,5313,8774,5,1
102368,108,46,62,11,1
102368,4257,1285,2972,12,3
102368,1331,445,886,19,1
102368,12756,4868,7888,20,1
102368,10334,3975,6359,21,4
102368,9141,3614,5527,22,1
102368,9109,3602,5507,23,1
102368,1613,674,939,24,1
102368,7496,2928,4568,25,1
102368,32,12,20,31,1
102368,1193,361,832,32,3
102368,647,229,418,39,1
102368,6849,2699,4150,40,1
102368,10239,3531,6708,41,4
102368,7175,2607,4568,42,1
102368,7099,2573,4526,43,1
102368,508,188,320,44,1
102368,6591,2385,4206,45,1
102368,76,34,42,51,1
102368,3064,924,2140,52,3
102368,684,216,468,59,1
102368,5907,2169,3738,60,1
102377,3118,1258,1860,1,4
102377,2584,1093,1491,2,1
102377,2584,1093,1491,3,1
102377,659,246,413,4,1
102377,1925,847,1078,5,1
102377,534,165,369,12,3
102377,55,27,28,19,1
102377,1870,820,1050,20,1
102377,2954,1183,1771,21,4
102377,2468,1038,1430,22,1
102377,2468,1038,1430,23,1
102377,645,244,401,24,1
102377,1823,794,1029,25,1
102377,486,145,341,32,3
102377,54,27,27,39,1
102377,1769,767,1002,40,1
102377,164,75,89,41,4
102377,116,55,61,42,1
102377,116,55,61,43,1
102377,14,2,12,44,1
102377,102,53,49,45,1
102377,48,20,28,52,3
102377,1,0,1,59,1
102377,101,53,48,60,1
102395,347,241,106,1,4
102395,95,79,16,2,1
102395,80,68,12,3,1
102395,80,68,12,5,1
102395,15,11,4,11,1
102395,252,162,90,12,3
102395,26,23,3,19,1
102395,54,45,9,20,1
102395,89,61,28,21,4
102395,14,12,2,22,1
102395,14,12,2,23,1
102395,14,12,2,25,1
102395,75,49,26,32,3
102395,2,2,0,39,1
102395,12,10,2,40,1
102395,258,180,78,41,4
102395,81,67,14,42,1
102395,66,56,10,43,1
102395,66,56,10,45,1
102395,15,11,4,51,1
102395,177,113,64,52,3
102395,24,21,3,59,1
102395,42,35,7,60,1
102429,3490,1265,2225,1,4
102429,3490,1265,2225,2,1
102429,3212,1141,2071,3,1
102429,905,395,510,4,1
102429,2307,746,1561,5,1
102429,278,124,154,11,1
102429,264,86,178,19,1
102429,2043,660,1383,20,1
102429,1808,710,1098,21,4
102429,1808,710,1098,22,1
102429,1804,707,1097,23,1
102429,753,322,431,24,1
102429,1051,385,666,25,1
102429,4,3,1,31,1
102429,115,43,72,39,1
102429,936,342,594,40,1
102429,1682,555,1127,41,4
102429,1682,555,1127,42,1
102429,1408,434,974,43,1
102429,152,73,79,44,1
102429,1256,361,895,45,1
102429,274,121,153,51,1
102429,149,43,106,59,1
102429,1107,318,789,60,1
102553,17363,7086,10277,1,4
102553,16380,6762,9618,2,1
102553,13116,5470,7646,3,1
102553,1965,821,1144,4,1
102553,11151,4649,6502,5,1
102553,3264,1292,1972,11,1
102553,983,324,659,12,3
102553,613,257,356,19,1
102553,10538,4392,6146,20,1
102553,7904,3593,4311,21,4
102553,7679,3519,4160,22,1
102553,7193,3245,3948,23,1
102553,1411,603,808,24,1
102553,5782,2642,3140,25,1
102553,486,274,212,31,1
102553,225,74,151,32,3
102553,359,171,188,39,1
102553,5423,2471,2952,40,1
102553,9459,3493,5966,41,4
102553,8701,3243,5458,42,1
102553,5923,2225,3698,43,1
102553,554,218,336,44,1
102553,5369,2007,3362,45,1
102553,2778,1018,1760,51,1
102553,758,250,508,52,3
102553,254,86,168,59,1
102553,5115,1921,3194,60,1
102580,42,22,20,1,4
102580,42,22,20,2,1
102580,26,16,10,3,1
102580,13,5,8,4,1
102580,13,11,2,5,1
102580,16,6,10,11,1
102580,13,11,2,20,1
102580,21,13,8,21,4
102580,21,13,8,22,1
102580,21,13,8,23,1
102580,12,5,7,24,1
102580,9,8,1,25,1
102580,9,8,1,40,1
102580,21,9,12,41,4
102580,21,9,12,42,1
102580,5,3,2,43,1
102580,1,0,1,44,1
102580,4,3,1,45,1
102580,16,6,10,51,1
102580,4,3,1,60,1
102614,9166,3892,5274,1,4
102614,7989,3411,4578,2,1
102614,5729,2530,3199,3,1
102614,981,480,501,4,1
102614,4748,2050,2698,5,1
102614,2260,881,1379,11,1
102614,1177,481,696,12,3
102614,462,209,253,19,1
102614,4286,1841,2445,20,1
102614,4283,2097,2186,21,4
102614,3654,1824,1830,22,1
102614,3555,1772,1783,23,1
102614,775,403,372,24,1
102614,2780,1369,1411,25,1
102614,99,52,47,31,1
102614,629,273,356,32,3
102614,288,137,151,39,1
102614,2492,1232,1260,40,1
102614,4883,1795,3088,41,4
102614,4335,1587,2748,42,1
102614,2174,758,1416,43,1
102614,206,77,129,44,1
102614,1968,681,1287,45,1
102614,2161,829,1332,51,1
102614,548,208,340,52,3
102614,174,72,102,59,1
102614,1794,609,1185,60,1
102632,2996,1040,1956,1,4
102632,2645,945,1700,2,1
102632,1488,520,968,3,1
102632,228,105,123,4,1
102632,1260,415,845,5,1
102632,1157,425,732,11,1
102632,351,95,256,12,3
102632,174,55,119,19,1
102632,1086,360,726,20,1
102632,889,381,508,21,4
102632,821,358,463,22,1
102632,759,327,432,23,1
102632,159,78,81,24,1
102632,600,249,351,25,1
102632,62,31,31,31,1
102632,68,23,45,32,3
102632,101,42,59,39,1
102632,499,207,292,40,1
102632,2107,659,1448,41,4
102632,1824,587,1237,42,1
102632,729,193,536,43,1
102632,69,27,42,44,1
102632,660,166,494,45,1
102632,1095,394,701,51,1
102632,283,72,211,52,3
102632,73,13,60,59,1
102632,587,153,434,60,1
102669,669,235,434,1,4
102669,387,132,255,2,1
102669,340,118,222,3,1
102669,32,16,16,4,1
102669,308,102,206,5,1
102669,47,14,33,11,1
102669,282,103,179,12,3
102669,63,21,42,19,1
102669,245,81,164,20,1
102669,323,124,199,21,4
102669,245,92,153,22,1
102669,209,82,127,23,1
102669,31,16,15,24,1
102669,178,66,112,25,1
102669,36,10,26,31,1
102669,78,32,46,32,3
102669,33,10,23,39,1
102669,145,56,89,40,1
102669,346,111,235,41,4
102669,142,40,102,42,1
102669,131,36,95,43,1
102669,1,0,1,44,1
102669,130,36,94,45,1
102669,11,4,7,51,1
102669,204,71,133,52,3
102669,30,11,19,59,1
102669,100,25,75,60,1
102711,1347,1032,315,1,4
102711,1347,1032,315,2,1
102711,1347,1032,315,3,1
102711,359,256,103,4,1
102711,988,776,212,5,1
102711,988,776,212,20,1
102711,301,149,152,21,4
102711,301,149,152,22,1
102711,301,149,152,23,1
102711,180,107,73,24,1
102711,121,42,79,25,1
102711,121,42,79,40,1
102711,1046,883,163,41,4
102711,1046,883,163,42,1
102711,1046,883,163,43,1
102711,179,149,30,44,1
102711,867,734,133,45,1
102711,867,734,133,60,1
102845,2191,611,1580,1,4
102845,2191,611,1580,2,1
102845,2191,611,1580,3,1
102845,1053,302,751,4,1
102845,1138,309,829,5,1
102845,1138,309,829,20,1
102845,2191,611,1580,21,4
102845,2191,611,1580,22,1
102845,2191,611,1580,23,1
102845,1053,302,751,24,1
102845,1138,309,829,25,1
102845,1138,309,829,40,1
103361,471,182,289,1,4
103361,471,182,289,2,1
103361,134,42,92,3,1
103361,8,3,5,4,1
103361,126,39,87,5,1
103361,337,140,197,11,1
103361,4,0,4,19,1
103361,122,39,83,20,1
103361,55,24,31,21,4
103361,55,24,31,22,1
103361,47,18,29,23,1
103361,5,1,4,24,1
103361,42,17,25,25,1
103361,8,6,2,31,1
103361,1,0,1,39,1
103361,41,17,24,40,1
103361,416,158,258,41,4
103361,416,158,258,42,1
103361,87,24,63,43,1
103361,3,2,1,44,1
103361,84,22,62,45,1
103361,329,134,195,51,1
103361,3,0,3,59,1
103361,81,22,59,60,1
103501,335,60,275,1,4
103501,335,60,275,2,1
103501,335,60,275,3,1
103501,102,19,83,4,1
103501,233,41,192,5,1
103501,4,2,2,19,1
103501,229,39,190,20,1
103501,335,60,275,21,4
103501,335,60,275,22,1
103501,335,60,275,23,1
103501,102,19,83,24,1
103501,233,41,192,25,1
103501,4,2,2,39,1
103501,229,39,190,40,1
103644,2761,742,2019,1,4
103644,2761,742,2019,2,1
103644,2761,742,2019,3,1
103644,110,26,84,4,1
103644,2651,716,1935,5,1
103644,712,204,508,19,1
103644,1939,512,1427,20,1
103644,1488,350,1138,21,4
103644,1488,350,1138,22,1
103644,1488,350,1138,23,1
103644,97,17,80,24,1
103644,1391,333,1058,25,1
103644,351,95,256,39,1
103644,1040,238,802,40,1
103644,1273,392,881,41,4
103644,1273,392,881,42,1
103644,1273,392,881,43,1
103644,13,9,4,44,1
103644,1260,383,877,45,1
103644,361,109,252,59,1
103644,899,274,625,60,1
103723,254,189,65,1,4
103723,254,189,65,2,1
103723,254,189,65,3,1
103723,254,189,65,5,1
103723,254,189,65,20,1
103723,206,150,56,21,4
103723,206,150,56,22,1
103723,206,150,56,23,1
103723,206,150,56,25,1
103723,206,150,56,40,1
103723,48,39,9,41,4
103723,48,39,9,42,1
103723,48,39,9,43,1
103723,48,39,9,45,1
103723,48,39,9,60,1
103732,43,8,35,1,4
103732,43,8,35,2,1
103732,43,8,35,3,1
103732,13,2,11,4,1
103732,30,6,24,5,1
103732,30,6,24,20,1
103732,34,6,28,21,4
103732,34,6,28,22,1
103732,34,6,28,23,1
103732,10,2,8,24,1
103732,24,4,20,25,1
103732,24,4,20,40,1
103732,9,2,7,41,4
103732,9,2,7,42,1
103732,9,2,7,43,1
103732,3,0,3,44,1
103732,6,2,4,45,1
103732,6,2,4,60,1
103741,175,10,165,1,4
103741,175,10,165,2,1
103741,175,10,165,3,1
103741,65,4,61,4,1
103741,110,6,104,5,1
103741,110,6,104,20,1
103741,140,9,131,21,4
103741,140,9,131,22,1
103741,140,9,131,23,1
103741,58,4,54,24,1
103741,82,5,77,25,1
103741,82,5,77,40,1
103741,35,1,34,41,4
103741,35,1,34,42,1
103741,35,1,34,43,1
103741,7,0,7,44,1
103741,28,1,27,45,1
103741,28,1,27,60,1
103778,1022,722,300,1,4
103778,2,2,0,2,1
103778,2,2,0,3,1
103778,2,2,0,4,1
103778,1020,720,300,12,3
103778,534,371,163,21,4
103778,534,371,163,32,3
103778,488,351,137,41,4
103778,2,2,0,42,1
103778,2,2,0,43,1
103778,2,2,0,44,1
103778,486,349,137,52,3
103787,79,34,45,1,4
103787,79,34,45,2,1
103787,77,33,44,3,1
103787,15,5,10,4,1
103787,62,28,34,5,1
103787,2,1,1,11,1
103787,4,0,4,19,1
103787,58,28,30,20,1
103787,68,29,39,21,4
103787,68,29,39,22,1
103787,68,29,39,23,1
103787,15,5,10,24,1
103787,53,24,29,25,1
103787,4,0,4,39,1
103787,49,24,25,40,1
103787,11,5,6,41,4
103787,11,5,6,42,1
103787,9,4,5,43,1
103787,9,4,5,45,1
103787,2,1,1,51,1
103787,9,4,5,60,1
103811,278,250,28,1,4
103811,278,250,28,2,1
103811,278,250,28,3,1
103811,15,13,2,4,1
103811,263,237,26,5,1
103811,263,237,26,20,1
103811,278,250,28,21,4
103811,278,250,28,22,1
103811,278,250,28,23,1
103811,15,13,2,24,1
103811,263,237,26,25,1
103811,263,237,26,40,1
103893,676,111,565,1,4
103893,676,111,565,2,1
103893,676,111,565,3,1
103893,132,21,111,4,1
103893,544,90,454,5,1
103893,57,7,50,19,1
103893,487,83,404,20,1
103893,676,111,565,21,4
103893,676,111,565,22,1
103893,676,111,565,23,1
103893,132,21,111,24,1
103893,544,90,454,25,1
103893,57,7,50,39,1
103893,487,83,404,40,1
103909,691,128,563,1,4
103909,691,128,563,2,1
103909,691,128,563,3,1
103909,100,11,89,4,1
103909,591,117,474,5,1
103909,64,14,50,19,1
103909,527,103,424,20,1
103909,624,112,512,21,4
103909,624,112,512,22,1
103909,624,112,512,23,1
103909,100,11,89,24,1
103909,524,101,423,25,1
103909,64,14,50,39,1
103909,460,87,373,40,1
103909,67,16,51,41,4
103909,67,16,51,42,1
103909,67,16,51,43,1
103909,67,16,51,45,1
103909,67,16,51,60,1
103927,440,93,347,1,4
103927,440,93,347,2,1
103927,440,93,347,3,1
103927,84,12,72,4,1
103927,356,81,275,5,1
103927,33,7,26,19,1
103927,323,74,249,20,1
103927,437,92,345,21,4
103927,437,92,345,22,1
103927,437,92,345,23,1
103927,84,12,72,24,1
103927,353,80,273,25,1
103927,33,7,26,39,1
103927,320,73,247,40,1
103927,3,1,2,41,4
103927,3,1,2,42,1
103927,3,1,2,43,1
103927,3,1,2,45,1
103927,3,1,2,60,1
103945,209,53,156,1,4
103945,209,53,156,2,1
103945,209,53,156,3,1
103945,126,32,94,4,1
103945,83,21,62,5,1
103945,83,21,62,20,1
103945,209,53,156,21,4
103945,209,53,156,22,1
103945,209,53,156,23,1
103945,126,32,94,24,1
103945,83,21,62,25,1
103945,83,21,62,40,1
103954,47,2,45,1,4
103954,47,2,45,2,1
103954,47,2,45,3,1
103954,3,0,3,4,1
103954,44,2,42,5,1
103954,44,2,42,20,1
103954,47,2,45,21,4
103954,47,2,45,22,1
103954,47,2,45,23,1
103954,3,0,3,24,1
103954,44,2,42,25,1
103954,44,2,42,40,1
103963,505,481,24,1,4
103963,505,481,24,2,1
103963,505,481,24,3,1
103963,162,154,8,4,1
103963,343,327,16,5,1
103963,343,327,16,20,1
103963,505,481,24,21,4
103963,505,481,24,22,1
103963,505,481,24,23,1
103963,162,154,8,24,1
103963,343,327,16,25,1
103963,343,327,16,40,1
104090,844,158,686,1,4
104090,828,157,671,2,1
104090,828,157,671,3,1
104090,402,81,321,4,1
104090,426,76,350,5,1
104090,16,1,15,12,3
104090,426,76,350,20,1
104090,844,158,686,21,4
104090,828,157,671,22,1
104090,828,157,671,23,1
104090,402,81,321,24,1
104090,426,76,350,25,1
104090,16,1,15,32,3
104090,426,76,350,40,1
104151,48702,27532,21170,1,4
104151,38730,21588,17142,2,1
104151,38480,21471,17009,3,1
104151,7171,4019,3152,4,1
104151,31309,17452,13857,5,1
104151,250,117,133,11,1
104151,9972,5944,4028,12,3
104151,3354,1826,1528,19,1
104151,27955,15626,12329,20,1
104151,42498,24011,18487,21,4
104151,34989,19401,15588,22,1
104151,34852,19336,15516,23,1
104151,7114,3982,3132,24,1
104151,27738,15354,12384,25,1
104151,137,65,72,31,1
104151,7509,4610,2899,32,3
104151,2863,1559,1304,39,1
104151,24875,13795,11080,40,1
104151,6204,3521,2683,41,4
104151,3741,2187,1554,42,1
104151,3628,2135,1493,43,1
104151,57,37,20,44,1
104151,3571,2098,1473,45,1
104151,113,52,61,51,1
104151,2463,1334,1129,52,3
104151,491,267,224,59,1
104151,3080,1831,1249,60,1
104160,8000,3459,4541,1,4
104160,8000,3459,4541,2,1
104160,7442,3247,4195,3,1
104160,1786,911,875,4,1
104160,5656,2336,3320,5,1
104160,558,212,346,11,1
104160,270,140,130,19,1
104160,5386,2196,3190,20,1
104160,2803,1293,1510,21,4
104160,2803,1293,1510,22,1
104160,2740,1267,1473,23,1
104160,844,417,427,24,1
104160,1896,850,1046,25,1
104160,63,26,37,31,1
104160,102,63,39,39,1
104160,1794,787,1007,40,1
104160,5197,2166,3031,41,4
104160,5197,2166,3031,42,1
104160,4702,1980,2722,43,1
104160,942,494,448,44,1
104160,3760,1486,2274,45,1
104160,495,186,309,51,1
104160,168,77,91,59,1
104160,3592,1409,2183,60,1
104179,40621,19520,21101,1,4
104179,31670,15111,16559,2,1
104179,31399,14954,16445,3,1
104179,6881,3184,3697,4,1
104179,24518,11770,12748,5,1
104179,271,157,114,11,1
104179,8951,4409,4542,12,3
104179,1984,1024,960,19,1
104179,22534,10746,11788,20,1
104179,35388,16947,18441,21,4
104179,28401,13448,14953,22,1
104179,28289,13385,14904,23,1
104179,6272,2913,3359,24,1
104179,22017,10472,11545,25,1
104179,112,63,49,31,1
104179,6987,3499,3488,32,3
104179,1549,802,747,39,1
104179,20468,9670,10798,40,1
104179,5233,2573,2660,41,4
104179,3269,1663,1606,42,1
104179,3110,1569,1541,43,1
104179,609,271,338,44,1
104179,2501,1298,1203,45,1
104179,159,94,65,51,1
104179,1964,910,1054,52,3
104179,435,222,213,59,1
104179,2066,1076,990,60,1
104188,221,104,117,1,4
104188,216,100,116,2,1
104188,216,100,116,3,1
104188,48,31,17,4,1
104188,168,69,99,5,1
104188,5,4,1,12,3
104188,7,1,6,19,1
104188,161,68,93,20,1
104188,131,63,68,21,4
104188,126,59,67,22,1
104188,126,59,67,23,1
104188,30,20,10,24,1
104188,96,39,57,25,1
104188,5,4,1,32,3
104188,2,1,1,39,1
104188,94,38,56,40,1
104188,90,41,49,41,4
104188,90,41,49,42,1
104188,90,41,49,43,1
104188,18,11,7,44,1
104188,72,30,42,45,1
104188,5,0,5,59,1
104188,67,30,37,60,1
104294,226,20,206,1,4
104294,226,20,206,2,1
104294,226,20,206,3,1
104294,99,11,88,4,1
104294,127,9,118,5,1
104294,127,9,118,20,1
104294,129,13,116,21,4
104294,129,13,116,22,1
104294,129,13,116,23,1
104294,62,8,54,24,1
104294,67,5,62,25,1
104294,67,5,62,40,1
104294,97,7,90,41,4
104294,97,7,90,42,1
104294,97,7,90,43,1
104294,37,3,34,44,1
104294,60,4,56,45,1
104294,60,4,56,60,1
104346,6445,2377,4068,1,4
104346,6445,2377,4068,2,1
104346,5462,2001,3461,3,1
104346,1270,569,701,4,1
104346,4192,1432,2760,5,1
104346,983,376,607,11,1
104346,822,261,561,19,1
104346,3370,1171,2199,20,1
104346,2129,905,1224,21,4
104346,2129,905,1224,22,1
104346,2002,842,1160,23,1
104346,544,279,265,24,1
104346,1458,563,895,25,1
104346,127,63,64,31,1
104346,244,106,138,39,1
104346,1214,457,757,40,1
104346,4316,1472,2844,41,4
104346,4316,1472,2844,42,1
104346,3460,1159,2301,43,1
104346,726,290,436,44,1
104346,2734,869,1865,45,1
104346,856,313,543,51,1
104346,578,155,423,59,1
104346,2156,714,1442,60,1
104364,684,288,396,1,4
104364,684,288,396,2,1
104364,684,288,396,3,1
104364,80,39,41,4,1
104364,604,249,355,5,1
104364,116,43,73,19,1
104364,488,206,282,20,1
104364,684,288,396,21,4
104364,684,288,396,22,1
104364,684,288,396,23,1
104364,80,39,41,24,1
104364,604,249,355,25,1
104364,116,43,73,39,1
104364,488,206,282,40,1
104391,83,8,75,1,4
104391,83,8,75,2,1
104391,83,8,75,3,1
104391,73,7,66,4,1
104391,10,1,9,5,1
104391,10,1,9,20,1
104391,83,8,75,21,4
104391,83,8,75,22,1
104391,83,8,75,23,1
104391,73,7,66,24,1
104391,10,1,9,25,1
104391,10,1,9,40,1
104425,4453,2085,2368,1,4
104425,4453,2085,2368,2,1
104425,3787,1779,2008,3,1
104425,803,403,400,4,1
104425,2984,1376,1608,5,1
104425,666,306,360,11,1
104425,301,145,156,19,1
104425,2683,1231,1452,20,1
104425,1649,768,881,21,4
104425,1649,768,881,22,1
104425,1567,715,852,23,1
104425,494,251,243,24,1
104425,1073,464,609,25,1
104425,82,53,29,31,1
104425,129,60,69,39,1
104425,944,404,540,40,1
104425,2804,1317,1487,41,4
104425,2804,1317,1487,42,1
104425,2220,1064,1156,43,1
104425,309,152,157,44,1
104425,1911,912,999,45,1
104425,584,253,331,51,1
104425,172,85,87,59,1
104425,1739,827,912,60,1
104434,53,1,52,1,4
104434,53,1,52,2,1
104434,53,1,52,3,1
104434,29,0,29,4,1
104434,24,1,23,5,1
104434,24,1,23,20,1
104434,53,1,52,21,4
104434,53,1,52,22,1
104434,53,1,52,23,1
104434,29,0,29,24,1
104434,24,1,23,25,1
104434,24,1,23,40,1
104443,113,15,98,1,4
104443,113,15,98,2,1
104443,113,15,98,3,1
104443,32,6,26,4,1
104443,81,9,72,5,1
104443,81,9,72,20,1
104443,86,12,74,21,4
104443,86,12,74,22,1
104443,86,12,74,23,1
104443,27,5,22,24,1
104443,59,7,52,25,1
104443,59,7,52,40,1
104443,27,3,24,41,4
104443,27,3,24,42,1
104443,27,3,24,43,1
104443,5,1,4,44,1
104443,22,2,20,45,1
104443,22,2,20,60,1
104504,143,38,105,1,4
104504,143,38,105,2,1
104504,143,38,105,3,1
104504,67,24,43,4,1
104504,76,14,62,5,1
104504,76,14,62,20,1
104504,96,25,71,21,4
104504,96,25,71,22,1
104504,96,25,71,23,1
104504,41,15,26,24,1
104504,55,10,45,25,1
104504,55,10,45,40,1
104504,47,13,34,41,4
104504,47,13,34,42,1
104504,47,13,34,43,1
104504,26,9,17,44,1
104504,21,4,17,45,1
104504,21,4,17,60,1
104568,273,10,263,1,4
104568,273,10,263,2,1
104568,273,10,263,3,1
104568,243,8,235,4,1
104568,30,2,28,5,1
104568,30,2,28,20,1
104568,177,7,170,21,4
104568,177,7,170,22,1
104568,177,7,170,23,1
104568,159,5,154,24,1
104568,18,2,16,25,1
104568,18,2,16,40,1
104568,96,3,93,41,4
104568,96,3,93,42,1
104568,96,3,93,43,1
104568,84,3,81,44,1
104568,12,0,12,45,1
104568,12,0,12,60,1
104577,6602,2945,3657,1,4
104577,6602,2945,3657,2,1
104577,4812,2306,2506,3,1
104577,1297,748,549,4,1
104577,3515,1558,1957,5,1
104577,1790,639,1151,11,1
104577,76,36,40,19,1
104577,3439,1522,1917,20,1
104577,1953,1027,926,21,4
104577,1953,1027,926,22,1
104577,1924,1007,917,23,1
104577,502,310,192,24,1
104577,1422,697,725,25,1
104577,29,20,9,31,1
104577,31,22,9,39,1
104577,1391,675,716,40,1
104577,4649,1918,2731,41,4
104577,4649,1918,2731,42,1
104577,2888,1299,1589,43,1
104577,795,438,357,44,1
104577,2093,861,1232,45,1
104577,1761,619,1142,51,1
104577,45,14,31,59,1
104577,2048,847,1201,60,1
104586,1921,1517,404,1,4
104586,1879,1485,394,2,1
104586,1802,1411,391,3,1
104586,448,329,119,4,1
104586,1354,1082,272,5,1
104586,77,74,3,11,1
104586,42,32,10,12,3
104586,109,79,30,19,1
104586,1245,1003,242,20,1
104586,1786,1411,375,21,4
104586,1753,1386,367,22,1
104586,1687,1320,367,23,1
104586,443,324,119,24,1
104586,1244,996,248,25,1
104586,66,66,0,31,1
104586,33,25,8,32,3
104586,107,77,30,39,1
104586,1137,919,218,40,1
104586,135,106,29,41,4
104586,126,99,27,42,1
104586,115,91,24,43,1
104586,5,5,0,44,1
104586,110,86,24,45,1
104586,11,8,3,51,1
104586,9,7,2,52,3
104586,2,2,0,59,1
104586,108,84,24,60,1
104665,10,7,3,1,4
104665,2,2,0,2,1
104665,2,2,0,3,1
104665,2,2,0,5,1
104665,8,5,3,12,3
104665,2,2,0,20,1
104665,10,7,3,21,4
104665,2,2,0,22,1
104665,2,2,0,23,1
104665,2,2,0,25,1
104665,8,5,3,32,3
104665,2,2,0,40,1
104708,20872,9673,11199,1,4
104708,20872,9673,11199,2,1
104708,16623,7750,8873,3,1
104708,3519,1790,1729,4,1
104708,13104,5960,7144,5,1
104708,4249,1923,2326,11,1
104708,1335,580,755,19,1
104708,11769,5380,6389,20,1
104708,7224,3660,3564,21,4
104708,7224,3660,3564,22,1
104708,6512,3304,3208,23,1
104708,2057,1045,1012,24,1
104708,4455,2259,2196,25,1
104708,712,356,356,31,1
104708,428,215,213,39,1
104708,4027,2044,1983,40,1
104708,13648,6013,7635,41,4
104708,13648,6013,7635,42,1
104708,10111,4446,5665,43,1
104708,1462,745,717,44,1
104708,8649,3701,4948,45,1
104708,3537,1567,1970,51,1
104708,907,365,542,59,1
104708,7742,3336,4406,60,1
104717,55497,13704,41793,1,4
104717,35205,8628,26577,2,1
104717,34643,8378,26265,3,1
104717,3264,946,2318,4,1
104717,31379,7432,23947,5,1
104717,562,250,312,11,1
104717,20292,5076,15216,12,3
104717,8919,2087,6832,19,1
104717,22460,5345,17115,20,1
104717,8023,2573,5450,21,4
104717,7984,2557,5427,22,1
104717,7975,2557,5418,23,1
104717,1554,547,1007,24,1
104717,6421,2010,4411,25,1
104717,9,0,9,31,1
104717,39,16,23,32,3
104717,2339,711,1628,39,1
104717,4082,1299,2783,40,1
104717,47474,11131,36343,41,4
104717,27221,6071,21150,42,1
104717,26668,5821,20847,43,1
104717,1710,399,1311,44,1
104717,24958,5422,19536,45,1
104717,553,250,303,51,1
104717,20253,5060,15193,52,3
104717,6580,1376,5204,59,1
104717,18378,4046,14332,60,1
104805,2238,429,1809,1,4
104805,2238,429,1809,2,1
104805,2238,429,1809,3,1
104805,918,184,734,4,1
104805,1320,245,1075,5,1
104805,1320,245,1075,20,1
104805,2238,429,1809,21,4
104805,2238,429,1809,22,1
104805,2238,429,1809,23,1
104805,918,184,734,24,1
104805,1320,245,1075,25,1
104805,1320,245,1075,40,1
104911,210,11,199,1,4
104911,210,11,199,2,1
104911,210,11,199,3,1
104911,71,5,66,4,1
104911,139,6,133,5,1
104911,139,6,133,20,1
104911,210,11,199,21,4
104911,210,11,199,22,1
104911,210,11,199,23,1
104911,71,5,66,24,1
104911,139,6,133,25,1
104911,139,6,133,40,1
105118,93,21,72,1,4
105118,93,21,72,2,1
105118,93,21,72,3,1
105118,93,21,72,5,1
105118,93,21,72,20,1
105118,93,21,72,21,4
105118,93,21,72,22,1
105118,93,21,72,23,1
105118,93,21,72,25,1
105118,93,21,72,40,1
105145,6440,3180,3260,1,4
105145,6440,3180,3260,2,1
105145,5653,2798,2855,3,1
105145,782,419,363,4,1
105145,4871,2379,2492,5,1
105145,787,382,405,11,1
105145,939,386,553,19,1
105145,3932,1993,1939,20,1
105145,1345,568,777,21,4
105145,1345,568,777,22,1
105145,1289,544,745,23,1
105145,334,146,188,24,1
105145,955,398,557,25,1
105145,56,24,32,31,1
105145,176,73,103,39,1
105145,779,325,454,40,1
105145,5095,2612,2483,41,4
105145,5095,2612,2483,42,1
105145,4364,2254,2110,43,1
105145,448,273,175,44,1
105145,3916,1981,1935,45,1
105145,731,358,373,51,1
105145,763,313,450,59,1
105145,3153,1668,1485,60,1
105154,23678,11519,12159,1,4
105154,23678,11519,12159,2,1
105154,20120,9813,10307,3,1
105154,3474,1797,1677,4,1
105154,16646,8016,8630,5,1
105154,3558,1706,1852,11,1
105154,1744,807,937,19,1
105154,14902,7209,7693,20,1
105154,7550,4068,3482,21,4
105154,7550,4068,3482,22,1
105154,7040,3753,3287,23,1
105154,1942,1011,931,24,1
105154,5098,2742,2356,25,1
105154,510,315,195,31,1
105154,496,254,242,39,1
105154,4602,2488,2114,40,1
105154,16128,7451,8677,41,4
105154,16128,7451,8677,42,1
105154,13080,6060,7020,43,1
105154,1532,786,746,44,1
105154,11548,5274,6274,45,1
105154,3048,1391,1657,51,1
105154,1248,553,695,59,1
105154,10300,4721,5579,60,1
105163,409,353,56,1,4
105163,409,353,56,2,1
105163,409,353,56,3,1
105163,58,49,9,4,1
105163,351,304,47,5,1
105163,10,8,2,19,1
105163,341,296,45,20,1
105163,305,263,42,21,4
105163,305,263,42,22,1
105163,305,263,42,23,1
105163,44,37,7,24,1
105163,261,226,35,25,1
105163,9,7,2,39,1
105163,252,219,33,40,1
105163,104,90,14,41,4
105163,104,90,14,42,1
105163,104,90,14,43,1
105163,14,12,2,44,1
105163,90,78,12,45,1
105163,1,1,0,59,1
105163,89,77,12,60,1
105172,498,428,70,1,4
105172,498,428,70,2,1
105172,498,428,70,3,1
105172,76,69,7,4,1
105172,422,359,63,5,1
105172,15,12,3,19,1
105172,407,347,60,20,1
105172,392,340,52,21,4
105172,392,340,52,22,1
105172,392,340,52,23,1
105172,73,66,7,24,1
105172,319,274,45,25,1
105172,11,9,2,39,1
105172,308,265,43,40,1
105172,106,88,18,41,4
105172,106,88,18,42,1
105172,106,88,18,43,1
105172,3,3,0,44,1
105172,103,85,18,45,1
105172,4,3,1,59,1
105172,99,82,17,60,1
105206,5227,1894,3333,1,4
105206,5227,1894,3333,2,1
105206,4759,1704,3055,3,1
105206,981,445,536,4,1
105206,3778,1259,2519,5,1
105206,468,190,278,11,1
105206,215,78,137,19,1
105206,3563,1181,2382,20,1
105206,1433,614,819,21,4
105206,1433,614,819,22,1
105206,1366,582,784,23,1
105206,231,117,114,24,1
105206,1135,465,670,25,1
105206,67,32,35,31,1
105206,71,40,31,39,1
105206,1064,425,639,40,1
105206,3794,1280,2514,41,4
105206,3794,1280,2514,42,1
105206,3393,1122,2271,43,1
105206,750,328,422,44,1
105206,2643,794,1849,45,1
105206,401,158,243,51,1
105206,144,38,106,59,1
105206,2499,756,1743,60,1
105215,2049,1948,101,1,4
105215,2049,1948,101,2,1
105215,2049,1948,101,3,1
105215,277,265,12,4,1
105215,1772,1683,89,5,1
105215,1772,1683,89,20,1
105215,2049,1948,101,21,4
105215,2049,1948,101,22,1
105215,2049,1948,101,23,1
105215,277,265,12,24,1
105215,1772,1683,89,25,1
105215,1772,1683,89,40,1
105297,1466,467,999,1,4
105297,1466,467,999,2,1
105297,1402,441,961,3,1
105297,232,91,141,4,1
105297,1170,350,820,5,1
105297,64,26,38,11,1
105297,32,12,20,19,1
105297,1138,338,800,20,1
105297,912,313,599,21,4
105297,912,313,599,22,1
105297,904,309,595,23,1
105297,187,77,110,24,1
105297,717,232,485,25,1
105297,8,4,4,31,1
105297,25,10,15,39,1
105297,692,222,470,40,1
105297,554,154,400,41,4
105297,554,154,400,42,1
105297,498,132,366,43,1
105297,45,14,31,44,1
105297,453,118,335,45,1
105297,56,22,34,51,1
105297,7,2,5,59,1
105297,446,116,330,60,1
105330,26594,10799,15795,1,4
105330,22160,9343,12817,2,1
105330,22011,9275,12736,3,1
105330,4728,1971,2757,4,1
105330,17283,7304,9979,5,1
105330,149,68,81,11,1
105330,4434,1456,2978,12,3
105330,2478,943,1535,19,1
105330,14805,6361,8444,20,1
105330,20533,8706,11827,21,4
105330,18577,7984,10593,22,1
105330,18575,7983,10592,23,1
105330,4348,1814,2534,24,1
105330,14227,6169,8058,25,1
105330,2,1,1,31,1
105330,1956,722,1234,32,3
105330,1733,743,990,39,1
105330,12494,5426,7068,40,1
105330,6061,2093,3968,41,4
105330,3583,1359,2224,42,1
105330,3436,1292,2144,43,1
105330,380,157,223,44,1
105330,3056,1135,1921,45,1
105330,147,67,80,51,1
105330,2478,734,1744,52,3
105330,745,200,545,59,1
105330,2311,935,1376,60,1
105349,3233,1284,1949,1,4
105349,3233,1284,1949,2,1
105349,1641,554,1087,3,1
105349,181,64,117,4,1
105349,1460,490,970,5,1
105349,1592,730,862,11,1
105349,530,151,379,19,1
105349,930,339,591,20,1
105349,674,335,339,21,4
105349,674,335,339,22,1
105349,441,189,252,23,1
105349,54,20,34,24,1
105349,387,169,218,25,1
105349,233,146,87,31,1
105349,127,51,76,39,1
105349,260,118,142,40,1
105349,2559,949,1610,41,4
105349,2559,949,1610,42,1
105349,1200,365,835,43,1
105349,127,44,83,44,1
105349,1073,321,752,45,1
105349,1359,584,775,51,1
105349,403,100,303,59,1
105349,670,221,449,60,1
105367,653,178,475,1,4
105367,345,108,237,2,1
105367,335,105,230,3,1
105367,335,105,230,5,1
105367,10,3,7,11,1
105367,308,70,238,12,3
105367,70,27,43,19,1
105367,265,78,187,20,1
105367,6,2,4,21,4
105367,2,0,2,22,1
105367,2,0,2,23,1
105367,2,0,2,25,1
105367,4,2,2,32,3
105367,2,0,2,40,1
105367,647,176,471,41,4
105367,343,108,235,42,1
105367,333,105,228,43,1
105367,333,105,228,45,1
105367,10,3,7,51,1
105367,304,68,236,52,3
105367,70,27,43,59,1
105367,263,78,185,60,1
105428,12676,4965,7711,1,4
105428,12676,4965,7711,2,1
105428,10234,3921,6313,3,1
105428,1786,853,933,4,1
105428,8448,3068,5380,5,1
105428,2442,1044,1398,11,1
105428,1367,468,899,19,1
105428,7081,2600,4481,20,1
105428,3421,1477,1944,21,4
105428,3421,1477,1944,22,1
105428,3115,1326,1789,23,1
105428,733,359,374,24,1
105428,2382,967,1415,25,1
105428,306,151,155,31,1
105428,348,144,204,39,1
105428,2034,823,1211,40,1
105428,9255,3488,5767,41,4
105428,9255,3488,5767,42,1
105428,7119,2595,4524,43,1
105428,1053,494,559,44,1
105428,6066,2101,3965,45,1
105428,2136,893,1243,51,1
105428,1019,324,695,59,1
105428,5047,1777,3270,60,1
105482,87,28,59,1,4
105482,87,28,59,2,1
105482,87,28,59,3,1
105482,21,6,15,4,1
105482,66,22,44,5,1
105482,66,22,44,20,1
105482,48,15,33,21,4
105482,48,15,33,22,1
105482,48,15,33,23,1
105482,12,3,9,24,1
105482,36,12,24,25,1
105482,36,12,24,40,1
105482,39,13,26,41,4
105482,39,13,26,42,1
105482,39,13,26,43,1
105482,9,3,6,44,1
105482,30,10,20,45,1
105482,30,10,20,60,1
105516,4480,1991,2489,1,4
105516,3099,1431,1668,2,1
105516,3044,1416,1628,3,1
105516,44,23,21,4,1
105516,3000,1393,1607,5,1
105516,55,15,40,11,1
105516,1381,560,821,12,3
105516,196,105,91,19,1
105516,2804,1288,1516,20,1
105516,4480,1991,2489,21,4
105516,3099,1431,1668,22,1
105516,3044,1416,1628,23,1
105516,44,23,21,24,1
105516,3000,1393,1607,25,1
105516,55,15,40,31,1
105516,1381,560,821,32,3
105516,196,105,91,39,1
105516,2804,1288,1516,40,1
105525,30082,14119,15963,1,4
105525,30082,14119,15963,2,1
105525,26600,12168,14432,3,1
105525,5264,2638,2626,4,1
105525,21336,9530,11806,5,1
105525,3482,1951,1531,11,1
105525,1844,836,1008,19,1
105525,19492,8694,10798,20,1
105525,10776,5445,5331,21,4
105525,10776,5445,5331,22,1
105525,10427,5203,5224,23,1
105525,2675,1370,1305,24,1
105525,7752,3833,3919,25,1
105525,349,242,107,31,1
105525,731,367,364,39,1
105525,7021,3466,3555,40,1
105525,19306,8674,10632,41,4
105525,19306,8674,10632,42,1
105525,16173,6965,9208,43,1
105525,2589,1268,1321,44,1
105525,13584,5697,7887,45,1
105525,3133,1709,1424,51,1
105525,1113,469,644,59,1
105525,12471,5228,7243,60,1
105534,1726,441,1285,1,4
105534,1726,441,1285,2,1
105534,1726,441,1285,3,1
105534,416,97,319,4,1
105534,1310,344,966,5,1
105534,1310,344,966,20,1
105534,1726,441,1285,21,4
105534,1726,441,1285,22,1
105534,1726,441,1285,23,1
105534,416,97,319,24,1
105534,1310,344,966,25,1
105534,1310,344,966,40,1
105543,930,165,765,1,4
105543,930,165,765,2,1
105543,930,165,765,3,1
105543,250,42,208,4,1
105543,680,123,557,5,1
105543,680,123,557,20,1
105543,930,165,765,21,4
105543,930,165,765,22,1
105543,930,165,765,23,1
105543,250,42,208,24,1
105543,680,123,557,25,1
105543,680,123,557,40,1
105589,943,334,609,1,4
105589,545,244,301,2,1
105589,540,242,298,3,1
105589,40,11,29,4,1
105589,500,231,269,5,1
105589,5,2,3,11,1
105589,398,90,308,12,3
105589,96,43,53,19,1
105589,404,188,216,20,1
105589,572,232,340,21,4
105589,444,204,240,22,1
105589,439,202,237,23,1
105589,40,11,29,24,1
105589,399,191,208,25,1
105589,5,2,3,31,1
105589,128,28,100,32,3
105589,78,34,44,39,1
105589,321,157,164,40,1
105589,371,102,269,41,4
105589,101,40,61,42,1
105589,101,40,61,43,1
105589,101,40,61,45,1
105589,270,62,208,52,3
105589,18,9,9,59,1
105589,83,31,52,60,1
105659,621,609,12,1,4
105659,621,609,12,2,1
105659,621,609,12,3,1
105659,201,197,4,4,1
105659,420,412,8,5,1
105659,420,412,8,20,1
105659,621,609,12,21,4
105659,621,609,12,22,1
105659,621,609,12,23,1
105659,201,197,4,24,1
105659,420,412,8,25,1
105659,420,412,8,40,1
105668,21472,8163,13309,1,4
105668,21472,8163,13309,2,1
105668,10217,3493,6724,3,1
105668,572,222,350,4,1
105668,9645,3271,6374,5,1
105668,11255,4670,6585,11,1
105668,2093,765,1328,19,1
105668,7552,2506,5046,20,1
105668,3054,1186,1868,21,4
105668,3054,1186,1868,22,1
105668,1988,753,1235,23,1
105668,172,76,96,24,1
105668,1816,677,1139,25,1
105668,1066,433,633,31,1
105668,430,155,275,39,1
105668,1386,522,864,40,1
105668,18418,6977,11441,41,4
105668,18418,6977,11441,42,1
105668,8229,2740,5489,43,1
105668,400,146,254,44,1
105668,7829,2594,5235,45,1
105668,10189,4237,5952,51,1
105668,1663,610,1053,59,1
105668,6166,1984,4182,60,1
105677,39,38,1,1,4
105677,39,38,1,2,1
105677,39,38,1,3,1
105677,15,14,1,4,1
105677,24,24,0,5,1
105677,24,24,0,20,1
105677,39,38,1,21,4
105677,39,38,1,22,1
105677,39,38,1,23,1
105677,15,14,1,24,1
105677,24,24,0,25,1
105677,24,24,0,40,1
105701,64,2,62,1,4
105701,64,2,62,2,1
105701,64,2,62,3,1
105701,15,2,13,4,1
105701,49,0,49,5,1
105701,49,0,49,20,1
105701,64,2,62,21,4
105701,64,2,62,22,1
105701,64,2,62,23,1
105701,15,2,13,24,1
105701,49,0,49,25,1
105701,49,0,49,40,1
105747,10313,4803,5510,1,4
105747,10313,4803,5510,2,1
105747,7687,3661,4026,3,1
105747,1366,729,637,4,1
105747,6321,2932,3389,5,1
105747,2626,1142,1484,11,1
105747,992,410,582,19,1
105747,5329,2522,2807,20,1
105747,3159,1671,1488,21,4
105747,3159,1671,1488,22,1
105747,3025,1601,1424,23,1
105747,898,492,406,24,1
105747,2127,1109,1018,25,1
105747,134,70,64,31,1
105747,340,158,182,39,1
105747,1787,951,836,40,1
105747,7154,3132,4022,41,4
105747,7154,3132,4022,42,1
105747,4662,2060,2602,43,1
105747,468,237,231,44,1
105747,4194,1823,2371,45,1
105747,2492,1072,1420,51,1
105747,652,252,400,59,1
105747,3542,1571,1971,60,1
105792,4718,1868,2850,1,4
105792,4718,1868,2850,2,1
105792,3980,1586,2394,3,1
105792,864,359,505,4,1
105792,3116,1227,1889,5,1
105792,738,282,456,11,1
105792,464,177,287,19,1
105792,2652,1050,1602,20,1
105792,1437,616,821,21,4
105792,1437,616,821,22,1
105792,1386,592,794,23,1
105792,439,187,252,24,1
105792,947,405,542,25,1
105792,51,24,27,31,1
105792,113,47,66,39,1
105792,834,358,476,40,1
105792,3281,1252,2029,41,4
105792,3281,1252,2029,42,1
105792,2594,994,1600,43,1
105792,425,172,253,44,1
105792,2169,822,1347,45,1
105792,687,258,429,51,1
105792,351,130,221,59,1
105792,1818,692,1126,60,1
105899,635,317,318,1,4
105899,635,317,318,2,1
105899,491,252,239,3,1
105899,90,36,54,4,1
105899,401,216,185,5,1
105899,144,65,79,11,1
105899,58,38,20,19,1
105899,343,178,165,20,1
105899,454,231,223,21,4
105899,454,231,223,22,1
105899,452,230,222,23,1
105899,90,36,54,24,1
105899,362,194,168,25,1
105899,2,1,1,31,1
105899,50,34,16,39,1
105899,312,160,152,40,1
105899,181,86,95,41,4
105899,181,86,95,42,1
105899,39,22,17,43,1
105899,39,22,17,45,1
105899,142,64,78,51,1
105899,8,4,4,59,1
105899,31,18,13,60,1
105987,284,132,152,1,4
105987,284,132,152,2,1
105987,284,132,152,3,1
105987,134,64,70,4,1
105987,150,68,82,5,1
105987,150,68,82,20,1
105987,284,132,152,21,4
105987,284,132,152,22,1
105987,284,132,152,23,1
105987,134,64,70,24,1
105987,150,68,82,25,1
105987,150,68,82,40,1
106041,2337,2267,70,1,4
106041,2337,2267,70,2,1
106041,2337,2267,70,3,1
106041,449,440,9,4,1
106041,1888,1827,61,5,1
106041,160,153,7,19,1
106041,1728,1674,54,20,1
106041,2337,2267,70,21,4
106041,2337,2267,70,22,1
106041,2337,2267,70,23,1
106041,449,440,9,24,1
106041,1888,1827,61,25,1
106041,160,153,7,39,1
106041,1728,1674,54,40,1
106102,2042,771,1271,1,4
106102,1497,524,973,2,1
106102,1369,468,901,3,1
106102,2,0,2,4,1
106102,1367,468,899,5,1
106102,128,56,72,11,1
106102,545,247,298,12,3
106102,1367,468,899,20,1
106102,2042,771,1271,21,4
106102,1497,524,973,22,1
106102,1369,468,901,23,1
106102,2,0,2,24,1
106102,1367,468,899,25,1
106102,128,56,72,31,1
106102,545,247,298,32,3
106102,1367,468,899,40,1
106111,172,15,157,1,4
106111,172,15,157,2,1
106111,172,15,157,3,1
106111,44,5,39,4,1
106111,128,10,118,5,1
106111,128,10,118,20,1
106111,130,14,116,21,4
106111,130,14,116,22,1
106111,130,14,116,23,1
106111,36,5,31,24,1
106111,94,9,85,25,1
106111,94,9,85,40,1
106111,42,1,41,41,4
106111,42,1,41,42,1
106111,42,1,41,43,1
106111,8,0,8,44,1
106111,34,1,33,45,1
106111,34,1,33,60,1
106148,8197,3582,4615,1,4
106148,8197,3582,4615,2,1
106148,6072,2614,3458,3,1
106148,900,439,461,4,1
106148,5172,2175,2997,5,1
106148,2125,968,1157,11,1
106148,398,191,207,19,1
106148,4774,1984,2790,20,1
106148,2224,1167,1057,21,4
106148,2224,1167,1057,22,1
106148,2202,1153,1049,23,1
106148,440,248,192,24,1
106148,1762,905,857,25,1
106148,22,14,8,31,1
106148,173,104,69,39,1
106148,1589,801,788,40,1
106148,5973,2415,3558,41,4
106148,5973,2415,3558,42,1
106148,3870,1461,2409,43,1
106148,460,191,269,44,1
106148,3410,1270,2140,45,1
106148,2103,954,1149,51,1
106148,225,87,138,59,1
106148,3185,1183,2002,60,1
106245,12377,5029,7348,1,4
106245,9970,4135,5835,2,1
106245,8504,3532,4972,3,1
106245,667,287,380,4,1
106245,7837,3245,4592,5,1
106245,1466,603,863,11,1
106245,2407,894,1513,12,3
106245,1165,497,668,19,1
106245,6672,2748,3924,20,1
106245,6632,2887,3745,21,4
106245,5552,2457,3095,22,1
106245,5261,2333,2928,23,1
106245,633,269,364,24,1
106245,4628,2064,2564,25,1
106245,291,124,167,31,1
106245,1080,430,650,32,3
106245,817,360,457,39,1
106245,3811,1704,2107,40,1
106245,5745,2142,3603,41,4
106245,4418,1678,2740,42,1
106245,3243,1199,2044,43,1
106245,34,18,16,44,1
106245,3209,1181,2028,45,1
106245,1175,479,696,51,1
106245,1327,464,863,52,3
106245,348,137,211,59,1
106245,2861,1044,1817,60,1
106263,2867,993,1874,1,4
106263,791,149,642,2,1
106263,755,132,623,3,1
106263,755,132,623,5,1
106263,36,17,19,11,1
106263,2076,844,1232,12,3
106263,247,42,205,19,1
106263,508,90,418,20,1
106263,2059,815,1244,21,4
106263,564,91,473,22,1
106263,563,91,472,23,1
106263,563,91,472,25,1
106263,1,0,1,31,1
106263,1495,724,771,32,3
106263,174,32,142,39,1
106263,389,59,330,40,1
106263,808,178,630,41,4
106263,227,58,169,42,1
106263,192,41,151,43,1
106263,192,41,151,45,1
106263,35,17,18,51,1
106263,581,120,461,52,3
106263,73,10,63,59,1
106263,119,31,88,60,1
106281,32,8,24,1,4
106281,32,8,24,2,1
106281,32,8,24,3,1
106281,20,5,15,4,1
106281,12,3,9,5,1
106281,12,3,9,20,1
106281,27,8,19,21,4
106281,27,8,19,22,1
106281,27,8,19,23,1
106281,16,5,11,24,1
106281,11,3,8,25,1
106281,11,3,8,40,1
106281,5,0,5,41,4
106281,5,0,5,42,1
106281,5,0,5,43,1
106281,4,0,4,44,1
106281,1,0,1,45,1
106281,1,0,1,60,1
106306,1027,650,377,1,4
106306,1027,650,377,2,1
106306,1022,650,372,3,1
106306,237,168,69,4,1
106306,785,482,303,5,1
106306,5,0,5,11,1
106306,130,75,55,19,1
106306,655,407,248,20,1
106306,867,572,295,21,4
106306,867,572,295,22,1
106306,862,572,290,23,1
106306,206,152,54,24,1
106306,656,420,236,25,1
106306,5,0,5,31,1
106306,108,66,42,39,1
106306,548,354,194,40,1
106306,160,78,82,41,4
106306,160,78,82,42,1
106306,160,78,82,43,1
106306,31,16,15,44,1
106306,129,62,67,45,1
106306,22,9,13,59,1
106306,107,53,54,60,1
106315,37,8,29,1,4
106315,37,8,29,2,1
106315,37,8,29,3,1
106315,7,3,4,4,1
106315,30,5,25,5,1
106315,30,5,25,20,1
106315,27,7,20,21,4
106315,27,7,20,22,1
106315,27,7,20,23,1
106315,7,3,4,24,1
106315,20,4,16,25,1
106315,20,4,16,40,1
106315,10,1,9,41,4
106315,10,1,9,42,1
106315,10,1,9,43,1
106315,10,1,9,45,1
106315,10,1,9,60,1
106324,46,1,45,1,4
106324,46,1,45,2,1
106324,46,1,45,3,1
106324,26,1,25,4,1
106324,20,0,20,5,1
106324,20,0,20,20,1
106324,44,1,43,21,4
106324,44,1,43,22,1
106324,44,1,43,23,1
106324,25,1,24,24,1
106324,19,0,19,25,1
106324,19,0,19,40,1
106324,2,0,2,41,4
106324,2,0,2,42,1
106324,2,0,2,43,1
106324,1,0,1,44,1
106324,1,0,1,45,1
106324,1,0,1,60,1
106342,592,271,321,1,4
106342,592,271,321,2,1
106342,570,264,306,3,1
106342,174,82,92,4,1
106342,396,182,214,5,1
106342,22,7,15,11,1
106342,40,19,21,19,1
106342,356,163,193,20,1
106342,562,261,301,21,4
106342,562,261,301,22,1
106342,561,260,301,23,1
106342,174,82,92,24,1
106342,387,178,209,25,1
106342,1,1,0,31,1
106342,38,17,21,39,1
106342,349,161,188,40,1
106342,30,10,20,41,4
106342,30,10,20,42,1
106342,9,4,5,43,1
106342,9,4,5,45,1
106342,21,6,15,51,1
106342,2,2,0,59,1
106342,7,2,5,60,1
106351,134,77,57,1,4
106351,134,77,57,2,1
106351,134,77,57,3,1
106351,14,8,6,4,1
106351,120,69,51,5,1
106351,120,69,51,20,1
106351,127,73,54,21,4
106351,127,73,54,22,1
106351,127,73,54,23,1
106351,14,8,6,24,1
106351,113,65,48,25,1
106351,113,65,48,40,1
106351,7,4,3,41,4
106351,7,4,3,42,1
106351,7,4,3,43,1
106351,7,4,3,45,1
106351,7,4,3,60,1
106360,50,6,44,1,4
106360,50,6,44,2,1
106360,50,6,44,3,1
106360,9,1,8,4,1
106360,41,5,36,5,1
106360,41,5,36,20,1
106360,50,6,44,21,4
106360,50,6,44,22,1
106360,50,6,44,23,1
106360,9,1,8,24,1
106360,41,5,36,25,1
106360,41,5,36,40,1
106397,25341,12601,12740,1,4
106397,21009,10347,10662,2,1
106397,20776,10234,10542,3,1
106397,4339,2051,2288,4,1
106397,16437,8183,8254,5,1
106397,233,113,120,11,1
106397,4332,2254,2078,12,3
106397,1282,671,611,19,1
106397,15155,7512,7643,20,1
106397,20379,9939,10440,21,4
106397,18565,9044,9521,22,1
106397,18455,8990,9465,23,1
106397,4300,2033,2267,24,1
106397,14155,6957,7198,25,1
106397,110,54,56,31,1
106397,1814,895,919,32,3
106397,1044,564,480,39,1
106397,13111,6393,6718,40,1
106397,4962,2662,2300,41,4
106397,2444,1303,1141,42,1
106397,2321,1244,1077,43,1
106397,39,18,21,44,1
106397,2282,1226,1056,45,1
106397,123,59,64,51,1
106397,2518,1359,1159,52,3
106397,238,107,131,59,1
106397,2044,1119,925,60,1
106412,2615,1196,1419,1,4
106412,2521,1149,1372,2,1
106412,2503,1142,1361,3,1
106412,568,300,268,4,1
106412,1935,842,1093,5,1
106412,18,7,11,11,1
106412,94,47,47,12,3
106412,152,78,74,19,1
106412,1783,764,1019,20,1
106412,2328,1083,1245,21,4
106412,2300,1068,1232,22,1
106412,2300,1068,1232,23,1
106412,557,296,261,24,1
106412,1743,772,971,25,1
106412,28,15,13,32,3
106412,136,74,62,39,1
106412,1607,698,909,40,1
106412,287,113,174,41,4
106412,221,81,140,42,1
106412,203,74,129,43,1
106412,11,4,7,44,1
106412,192,70,122,45,1
106412,18,7,11,51,1
106412,66,32,34,52,3
106412,16,4,12,59,1
106412,176,66,110,60,1
106449,4380,1874,2506,1,4
106449,4380,1874,2506,2,1
106449,3217,1277,1940,3,1
106449,839,381,458,4,1
106449,2378,896,1482,5,1
106449,1163,597,566,11,1
106449,138,46,92,19,1
106449,2240,850,1390,20,1
106449,2220,937,1283,21,4
106449,2220,937,1283,22,1
106449,2189,919,1270,23,1
106449,779,358,421,24,1
106449,1410,561,849,25,1
106449,31,18,13,31,1
106449,96,37,59,39,1
106449,1314,524,790,40,1
106449,2160,937,1223,41,4
106449,2160,937,1223,42,1
106449,1028,358,670,43,1
106449,60,23,37,44,1
106449,968,335,633,45,1
106449,1132,579,553,51,1
106449,42,9,33,59,1
106449,926,326,600,60,1
106458,13552,5386,8166,1,4
106458,10098,4279,5819,2,1
106458,9325,3973,5352,3,1
106458,1619,706,913,4,1
106458,7706,3267,4439,5,1
106458,773,306,467,11,1
106458,3454,1107,2347,12,3
106458,886,319,567,19,1
106458,6820,2948,3872,20,1
106458,8384,3630,4754,21,4
106458,7645,3289,4356,22,1
106458,7557,3252,4305,23,1
106458,1575,685,890,24,1
106458,5982,2567,3415,25,1
106458,88,37,51,31,1
106458,739,341,398,32,3
106458,610,236,374,39,1
106458,5372,2331,3041,40,1
106458,5168,1756,3412,41,4
106458,2453,990,1463,42,1
106458,1768,721,1047,43,1
106458,44,21,23,44,1
106458,1724,700,1024,45,1
106458,685,269,416,51,1
106458,2715,766,1949,52,3
106458,276,83,193,59,1
106458,1448,617,831,60,1
106467,11369,5054,6315,1,4
106467,10482,4789,5693,2,1
106467,8734,3910,4824,3,1
106467,1755,862,893,4,1
106467,6979,3048,3931,5,1
106467,1748,879,869,11,1
106467,887,265,622,12,3
106467,615,253,362,19,1
106467,6364,2795,3569,20,1
106467,7283,3426,3857,21,4
106467,7063,3334,3729,22,1
106467,7055,3331,3724,23,1
106467,1678,839,839,24,1
106467,5377,2492,2885,25,1
106467,8,3,5,31,1
106467,220,92,128,32,3
106467,421,196,225,39,1
106467,4956,2296,2660,40,1
106467,4086,1628,2458,41,4
106467,3419,1455,1964,42,1
106467,1679,579,1100,43,1
106467,77,23,54,44,1
106467,1602,556,1046,45,1
106467,1740,876,864,51,1
106467,667,173,494,52,3
106467,194,57,137,59,1
106467,1408,499,909,60,1
106485,3893,1600,2293,1,4
106485,3706,1538,2168,2,1
106485,3024,1264,1760,3,1
106485,679,321,358,4,1
106485,2345,943,1402,5,1
106485,682,274,408,11,1
106485,187,62,125,12,3
106485,186,88,98,19,1
106485,2159,855,1304,20,1
106485,2546,1146,1400,21,4
106485,2477,1125,1352,22,1
106485,2470,1123,1347,23,1
106485,623,304,319,24,1
106485,1847,819,1028,25,1
106485,7,2,5,31,1
106485,69,21,48,32,3
106485,166,83,83,39,1
106485,1681,736,945,40,1
106485,1347,454,893,41,4
106485,1229,413,816,42,1
106485,554,141,413,43,1
106485,56,17,39,44,1
106485,498,124,374,45,1
106485,675,272,403,51,1
106485,118,41,77,52,3
106485,20,5,15,59,1
106485,478,119,359,60,1
106494,64,3,61,1,4
106494,64,3,61,2,1
106494,64,3,61,3,1
106494,11,0,11,4,1
106494,53,3,50,5,1
106494,53,3,50,20,1
106494,64,3,61,21,4
106494,64,3,61,22,1
106494,64,3,61,23,1
106494,11,0,11,24,1
106494,53,3,50,25,1
106494,53,3,50,40,1
106546,918,96,822,1,4
106546,918,96,822,2,1
106546,918,96,822,3,1
106546,37,3,34,4,1
106546,881,93,788,5,1
106546,881,93,788,20,1
106546,802,79,723,21,4
106546,802,79,723,22,1
106546,802,79,723,23,1
106546,37,3,34,24,1
106546,765,76,689,25,1
106546,765,76,689,40,1
106546,116,17,99,41,4
106546,116,17,99,42,1
106546,116,17,99,43,1
106546,116,17,99,45,1
106546,116,17,99,60,1
106625,2248,815,1433,1,4
106625,2248,815,1433,2,1
106625,1894,678,1216,3,1
106625,390,182,208,4,1
106625,1504,496,1008,5,1
106625,354,137,217,11,1
106625,126,48,78,19,1
106625,1378,448,930,20,1
106625,1412,544,868,21,4
106625,1412,544,868,22,1
106625,1401,541,860,23,1
106625,344,164,180,24,1
106625,1057,377,680,25,1
106625,11,3,8,31,1
106625,94,44,50,39,1
106625,963,333,630,40,1
106625,836,271,565,41,4
106625,836,271,565,42,1
106625,493,137,356,43,1
106625,46,18,28,44,1
106625,447,119,328,45,1
106625,343,134,209,51,1
106625,32,4,28,59,1
106625,415,115,300,60,1
106704,11534,4531,7003,1,4
106704,9754,4084,5670,2,1
106704,9261,3853,5408,3,1
106704,2202,871,1331,4,1
106704,7059,2982,4077,5,1
106704,493,231,262,11,1
106704,1780,447,1333,12,3
106704,640,263,377,19,1
106704,6419,2719,3700,20,1
106704,9045,3642,5403,21,4
106704,8285,3404,4881,22,1
106704,8237,3386,4851,23,1
106704,2177,856,1321,24,1
106704,6060,2530,3530,25,1
106704,48,18,30,31,1
106704,760,238,522,32,3
106704,557,227,330,39,1
106704,5503,2303,3200,40,1
106704,2489,889,1600,41,4
106704,1469,680,789,42,1
106704,1024,467,557,43,1
106704,25,15,10,44,1
106704,999,452,547,45,1
106704,445,213,232,51,1
106704,1020,209,811,52,3
106704,83,36,47,59,1
106704,916,416,500,60,1
106713,827,422,405,1,4
106713,827,422,405,2,1
106713,769,392,377,3,1
106713,129,63,66,4,1
106713,640,329,311,5,1
106713,58,30,28,11,1
106713,122,65,57,19,1
106713,518,264,254,20,1
106713,650,341,309,21,4
106713,650,341,309,22,1
106713,648,340,308,23,1
106713,119,59,60,24,1
106713,529,281,248,25,1
106713,2,1,1,31,1
106713,86,47,39,39,1
106713,443,234,209,40,1
106713,177,81,96,41,4
106713,177,81,96,42,1
106713,121,52,69,43,1
106713,10,4,6,44,1
106713,111,48,63,45,1
106713,56,29,27,51,1
106713,36,18,18,59,1
106713,75,30,45,60,1
106795,1597,526,1071,1,4
106795,1597,526,1071,2,1
106795,1129,346,783,3,1
106795,328,152,176,4,1
106795,801,194,607,5,1
106795,468,180,288,11,1
106795,49,9,40,19,1
106795,752,185,567,20,1
106795,652,225,427,21,4
106795,652,225,427,22,1
106795,642,222,420,23,1
106795,255,113,142,24,1
106795,387,109,278,25,1
106795,10,3,7,31,1
106795,16,5,11,39,1
106795,371,104,267,40,1
106795,945,301,644,41,4
106795,945,301,644,42,1
106795,487,124,363,43,1
106795,73,39,34,44,1
106795,414,85,329,45,1
106795,458,177,281,51,1
106795,33,4,29,59,1
106795,381,81,300,60,1
106810,200,110,90,1,4
106810,200,110,90,2,1
106810,153,81,72,3,1
106810,47,26,21,4,1
106810,106,55,51,5,1
106810,47,29,18,11,1
106810,11,7,4,19,1
106810,95,48,47,20,1
106810,143,76,67,21,4
106810,143,76,67,22,1
106810,143,76,67,23,1
106810,44,25,19,24,1
106810,99,51,48,25,1
106810,8,5,3,39,1
106810,91,46,45,40,1
106810,57,34,23,41,4
106810,57,34,23,42,1
106810,10,5,5,43,1
106810,3,1,2,44,1
106810,7,4,3,45,1
106810,47,29,18,51,1
106810,3,2,1,59,1
106810,4,2,2,60,1
106829,286,171,115,1,4
106829,286,171,115,2,1
106829,286,171,115,3,1
106829,99,65,34,4,1
106829,187,106,81,5,1
106829,187,106,81,20,1
106829,258,155,103,21,4
106829,258,155,103,22,1
106829,258,155,103,23,1
106829,85,54,31,24,1
106829,173,101,72,25,1
106829,173,101,72,40,1
106829,28,16,12,41,4
106829,28,16,12,42,1
106829,28,16,12,43,1
106829,14,11,3,44,1
106829,14,5,9,45,1
106829,14,5,9,60,1
106883,1386,471,915,1,4
106883,1386,471,915,2,1
106883,922,328,594,3,1
106883,286,147,139,4,1
106883,636,181,455,5,1
106883,464,143,321,11,1
106883,114,14,100,19,1
106883,522,167,355,20,1
106883,610,201,409,21,4
106883,610,201,409,22,1
106883,601,199,402,23,1
106883,224,92,132,24,1
106883,377,107,270,25,1
106883,9,2,7,31,1
106883,31,9,22,39,1
106883,346,98,248,40,1
106883,776,270,506,41,4
106883,776,270,506,42,1
106883,321,129,192,43,1
106883,62,55,7,44,1
106883,259,74,185,45,1
106883,455,141,314,51,1
106883,83,5,78,59,1
106883,176,69,107,60,1
106892,302,9,293,1,4
106892,302,9,293,2,1
106892,302,9,293,3,1
106892,81,4,77,4,1
106892,221,5,216,5,1
106892,221,5,216,20,1
106892,302,9,293,21,4
106892,302,9,293,22,1
106892,302,9,293,23,1
106892,81,4,77,24,1
106892,221,5,216,25,1
106892,221,5,216,40,1
106908,482,29,453,1,4
106908,482,29,453,2,1
106908,482,29,453,3,1
106908,67,1,66,4,1
106908,415,28,387,5,1
106908,415,28,387,20,1
106908,385,23,362,21,4
106908,385,23,362,22,1
106908,385,23,362,23,1
106908,58,1,57,24,1
106908,327,22,305,25,1
106908,327,22,305,40,1
106908,97,6,91,41,4
106908,97,6,91,42,1
106908,97,6,91,43,1
106908,9,0,9,44,1
106908,88,6,82,45,1
106908,88,6,82,60,1
106980,3246,1200,2046,1,4
106980,3246,1200,2046,2,1
106980,2445,874,1571,3,1
106980,545,244,301,4,1
106980,1900,630,1270,5,1
106980,801,326,475,11,1
106980,136,44,92,19,1
106980,1764,586,1178,20,1
106980,1525,594,931,21,4
106980,1525,594,931,22,1
106980,1475,573,902,23,1
106980,410,186,224,24,1
106980,1065,387,678,25,1
106980,50,21,29,31,1
106980,109,35,74,39,1
106980,956,352,604,40,1
106980,1721,606,1115,41,4
106980,1721,606,1115,42,1
106980,970,301,669,43,1
106980,135,58,77,44,1
106980,835,243,592,45,1
106980,751,305,446,51,1
106980,27,9,18,59,1
106980,808,234,574,60,1
106999,1353,435,918,1,4
106999,1353,435,918,2,1
106999,1090,348,742,3,1
106999,290,133,157,4,1
106999,800,215,585,5,1
106999,263,87,176,11,1
106999,57,14,43,19,1
106999,743,201,542,20,1
106999,784,261,523,21,4
106999,784,261,523,22,1
106999,779,260,519,23,1
106999,258,118,140,24,1
106999,521,142,379,25,1
106999,5,1,4,31,1
106999,24,8,16,39,1
106999,497,134,363,40,1
106999,569,174,395,41,4
106999,569,174,395,42,1
106999,311,88,223,43,1
106999,32,15,17,44,1
106999,279,73,206,45,1
106999,258,86,172,51,1
106999,33,6,27,59,1
106999,246,67,179,60,1
107044,6238,2677,3561,1,4
107044,4428,2057,2371,2,1
107044,4428,2057,2371,3,1
107044,1041,463,578,4,1
107044,3387,1594,1793,5,1
107044,1810,620,1190,12,3
107044,219,108,111,19,1
107044,3168,1486,1682,20,1
107044,4820,2130,2690,21,4
107044,4105,1873,2232,22,1
107044,4105,1873,2232,23,1
107044,1030,458,572,24,1
107044,3075,1415,1660,25,1
107044,715,257,458,32,3
107044,204,103,101,39,1
107044,2871,1312,1559,40,1
107044,1418,547,871,41,4
107044,323,184,139,42,1
107044,323,184,139,43,1
107044,11,5,6,44,1
107044,312,179,133,45,1
107044,1095,363,732,52,3
107044,15,5,10,59,1
107044,297,174,123,60,1
107071,3583,1532,2051,1,4
107071,3199,1410,1789,2,1
107071,3190,1406,1784,3,1
107071,704,308,396,4,1
107071,2486,1098,1388,5,1
107071,9,4,5,11,1
107071,384,122,262,12,3
107071,294,121,173,19,1
107071,2192,977,1215,20,1
107071,2953,1301,1652,21,4
107071,2878,1268,1610,22,1
107071,2876,1267,1609,23,1
107071,698,305,393,24,1
107071,2178,962,1216,25,1
107071,2,1,1,31,1
107071,75,33,42,32,3
107071,244,106,138,39,1
107071,1934,856,1078,40,1
107071,630,231,399,41,4
107071,321,142,179,42,1
107071,314,139,175,43,1
107071,6,3,3,44,1
107071,308,136,172,45,1
107071,7,3,4,51,1
107071,309,89,220,52,3
107071,50,15,35,59,1
107071,258,121,137,60,1
107080,1444,652,792,1,4
107080,1431,644,787,2,1
107080,1428,643,785,3,1
107080,450,218,232,4,1
107080,978,425,553,5,1
107080,3,1,2,11,1
107080,13,8,5,12,3
107080,19,11,8,19,1
107080,959,414,545,20,1
107080,1434,645,789,21,4
107080,1422,638,784,22,1
107080,1422,638,784,23,1
107080,450,218,232,24,1
107080,972,420,552,25,1
107080,12,7,5,32,3
107080,19,11,8,39,1
107080,953,409,544,40,1
107080,10,7,3,41,4
107080,9,6,3,42,1
107080,6,5,1,43,1
107080,6,5,1,45,1
107080,3,1,2,51,1
107080,1,1,0,52,3
107080,6,5,1,60,1
107099,43,1,42,1,4
107099,43,1,42,2,1
107099,43,1,42,3,1
107099,9,0,9,4,1
107099,34,1,33,5,1
107099,34,1,33,20,1
107099,43,1,42,21,4
107099,43,1,42,22,1
107099,43,1,42,23,1
107099,9,0,9,24,1
107099,34,1,33,25,1
107099,34,1,33,40,1
107123,76,10,66,1,4
107123,76,10,66,2,1
107123,76,10,66,3,1
107123,76,10,66,5,1
107123,76,10,66,20,1
107123,76,10,66,21,4
107123,76,10,66,22,1
107123,76,10,66,23,1
107123,76,10,66,25,1
107123,76,10,66,40,1
107141,2596,1100,1496,1,4
107141,2080,920,1160,2,1
107141,1770,792,978,3,1
107141,303,132,171,4,1
107141,1467,660,807,5,1
107141,310,128,182,11,1
107141,516,180,336,12,3
107141,179,79,100,19,1
107141,1288,581,707,20,1
107141,1698,737,961,21,4
107141,1571,705,866,22,1
107141,1571,705,866,23,1
107141,303,132,171,24,1
107141,1268,573,695,25,1
107141,127,32,95,32,3
107141,151,72,79,39,1
107141,1117,501,616,40,1
107141,898,363,535,41,4
107141,509,215,294,42,1
107141,199,87,112,43,1
107141,199,87,112,45,1
107141,310,128,182,51,1
107141,389,148,241,52,3
107141,28,7,21,59,1
107141,171,80,91,60,1
107211,27,5,22,1,4
107211,27,5,22,2,1
107211,27,5,22,3,1
107211,8,3,5,4,1
107211,19,2,17,5,1
107211,19,2,17,20,1
107211,27,5,22,21,4
107211,27,5,22,22,1
107211,27,5,22,23,1
107211,8,3,5,24,1
107211,19,2,17,25,1
107211,19,2,17,40,1
107220,364,18,346,1,4
107220,364,18,346,2,1
107220,364,18,346,3,1
107220,258,15,243,4,1
107220,106,3,103,5,1
107220,106,3,103,20,1
107220,228,14,214,21,4
107220,228,14,214,22,1
107220,228,14,214,23,1
107220,166,11,155,24,1
107220,62,3,59,25,1
107220,62,3,59,40,1
107220,136,4,132,41,4
107220,136,4,132,42,1
107220,136,4,132,43,1
107220,92,4,88,44,1
107220,44,0,44,45,1
107220,44,0,44,60,1
107275,15,0,15,1,4
107275,15,0,15,2,1
107275,15,0,15,3,1
107275,5,0,5,4,1
107275,10,0,10,5,1
107275,10,0,10,20,1
107275,15,0,15,21,4
107275,15,0,15,22,1
107275,15,0,15,23,1
107275,5,0,5,24,1
107275,10,0,10,25,1
107275,10,0,10,40,1
107293,75,1,74,1,4
107293,75,1,74,2,1
107293,75,1,74,3,1
107293,31,0,31,4,1
107293,44,1,43,5,1
107293,44,1,43,20,1
107293,75,1,74,21,4
107293,75,1,74,22,1
107293,75,1,74,23,1
107293,31,0,31,24,1
107293,44,1,43,25,1
107293,44,1,43,40,1
107318,1793,678,1115,1,4
107318,1793,678,1115,2,1
107318,1263,467,796,3,1
107318,326,153,173,4,1
107318,937,314,623,5,1
107318,530,211,319,11,1
107318,108,49,59,19,1
107318,829,265,564,20,1
107318,703,260,443,21,4
107318,703,260,443,22,1
107318,667,246,421,23,1
107318,238,112,126,24,1
107318,429,134,295,25,1
107318,36,14,22,31,1
107318,47,23,24,39,1
107318,382,111,271,40,1
107318,1090,418,672,41,4
107318,1090,418,672,42,1
107318,596,221,375,43,1
107318,88,41,47,44,1
107318,508,180,328,45,1
107318,494,197,297,51,1
107318,61,26,35,59,1
107318,447,154,293,60,1
107327,1425,515,910,1,4
107327,1425,515,910,2,1
107327,1141,392,749,3,1
107327,283,116,167,4,1
107327,858,276,582,5,1
107327,284,123,161,11,1
107327,99,25,74,19,1
107327,759,251,508,20,1
107327,619,256,363,21,4
107327,619,256,363,22,1
107327,614,252,362,23,1
107327,223,91,132,24,1
107327,391,161,230,25,1
107327,5,4,1,31,1
107327,45,13,32,39,1
107327,346,148,198,40,1
107327,806,259,547,41,4
107327,806,259,547,42,1
107327,527,140,387,43,1
107327,60,25,35,44,1
107327,467,115,352,45,1
107327,279,119,160,51,1
107327,54,12,42,59,1
107327,413,103,310,60,1
107363,65,6,59,1,4
107363,65,6,59,2,1
107363,65,6,59,3,1
107363,42,6,36,4,1
107363,23,0,23,5,1
107363,23,0,23,20,1
107363,65,6,59,21,4
107363,65,6,59,22,1
107363,65,6,59,23,1
107363,42,6,36,24,1
107363,23,0,23,25,1
107363,23,0,23,40,1
107442,79,47,32,1,4
107442,79,47,32,2,1
107442,79,47,32,3,1
107442,62,36,26,4,1
107442,17,11,6,5,1
107442,17,11,6,20,1
107442,79,47,32,21,4
107442,79,47,32,22,1
107442,79,47,32,23,1
107442,62,36,26,24,1
107442,17,11,6,25,1
107442,17,11,6,40,1
107460,2167,903,1264,1,4
107460,2167,903,1264,2,1
107460,1885,758,1127,3,1
107460,484,228,256,4,1
107460,1401,530,871,5,1
107460,282,145,137,11,1
107460,147,59,88,19,1
107460,1254,471,783,20,1
107460,1079,485,594,21,4
107460,1079,485,594,22,1
107460,1075,483,592,23,1
107460,375,192,183,24,1
107460,700,291,409,25,1
107460,4,2,2,31,1
107460,75,34,41,39,1
107460,625,257,368,40,1
107460,1088,418,670,41,4
107460,1088,418,670,42,1
107460,810,275,535,43,1
107460,109,36,73,44,1
107460,701,239,462,45,1
107460,278,143,135,51,1
107460,72,25,47,59,1
107460,629,214,415,60,1
107488,252,152,100,1,4
107488,252,152,100,2,1
107488,252,152,100,3,1
107488,233,139,94,4,1
107488,19,13,6,5,1
107488,19,13,6,20,1
107488,244,147,97,21,4
107488,244,147,97,22,1
107488,244,147,97,23,1
107488,227,135,92,24,1
107488,17,12,5,25,1
107488,17,12,5,40,1
107488,8,5,3,41,4
107488,8,5,3,42,1
107488,8,5,3,43,1
107488,6,4,2,44,1
107488,2,1,1,45,1
107488,2,1,1,60,1
107512,1543,726,817,1,4
107512,1543,726,817,2,1
107512,1513,705,808,3,1
107512,393,180,213,4,1
107512,1120,525,595,5,1
107512,30,21,9,11,1
107512,47,30,17,19,1
107512,1073,495,578,20,1
107512,1507,704,803,21,4
107512,1507,704,803,22,1
107512,1503,702,801,23,1
107512,393,180,213,24,1
107512,1110,522,588,25,1
107512,4,2,2,31,1
107512,47,30,17,39,1
107512,1063,492,571,40,1
107512,36,22,14,41,4
107512,36,22,14,42,1
107512,10,3,7,43,1
107512,10,3,7,45,1
107512,26,19,7,51,1
107512,10,3,7,60,1
107521,1501,550,951,1,4
107521,1501,550,951,2,1
107521,817,198,619,3,1
107521,147,44,103,4,1
107521,670,154,516,5,1
107521,684,352,332,11,1
107521,96,23,73,19,1
107521,574,131,443,20,1
107521,584,139,445,21,4
107521,584,139,445,22,1
107521,553,124,429,23,1
107521,120,38,82,24,1
107521,433,86,347,25,1
107521,31,15,16,31,1
107521,64,12,52,39,1
107521,369,74,295,40,1
107521,917,411,506,41,4
107521,917,411,506,42,1
107521,264,74,190,43,1
107521,27,6,21,44,1
107521,237,68,169,45,1
107521,653,337,316,51,1
107521,32,11,21,59,1
107521,205,57,148,60,1
107549,1489,478,1011,1,4
107549,1489,478,1011,2,1
107549,1226,367,859,3,1
107549,265,113,152,4,1
107549,961,254,707,5,1
107549,263,111,152,11,1
107549,474,110,364,19,1
107549,487,144,343,20,1
107549,873,263,610,21,4
107549,873,263,610,22,1
107549,860,257,603,23,1
107549,218,87,131,24,1
107549,642,170,472,25,1
107549,13,6,7,31,1
107549,295,66,229,39,1
107549,347,104,243,40,1
107549,616,215,401,41,4
107549,616,215,401,42,1
107549,366,110,256,43,1
107549,47,26,21,44,1
107549,319,84,235,45,1
107549,250,105,145,51,1
107549,179,44,135,59,1
107549,140,40,100,60,1
107558,585,283,302,1,4
107558,585,283,302,2,1
107558,568,278,290,3,1
107558,159,72,87,4,1
107558,409,206,203,5,1
107558,17,5,12,11,1
107558,14,9,5,19,1
107558,395,197,198,20,1
107558,571,278,293,21,4
107558,571,278,293,22,1
107558,565,276,289,23,1
107558,159,72,87,24,1
107558,406,204,202,25,1
107558,6,2,4,31,1
107558,14,9,5,39,1
107558,392,195,197,40,1
107558,14,5,9,41,4
107558,14,5,9,42,1
107558,3,2,1,43,1
107558,3,2,1,45,1
107558,11,3,8,51,1
107558,3,2,1,60,1
107585,2149,907,1242,1,4
107585,2149,907,1242,2,1
107585,2077,874,1203,3,1
107585,586,288,298,4,1
107585,1491,586,905,5,1
107585,72,33,39,11,1
107585,207,76,131,19,1
107585,1284,510,774,20,1
107585,1270,568,702,21,4
107585,1270,568,702,22,1
107585,1268,568,700,23,1
107585,467,223,244,24,1
107585,801,345,456,25,1
107585,2,0,2,31,1
107585,102,39,63,39,1
107585,699,306,393,40,1
107585,879,339,540,41,4
107585,879,339,540,42,1
107585,809,306,503,43,1
107585,119,65,54,44,1
107585,690,241,449,45,1
107585,70,33,37,51,1
107585,105,37,68,59,1
107585,585,204,381,60,1
107600,556,187,369,1,4
107600,556,187,369,2,1
107600,554,185,369,3,1
107600,135,40,95,4,1
107600,419,145,274,5,1
107600,2,2,0,11,1
107600,41,12,29,19,1
107600,378,133,245,20,1
107600,523,173,350,21,4
107600,523,173,350,22,1
107600,523,173,350,23,1
107600,134,39,95,24,1
107600,389,134,255,25,1
107600,35,11,24,39,1
107600,354,123,231,40,1
107600,33,14,19,41,4
107600,33,14,19,42,1
107600,31,12,19,43,1
107600,1,1,0,44,1
107600,30,11,19,45,1
107600,2,2,0,51,1
107600,6,1,5,59,1
107600,24,10,14,60,1
107619,2029,711,1318,1,4
107619,2029,711,1318,2,1
107619,986,247,739,3,1
107619,234,89,145,4,1
107619,752,158,594,5,1
107619,1043,464,579,11,1
107619,58,8,50,19,1
107619,694,150,544,20,1
107619,757,206,551,21,4
107619,757,206,551,22,1
107619,668,164,504,23,1
107619,198,70,128,24,1
107619,470,94,376,25,1
107619,89,42,47,31,1
107619,32,5,27,39,1
107619,438,89,349,40,1
107619,1272,505,767,41,4
107619,1272,505,767,42,1
107619,318,83,235,43,1
107619,36,19,17,44,1
107619,282,64,218,45,1
107619,954,422,532,51,1
107619,26,3,23,59,1
107619,256,61,195,60,1
107637,1601,525,1076,1,4
107637,1601,525,1076,2,1
107637,1415,453,962,3,1
107637,332,135,197,4,1
107637,1083,318,765,5,1
107637,186,72,114,11,1
107637,108,36,72,19,1
107637,975,282,693,20,1
107637,850,328,522,21,4
107637,850,328,522,22,1
107637,819,311,508,23,1
107637,251,107,144,24,1
107637,568,204,364,25,1
107637,31,17,14,31,1
107637,69,27,42,39,1
107637,499,177,322,40,1
107637,751,197,554,41,4
107637,751,197,554,42,1
107637,596,142,454,43,1
107637,81,28,53,44,1
107637,515,114,401,45,1
107637,155,55,100,51,1
107637,39,9,30,59,1
107637,476,105,371,60,1
107655,50,0,50,1,4
107655,50,0,50,2,1
107655,50,0,50,3,1
107655,17,0,17,4,1
107655,33,0,33,5,1
107655,33,0,33,20,1
107655,50,0,50,21,4
107655,50,0,50,22,1
107655,50,0,50,23,1
107655,17,0,17,24,1
107655,33,0,33,25,1
107655,33,0,33,40,1
107664,10527,3776,6751,1,4
107664,10527,3776,6751,2,1
107664,9480,3406,6074,3,1
107664,1366,655,711,4,1
107664,8114,2751,5363,5,1
107664,1047,370,677,11,1
107664,812,295,517,19,1
107664,7302,2456,4846,20,1
107664,5062,2039,3023,21,4
107664,5062,2039,3023,22,1
107664,4985,2004,2981,23,1
107664,1053,490,563,24,1
107664,3932,1514,2418,25,1
107664,77,35,42,31,1
107664,497,178,319,39,1
107664,3435,1336,2099,40,1
107664,5465,1737,3728,41,4
107664,5465,1737,3728,42,1
107664,4495,1402,3093,43,1
107664,313,165,148,44,1
107664,4182,1237,2945,45,1
107664,970,335,635,51,1
107664,315,117,198,59,1
107664,3867,1120,2747,60,1
107725,1460,478,982,1,4
107725,1460,478,982,2,1
107725,1157,366,791,3,1
107725,306,124,182,4,1
107725,851,242,609,5,1
107725,303,112,191,11,1
107725,96,31,65,19,1
107725,755,211,544,20,1
107725,732,258,474,21,4
107725,732,258,474,22,1
107725,723,254,469,23,1
107725,235,98,137,24,1
107725,488,156,332,25,1
107725,9,4,5,31,1
107725,47,20,27,39,1
107725,441,136,305,40,1
107725,728,220,508,41,4
107725,728,220,508,42,1
107725,434,112,322,43,1
107725,71,26,45,44,1
107725,363,86,277,45,1
107725,294,108,186,51,1
107725,49,11,38,59,1
107725,314,75,239,60,1
107743,957,322,635,1,4
107743,957,322,635,2,1
107743,553,178,375,3,1
107743,152,65,87,4,1
107743,401,113,288,5,1
107743,404,144,260,11,1
107743,46,11,35,19,1
107743,355,102,253,20,1
107743,411,141,270,21,4
107743,411,141,270,22,1
107743,403,136,267,23,1
107743,137,59,78,24,1
107743,266,77,189,25,1
107743,8,5,3,31,1
107743,28,6,22,39,1
107743,238,71,167,40,1
107743,546,181,365,41,4
107743,546,181,365,42,1
107743,150,42,108,43,1
107743,15,6,9,44,1
107743,135,36,99,45,1
107743,396,139,257,51,1
107743,18,5,13,59,1
107743,117,31,86,60,1
107789,96,8,88,1,4
107789,96,8,88,2,1
107789,96,8,88,3,1
107789,14,1,13,4,1
107789,82,7,75,5,1
107789,82,7,75,20,1
107789,82,8,74,21,4
107789,82,8,74,22,1
107789,82,8,74,23,1
107789,12,1,11,24,1
107789,70,7,63,25,1
107789,70,7,63,40,1
107789,14,0,14,41,4
107789,14,0,14,42,1
107789,14,0,14,43,1
107789,2,0,2,44,1
107789,12,0,12,45,1
107789,12,0,12,60,1
107831,104,5,99,1,4
107831,104,5,99,2,1
107831,104,5,99,3,1
107831,1,0,1,4,1
107831,103,5,98,5,1
107831,103,5,98,20,1
107831,57,4,53,21,4
107831,57,4,53,22,1
107831,57,4,53,23,1
107831,1,0,1,24,1
107831,56,4,52,25,1
107831,56,4,52,40,1
107831,47,1,46,41,4
107831,47,1,46,42,1
107831,47,1,46,43,1
107831,47,1,46,45,1
107831,47,1,46,60,1
107840,330,90,240,1,4
107840,330,90,240,2,1
107840,330,90,240,3,1
107840,81,24,57,4,1
107840,249,66,183,5,1
107840,207,51,156,19,1
107840,42,15,27,20,1
107840,262,75,187,21,4
107840,262,75,187,22,1
107840,262,75,187,23,1
107840,68,21,47,24,1
107840,194,54,140,25,1
107840,152,39,113,39,1
107840,42,15,27,40,1
107840,68,15,53,41,4
107840,68,15,53,42,1
107840,68,15,53,43,1
107840,13,3,10,44,1
107840,55,12,43,45,1
107840,55,12,43,59,1
107877,574,219,355,1,4
107877,574,219,355,2,1
107877,501,189,312,3,1
107877,154,59,95,4,1
107877,347,130,217,5,1
107877,73,30,43,11,1
107877,36,18,18,19,1
107877,311,112,199,20,1
107877,486,185,301,21,4
107877,486,185,301,22,1
107877,486,185,301,23,1
107877,154,59,95,24,1
107877,332,126,206,25,1
107877,36,18,18,39,1
107877,296,108,188,40,1
107877,88,34,54,41,4
107877,88,34,54,42,1
107877,15,4,11,43,1
107877,15,4,11,45,1
107877,73,30,43,51,1
107877,15,4,11,60,1
107974,1632,437,1195,1,4
107974,1632,437,1195,2,1
107974,1306,296,1010,3,1
107974,238,78,160,4,1
107974,1068,218,850,5,1
107974,326,141,185,11,1
107974,188,39,149,19,1
107974,880,179,701,20,1
107974,717,185,532,21,4
107974,717,185,532,22,1
107974,694,176,518,23,1
107974,161,46,115,24,1
107974,533,130,403,25,1
107974,23,9,14,31,1
107974,106,28,78,39,1
107974,427,102,325,40,1
107974,915,252,663,41,4
107974,915,252,663,42,1
107974,612,120,492,43,1
107974,77,32,45,44,1
107974,535,88,447,45,1
107974,303,132,171,51,1
107974,82,11,71,59,1
107974,453,77,376,60,1
107983,3404,1394,2010,1,4
107983,2960,1236,1724,2,1
107983,2640,1108,1532,3,1
107983,663,304,359,4,1
107983,1977,804,1173,5,1
107983,320,128,192,11,1
107983,444,158,286,12,3
107983,226,84,142,19,1
107983,1751,720,1031,20,1
107983,2561,1111,1450,21,4
107983,2497,1083,1414,22,1
107983,2420,1043,1377,23,1
107983,658,303,355,24,1
107983,1762,740,1022,25,1
107983,77,40,37,31,1
107983,64,28,36,32,3
107983,185,77,108,39,1
107983,1577,663,914,40,1
107983,843,283,560,41,4
107983,463,153,310,42,1
107983,220,65,155,43,1
107983,5,1,4,44,1
107983,215,64,151,45,1
107983,243,88,155,51,1
107983,380,130,250,52,3
107983,41,7,34,59,1
107983,174,57,117,60,1
107992,1730,852,878,1,4
107992,1730,852,878,2,1
107992,894,455,439,3,1
107992,218,124,94,4,1
107992,676,331,345,5,1
107992,836,397,439,11,1
107992,108,73,35,19,1
107992,568,258,310,20,1
107992,653,352,301,21,4
107992,653,352,301,22,1
107992,650,352,298,23,1
107992,207,119,88,24,1
107992,443,233,210,25,1
107992,3,0,3,31,1
107992,95,69,26,39,1
107992,348,164,184,40,1
107992,1077,500,577,41,4
107992,1077,500,577,42,1
107992,244,103,141,43,1
107992,11,5,6,44,1
107992,233,98,135,45,1
107992,833,397,436,51,1
107992,13,4,9,59,1
107992,220,94,126,60,1
108065,25,0,25,1,4
108065,25,0,25,2,1
108065,25,0,25,3,1
108065,19,0,19,4,1
108065,6,0,6,5,1
108065,6,0,6,20,1
108065,19,0,19,21,4
108065,19,0,19,22,1
108065,19,0,19,23,1
108065,16,0,16,24,1
108065,3,0,3,25,1
108065,3,0,3,40,1
108065,6,0,6,41,4
108065,6,0,6,42,1
108065,6,0,6,43,1
108065,3,0,3,44,1
108065,3,0,3,45,1
108065,3,0,3,60,1
108092,7170,3141,4029,1,4
108092,7170,3141,4029,2,1
108092,6508,2866,3642,3,1
108092,1343,603,740,4,1
108092,5165,2263,2902,5,1
108092,662,275,387,11,1
108092,490,163,327,19,1
108092,4675,2100,2575,20,1
108092,5116,2208,2908,21,4
108092,5116,2208,2908,22,1
108092,5087,2197,2890,23,1
108092,1265,558,707,24,1
108092,3822,1639,2183,25,1
108092,29,11,18,31,1
108092,415,139,276,39,1
108092,3407,1500,1907,40,1
108092,2054,933,1121,41,4
108092,2054,933,1121,42,1
108092,1421,669,752,43,1
108092,78,45,33,44,1
108092,1343,624,719,45,1
108092,633,264,369,51,1
108092,75,24,51,59,1
108092,1268,600,668,60,1
108232,16001,6787,9214,1,4
108232,10508,4612,5896,2,1
108232,10300,4544,5756,3,1
108232,1027,448,579,4,1
108232,9273,4096,5177,5,1
108232,208,68,140,11,1
108232,5493,2175,3318,12,3
108232,841,350,491,19,1
108232,8432,3746,4686,20,1
108232,9038,3947,5091,21,4
108232,5727,2637,3090,22,1
108232,5691,2627,3064,23,1
108232,667,303,364,24,1
108232,5024,2324,2700,25,1
108232,36,10,26,31,1
108232,3311,1310,2001,32,3
108232,454,202,252,39,1
108232,4570,2122,2448,40,1
108232,6963,2840,4123,41,4
108232,4781,1975,2806,42,1
108232,4609,1917,2692,43,1
108232,360,145,215,44,1
108232,4249,1772,2477,45,1
108232,172,58,114,51,1
108232,2182,865,1317,52,3
108232,387,148,239,59,1
108232,3862,1624,2238,60,1
108250,510,405,105,1,4
108250,510,405,105,2,1
108250,510,405,105,3,1
108250,45,40,5,4,1
108250,465,365,100,5,1
108250,7,7,0,19,1
108250,458,358,100,20,1
108250,387,325,62,21,4
108250,387,325,62,22,1
108250,387,325,62,23,1
108250,42,37,5,24,1
108250,345,288,57,25,1
108250,7,7,0,39,1
108250,338,281,57,40,1
108250,123,80,43,41,4
108250,123,80,43,42,1
108250,123,80,43,43,1
108250,3,3,0,44,1
108250,120,77,43,45,1
108250,120,77,43,60,1
108269,132,51,81,1,4
108269,132,51,81,12,3
108269,113,43,70,21,4
108269,113,43,70,32,3
108269,19,8,11,41,4
108269,19,8,11,52,3
108348,44,22,22,1,4
108348,44,22,22,2,1
108348,44,22,22,3,1
108348,38,19,19,4,1
108348,6,3,3,5,1
108348,6,3,3,20,1
108348,44,22,22,21,4
108348,44,22,22,22,1
108348,44,22,22,23,1
108348,38,19,19,24,1
108348,6,3,3,25,1
108348,6,3,3,40,1
108649,186,4,182,1,4
108649,186,4,182,2,1
108649,186,4,182,3,1
108649,93,2,91,4,1
108649,93,2,91,5,1
108649,93,2,91,20,1
108649,83,4,79,21,4
108649,83,4,79,22,1
108649,83,4,79,23,1
108649,43,2,41,24,1
108649,40,2,38,25,1
108649,40,2,38,40,1
108649,103,0,103,41,4
108649,103,0,103,42,1
108649,103,0,103,43,1
108649,50,0,50,44,1
108649,53,0,53,45,1
108649,53,0,53,60,1
108667,5799,2637,3162,1,4
108667,5799,2637,3162,2,1
108667,5147,2344,2803,3,1
108667,915,447,468,4,1
108667,4232,1897,2335,5,1
108667,652,293,359,11,1
108667,977,408,569,19,1
108667,3255,1489,1766,20,1
108667,716,355,361,21,4
108667,716,355,361,22,1
108667,687,344,343,23,1
108667,195,94,101,24,1
108667,492,250,242,25,1
108667,29,11,18,31,1
108667,43,20,23,39,1
108667,449,230,219,40,1
108667,5083,2282,2801,41,4
108667,5083,2282,2801,42,1
108667,4460,2000,2460,43,1
108667,720,353,367,44,1
108667,3740,1647,2093,45,1
108667,623,282,341,51,1
108667,934,388,546,59,1
108667,2806,1259,1547,60,1
108807,10885,5215,5670,1,4
108807,10885,5215,5670,2,1
108807,9692,4709,4983,3,1
108807,1700,877,823,4,1
108807,7992,3832,4160,5,1
108807,1193,506,687,11,1
108807,796,444,352,19,1
108807,7196,3388,3808,20,1
108807,3395,1620,1775,21,4
108807,3395,1620,1775,22,1
108807,3316,1586,1730,23,1
108807,917,471,446,24,1
108807,2399,1115,1284,25,1
108807,79,34,45,31,1
108807,179,105,74,39,1
108807,2220,1010,1210,40,1
108807,7490,3595,3895,41,4
108807,7490,3595,3895,42,1
108807,6376,3123,3253,43,1
108807,783,406,377,44,1
108807,5593,2717,2876,45,1
108807,1114,472,642,51,1
108807,617,339,278,59,1
108807,4976,2378,2598,60,1
108852,258,114,144,1,4
108852,258,114,144,2,1
108852,258,114,144,3,1
108852,134,58,76,4,1
108852,124,56,68,5,1
108852,124,56,68,20,1
108852,258,114,144,21,4
108852,258,114,144,22,1
108852,258,114,144,23,1
108852,134,58,76,24,1
108852,124,56,68,25,1
108852,124,56,68,40,1
108861,49,32,17,1,4
108861,49,32,17,12,3
108861,29,17,12,21,4
108861,29,17,12,32,3
108861,20,15,5,41,4
108861,20,15,5,52,3
108870,348,208,140,1,4
108870,348,208,140,12,3
108870,287,166,121,21,4
108870,287,166,121,32,3
108870,61,42,19,41,4
108870,61,42,19,52,3
108977,45,9,36,1,4
108977,45,9,36,2,1
108977,45,9,36,3,1
108977,16,3,13,4,1
108977,29,6,23,5,1
108977,29,6,23,20,1
108977,21,1,20,21,4
108977,21,1,20,22,1
108977,21,1,20,23,1
108977,9,1,8,24,1
108977,12,0,12,25,1
108977,12,0,12,40,1
108977,24,8,16,41,4
108977,24,8,16,42,1
108977,24,8,16,43,1
108977,7,2,5,44,1
108977,17,6,11,45,1
108977,17,6,11,60,1
109040,1770,390,1380,1,4
109040,1770,390,1380,2,1
109040,1770,390,1380,3,1
109040,253,58,195,4,1
109040,1517,332,1185,5,1
109040,208,51,157,19,1
109040,1309,281,1028,20,1
109040,1770,390,1380,21,4
109040,1770,390,1380,22,1
109040,1770,390,1380,23,1
109040,253,58,195,24,1
109040,1517,332,1185,25,1
109040,208,51,157,39,1
109040,1309,281,1028,40,1
109086,31,16,15,1,4
109086,31,16,15,12,3
109086,31,16,15,21,4
109086,31,16,15,32,3
109208,29701,13643,16058,1,4
109208,29701,13643,16058,2,1
109208,27332,12601,14731,3,1
109208,3893,2022,1871,4,1
109208,23439,10579,12860,5,1
109208,2369,1042,1327,11,1
109208,3477,1622,1855,19,1
109208,19962,8957,11005,20,1
109208,7560,3694,3866,21,4
109208,7560,3694,3866,22,1
109208,7272,3576,3696,23,1
109208,1434,734,700,24,1
109208,5838,2842,2996,25,1
109208,288,118,170,31,1
109208,582,301,281,39,1
109208,5256,2541,2715,40,1
109208,22141,9949,12192,41,4
109208,22141,9949,12192,42,1
109208,20060,9025,11035,43,1
109208,2459,1288,1171,44,1
109208,17601,7737,9864,45,1
109208,2081,924,1157,51,1
109208,2895,1321,1574,59,1
109208,14706,6416,8290,60,1
109332,170,19,151,1,4
109332,170,19,151,2,1
109332,170,19,151,3,1
109332,26,2,24,4,1
109332,144,17,127,5,1
109332,144,17,127,20,1
109332,170,19,151,21,4
109332,170,19,151,22,1
109332,170,19,151,23,1
109332,26,2,24,24,1
109332,144,17,127,25,1
109332,144,17,127,40,1
109350,14262,5815,8447,1,4
109350,14262,5815,8447,2,1
109350,12416,5096,7320,3,1
109350,2236,1099,1137,4,1
109350,10180,3997,6183,5,1
109350,1846,719,1127,11,1
109350,662,252,410,19,1
109350,9518,3745,5773,20,1
109350,4509,1988,2521,21,4
109350,4509,1988,2521,22,1
109350,4340,1922,2418,23,1
109350,978,488,490,24,1
109350,3362,1434,1928,25,1
109350,169,66,103,31,1
109350,239,102,137,39,1
109350,3123,1332,1791,40,1
109350,9753,3827,5926,41,4
109350,9753,3827,5926,42,1
109350,8076,3174,4902,43,1
109350,1258,611,647,44,1
109350,6818,2563,4255,45,1
109350,1677,653,1024,51,1
109350,423,150,273,59,1
109350,6395,2413,3982,60,1
109651,1985,1002,983,1,4
109651,1767,880,887,2,1
109651,1742,871,871,3,1
109651,164,61,103,4,1
109651,1578,810,768,5,1
109651,25,9,16,11,1
109651,218,122,96,12,3
109651,194,97,97,19,1
109651,1384,713,671,20,1
109651,1657,811,846,21,4
109651,1499,728,771,22,1
109651,1475,720,755,23,1
109651,164,61,103,24,1
109651,1311,659,652,25,1
109651,24,8,16,31,1
109651,158,83,75,32,3
109651,192,96,96,39,1
109651,1119,563,556,40,1
109651,328,191,137,41,4
109651,268,152,116,42,1
109651,267,151,116,43,1
109651,267,151,116,45,1
109651,1,1,0,51,1
109651,60,39,21,52,3
109651,2,1,1,59,1
109651,265,150,115,60,1
109721,404,176,228,1,4
109721,404,176,228,2,1
109721,404,176,228,3,1
109721,366,160,206,4,1
109721,38,16,22,5,1
109721,38,16,22,20,1
109721,404,176,228,21,4
109721,404,176,228,22,1
109721,404,176,228,23,1
109721,366,160,206,24,1
109721,38,16,22,25,1
109721,38,16,22,40,1
109730,110,88,22,1,4
109730,110,88,22,2,1
109730,110,88,22,3,1
109730,78,61,17,4,1
109730,32,27,5,5,1
109730,32,27,5,20,1
109730,110,88,22,21,4
109730,110,88,22,22,1
109730,110,88,22,23,1
109730,78,61,17,24,1
109730,32,27,5,25,1
109730,32,27,5,40,1
109785,10755,3634,7121,1,4
109785,6543,2387,4156,2,1
109785,6543,2387,4156,3,1
109785,1225,410,815,4,1
109785,5318,1977,3341,5,1
109785,4212,1247,2965,12,3
109785,658,268,390,19,1
109785,4660,1709,2951,20,1
109785,7783,2679,5104,21,4
109785,5683,2056,3627,22,1
109785,5683,2056,3627,23,1
109785,1217,407,810,24,1
109785,4466,1649,2817,25,1
109785,2100,623,1477,32,3
109785,504,218,286,39,1
109785,3962,1431,2531,40,1
109785,2972,955,2017,41,4
109785,860,331,529,42,1
109785,860,331,529,43,1
109785,8,3,5,44,1
109785,852,328,524,45,1
109785,2112,624,1488,52,3
109785,154,50,104,59,1
109785,698,278,420,60,1
109819,17770,7796,9974,1,4
109819,17770,7796,9974,2,1
109819,15854,7023,8831,3,1
109819,3118,1519,1599,4,1
109819,12736,5504,7232,5,1
109819,1916,773,1143,11,1
109819,878,424,454,19,1
109819,11858,5080,6778,20,1
109819,5615,2427,3188,21,4
109819,5615,2427,3188,22,1
109819,5458,2356,3102,23,1
109819,1578,728,850,24,1
109819,3880,1628,2252,25,1
109819,157,71,86,31,1
109819,291,142,149,39,1
109819,3589,1486,2103,40,1
109819,12155,5369,6786,41,4
109819,12155,5369,6786,42,1
109819,10396,4667,5729,43,1
109819,1540,791,749,44,1
109819,8856,3876,4980,45,1
109819,1759,702,1057,51,1
109819,587,282,305,59,1
109819,8269,3594,4675,60,1
109907,3211,1285,1926,1,4
109907,3211,1285,1926,2,1
109907,2866,1131,1735,3,1
109907,586,282,304,4,1
109907,2280,849,1431,5,1
109907,345,154,191,11,1
109907,519,180,339,19,1
109907,1761,669,1092,20,1
109907,1172,460,712,21,4
109907,1172,460,712,22,1
109907,1156,455,701,23,1
109907,265,125,140,24,1
109907,891,330,561,25,1
109907,16,5,11,31,1
109907,143,56,87,39,1
109907,748,274,474,40,1
109907,2039,825,1214,41,4
109907,2039,825,1214,42,1
109907,1710,676,1034,43,1
109907,321,157,164,44,1
109907,1389,519,870,45,1
109907,329,149,180,51,1
109907,376,124,252,59,1
109907,1013,395,618,60,1
109934,185,11,174,1,4
109934,185,11,174,2,1
109934,185,11,174,3,1
109934,27,1,26,4,1
109934,158,10,148,5,1
109934,158,10,148,20,1
109934,185,11,174,21,4
109934,185,11,174,22,1
109934,185,11,174,23,1
109934,27,1,26,24,1
109934,158,10,148,25,1
109934,158,10,148,40,1
110060,353,202,151,1,4
110060,259,147,112,2,1
110060,259,147,112,3,1
110060,68,41,27,4,1
110060,191,106,85,5,1
110060,94,55,39,12,3
110060,3,3,0,19,1
110060,188,103,85,20,1
110060,268,156,112,21,4
110060,204,119,85,22,1
110060,204,119,85,23,1
110060,63,37,26,24,1
110060,141,82,59,25,1
110060,64,37,27,32,3
110060,3,3,0,39,1
110060,138,79,59,40,1
110060,85,46,39,41,4
110060,55,28,27,42,1
110060,55,28,27,43,1
110060,5,4,1,44,1
110060,50,24,26,45,1
110060,30,18,12,52,3
110060,50,24,26,60,1
110097,6301,2940,3361,1,4
110097,4331,1641,2690,2,1
110097,4324,1639,2685,3,1
110097,903,322,581,4,1
110097,3421,1317,2104,5,1
110097,7,2,5,11,1
110097,1970,1299,671,12,3
110097,312,140,172,19,1
110097,3109,1177,1932,20,1
110097,5107,2183,2924,21,4
110097,4184,1570,2614,22,1
110097,4180,1569,2611,23,1
110097,900,319,581,24,1
110097,3280,1250,2030,25,1
110097,4,1,3,31,1
110097,923,613,310,32,3
110097,303,136,167,39,1
110097,2977,1114,1863,40,1
110097,1194,757,437,41,4
110097,147,71,76,42,1
110097,144,70,74,43,1
110097,3,3,0,44,1
110097,141,67,74,45,1
110097,3,1,2,51,1
110097,1047,686,361,52,3
110097,9,4,5,59,1
110097,132,63,69,60,1
110185,518,303,215,1,4
110185,492,289,203,2,1
110185,492,289,203,3,1
110185,81,35,46,4,1
110185,411,254,157,5,1
110185,26,14,12,12,3
110185,28,12,16,19,1
110185,383,242,141,20,1
110185,405,247,158,21,4
110185,385,237,148,22,1
110185,385,237,148,23,1
110185,33,16,17,24,1
110185,352,221,131,25,1
110185,20,10,10,32,3
110185,16,7,9,39,1
110185,336,214,122,40,1
110185,113,56,57,41,4
110185,107,52,55,42,1
110185,107,52,55,43,1
110185,48,19,29,44,1
110185,59,33,26,45,1
110185,6,4,2,52,3
110185,12,5,7,59,1
110185,47,28,19,60,1
110194,45,45,0,1,4
110194,45,45,0,2,1
110194,45,45,0,3,1
110194,42,42,0,4,1
110194,3,3,0,5,1
110194,3,3,0,20,1
110194,45,45,0,21,4
110194,45,45,0,22,1
110194,45,45,0,23,1
110194,42,42,0,24,1
110194,3,3,0,25,1
110194,3,3,0,40,1
110219,927,231,696,1,4
110219,879,214,665,2,1
110219,879,214,665,3,1
110219,158,65,93,4,1
110219,721,149,572,5,1
110219,48,17,31,12,3
110219,721,149,572,20,1
110219,927,231,696,21,4
110219,879,214,665,22,1
110219,879,214,665,23,1
110219,158,65,93,24,1
110219,721,149,572,25,1
110219,48,17,31,32,3
110219,721,149,572,40,1
110246,12163,5807,6356,1,4
110246,12163,5807,6356,2,1
110246,11123,5290,5833,3,1
110246,2022,1069,953,4,1
110246,9101,4221,4880,5,1
110246,1040,517,523,11,1
110246,849,414,435,19,1
110246,8252,3807,4445,20,1
110246,5816,2901,2915,21,4
110246,5816,2901,2915,22,1
110246,5671,2822,2849,23,1
110246,1299,677,622,24,1
110246,4372,2145,2227,25,1
110246,145,79,66,31,1
110246,424,231,193,39,1
110246,3948,1914,2034,40,1
110246,6347,2906,3441,41,4
110246,6347,2906,3441,42,1
110246,5452,2468,2984,43,1
110246,723,392,331,44,1
110246,4729,2076,2653,45,1
110246,895,438,457,51,1
110246,425,183,242,59,1
110246,4304,1893,2411,60,1
110307,206,40,166,1,4
110307,206,40,166,12,3
110307,177,31,146,21,4
110307,177,31,146,32,3
110307,29,9,20,41,4
110307,29,9,20,52,3
110316,1271,340,931,1,4
110316,75,20,55,2,1
110316,75,20,55,3,1
110316,75,20,55,5,1
110316,1196,320,876,12,3
110316,47,14,33,19,1
110316,28,6,22,20,1
110316,988,258,730,21,4
110316,68,19,49,22,1
110316,68,19,49,23,1
110316,68,19,49,25,1
110316,920,239,681,32,3
110316,46,14,32,39,1
110316,22,5,17,40,1
110316,283,82,201,41,4
110316,7,1,6,42,1
110316,7,1,6,43,1
110316,7,1,6,45,1
110316,276,81,195,52,3
110316,1,0,1,59,1
110316,6,1,5,60,1
110334,13666,6589,7077,1,4
110334,13666,6589,7077,2,1
110334,12724,6141,6583,3,1
110334,2002,1019,983,4,1
110334,10722,5122,5600,5,1
110334,942,448,494,11,1
110334,661,328,333,19,1
110334,10061,4794,5267,20,1
110334,4625,2261,2364,21,4
110334,4625,2261,2364,22,1
110334,4562,2223,2339,23,1
110334,1081,543,538,24,1
110334,3481,1680,1801,25,1
110334,63,38,25,31,1
110334,238,126,112,39,1
110334,3243,1554,1689,40,1
110334,9041,4328,4713,41,4
110334,9041,4328,4713,42,1
110334,8162,3918,4244,43,1
110334,921,476,445,44,1
110334,7241,3442,3799,45,1
110334,879,410,469,51,1
110334,423,202,221,59,1
110334,6818,3240,3578,60,1
110361,7144,2455,4689,1,4
110361,5797,2105,3692,2,1
110361,5797,2105,3692,3,1
110361,993,389,604,4,1
110361,4804,1716,3088,5,1
110361,1347,350,997,12,3
110361,769,253,516,19,1
110361,4035,1463,2572,20,1
110361,5864,2055,3809,21,4
110361,5086,1861,3225,22,1
110361,5086,1861,3225,23,1
110361,967,381,586,24,1
110361,4119,1480,2639,25,1
110361,778,194,584,32,3
110361,652,212,440,39,1
110361,3467,1268,2199,40,1
110361,1280,400,880,41,4
110361,711,244,467,42,1
110361,711,244,467,43,1
110361,26,8,18,44,1
110361,685,236,449,45,1
110361,569,156,413,52,3
110361,117,41,76,59,1
110361,568,195,373,60,1
110370,1949,742,1207,1,4
110370,1502,569,933,2,1
110370,1463,561,902,3,1
110370,232,73,159,4,1
110370,1231,488,743,5,1
110370,39,8,31,11,1
110370,447,173,274,12,3
110370,190,68,122,19,1
110370,1041,420,621,20,1
110370,1825,701,1124,21,4
110370,1410,539,871,22,1
110370,1390,534,856,23,1
110370,232,73,159,24,1
110370,1158,461,697,25,1
110370,20,5,15,31,1
110370,415,162,253,32,3
110370,187,67,120,39,1
110370,971,394,577,40,1
110370,124,41,83,41,4
110370,92,30,62,42,1
110370,73,27,46,43,1
110370,73,27,46,45,1
110370,19,3,16,51,1
110370,32,11,21,52,3
110370,3,1,2,59,1
110370,70,26,44,60,1
110398,1088,534,554,1,4
110398,1088,534,554,12,3
110398,1072,527,545,21,4
110398,1072,527,545,32,3
110398,16,7,9,41,4
110398,16,7,9,52,3
110404,2181,1497,684,1,4
110404,977,619,358,2,1
110404,977,619,358,3,1
110404,248,160,88,4,1
110404,729,459,270,5,1
110404,1204,878,326,12,3
110404,7,6,1,19,1
110404,722,453,269,20,1
110404,2181,1497,684,21,4
110404,977,619,358,22,1
110404,977,619,358,23,1
110404,248,160,88,24,1
110404,729,459,270,25,1
110404,1204,878,326,32,3
110404,7,6,1,39,1
110404,722,453,269,40,1
110413,4282,1863,2419,1,4
110413,2888,1302,1586,2,1
110413,2882,1301,1581,3,1
110413,540,247,293,4,1
110413,2342,1054,1288,5,1
110413,6,1,5,11,1
110413,1394,561,833,12,3
110413,320,154,166,19,1
110413,2022,900,1122,20,1
110413,3740,1623,2117,21,4
110413,2717,1232,1485,22,1
110413,2712,1231,1481,23,1
110413,540,247,293,24,1
110413,2172,984,1188,25,1
110413,5,1,4,31,1
110413,1023,391,632,32,3
110413,296,147,149,39,1
110413,1876,837,1039,40,1
110413,542,240,302,41,4
110413,171,70,101,42,1
110413,170,70,100,43,1
110413,170,70,100,45,1
110413,1,0,1,51,1
110413,371,170,201,52,3
110413,24,7,17,59,1
110413,146,63,83,60,1
110422,19703,10772,8931,1,4
110422,18739,10263,8476,2,1
110422,18664,10223,8441,3,1
110422,4773,2519,2254,4,1
110422,13891,7704,6187,5,1
110422,75,40,35,11,1
110422,964,509,455,12,3
110422,936,513,423,19,1
110422,12955,7191,5764,20,1
110422,18775,10208,8567,21,4
110422,18058,9836,8222,22,1
110422,17992,9800,8192,23,1
110422,4765,2513,2252,24,1
110422,13227,7287,5940,25,1
110422,66,36,30,31,1
110422,717,372,345,32,3
110422,911,497,414,39,1
110422,12316,6790,5526,40,1
110422,928,564,364,41,4
110422,681,427,254,42,1
110422,672,423,249,43,1
110422,8,6,2,44,1
110422,664,417,247,45,1
110422,9,4,5,51,1
110422,247,137,110,52,3
110422,25,16,9,59,1
110422,639,401,238,60,1
110468,4201,1256,2945,1,4
110468,917,402,515,2,1
110468,254,98,156,3,1
110468,26,7,19,4,1
110468,228,91,137,5,1
110468,663,304,359,11,1
110468,3284,854,2430,12,3
110468,142,57,85,19,1
110468,86,34,52,20,1
110468,2038,541,1497,21,4
110468,179,81,98,22,1
110468,171,76,95,23,1
110468,25,7,18,24,1
110468,146,69,77,25,1
110468,8,5,3,31,1
110468,1859,460,1399,32,3
110468,81,43,38,39,1
110468,65,26,39,40,1
110468,2163,715,1448,41,4
110468,738,321,417,42,1
110468,83,22,61,43,1
110468,1,0,1,44,1
110468,82,22,60,45,1
110468,655,299,356,51,1
110468,1425,394,1031,52,3
110468,61,14,47,59,1
110468,21,8,13,60,1
110486,8371,3239,5132,1,4
110486,7350,2902,4448,2,1
110486,7226,2827,4399,3,1
110486,1342,521,821,4,1
110486,5884,2306,3578,5,1
110486,124,75,49,11,1
110486,1021,337,684,12,3
110486,693,276,417,19,1
110486,5191,2030,3161,20,1
110486,7190,2717,4473,21,4
110486,6519,2528,3991,22,1
110486,6507,2524,3983,23,1
110486,1323,511,812,24,1
110486,5184,2013,3171,25,1
110486,12,4,8,31,1
110486,671,189,482,32,3
110486,603,248,355,39,1
110486,4581,1765,2816,40,1
110486,1181,522,659,41,4
110486,831,374,457,42,1
110486,719,303,416,43,1
110486,19,10,9,44,1
110486,700,293,407,45,1
110486,112,71,41,51,1
110486,350,148,202,52,3
110486,90,28,62,59,1
110486,610,265,345,60,1
110495,8917,3111,5806,1,4
110495,7754,2782,4972,2,1
110495,7751,2781,4970,3,1
110495,1224,408,816,4,1
110495,6527,2373,4154,5,1
110495,3,1,2,11,1
110495,1163,329,834,12,3
110495,1108,434,674,19,1
110495,5419,1939,3480,20,1
110495,7256,2529,4727,21,4
110495,6547,2332,4215,22,1
110495,6544,2331,4213,23,1
110495,1181,394,787,24,1
110495,5363,1937,3426,25,1
110495,3,1,2,31,1
110495,709,197,512,32,3
110495,893,351,542,39,1
110495,4470,1586,2884,40,1
110495,1661,582,1079,41,4
110495,1207,450,757,42,1
110495,1207,450,757,43,1
110495,43,14,29,44,1
110495,1164,436,728,45,1
110495,454,132,322,52,3
110495,215,83,132,59,1
110495,949,353,596,60,1
110510,18398,7030,11368,1,4
110510,16191,6290,9901,2,1
110510,15887,6137,9750,3,1
110510,2358,867,1491,4,1
110510,13529,5270,8259,5,1
110510,304,153,151,11,1
110510,2207,740,1467,12,3
110510,1949,790,1159,19,1
110510,11580,4480,7100,20,1
110510,15213,5750,9463,21,4
110510,14299,5476,8823,22,1
110510,14195,5425,8770,23,1
110510,2319,847,1472,24,1
110510,11876,4578,7298,25,1
110510,104,51,53,31,1
110510,914,274,640,32,3
110510,1661,684,977,39,1
110510,10215,3894,6321,40,1
110510,3185,1280,1905,41,4
110510,1892,814,1078,42,1
110510,1692,712,980,43,1
110510,39,20,19,44,1
110510,1653,692,961,45,1
110510,200,102,98,51,1
110510,1293,466,827,52,3
110510,288,106,182,59,1
110510,1365,586,779,60,1
110529,22501,12584,9917,1,4
110529,20952,11861,9091,2,1
110529,20857,11825,9032,3,1
110529,3257,1739,1518,4,1
110529,17600,10086,7514,5,1
110529,95,36,59,11,1
110529,1549,723,826,12,3
110529,2487,1337,1150,19,1
110529,15113,8749,6364,20,1
110529,18995,10496,8499,21,4
110529,18410,10251,8159,22,1
110529,18383,10237,8146,23,1
110529,3169,1681,1488,24,1
110529,15214,8556,6658,25,1
110529,27,14,13,31,1
110529,585,245,340,32,3
110529,2164,1148,1016,39,1
110529,13050,7408,5642,40,1
110529,3506,2088,1418,41,4
110529,2542,1610,932,42,1
110529,2474,1588,886,43,1
110529,88,58,30,44,1
110529,2386,1530,856,45,1
110529,68,22,46,51,1
110529,964,478,486,52,3
110529,323,189,134,59,1
110529,2063,1341,722,60,1
110538,16356,7685,8671,1,4
110538,15290,7348,7942,2,1
110538,15106,7268,7838,3,1
110538,2340,1012,1328,4,1
110538,12766,6256,6510,5,1
110538,184,80,104,11,1
110538,1066,337,729,12,3
110538,1599,818,781,19,1
110538,11167,5438,5729,20,1
110538,14960,7038,7922,21,4
110538,14207,6805,7402,22,1
110538,14116,6765,7351,23,1
110538,2316,1000,1316,24,1
110538,11800,5765,6035,25,1
110538,91,40,51,31,1
110538,753,233,520,32,3
110538,1476,769,707,39,1
110538,10324,4996,5328,40,1
110538,1396,647,749,41,4
110538,1083,543,540,42,1
110538,990,503,487,43,1
110538,24,12,12,44,1
110538,966,491,475,45,1
110538,93,40,53,51,1
110538,313,104,209,52,3
110538,123,49,74,59,1
110538,843,442,401,60,1
110547,14670,5050,9620,1,4
110547,12481,4496,7985,2,1
110547,11894,4232,7662,3,1
110547,1556,575,981,4,1
110547,10338,3657,6681,5,1
110547,587,264,323,11,1
110547,2189,554,1635,12,3
110547,2632,945,1687,19,1
110547,7706,2712,4994,20,1
110547,9599,3463,6136,21,4
110547,8574,3182,5392,22,1
110547,8571,3180,5391,23,1
110547,1460,531,929,24,1
110547,7111,2649,4462,25,1
110547,3,2,1,31,1
110547,1025,281,744,32,3
110547,1690,655,1035,39,1
110547,5421,1994,3427,40,1
110547,5071,1587,3484,41,4
110547,3907,1314,2593,42,1
110547,3323,1052,2271,43,1
110547,96,44,52,44,1
110547,3227,1008,2219,45,1
110547,584,262,322,51,1
110547,1164,273,891,52,3
110547,942,290,652,59,1
110547,2285,718,1567,60,1
110556,23060,9682,13378,1,4
110556,20295,8754,11541,2,1
110556,19911,8583,11328,3,1
110556,3265,1348,1917,4,1
110556,16646,7235,9411,5,1
110556,384,171,213,11,1
110556,2765,928,1837,12,3
110556,2305,1099,1206,19,1
110556,14341,6136,8205,20,1
110556,19511,8112,11399,21,4
110556,17571,7471,10100,22,1
110556,17550,7461,10089,23,1
110556,3166,1302,1864,24,1
110556,14384,6159,8225,25,1
110556,21,10,11,31,1
110556,1940,641,1299,32,3
110556,1860,893,967,39,1
110556,12524,5266,7258,40,1
110556,3549,1570,1979,41,4
110556,2724,1283,1441,42,1
110556,2361,1122,1239,43,1
110556,99,46,53,44,1
110556,2262,1076,1186,45,1
110556,363,161,202,51,1
110556,825,287,538,52,3
110556,445,206,239,59,1
110556,1817,870,947,60,1
110565,38325,16854,21471,1,4
110565,33116,14750,18366,2,1
110565,33000,14697,18303,3,1
110565,4667,2045,2622,4,1
110565,28333,12652,15681,5,1
110565,116,53,63,11,1
110565,5209,2104,3105,12,3
110565,4752,2180,2572,19,1
110565,23581,10472,13109,20,1
110565,29023,12574,16449,21,4
110565,26682,11751,14931,22,1
110565,26622,11721,14901,23,1
110565,4512,1962,2550,24,1
110565,22110,9759,12351,25,1
110565,60,30,30,31,1
110565,2341,823,1518,32,3
110565,3445,1592,1853,39,1
110565,18665,8167,10498,40,1
110565,9302,4280,5022,41,4
110565,6434,2999,3435,42,1
110565,6378,2976,3402,43,1
110565,155,83,72,44,1
110565,6223,2893,3330,45,1
110565,56,23,33,51,1
110565,2868,1281,1587,52,3
110565,1307,588,719,59,1
110565,4916,2305,2611,60,1
110574,14526,5616,8910,1,4
110574,12146,4703,7443,2,1
110574,12079,4678,7401,3,1
110574,1512,523,989,4,1
110574,10567,4155,6412,5,1
110574,67,25,42,11,1
110574,2380,913,1467,12,3
110574,2064,782,1282,19,1
110574,8503,3373,5130,20,1
110574,11733,4426,7307,21,4
110574,10546,4030,6516,22,1
110574,10508,4018,6490,23,1
110574,1477,505,972,24,1
110574,9031,3513,5518,25,1
110574,38,12,26,31,1
110574,1187,396,791,32,3
110574,1742,646,1096,39,1
110574,7289,2867,4422,40,1
110574,2793,1190,1603,41,4
110574,1600,673,927,42,1
110574,1571,660,911,43,1
110574,35,18,17,44,1
110574,1536,642,894,45,1
110574,29,13,16,51,1
110574,1193,517,676,52,3
110574,322,136,186,59,1
110574,1214,506,708,60,1
110583,35586,15204,20382,1,4
110583,30593,13270,17323,2,1
110583,30440,13204,17236,3,1
110583,4343,1830,2513,4,1
110583,26097,11374,14723,5,1
110583,153,66,87,11,1
110583,4993,1934,3059,12,3
110583,3284,1477,1807,19,1
110583,22813,9897,12916,20,1
110583,28440,12073,16367,21,4
110583,25815,11042,14773,22,1
110583,25677,10986,14691,23,1
110583,4119,1685,2434,24,1
110583,21558,9301,12257,25,1
110583,138,56,82,31,1
110583,2625,1031,1594,32,3
110583,2829,1285,1544,39,1
110583,18729,8016,10713,40,1
110583,7146,3131,4015,41,4
110583,4778,2228,2550,42,1
110583,4763,2218,2545,43,1
110583,224,145,79,44,1
110583,4539,2073,2466,45,1
110583,15,10,5,51,1
110583,2368,903,1465,52,3
110583,455,192,263,59,1
110583,4084,1881,2203,60,1
110592,23258,9471,13787,1,4
110592,19589,8073,11516,2,1
110592,19525,8044,11481,3,1
110592,3021,1238,1783,4,1
110592,16504,6806,9698,5,1
110592,64,29,35,11,1
110592,3669,1398,2271,12,3
110592,3264,1459,1805,19,1
110592,13240,5347,7893,20,1
110592,18104,7291,10813,21,4
110592,16280,6691,9589,22,1
110592,16245,6675,9570,23,1
110592,2895,1180,1715,24,1
110592,13350,5495,7855,25,1
110592,35,16,19,31,1
110592,1824,600,1224,32,3
110592,2233,1020,1213,39,1
110592,11117,4475,6642,40,1
110592,5154,2180,2974,41,4
110592,3309,1382,1927,42,1
110592,3280,1369,1911,43,1
110592,126,58,68,44,1
110592,3154,1311,1843,45,1
110592,29,13,16,51,1
110592,1845,798,1047,52,3
110592,1031,439,592,59,1
110592,2123,872,1251,60,1
110608,38310,17020,21290,1,4
110608,33771,15359,18412,2,1
110608,33581,15302,18279,3,1
110608,5818,2514,3304,4,1
110608,27763,12788,14975,5,1
110608,190,57,133,11,1
110608,4539,1661,2878,12,3
110608,5242,2377,2865,19,1
110608,22521,10411,12110,20,1
110608,30423,13417,17006,21,4
110608,28200,12656,15544,22,1
110608,28146,12640,15506,23,1
110608,5760,2478,3282,24,1
110608,22386,10162,12224,25,1
110608,54,16,38,31,1
110608,2223,761,1462,32,3
110608,3968,1769,2199,39,1
110608,18418,8393,10025,40,1
110608,7887,3603,4284,41,4
110608,5571,2703,2868,42,1
110608,5435,2662,2773,43,1
110608,58,36,22,44,1
110608,5377,2626,2751,45,1
110608,136,41,95,51,1
110608,2316,900,1416,52,3
110608,1274,608,666,59,1
110608,4103,2018,2085,60,1
110617,28811,12272,16539,1,4
110617,26094,11333,14761,2,1
110617,25991,11292,14699,3,1
110617,3366,1384,1982,4,1
110617,22625,9908,12717,5,1
110617,103,41,62,11,1
110617,2717,939,1778,12,3
110617,4353,1937,2416,19,1
110617,18272,7971,10301,20,1
110617,22735,9475,13260,21,4
110617,21094,8982,12112,22,1
110617,21028,8958,12070,23,1
110617,3202,1306,1896,24,1
110617,17826,7652,10174,25,1
110617,66,24,42,31,1
110617,1641,493,1148,32,3
110617,3170,1402,1768,39,1
110617,14656,6250,8406,40,1
110617,6076,2797,3279,41,4
110617,5000,2351,2649,42,1
110617,4963,2334,2629,43,1
110617,164,78,86,44,1
110617,4799,2256,2543,45,1
110617,37,17,20,51,1
110617,1076,446,630,52,3
110617,1183,535,648,59,1
110617,3616,1721,1895,60,1
110635,36198,18099,18099,1,4
110635,25951,12490,13461,2,1
110635,25951,12490,13461,3,1
110635,4706,2292,2414,4,1
110635,21245,10198,11047,5,1
110635,10247,5609,4638,12,3
110635,2241,1162,1079,19,1
110635,19004,9036,9968,20,1
110635,34675,17203,17472,21,4
110635,25220,12146,13074,22,1
110635,25220,12146,13074,23,1
110635,4677,2279,2398,24,1
110635,20543,9867,10676,25,1
110635,9455,5057,4398,32,3
110635,2191,1136,1055,39,1
110635,18352,8731,9621,40,1
110635,1523,896,627,41,4
110635,731,344,387,42,1
110635,731,344,387,43,1
110635,29,13,16,44,1
110635,702,331,371,45,1
110635,792,552,240,52,3
110635,50,26,24,59,1
110635,652,305,347,60,1
110644,33307,14894,18413,1,4
110644,26533,11580,14953,2,1
110644,26483,11560,14923,3,1
110644,5113,1909,3204,4,1
110644,21370,9651,11719,5,1
110644,50,20,30,11,1
110644,6774,3314,3460,12,3
110644,3087,1550,1537,19,1
110644,18283,8101,10182,20,1
110644,31986,14211,17775,21,4
110644,25826,11227,14599,22,1
110644,25776,11207,14569,23,1
110644,5063,1889,3174,24,1
110644,20713,9318,11395,25,1
110644,50,20,30,31,1
110644,6160,2984,3176,32,3
110644,3028,1522,1506,39,1
110644,17685,7796,9889,40,1
110644,1321,683,638,41,4
110644,707,353,354,42,1
110644,707,353,354,43,1
110644,50,20,30,44,1
110644,657,333,324,45,1
110644,614,330,284,52,3
110644,59,28,31,59,1
110644,598,305,293,60,1
110653,28895,13832,15063,1,4
110653,23530,10752,12778,2,1
110653,23517,10743,12774,3,1
110653,5460,2409,3051,4,1
110653,18057,8334,9723,5,1
110653,13,9,4,11,1
110653,5365,3080,2285,12,3
110653,1998,1023,975,19,1
110653,16059,7311,8748,20,1
110653,28046,13323,14723,21,4
110653,23127,10534,12593,22,1
110653,23114,10525,12589,23,1
110653,5449,2400,3049,24,1
110653,17665,8125,9540,25,1
110653,13,9,4,31,1
110653,4919,2789,2130,32,3
110653,1968,1008,960,39,1
110653,15697,7117,8580,40,1
110653,849,509,340,41,4
110653,403,218,185,42,1
110653,403,218,185,43,1
110653,11,9,2,44,1
110653,392,209,183,45,1
110653,446,291,155,52,3
110653,30,15,15,59,1
110653,362,194,168,60,1
110662,40795,19349,21446,1,4
110662,28674,12825,15849,2,1
110662,28667,12819,15848,3,1
110662,5697,2401,3296,4,1
110662,22970,10418,12552,5,1
110662,7,6,1,11,1
110662,12121,6524,5597,12,3
110662,2821,1272,1549,19,1
110662,20149,9146,11003,20,1
110662,39794,18737,21057,21,4
110662,28084,12520,15564,22,1
110662,28077,12514,15563,23,1
110662,5684,2395,3289,24,1
110662,22393,10119,12274,25,1
110662,7,6,1,31,1
110662,11710,6217,5493,32,3
110662,2780,1257,1523,39,1
110662,19613,8862,10751,40,1
110662,1001,612,389,41,4
110662,590,305,285,42,1
110662,590,305,285,43,1
110662,13,6,7,44,1
110662,577,299,278,45,1
110662,411,307,104,52,3
110662,41,15,26,59,1
110662,536,284,252,60,1
110671,21207,10529,10678,1,4
110671,18621,9106,9515,2,1
110671,18612,9101,9511,3,1
110671,4203,2007,2196,4,1
110671,14409,7094,7315,5,1
110671,9,5,4,11,1
110671,2586,1423,1163,12,3
110671,1312,739,573,19,1
110671,13097,6355,6742,20,1
110671,20653,10219,10434,21,4
110671,18205,8858,9347,22,1
110671,18197,8853,9344,23,1
110671,4187,2000,2187,24,1
110671,14010,6853,7157,25,1
110671,8,5,3,31,1
110671,2448,1361,1087,32,3
110671,1279,719,560,39,1
110671,12731,6134,6597,40,1
110671,554,310,244,41,4
110671,416,248,168,42,1
110671,415,248,167,43,1
110671,16,7,9,44,1
110671,399,241,158,45,1
110671,1,0,1,51,1
110671,138,62,76,52,3
110671,33,20,13,59,1
110671,366,221,145,60,1
110680,29517,15752,13765,1,4
110680,23805,12270,11535,2,1
110680,23792,12263,11529,3,1
110680,5228,2616,2612,4,1
110680,18564,9647,8917,5,1
110680,13,7,6,11,1
110680,5712,3482,2230,12,3
110680,2699,1495,1204,19,1
110680,15865,8152,7713,20,1
110680,28606,15195,13411,21,4
110680,23152,11887,11265,22,1
110680,23147,11882,11265,23,1
110680,5218,2611,2607,24,1
110680,17929,9271,8658,25,1
110680,5,5,0,31,1
110680,5454,3308,2146,32,3
110680,2654,1472,1182,39,1
110680,15275,7799,7476,40,1
110680,911,557,354,41,4
110680,653,383,270,42,1
110680,645,381,264,43,1
110680,10,5,5,44,1
110680,635,376,259,45,1
110680,8,2,6,51,1
110680,258,174,84,52,3
110680,45,23,22,59,1
110680,590,353,237,60,1
110699,3079,1159,1920,1,4
110699,3079,1159,1920,12,3
110699,3079,1159,1920,21,4
110699,3079,1159,1920,32,3
110705,22225,10848,11377,1,4
110705,19362,9237,10125,2,1
110705,19362,9237,10125,3,1
110705,4624,2182,2442,4,1
110705,14738,7055,7683,5,1
110705,2863,1611,1252,12,3
110705,1495,763,732,19,1
110705,13243,6292,6951,20,1
110705,21771,10601,11170,21,4
110705,19076,9065,10011,22,1
110705,19076,9065,10011,23,1
110705,4597,2168,2429,24,1
110705,14479,6897,7582,25,1
110705,2695,1536,1159,32,3
110705,1452,739,713,39,1
110705,13027,6158,6869,40,1
110705,454,247,207,41,4
110705,286,172,114,42,1
110705,286,172,114,43,1
110705,27,14,13,44,1
110705,259,158,101,45,1
110705,168,75,93,52,3
110705,43,24,19,59,1
110705,216,134,82,60,1
110714,17203,8160,9043,1,4
110714,15695,7342,8353,2,1
110714,15695,7342,8353,3,1
110714,3302,1498,1804,4,1
110714,12393,5844,6549,5,1
110714,1508,818,690,12,3
110714,1001,533,468,19,1
110714,11392,5311,6081,20,1
110714,16755,7910,8845,21,4
110714,15323,7148,8175,22,1
110714,15323,7148,8175,23,1
110714,3295,1496,1799,24,1
110714,12028,5652,6376,25,1
110714,1432,762,670,32,3
110714,978,522,456,39,1
110714,11050,5130,5920,40,1
110714,448,250,198,41,4
110714,372,194,178,42,1
110714,372,194,178,43,1
110714,7,2,5,44,1
110714,365,192,173,45,1
110714,76,56,20,52,3
110714,23,11,12,59,1
110714,342,181,161,60,1
110778,453,114,339,1,4
110778,20,4,16,2,1
110778,20,4,16,3,1
110778,20,4,16,5,1
110778,433,110,323,12,3
110778,20,4,16,19,1
110778,399,103,296,21,4
110778,20,4,16,22,1
110778,20,4,16,23,1
110778,20,4,16,25,1
110778,379,99,280,32,3
110778,20,4,16,39,1
110778,54,11,43,41,4
110778,54,11,43,52,3
110875,114,6,108,1,4
110875,114,6,108,2,1
110875,114,6,108,3,1
110875,32,1,31,4,1
110875,82,5,77,5,1
110875,82,5,77,20,1
110875,88,5,83,21,4
110875,88,5,83,22,1
110875,88,5,83,23,1
110875,31,1,30,24,1
110875,57,4,53,25,1
110875,57,4,53,40,1
110875,26,1,25,41,4
110875,26,1,25,42,1
110875,26,1,25,43,1
110875,1,0,1,44,1
110875,25,1,24,45,1
110875,25,1,24,60,1
110918,30,19,11,1,4
110918,30,19,11,2,1
110918,30,19,11,3,1
110918,4,1,3,4,1
110918,26,18,8,5,1
110918,6,4,2,19,1
110918,20,14,6,20,1
110918,18,11,7,21,4
110918,18,11,7,22,1
110918,18,11,7,23,1
110918,2,1,1,24,1
110918,16,10,6,25,1
110918,3,1,2,39,1
110918,13,9,4,40,1
110918,12,8,4,41,4
110918,12,8,4,42,1
110918,12,8,4,43,1
110918,2,0,2,44,1
110918,10,8,2,45,1
110918,3,3,0,59,1
110918,7,5,2,60,1
110945,762,340,422,1,4
110945,762,340,422,2,1
110945,762,340,422,3,1
110945,175,74,101,4,1
110945,587,266,321,5,1
110945,587,266,321,20,1
110945,762,340,422,21,4
110945,762,340,422,22,1
110945,762,340,422,23,1
110945,175,74,101,24,1
110945,587,266,321,25,1
110945,587,266,321,40,1
111009,489,275,214,1,4
111009,489,275,214,2,1
111009,489,275,214,3,1
111009,96,49,47,4,1
111009,393,226,167,5,1
111009,18,6,12,19,1
111009,375,220,155,20,1
111009,489,275,214,21,4
111009,489,275,214,22,1
111009,489,275,214,23,1
111009,96,49,47,24,1
111009,393,226,167,25,1
111009,18,6,12,39,1
111009,375,220,155,40,1
111054,219,10,209,1,4
111054,219,10,209,2,1
111054,219,10,209,3,1
111054,30,3,27,4,1
111054,189,7,182,5,1
111054,189,7,182,20,1
111054,219,10,209,21,4
111054,219,10,209,22,1
111054,219,10,209,23,1
111054,30,3,27,24,1
111054,189,7,182,25,1
111054,189,7,182,40,1
111081,1489,708,781,1,4
111081,995,466,529,2,1
111081,987,462,525,3,1
111081,172,72,100,4,1
111081,815,390,425,5,1
111081,8,4,4,11,1
111081,494,242,252,12,3
111081,149,89,60,19,1
111081,666,301,365,20,1
111081,1472,695,777,21,4
111081,982,456,526,22,1
111081,974,452,522,23,1
111081,172,72,100,24,1
111081,802,380,422,25,1
111081,8,4,4,31,1
111081,490,239,251,32,3
111081,148,88,60,39,1
111081,654,292,362,40,1
111081,17,13,4,41,4
111081,13,10,3,42,1
111081,13,10,3,43,1
111081,13,10,3,45,1
111081,4,3,1,52,3
111081,1,1,0,59,1
111081,12,9,3,60,1
111188,1045,896,149,1,4
111188,1045,896,149,2,1
111188,1044,895,149,3,1
111188,202,179,23,4,1
111188,842,716,126,5,1
111188,1,1,0,11,1
111188,87,69,18,19,1
111188,755,647,108,20,1
111188,1008,865,143,21,4
111188,1008,865,143,22,1
111188,1007,864,143,23,1
111188,199,176,23,24,1
111188,808,688,120,25,1
111188,1,1,0,31,1
111188,87,69,18,39,1
111188,721,619,102,40,1
111188,37,31,6,41,4
111188,37,31,6,42,1
111188,37,31,6,43,1
111188,3,3,0,44,1
111188,34,28,6,45,1
111188,34,28,6,60,1
111391,704,324,380,1,4
111391,704,324,380,12,3
111391,610,282,328,21,4
111391,610,282,328,32,3
111391,94,42,52,41,4
111391,94,42,52,52,3
111434,6620,2469,4151,1,4
111434,6620,2469,4151,2,1
111434,5217,1880,3337,3,1
111434,683,296,387,4,1
111434,4534,1584,2950,5,1
113096,1097,466,631,11,1
113096,1563,617,946,19,1
113096,9118,4016,5102,20,1
113096,3333,1620,1713,21,4
113096,3333,1620,1713,22,1
113096,3234,1575,1659,23,1
113096,734,362,372,24,1
113096,2500,1213,1287,25,1
113096,99,45,54,31,1
113096,203,87,116,39,1
113096,2297,1126,1171,40,1
113096,10616,4553,6063,41,4
113096,10616,4553,6063,42,1
113096,9618,4132,5486,43,1
113096,1437,712,725,44,1
113096,8181,3420,4761,45,1
113096,998,421,577,51,1
113096,1360,530,830,59,1
113096,6821,2890,3931,60,1
113111,5697,2705,2992,1,4
113111,5697,2705,2992,2,1
113111,4716,2239,2477,3,1
113111,888,445,443,4,1
113111,3828,1794,2034,5,1
113111,981,466,515,11,1
113111,492,226,266,19,1
113111,3336,1568,1768,20,1
113111,1991,940,1051,21,4
113111,1991,940,1051,22,1
113111,1652,791,861,23,1
113111,366,177,189,24,1
113111,1286,614,672,25,1
113111,339,149,190,31,1
113111,100,50,50,39,1
113111,1186,564,622,40,1
113111,3706,1765,1941,41,4
113111,3706,1765,1941,42,1
113111,3064,1448,1616,43,1
113111,522,268,254,44,1
113111,2542,1180,1362,45,1
113111,642,317,325,51,1
113111,392,176,216,59,1
113111,2150,1004,1146,60,1
113193,9256,4530,4726,1,4
113193,9256,4530,4726,2,1
113193,7964,3873,4091,3,1
113193,1539,824,715,4,1
113193,6425,3049,3376,5,1
113193,1292,657,635,11,1
113193,836,434,402,19,1
113193,5589,2615,2974,20,1
113193,3837,1994,1843,21,4
113193,3837,1994,1843,22,1
113193,3790,1966,1824,23,1
113193,1019,539,480,24,1
113193,2771,1427,1344,25,1
113193,47,28,19,31,1
113193,413,225,188,39,1
113193,2358,1202,1156,40,1
113193,5419,2536,2883,41,4
113193,5419,2536,2883,42,1
113193,4174,1907,2267,43,1
113193,520,285,235,44,1
113193,3654,1622,2032,45,1
113193,1245,629,616,51,1
113193,423,209,214,59,1
113193,3231,1413,1818,60,1
113218,8859,4183,4676,1,4
113218,8859,4183,4676,2,1
113218,7778,3676,4102,3,1
113218,1365,710,655,4,1
113218,6413,2966,3447,5,1
113218,1081,507,574,11,1
113218,1061,501,560,19,1
113218,5352,2465,2887,20,1
113218,2099,1051,1048,21,4
113218,2099,1051,1048,22,1
113218,1961,997,964,23,1
113218,600,318,282,24,1
113218,1361,679,682,25,1
113218,138,54,84,31,1
113218,136,73,63,39,1
113218,1225,606,619,40,1
113218,6760,3132,3628,41,4
113218,6760,3132,3628,42,1
113218,5817,2679,3138,43,1
113218,765,392,373,44,1
113218,5052,2287,2765,45,1
113218,943,453,490,51,1
113218,925,428,497,59,1
113218,4127,1859,2268,60,1
113236,15881,7164,8717,1,4
113236,15881,7164,8717,2,1
113236,14923,6736,8187,3,1
113236,2908,1366,1542,4,1
113236,12015,5370,6645,5,1
113236,958,428,530,11,1
113236,1671,747,924,19,1
113236,10344,4623,5721,20,1
113236,5079,2340,2739,21,4
113236,5079,2340,2739,22,1
113236,5042,2321,2721,23,1
113236,1084,489,595,24,1
113236,3958,1832,2126,25,1
113236,37,19,18,31,1
113236,260,124,136,39,1
113236,3698,1708,1990,40,1
113236,10802,4824,5978,41,4
113236,10802,4824,5978,42,1
113236,9881,4415,5466,43,1
113236,1824,877,947,44,1
113236,8057,3538,4519,45,1
113236,921,409,512,51,1
113236,1411,623,788,59,1
113236,6646,2915,3731,60,1
113333,23261,12003,11258,1,4
113333,23261,12003,11258,2,1
113333,20496,10619,9877,3,1
113333,4068,2197,1871,4,1
113333,16428,8422,8006,5,1
113333,2765,1384,1381,11,1
113333,1670,827,843,19,1
113333,14758,7595,7163,20,1
113333,10774,5916,4858,21,4
113333,10774,5916,4858,22,1
113333,10331,5676,4655,23,1
113333,2754,1523,1231,24,1
113333,7577,4153,3424,25,1
113333,443,240,203,31,1
113333,593,326,267,39,1
113333,6984,3827,3157,40,1
113333,12487,6087,6400,41,4
113333,12487,6087,6400,42,1
113333,10165,4943,5222,43,1
113333,1314,674,640,44,1
113333,8851,4269,4582,45,1
113333,2322,1144,1178,51,1
113333,1077,501,576,59,1
113333,7774,3768,4006,60,1
113397,1330,52,1278,1,4
113397,1330,52,1278,2,1
113397,1330,52,1278,3,1
113397,350,13,337,4,1
113397,980,39,941,5,1
113397,980,39,941,20,1
113397,1047,42,1005,21,4
113397,1047,42,1005,22,1
113397,1047,42,1005,23,1
113397,284,12,272,24,1
113397,763,30,733,25,1
113397,763,30,733,40,1
113397,283,10,273,41,4
113397,283,10,273,42,1
113397,283,10,273,43,1
113397,66,1,65,44,1
113397,217,9,208,45,1
113397,217,9,208,60,1
113449,229,78,151,1,4
113449,229,78,151,2,1
113449,229,78,151,3,1
113449,43,13,30,4,1
113449,186,65,121,5,1
113449,186,65,121,20,1
113449,229,78,151,21,4
113449,229,78,151,22,1
113449,229,78,151,23,1
113449,43,13,30,24,1
113449,186,65,121,25,1
113449,186,65,121,40,1
113537,29,15,14,1,4
113537,14,8,6,2,1
113537,14,8,6,3,1
113537,1,0,1,4,1
113537,13,8,5,5,1
113537,15,7,8,12,3
113537,13,8,5,19,1
113537,29,15,14,21,4
113537,14,8,6,22,1
113537,14,8,6,23,1
113537,1,0,1,24,1
113537,13,8,5,25,1
113537,15,7,8,32,3
113537,13,8,5,39,1
113573,9259,4269,4990,1,4
113573,9259,4269,4990,2,1
113573,8330,3886,4444,3,1
113573,1520,810,710,4,1
113573,6810,3076,3734,5,1
113573,929,383,546,11,1
113573,390,203,187,19,1
113573,6420,2873,3547,20,1
113573,3629,1829,1800,21,4
113573,3629,1829,1800,22,1
113573,3588,1808,1780,23,1
113573,753,429,324,24,1
113573,2835,1379,1456,25,1
113573,41,21,20,31,1
113573,143,73,70,39,1
113573,2692,1306,1386,40,1
113573,5630,2440,3190,41,4
113573,5630,2440,3190,42,1
113573,4742,2078,2664,43,1
113573,767,381,386,44,1
113573,3975,1697,2278,45,1
113573,888,362,526,51,1
113573,247,130,117,59,1
113573,3728,1567,2161,60,1
113582,181,11,170,1,4
113582,181,11,170,2,1
113582,181,11,170,3,1
113582,20,2,18,4,1
113582,161,9,152,5,1
113582,28,4,24,19,1
113582,133,5,128,20,1
113582,119,8,111,21,4
113582,119,8,111,22,1
113582,119,8,111,23,1
113582,19,2,17,24,1
113582,100,6,94,25,1
113582,18,3,15,39,1
113582,82,3,79,40,1
113582,62,3,59,41,4
113582,62,3,59,42,1
113582,62,3,59,43,1
113582,1,0,1,44,1
113582,61,3,58,45,1
113582,10,1,9,59,1
113582,51,2,49,60,1
113634,20286,9755,10531,1,4
113634,20286,9755,10531,2,1
113634,18566,8938,9628,3,1
113634,2858,1467,1391,4,1
113634,15708,7471,8237,5,1
113634,1720,817,903,11,1
113634,1366,567,799,19,1
113634,14342,6904,7438,20,1
113634,7690,4035,3655,21,4
113634,7690,4035,3655,22,1
113634,7541,3965,3576,23,1
113634,1429,748,681,24,1
113634,6112,3217,2895,25,1
113634,149,70,79,31,1
113634,324,146,178,39,1
113634,5788,3071,2717,40,1
113634,12596,5720,6876,41,4
113634,12596,5720,6876,42,1
113634,11025,4973,6052,43,1
113634,1429,719,710,44,1
113634,9596,4254,5342,45,1
113634,1571,747,824,51,1
113634,1042,421,621,59,1
113634,8554,3833,4721,60,1
113698,2147,537,1610,1,4
113698,1603,414,1189,2,1
113698,1567,404,1163,3,1
113698,306,83,223,4,1
113698,1261,321,940,5,1
113698,36,10,26,11,1
113698,544,123,421,12,3
113698,141,49,92,19,1
113698,1120,272,848,20,1
113698,1603,396,1207,21,4
113698,1298,335,963,22,1
113698,1289,333,956,23,1
113698,306,83,223,24,1
113698,983,250,733,25,1
113698,9,2,7,31,1
113698,305,61,244,32,3
113698,67,26,41,39,1
113698,916,224,692,40,1
113698,544,141,403,41,4
113698,305,79,226,42,1
113698,278,71,207,43,1
113698,278,71,207,45,1
113698,27,8,19,51,1
113698,239,62,177,52,3
113698,74,23,51,59,1
113698,204,48,156,60,1
113704,89,78,11,1,4
113704,89,78,11,12,3
113704,54,49,5,21,4
113704,54,49,5,32,3
113704,35,29,6,41,4
113704,35,29,6,52,3
113856,36606,19253,17353,1,4
113856,36606,19253,17353,2,1
113856,33439,17902,15537,3,1
113856,4853,2703,2150,4,1
113856,28586,15199,13387,5,1
113856,3167,1351,1816,11,1
113856,1571,708,863,19,1
113856,27015,14491,12524,20,1
113856,7090,3194,3896,21,4
113856,7090,3194,3896,22,1
113856,7008,3164,3844,23,1
113856,1331,670,661,24,1
113856,5677,2494,3183,25,1
113856,82,30,52,31,1
113856,273,133,140,39,1
113856,5404,2361,3043,40,1
113856,29516,16059,13457,41,4
113856,29516,16059,13457,42,1
113856,26431,14738,11693,43,1
113856,3522,2033,1489,44,1
113856,22909,12705,10204,45,1
113856,3085,1321,1764,51,1
113856,1298,575,723,59,1
113856,21611,12130,9481,60,1
113908,566,50,516,1,4
113908,566,50,516,2,1
113908,566,50,516,3,1
113908,152,22,130,4,1
113908,414,28,386,5,1
113908,414,28,386,20,1
113908,345,38,307,21,4
113908,345,38,307,22,1
113908,345,38,307,23,1
113908,110,19,91,24,1
113908,235,19,216,25,1
113908,235,19,216,40,1
113908,221,12,209,41,4
113908,221,12,209,42,1
113908,221,12,209,43,1
113908,42,3,39,44,1
113908,179,9,170,45,1
113908,179,9,170,60,1
113980,23996,11672,12324,1,4
113980,23996,11672,12324,2,1
113980,22222,10811,11411,3,1
113980,4322,2204,2118,4,1
113980,17900,8607,9293,5,1
113980,1774,861,913,11,1
113980,1500,698,802,19,1
113980,16400,7909,8491,20,1
113980,7866,4058,3808,21,4
113980,7866,4058,3808,22,1
113980,7785,4016,3769,23,1
113980,2216,1130,1086,24,1
113980,5569,2886,2683,25,1
113980,81,42,39,31,1
113980,316,172,144,39,1
113980,5253,2714,2539,40,1
113980,16130,7614,8516,41,4
113980,16130,7614,8516,42,1
113980,14437,6795,7642,43,1
113980,2106,1074,1032,44,1
113980,12331,5721,6610,45,1
113980,1693,819,874,51,1
113980,1184,526,658,59,1
113980,11147,5195,5952,60,1
114044,205,18,187,1,4
114044,205,18,187,2,1
114044,205,18,187,3,1
114044,78,5,73,4,1
114044,127,13,114,5,1
114044,127,13,114,20,1
114044,205,18,187,21,4
114044,205,18,187,22,1
114044,205,18,187,23,1
114044,78,5,73,24,1
114044,127,13,114,25,1
114044,127,13,114,40,1
114071,397,19,378,1,4
114071,397,19,378,2,1
114071,397,19,378,3,1
114071,98,4,94,4,1
114071,299,15,284,5,1
114071,299,15,284,20,1
114071,297,16,281,21,4
114071,297,16,281,22,1
114071,297,16,281,23,1
114071,66,4,62,24,1
114071,231,12,219,25,1
114071,231,12,219,40,1
114071,100,3,97,41,4
114071,100,3,97,42,1
114071,100,3,97,43,1
114071,32,0,32,44,1
114071,68,3,65,45,1
114071,68,3,65,60,1
114080,254,9,245,1,4
114080,254,9,245,2,1
114080,254,9,245,3,1
114080,90,2,88,4,1
114080,164,7,157,5,1
114080,164,7,157,20,1
114080,225,9,216,21,4
114080,225,9,216,22,1
114080,225,9,216,23,1
114080,85,2,83,24,1
114080,140,7,133,25,1
114080,140,7,133,40,1
114080,29,0,29,41,4
114080,29,0,29,42,1
114080,29,0,29,43,1
114080,5,0,5,44,1
114080,24,0,24,45,1
114080,24,0,24,60,1
114114,203,44,159,1,4
114114,203,44,159,12,3
114114,109,28,81,21,4
114114,109,28,81,32,3
114114,94,16,78,41,4
114114,94,16,78,52,3
114123,419,88,331,1,4
114123,419,88,331,2,1
114123,412,85,327,3,1
114123,300,51,249,4,1
114123,112,34,78,5,1
114123,7,3,4,11,1
114123,14,4,10,19,1
114123,98,30,68,20,1
114123,409,86,323,21,4
114123,409,86,323,22,1
114123,402,83,319,23,1
114123,293,51,242,24,1
114123,109,32,77,25,1
114123,7,3,4,31,1
114123,14,4,10,39,1
114123,95,28,67,40,1
114123,10,2,8,41,4
114123,10,2,8,42,1
114123,10,2,8,43,1
114123,7,0,7,44,1
114123,3,2,1,45,1
114123,3,2,1,60,1
114266,9211,4228,4983,1,4
114266,9211,4228,4983,2,1
114266,7472,3478,3994,3,1
114266,1156,551,605,4,1
114266,6316,2927,3389,5,1
114266,1739,750,989,11,1
114266,687,296,391,19,1
114266,5629,2631,2998,20,1
114266,2789,1330,1459,21,4
114266,2789,1330,1459,22,1
114266,2543,1234,1309,23,1
114266,595,278,317,24,1
114266,1948,956,992,25,1
114266,246,96,150,31,1
114266,135,71,64,39,1
114266,1813,885,928,40,1
114266,6422,2898,3524,41,4
114266,6422,2898,3524,42,1
114266,4929,2244,2685,43,1
114266,561,273,288,44,1
114266,4368,1971,2397,45,1
114266,1493,654,839,51,1
114266,552,225,327,59,1
114266,3816,1746,2070,60,1
114354,3459,382,3077,1,4
114354,3459,382,3077,2,1
114354,3459,382,3077,3,1
114354,523,70,453,4,1
114354,2936,312,2624,5,1
114354,552,57,495,19,1
114354,2384,255,2129,20,1
114354,3072,332,2740,21,4
114354,3072,332,2740,22,1
114354,3072,332,2740,23,1
114354,517,68,449,24,1
114354,2555,264,2291,25,1
114354,542,57,485,39,1
114354,2013,207,1806,40,1
114354,387,50,337,41,4
114354,387,50,337,42,1
114354,387,50,337,43,1
114354,6,2,4,44,1
114354,381,48,333,45,1
114354,10,0,10,59,1
114354,371,48,323,60,1
114390,637,43,594,1,4
114390,637,43,594,2,1
114390,637,43,594,3,1
114390,112,9,103,4,1
114390,525,34,491,5,1
114390,128,8,120,19,1
114390,397,26,371,20,1
114390,580,41,539,21,4
114390,580,41,539,22,1
114390,580,41,539,23,1
114390,111,9,102,24,1
114390,469,32,437,25,1
114390,126,8,118,39,1
114390,343,24,319,40,1
114390,57,2,55,41,4
114390,57,2,55,42,1
114390,57,2,55,43,1
114390,1,0,1,44,1
114390,56,2,54,45,1
114390,2,0,2,59,1
114390,54,2,52,60,1
114415,214,24,190,1,4
114415,214,24,190,2,1
114415,214,24,190,3,1
114415,115,9,106,4,1
114415,99,15,84,5,1
114415,62,9,53,19,1
114415,37,6,31,20,1
114415,205,23,182,21,4
114415,205,23,182,22,1
114415,205,23,182,23,1
114415,113,9,104,24,1
114415,92,14,78,25,1
114415,62,9,53,39,1
114415,30,5,25,40,1
114415,9,1,8,41,4
114415,9,1,8,42,1
114415,9,1,8,43,1
114415,2,0,2,44,1
114415,7,1,6,45,1
114415,7,1,6,60,1
114433,1782,943,839,1,4
114433,1782,943,839,2,1
114433,1444,814,630,3,1
114433,354,217,137,4,1
114433,1090,597,493,5,1
114433,338,129,209,11,1
114433,278,168,110,19,1
114433,812,429,383,20,1
114433,636,370,266,21,4
114433,636,370,266,22,1
114433,636,370,266,23,1
114433,203,115,88,24,1
114433,433,255,178,25,1
114433,65,39,26,39,1
114433,368,216,152,40,1
114433,1146,573,573,41,4
114433,1146,573,573,42,1
114433,808,444,364,43,1
114433,151,102,49,44,1
114433,657,342,315,45,1
114433,338,129,209,51,1
114433,213,129,84,59,1
114433,444,213,231,60,1
114460,246,12,234,1,4
114460,246,12,234,2,1
114460,246,12,234,3,1
114460,115,10,105,4,1
114460,131,2,129,5,1
114460,131,2,129,20,1
114460,169,11,158,21,4
114460,169,11,158,22,1
114460,169,11,158,23,1
114460,84,10,74,24,1
114460,85,1,84,25,1
114460,85,1,84,40,1
114460,77,1,76,41,4
114460,77,1,76,42,1
114460,77,1,76,43,1
114460,31,0,31,44,1
114460,46,1,45,45,1
114460,46,1,45,60,1
114549,1190,331,859,1,4
114549,1190,331,859,12,3
114549,963,272,691,21,4
114549,963,272,691,32,3
114549,227,59,168,41,4
114549,227,59,168,52,3
114585,402,126,276,1,4
114585,402,126,276,12,3
114585,308,87,221,21,4
114585,308,87,221,32,3
114585,94,39,55,41,4
114585,94,39,55,52,3
114628,47,9,38,1,4
114628,47,9,38,2,1
114628,47,9,38,3,1
114628,35,5,30,4,1
114628,12,4,8,5,1
114628,12,4,8,20,1
114628,26,6,20,21,4
114628,26,6,20,22,1
114628,26,6,20,23,1
114628,20,4,16,24,1
114628,6,2,4,25,1
114628,6,2,4,40,1
114628,21,3,18,41,4
114628,21,3,18,42,1
114628,21,3,18,43,1
114628,15,1,14,44,1
114628,6,2,4,45,1
114628,6,2,4,60,1
114716,14814,7408,7406,1,4
114716,14814,7408,7406,2,1
114716,13362,6719,6643,3,1
114716,2201,1156,1045,4,1
114716,11161,5563,5598,5,1
114716,1452,689,763,11,1
114716,2269,1094,1175,19,1
114716,8892,4469,4423,20,1
114716,5266,2709,2557,21,4
114716,5266,2709,2557,22,1
114716,5164,2655,2509,23,1
114716,1200,675,525,24,1
114716,3964,1980,1984,25,1
114716,102,54,48,31,1
114716,569,291,278,39,1
114716,3395,1689,1706,40,1
114716,9548,4699,4849,41,4
114716,9548,4699,4849,42,1
114716,8198,4064,4134,43,1
114716,1001,481,520,44,1
114716,7197,3583,3614,45,1
114716,1350,635,715,51,1
114716,1700,803,897,59,1
114716,5497,2780,2717,60,1
114734,44,19,25,1,4
114734,44,19,25,12,3
114734,20,11,9,21,4
114734,20,11,9,32,3
114734,24,8,16,41,4
114734,24,8,16,52,3
114761,83,1,82,1,4
114761,83,1,82,2,1
114761,83,1,82,3,1
114761,32,1,31,4,1
114761,51,0,51,5,1
114761,51,0,51,20,1
114761,80,1,79,21,4
114761,80,1,79,22,1
114761,80,1,79,23,1
114761,32,1,31,24,1
114761,48,0,48,25,1
114761,48,0,48,40,1
114761,3,0,3,41,4
114761,3,0,3,42,1
114761,3,0,3,43,1
114761,3,0,3,45,1
114761,3,0,3,60,1
114789,21344,9930,11414,1,4
114789,21344,9930,11414,2,1
114789,18888,8738,10150,3,1
114789,3823,1881,1942,4,1
114789,15065,6857,8208,5,1
114789,2456,1192,1264,11,1
114789,1597,736,861,19,1
114789,13468,6121,7347,20,1
114789,7815,3661,4154,21,4
114789,7815,3661,4154,22,1
114789,7323,3413,3910,23,1
114789,2057,971,1086,24,1
114789,5266,2442,2824,25,1
114789,492,248,244,31,1
114789,454,202,252,39,1
114789,4812,2240,2572,40,1
114789,13529,6269,7260,41,4
114789,13529,6269,7260,42,1
114789,11565,5325,6240,43,1
114789,1766,910,856,44,1
114789,9799,4415,5384,45,1
114789,1964,944,1020,51,1
114789,1143,534,609,59,1
114789,8656,3881,4775,60,1
114813,3393,1057,2336,1,4
114813,2586,826,1760,2,1
114813,2496,770,1726,3,1
114813,213,66,147,4,1
114813,2283,704,1579,5,1
114813,90,56,34,11,1
114813,807,231,576,12,3
114813,513,149,364,19,1
114813,1770,555,1215,20,1
114813,2423,765,1658,21,4
114813,2137,674,1463,22,1
114813,2134,673,1461,23,1
114813,210,64,146,24,1
114813,1924,609,1315,25,1
114813,3,1,2,31,1
114813,286,91,195,32,3
114813,419,127,292,39,1
114813,1505,482,1023,40,1
114813,970,292,678,41,4
114813,449,152,297,42,1
114813,362,97,265,43,1
114813,3,2,1,44,1
114813,359,95,264,45,1
114813,87,55,32,51,1
114813,521,140,381,52,3
114813,94,22,72,59,1
114813,265,73,192,60,1
114840,2694,1679,1015,1,4
114840,2694,1679,1015,12,3
114840,724,391,333,21,4
114840,724,391,333,32,3
114840,1970,1288,682,41,4
114840,1970,1288,682,52,3
114859,24301,11864,12437,1,4
114859,24301,11864,12437,2,1
114859,22295,10912,11383,3,1
114859,4785,2424,2361,4,1
114859,17510,8488,9022,5,1
114859,2006,952,1054,11,1
114859,2398,1142,1256,19,1
114859,15112,7346,7766,20,1
114859,8440,4158,4282,21,4
114859,8440,4158,4282,22,1
114859,8317,4101,4216,23,1
114859,2157,1082,1075,24,1
114859,6160,3019,3141,25,1
114859,123,57,66,31,1
114859,612,301,311,39,1
114859,5548,2718,2830,40,1
114859,15861,7706,8155,41,4
114859,15861,7706,8155,42,1
114859,13978,6811,7167,43,1
114859,2628,1342,1286,44,1
114859,11350,5469,5881,45,1
114859,1883,895,988,51,1
114859,1786,841,945,59,1
114859,9564,4628,4936,60,1
114938,5834,2774,3060,1,4
114938,5834,2774,3060,2,1
114938,5267,2555,2712,3,1
114938,1022,525,497,4,1
114938,4245,2030,2215,5,1
114938,567,219,348,11,1
114938,639,383,256,19,1
114938,3606,1647,1959,20,1
114938,1855,888,967,21,4
114938,1855,888,967,22,1
114938,1767,858,909,23,1
114938,412,224,188,24,1
114938,1355,634,721,25,1
114938,88,30,58,31,1
114938,146,99,47,39,1
114938,1209,535,674,40,1
114938,3979,1886,2093,41,4
114938,3979,1886,2093,42,1
114938,3500,1697,1803,43,1
114938,610,301,309,44,1
114938,2890,1396,1494,45,1
114938,479,189,290,51,1
114938,493,284,209,59,1
114938,2397,1112,1285,60,1
114947,192,100,92,1,4
114947,192,100,92,2,1
114947,192,100,92,3,1
114947,85,48,37,4,1
114947,107,52,55,5,1
114947,107,52,55,20,1
114947,192,100,92,21,4
114947,192,100,92,22,1
114947,192,100,92,23,1
114947,85,48,37,24,1
114947,107,52,55,25,1
114947,107,52,55,40,1
115001,15744,7124,8620,1,4
115001,15744,7124,8620,2,1
115001,14102,6323,7779,3,1
115001,2441,1172,1269,4,1
115001,11661,5151,6510,5,1
115001,1642,801,841,11,1
115001,852,382,470,19,1
115001,10809,4769,6040,20,1
115001,7164,3240,3924,21,4
115001,7164,3240,3924,22,1
115001,6733,3044,3689,23,1
115001,1288,639,649,24,1
115001,5445,2405,3040,25,1
115001,431,196,235,31,1
115001,263,128,135,39,1
115001,5182,2277,2905,40,1
115001,8580,3884,4696,41,4
115001,8580,3884,4696,42,1
115001,7369,3279,4090,43,1
115001,1153,533,620,44,1
115001,6216,2746,3470,45,1
115001,1211,605,606,51,1
115001,589,254,335,59,1
115001,5627,2492,3135,60,1
115010,293,75,218,1,4
115010,293,75,218,2,1
115010,293,75,218,3,1
115010,202,48,154,4,1
115010,91,27,64,5,1
115010,91,27,64,20,1
115010,293,75,218,21,4
115010,293,75,218,22,1
115010,293,75,218,23,1
115010,202,48,154,24,1
115010,91,27,64,25,1
115010,91,27,64,40,1
115083,3227,1410,1817,1,4
115083,475,220,255,2,1
115083,470,218,252,3,1
115083,470,218,252,5,1
115083,5,2,3,11,1
115083,2752,1190,1562,12,3
115083,93,44,49,19,1
115083,377,174,203,20,1
115083,1130,478,652,21,4
115083,104,62,42,22,1
115083,104,62,42,23,1
115083,104,62,42,25,1
115083,1026,416,610,32,3
115083,25,14,11,39,1
115083,79,48,31,40,1
115083,2097,932,1165,41,4
115083,371,158,213,42,1
115083,366,156,210,43,1
115083,366,156,210,45,1
115083,5,2,3,51,1
115083,1726,774,952,52,3
115083,68,30,38,59,1
115083,298,126,172,60,1
115126,12717,5997,6720,1,4
115126,12717,5997,6720,2,1
115126,11689,5494,6195,3,1
115126,2262,1136,1126,4,1
115126,9427,4358,5069,5,1
115126,1028,503,525,11,1
115126,1553,717,836,19,1
115126,7874,3641,4233,20,1
115126,4534,2307,2227,21,4
115126,4534,2307,2227,22,1
115126,4434,2248,2186,23,1
115126,1173,609,564,24,1
115126,3261,1639,1622,25,1
115126,100,59,41,31,1
115126,329,167,162,39,1
115126,2932,1472,1460,40,1
115126,8183,3690,4493,41,4
115126,8183,3690,4493,42,1
115126,7255,3246,4009,43,1
115126,1089,527,562,44,1
115126,6166,2719,3447,45,1
115126,928,444,484,51,1
115126,1224,550,674,59,1
115126,4942,2169,2773,60,1
115214,253,149,104,1,4
115214,253,149,104,12,3
115214,232,138,94,21,4
115214,232,138,94,32,3
115214,21,11,10,41,4
115214,21,11,10,52,3
115296,18618,8259,10359,1,4
115296,18618,8259,10359,2,1
115296,17042,7562,9480,3,1
115296,3256,1530,1726,4,1
115296,13786,6032,7754,5,1
115296,1576,697,879,11,1
115296,1734,772,962,19,1
115296,12052,5260,6792,20,1
115296,6654,3191,3463,21,4
115296,6654,3191,3463,22,1
115296,6355,3064,3291,23,1
115296,1600,748,852,24,1
115296,4755,2316,2439,25,1
115296,299,127,172,31,1
115296,488,254,234,39,1
115296,4267,2062,2205,40,1
115296,11964,5068,6896,41,4
115296,11964,5068,6896,42,1
115296,10687,4498,6189,43,1
115296,1656,782,874,44,1
115296,9031,3716,5315,45,1
115296,1277,570,707,51,1
115296,1246,518,728,59,1
115296,7785,3198,4587,60,1
115357,30,2,28,1,4
115357,30,2,28,2,1
115357,30,2,28,3,1
115357,7,0,7,4,1
115357,23,2,21,5,1
115357,23,2,21,20,1
115357,30,2,28,21,4
115357,30,2,28,22,1
115357,30,2,28,23,1
115357,7,0,7,24,1
115357,23,2,21,25,1
115357,23,2,21,40,1
115393,9439,4890,4549,1,4
115393,9439,4890,4549,2,1
115393,8829,4659,4170,3,1
115393,1787,1009,778,4,1
115393,7042,3650,3392,5,1
115393,610,231,379,11,1
115393,681,487,194,19,1
115393,6361,3163,3198,20,1
115393,3413,1662,1751,21,4
115393,3413,1662,1751,22,1
115393,3385,1646,1739,23,1
115393,798,421,377,24,1
115393,2587,1225,1362,25,1
115393,28,16,12,31,1
115393,163,106,57,39,1
115393,2424,1119,1305,40,1
115393,6026,3228,2798,41,4
115393,6026,3228,2798,42,1
115393,5444,3013,2431,43,1
115393,989,588,401,44,1
115393,4455,2425,2030,45,1
115393,582,215,367,51,1
115393,518,381,137,59,1
115393,3937,2044,1893,60,1
115409,807,432,375,1,4
115409,807,432,375,2,1
115409,803,428,375,3,1
115409,217,114,103,4,1
115409,586,314,272,5,1
115409,4,4,0,11,1
115409,1,0,1,19,1
115409,585,314,271,20,1
115409,805,431,374,21,4
115409,805,431,374,22,1
115409,801,427,374,23,1
115409,217,114,103,24,1
115409,584,313,271,25,1
115409,4,4,0,31,1
115409,1,0,1,39,1
115409,583,313,270,40,1
115409,2,1,1,41,4
115409,2,1,1,42,1
115409,2,1,1,43,1
115409,2,1,1,45,1
115409,2,1,1,60,1
115454,1150,336,814,1,4
115454,1150,336,814,2,1
115454,1146,334,812,3,1
115454,127,49,78,4,1
115454,1019,285,734,5,1
115454,4,2,2,11,1
115454,107,28,79,19,1
115454,912,257,655,20,1
115454,888,258,630,21,4
115454,888,258,630,22,1
115454,887,258,629,23,1
115454,75,29,46,24,1
115454,812,229,583,25,1
115454,1,0,1,31,1
115454,58,16,42,39,1
115454,754,213,541,40,1
115454,262,78,184,41,4
115454,262,78,184,42,1
115454,259,76,183,43,1
115454,52,20,32,44,1
115454,207,56,151,45,1
115454,3,2,1,51,1
115454,49,12,37,59,1
115454,158,44,114,60,1
115472,1791,549,1242,1,4
115472,1791,549,1242,2,1
115472,1791,549,1242,3,1
115472,218,64,154,4,1
115472,1573,485,1088,5,1
115472,152,50,102,19,1
115472,1421,435,986,20,1
115472,1342,429,913,21,4
115472,1342,429,913,22,1
115472,1342,429,913,23,1
115472,145,41,104,24,1
115472,1197,388,809,25,1
115472,74,24,50,39,1
115472,1123,364,759,40,1
115472,449,120,329,41,4
115472,449,120,329,42,1
115472,449,120,329,43,1
115472,73,23,50,44,1
115472,376,97,279,45,1
115472,78,26,52,59,1
115472,298,71,227,60,1
115490,1671,598,1073,1,4
115490,1671,598,1073,2,1
115490,1668,595,1073,3,1
115490,166,67,99,4,1
115490,1502,528,974,5,1
115490,3,3,0,11,1
115490,142,42,100,19,1
115490,1360,486,874,20,1
115490,1169,425,744,21,4
115490,1169,425,744,22,1
115490,1169,425,744,23,1
115490,82,35,47,24,1
115490,1087,390,697,25,1
115490,75,26,49,39,1
115490,1012,364,648,40,1
115490,502,173,329,41,4
115490,502,173,329,42,1
115490,499,170,329,43,1
115490,84,32,52,44,1
115490,415,138,277,45,1
115490,3,3,0,51,1
115490,67,16,51,59,1
115490,348,122,226,60,1
115515,1074,418,656,1,4
115515,1074,418,656,2,1
115515,1070,416,654,3,1
115515,117,46,71,4,1
115515,953,370,583,5,1
115515,4,2,2,11,1
115515,90,40,50,19,1
115515,863,330,533,20,1
115515,693,259,434,21,4
115515,693,259,434,22,1
115515,693,259,434,23,1
115515,62,22,40,24,1
115515,631,237,394,25,1
115515,50,21,29,39,1
115515,581,216,365,40,1
115515,381,159,222,41,4
115515,381,159,222,42,1
115515,377,157,220,43,1
115515,55,24,31,44,1
115515,322,133,189,45,1
115515,4,2,2,51,1
115515,40,19,21,59,1
115515,282,114,168,60,1
115533,1503,414,1089,1,4
115533,1503,414,1089,2,1
115533,1502,413,1089,3,1
115533,167,51,116,4,1
115533,1335,362,973,5,1
115533,1,1,0,11,1
115533,142,39,103,19,1
115533,1193,323,870,20,1
115533,1110,314,796,21,4
115533,1110,314,796,22,1
115533,1110,314,796,23,1
115533,111,35,76,24,1
115533,999,279,720,25,1
115533,79,24,55,39,1
115533,920,255,665,40,1
115533,393,100,293,41,4
115533,393,100,293,42,1
115533,392,99,293,43,1
115533,56,16,40,44,1
115533,336,83,253,45,1
115533,1,1,0,51,1
115533,63,15,48,59,1
115533,273,68,205,60,1
115658,126,9,117,1,4
115658,126,9,117,2,1
115658,126,9,117,3,1
115658,23,1,22,4,1
115658,103,8,95,5,1
115658,103,8,95,20,1
115658,18,0,18,21,4
115658,18,0,18,22,1
115658,18,0,18,23,1
115658,1,0,1,24,1
115658,17,0,17,25,1
115658,17,0,17,40,1
115658,108,9,99,41,4
115658,108,9,99,42,1
115658,108,9,99,43,1
115658,22,1,21,44,1
115658,86,8,78,45,1
115658,86,8,78,60,1
115728,1343,375,968,1,4
115728,888,274,614,2,1
115728,800,260,540,3,1
115728,87,33,54,4,1
115728,713,227,486,5,1
115728,88,14,74,11,1
115728,455,101,354,12,3
115728,74,41,33,19,1
115728,639,186,453,20,1
115728,827,272,555,21,4
115728,677,238,439,22,1
115728,594,224,370,23,1
115728,85,32,53,24,1
115728,509,192,317,25,1
115728,83,14,69,31,1
115728,150,34,116,32,3
115728,73,41,32,39,1
115728,436,151,285,40,1
115728,516,103,413,41,4
115728,211,36,175,42,1
115728,206,36,170,43,1
115728,2,1,1,44,1
115728,204,35,169,45,1
115728,5,0,5,51,1
115728,305,67,238,52,3
115728,1,0,1,59,1
115728,203,35,168,60,1
115746,1060,253,807,1,4
115746,1060,253,807,12,3
115746,590,146,444,21,4
115746,590,146,444,32,3
115746,470,107,363,41,4
115746,470,107,363,52,3
115755,8293,3817,4476,1,4
115755,7767,3624,4143,2,1
115755,7748,3617,4131,3,1
115755,1368,537,831,4,1
115755,6380,3080,3300,5,1
115755,19,7,12,11,1
115755,526,193,333,12,3
115755,971,517,454,19,1
115755,5409,2563,2846,20,1
115755,7631,3495,4136,21,4
115755,7256,3360,3896,22,1
115755,7241,3354,3887,23,1
115755,1344,526,818,24,1
115755,5897,2828,3069,25,1
115755,15,6,9,31,1
115755,375,135,240,32,3
115755,919,492,427,39,1
115755,4978,2336,2642,40,1
115755,662,322,340,41,4
115755,511,264,247,42,1
115755,507,263,244,43,1
115755,24,11,13,44,1
115755,483,252,231,45,1
115755,4,1,3,51,1
115755,151,58,93,52,3
115755,52,25,27,59,1
115755,431,227,204,60,1
115773,990,224,766,1,4
115773,757,162,595,2,1
115773,757,162,595,3,1
115773,59,21,38,4,1
115773,698,141,557,5,1
115773,233,62,171,12,3
115773,77,23,54,19,1
115773,621,118,503,20,1
115773,517,129,388,21,4
115773,402,90,312,22,1
115773,402,90,312,23,1
115773,32,14,18,24,1
115773,370,76,294,25,1
115773,115,39,76,32,3
115773,28,8,20,39,1
115773,342,68,274,40,1
115773,473,95,378,41,4
115773,355,72,283,42,1
115773,355,72,283,43,1
115773,27,7,20,44,1
115773,328,65,263,45,1
115773,118,23,95,52,3
115773,49,15,34,59,1
115773,279,50,229,60,1
115861,7701,3210,4491,1,4
115861,7701,3210,4491,2,1
115861,6663,2848,3815,3,1
115861,1530,675,855,4,1
115861,5133,2173,2960,5,1
115861,1038,362,676,11,1
115861,13,7,6,19,1
115861,5120,2166,2954,20,1
115861,3832,1637,2195,21,4
115861,3832,1637,2195,22,1
115861,3422,1517,1905,23,1
115861,1048,468,580,24,1
115861,2374,1049,1325,25,1
115861,410,120,290,31,1
115861,6,4,2,39,1
115861,2368,1045,1323,40,1
115861,3869,1573,2296,41,4
115861,3869,1573,2296,42,1
115861,3241,1331,1910,43,1
115861,482,207,275,44,1
115861,2759,1124,1635,45,1
115861,628,242,386,51,1
115861,7,3,4,59,1
115861,2752,1121,1631,60,1
115931,173,120,53,1,4
115931,173,120,53,2,1
115931,173,120,53,3,1
115931,172,119,53,4,1
115931,1,1,0,5,1
115931,1,1,0,20,1
115931,173,120,53,21,4
115931,173,120,53,22,1
115931,173,120,53,23,1
115931,172,119,53,24,1
115931,1,1,0,25,1
115931,1,1,0,40,1
116226,296,26,270,1,4
116226,295,26,269,2,1
116226,293,24,269,3,1
116226,15,1,14,4,1
116226,278,23,255,5,1
116226,2,2,0,11,1
116226,1,0,1,12,3
116226,278,23,255,20,1
116226,70,6,64,21,4
116226,70,6,64,22,1
116226,70,6,64,23,1
116226,70,6,64,25,1
116226,70,6,64,40,1
116226,226,20,206,41,4
116226,225,20,205,42,1
116226,223,18,205,43,1
116226,15,1,14,44,1
116226,208,17,191,45,1
116226,2,2,0,51,1
116226,1,0,1,52,3
116226,208,17,191,60,1
116350,268,32,236,1,4
116350,268,32,236,2,1
116350,268,32,236,3,1
116350,67,10,57,4,1
116350,201,22,179,5,1
116350,201,22,179,20,1
116350,268,32,236,21,4
116350,268,32,236,22,1
116350,268,32,236,23,1
116350,67,10,57,24,1
116350,201,22,179,25,1
116350,201,22,179,40,1
116439,13362,6613,6749,1,4
116439,13362,6613,6749,2,1
116439,11725,5872,5853,3,1
116439,2529,1374,1155,4,1
116439,9196,4498,4698,5,1
116439,1637,741,896,11,1
116439,1479,721,758,19,1
116439,7717,3777,3940,20,1
116439,4495,2476,2019,21,4
116439,4495,2476,2019,22,1
116439,4391,2415,1976,23,1
116439,1294,742,552,24,1
116439,3097,1673,1424,25,1
116439,104,61,43,31,1
116439,249,139,110,39,1
116439,2848,1534,1314,40,1
116439,8867,4137,4730,41,4
116439,8867,4137,4730,42,1
116439,7334,3457,3877,43,1
116439,1235,632,603,44,1
116439,6099,2825,3274,45,1
116439,1533,680,853,51,1
116439,1230,582,648,59,1
116439,4869,2243,2626,60,1
116466,1209,1079,130,1,4
116466,1209,1079,130,2,1
116466,1209,1079,130,3,1
116466,156,133,23,4,1
116466,1053,946,107,5,1
116466,36,32,4,19,1
116466,1017,914,103,20,1
116466,1063,948,115,21,4
116466,1063,948,115,22,1
116466,1063,948,115,23,1
116466,149,127,22,24,1
116466,914,821,93,25,1
116466,36,32,4,39,1
116466,878,789,89,40,1
116466,146,131,15,41,4
116466,146,131,15,42,1
116466,146,131,15,43,1
116466,7,6,1,44,1
116466,139,125,14,45,1
116466,139,125,14,60,1
116475,534,442,92,1,4
116475,534,442,92,2,1
116475,534,442,92,3,1
116475,62,54,8,4,1
116475,472,388,84,5,1
116475,4,3,1,19,1
116475,468,385,83,20,1
116475,449,378,71,21,4
116475,449,378,71,22,1
116475,449,378,71,23,1
116475,57,51,6,24,1
116475,392,327,65,25,1
116475,3,3,0,39,1
116475,389,324,65,40,1
116475,85,64,21,41,4
116475,85,64,21,42,1
116475,85,64,21,43,1
116475,5,3,2,44,1
116475,80,61,19,45,1
116475,1,0,1,59,1
116475,79,61,18,60,1
116484,823,698,125,1,4
116484,823,698,125,2,1
116484,823,698,125,3,1
116484,90,75,15,4,1
116484,733,623,110,5,1
116484,18,18,0,19,1
116484,715,605,110,20,1
116484,653,554,99,21,4
116484,653,554,99,22,1
116484,653,554,99,23,1
116484,78,66,12,24,1
116484,575,488,87,25,1
116484,18,18,0,39,1
116484,557,470,87,40,1
116484,170,144,26,41,4
116484,170,144,26,42,1
116484,170,144,26,43,1
116484,12,9,3,44,1
116484,158,135,23,45,1
116484,158,135,23,60,1
116563,184,8,176,1,4
116563,184,8,176,2,1
116563,184,8,176,3,1
116563,36,0,36,4,1
116563,148,8,140,5,1
116563,148,8,140,20,1
116563,184,8,176,21,4
116563,184,8,176,22,1
116563,184,8,176,23,1
116563,36,0,36,24,1
116563,148,8,140,25,1
116563,148,8,140,40,1
116712,1356,335,1021,1,4
116712,279,85,194,2,1
116712,271,81,190,3,1
116712,271,81,190,5,1
116712,8,4,4,11,1
116712,1077,250,827,12,3
116712,82,27,55,19,1
116712,189,54,135,20,1
116712,580,156,424,21,4
116712,75,22,53,22,1
116712,67,18,49,23,1
116712,67,18,49,25,1
116712,8,4,4,31,1
116712,505,134,371,32,3
116712,23,8,15,39,1
116712,44,10,34,40,1
116712,776,179,597,41,4
116712,204,63,141,42,1
116712,204,63,141,43,1
116712,204,63,141,45,1
116712,572,116,456,52,3
116712,59,19,40,59,1
116712,145,44,101,60,1
116846,229,119,110,1,4
116846,112,56,56,2,1
116846,109,54,55,3,1
116846,7,5,2,4,1
116846,102,49,53,5,1
116846,3,2,1,11,1
116846,117,63,54,12,3
116846,13,8,5,19,1
116846,89,41,48,20,1
116846,188,96,92,21,4
116846,108,54,54,22,1
116846,108,54,54,23,1
116846,7,5,2,24,1
116846,101,49,52,25,1
116846,80,42,38,32,3
116846,12,8,4,39,1
116846,89,41,48,40,1
116846,41,23,18,41,4
116846,4,2,2,42,1
116846,1,0,1,43,1
116846,1,0,1,45,1
116846,3,2,1,51,1
116846,37,21,16,52,3
116846,1,0,1,59,1
117052,13807,5932,7875,1,4
117052,13807,5932,7875,2,1
117052,12081,5171,6910,3,1
117052,2884,1336,1548,4,1
117052,9197,3835,5362,5,1
117052,1726,761,965,11,1
117052,1180,497,683,19,1
117052,8017,3338,4679,20,1
117052,5328,2430,2898,21,4
117052,5328,2430,2898,22,1
117052,4910,2246,2664,23,1
117052,1770,829,941,24,1
117052,3140,1417,1723,25,1
117052,418,184,234,31,1
117052,307,141,166,39,1
117052,2833,1276,1557,40,1
117052,8479,3502,4977,41,4
117052,8479,3502,4977,42,1
117052,7171,2925,4246,43,1
117052,1114,507,607,44,1
117052,6057,2418,3639,45,1
117052,1308,577,731,51,1
117052,873,356,517,59,1
117052,5184,2062,3122,60,1
117104,627,323,304,1,4
117104,577,289,288,2,1
117104,475,244,231,3,1
117104,78,40,38,4,1
117104,397,204,193,5,1
117104,102,45,57,11,1
117104,50,34,16,12,3
117104,61,32,29,19,1
117104,336,172,164,20,1
117104,447,235,212,21,4
117104,402,205,197,22,1
117104,392,202,190,23,1
117104,76,38,38,24,1
117104,316,164,152,25,1
117104,10,3,7,31,1
117104,45,30,15,32,3
117104,53,26,27,39,1
117104,263,138,125,40,1
117104,180,88,92,41,4
117104,175,84,91,42,1
117104,83,42,41,43,1
117104,2,2,0,44,1
117104,81,40,41,45,1
117104,92,42,50,51,1
117104,5,4,1,52,3
117104,8,6,2,59,1
117104,73,34,39,60,1
117113,1869,1048,821,1,4
117113,1869,1048,821,2,1
117113,1869,1048,821,3,1
117113,247,119,128,4,1
117113,1622,929,693,5,1
117113,350,209,141,19,1
117113,1272,720,552,20,1
117113,1466,849,617,21,4
117113,1466,849,617,22,1
117113,1466,849,617,23,1
117113,205,93,112,24,1
117113,1261,756,505,25,1
117113,267,170,97,39,1
117113,994,586,408,40,1
117113,403,199,204,41,4
117113,403,199,204,42,1
117113,403,199,204,43,1
117113,42,26,16,44,1
117113,361,173,188,45,1
117113,83,39,44,59,1
117113,278,134,144,60,1
117140,8796,3591,5205,1,4
117140,5216,2206,3010,2,1
117140,5128,2148,2980,3,1
117140,565,259,306,4,1
117140,4563,1889,2674,5,1
117140,88,58,30,11,1
117140,3580,1385,2195,12,3
117140,641,275,366,19,1
117140,3922,1614,2308,20,1
117140,5550,2378,3172,21,4
117140,3641,1556,2085,22,1
117140,3619,1543,2076,23,1
117140,561,256,305,24,1
117140,3058,1287,1771,25,1
117140,22,13,9,31,1
117140,1909,822,1087,32,3
117140,377,174,203,39,1
117140,2681,1113,1568,40,1
117140,3246,1213,2033,41,4
117140,1575,650,925,42,1
117140,1509,605,904,43,1
117140,4,3,1,44,1
117140,1505,602,903,45,1
117140,66,45,21,51,1
117140,1671,563,1108,52,3
117140,264,101,163,59,1
117140,1241,501,740,60,1
117168,544,219,325,1,4
117168,514,208,306,2,1
117168,514,208,306,3,1
117168,68,27,41,4,1
117168,446,181,265,5,1
117168,30,11,19,12,3
117168,73,36,37,19,1
117168,373,145,228,20,1
117168,491,202,289,21,4
117168,466,193,273,22,1
117168,466,193,273,23,1
117168,67,27,40,24,1
117168,399,166,233,25,1
117168,25,9,16,32,3
117168,69,36,33,39,1
117168,330,130,200,40,1
117168,53,17,36,41,4
117168,48,15,33,42,1
117168,48,15,33,43,1
117168,1,0,1,44,1
117168,47,15,32,45,1
117168,5,2,3,52,3
117168,4,0,4,59,1
117168,43,15,28,60,1
117195,2426,1059,1367,1,4
117195,2426,1059,1367,2,1
117195,2155,946,1209,3,1
117195,332,154,178,4,1
117195,1823,792,1031,5,1
117195,271,113,158,11,1
117195,242,121,121,19,1
117195,1581,671,910,20,1
117195,765,375,390,21,4
117195,765,375,390,22,1
117195,735,359,376,23,1
117195,134,58,76,24,1
117195,601,301,300,25,1
117195,30,16,14,31,1
117195,86,49,37,39,1
117195,515,252,263,40,1
117195,1661,684,977,41,4
117195,1661,684,977,42,1
117195,1420,587,833,43,1
117195,198,96,102,44,1
117195,1222,491,731,45,1
117195,241,97,144,51,1
117195,156,72,84,59,1
117195,1066,419,647,60,1
117238,93,18,75,1,4
117238,93,18,75,2,1
117238,93,18,75,3,1
117238,9,0,9,4,1
117238,84,18,66,5,1
117238,84,18,66,20,1
117238,93,18,75,21,4
117238,93,18,75,22,1
117238,93,18,75,23,1
117238,9,0,9,24,1
117238,84,18,66,25,1
117238,84,18,66,40,1
117247,11362,5260,6102,1,4
117247,11362,5260,6102,2,1
117247,10140,4696,5444,3,1
117247,1671,835,836,4,1
117247,8469,3861,4608,5,1
117247,1222,564,658,11,1
117247,1520,697,823,19,1
117247,6949,3164,3785,20,1
117247,1907,938,969,21,4
117247,1907,938,969,22,1
117247,1856,911,945,23,1
117247,400,213,187,24,1
117247,1456,698,758,25,1
117247,51,27,24,31,1
117247,155,88,67,39,1
117247,1301,610,691,40,1
117247,9455,4322,5133,41,4
117247,9455,4322,5133,42,1
117247,8284,3785,4499,43,1
117247,1271,622,649,44,1
117247,7013,3163,3850,45,1
117247,1171,537,634,51,1
117247,1365,609,756,59,1
117247,5648,2554,3094,60,1
117274,2494,1843,651,1,4
117274,2494,1843,651,2,1
117274,2290,1684,606,3,1
117274,815,692,123,4,1
117274,1475,992,483,5,1
117274,204,159,45,11,1
117274,323,258,65,19,1
117274,1152,734,418,20,1
117274,600,308,292,21,4
117274,600,308,292,22,1
117274,594,307,287,23,1
117274,170,94,76,24,1
117274,424,213,211,25,1
117274,6,1,5,31,1
117274,50,32,18,39,1
117274,374,181,193,40,1
117274,1894,1535,359,41,4
117274,1894,1535,359,42,1
117274,1696,1377,319,43,1
117274,645,598,47,44,1
117274,1051,779,272,45,1
117274,198,158,40,51,1
117274,273,226,47,59,1
117274,778,553,225,60,1
117520,456,259,197,1,4
117520,456,259,197,12,3
117520,431,247,184,21,4
117520,431,247,184,32,3
117520,25,12,13,41,4
117520,25,12,13,52,3
117557,492,245,247,1,4
117557,116,41,75,2,1
117557,97,36,61,3,1
117557,14,7,7,4,1
117557,83,29,54,5,1
117557,19,5,14,11,1
117557,376,204,172,12,3
117557,12,7,5,19,1
117557,71,22,49,20,1
117557,436,230,206,21,4
117557,64,29,35,22,1
117557,56,27,29,23,1
117557,9,6,3,24,1
117557,47,21,26,25,1
117557,8,2,6,31,1
117557,372,201,171,32,3
117557,12,7,5,39,1
117557,35,14,21,40,1
117557,56,15,41,41,4
117557,52,12,40,42,1
117557,41,9,32,43,1
117557,5,1,4,44,1
117557,36,8,28,45,1
117557,11,3,8,51,1
117557,4,3,1,52,3
117557,36,8,28,60,1
117575,189,120,69,1,4
117575,69,54,15,2,1
117575,68,54,14,3,1
117575,4,4,0,4,1
117575,64,50,14,5,1
117575,1,0,1,11,1
117575,120,66,54,12,3
117575,9,7,2,19,1
117575,55,43,12,20,1
117575,68,35,33,21,4
117575,19,16,3,22,1
117575,19,16,3,23,1
117575,2,2,0,24,1
117575,17,14,3,25,1
117575,49,19,30,32,3
117575,1,1,0,39,1
117575,16,13,3,40,1
117575,121,85,36,41,4
117575,50,38,12,42,1
117575,49,38,11,43,1
117575,2,2,0,44,1
117575,47,36,11,45,1
117575,1,0,1,51,1
117575,71,47,24,52,3
117575,8,6,2,59,1
117575,39,30,9,60,1
117627,2440,1034,1406,1,4
117627,2105,892,1213,2,1
117627,2060,873,1187,3,1
117627,477,169,308,4,1
117627,1583,704,879,5,1
117627,45,19,26,11,1
117627,335,142,193,12,3
117627,233,113,120,19,1
117627,1350,591,759,20,1
117627,2112,894,1218,21,4
117627,1912,804,1108,22,1
117627,1895,797,1098,23,1
117627,466,168,298,24,1
117627,1429,629,800,25,1
117627,17,7,10,31,1
117627,200,90,110,32,3
117627,197,93,104,39,1
117627,1232,536,696,40,1
117627,328,140,188,41,4
117627,193,88,105,42,1
117627,165,76,89,43,1
117627,11,1,10,44,1
117627,154,75,79,45,1
117627,28,12,16,51,1
117627,135,52,83,52,3
117627,36,20,16,59,1
117627,118,55,63,60,1
117636,4693,1835,2858,1,4
117636,1260,374,886,2,1
117636,1101,324,777,3,1
117636,1101,324,777,5,1
117636,159,50,109,11,1
117636,3433,1461,1972,12,3
117636,239,73,166,19,1
117636,862,251,611,20,1
117636,3711,1522,2189,21,4
117636,959,283,676,22,1
117636,951,279,672,23,1
117636,951,279,672,25,1
117636,8,4,4,31,1
117636,2752,1239,1513,32,3
117636,223,69,154,39,1
117636,728,210,518,40,1
117636,982,313,669,41,4
117636,301,91,210,42,1
117636,150,45,105,43,1
117636,150,45,105,45,1
117636,151,46,105,51,1
117636,681,222,459,52,3
117636,16,4,12,59,1
117636,134,41,93,60,1
117645,24020,10893,13127,1,4
117645,24020,10893,13127,2,1
117645,22475,10200,12275,3,1
117645,4308,2118,2190,4,1
117645,18167,8082,10085,5,1
117645,1545,693,852,11,1
117645,1879,801,1078,19,1
117645,16288,7281,9007,20,1
117645,9530,4463,5067,21,4
117645,9530,4463,5067,22,1
117645,9399,4394,5005,23,1
117645,2335,1145,1190,24,1
117645,7064,3249,3815,25,1
117645,131,69,62,31,1
117645,613,290,323,39,1
117645,6451,2959,3492,40,1
117645,14490,6430,8060,41,4
117645,14490,6430,8060,42,1
117645,13076,5806,7270,43,1
117645,1973,973,1000,44,1
117645,11103,4833,6270,45,1
117645,1414,624,790,51,1
117645,1266,511,755,59,1
117645,9837,4322,5515,60,1
117672,968,465,503,1,4
117672,404,130,274,2,1
117672,404,130,274,11,1
117672,564,335,229,12,3
117672,157,96,61,21,4
117672,157,96,61,32,3
117672,811,369,442,41,4
117672,404,130,274,42,1
117672,404,130,274,51,1
117672,407,239,168,52,3
117690,10098,4161,5937,1,4
117690,10098,4161,5937,2,1
117690,8719,3543,5176,3,1
117690,1405,656,749,4,1
117690,7314,2887,4427,5,1
117690,1379,618,761,11,1
117690,897,325,572,19,1
117690,6417,2562,3855,20,1
117690,2535,1151,1384,21,4
117690,2535,1151,1384,22,1
117690,2505,1131,1374,23,1
117690,500,241,259,24,1
117690,2005,890,1115,25,1
117690,30,20,10,31,1
117690,133,63,70,39,1
117690,1872,827,1045,40,1
117690,7563,3010,4553,41,4
117690,7563,3010,4553,42,1
117690,6214,2412,3802,43,1
117690,905,415,490,44,1
117690,5309,1997,3312,45,1
117690,1349,598,751,51,1
117690,764,262,502,59,1
117690,4545,1735,2810,60,1
117706,20080,9407,10673,1,4
117706,20080,9407,10673,2,1
117706,17528,8171,9357,3,1
117706,3156,1544,1612,4,1
117706,14372,6627,7745,5,1
117706,2552,1236,1316,11,1
117706,1473,631,842,19,1
117706,12899,5996,6903,20,1
117706,4489,2278,2211,21,4
117706,4489,2278,2211,22,1
117706,4406,2233,2173,23,1
117706,865,432,433,24,1
117706,3541,1801,1740,25,1
117706,83,45,38,31,1
117706,182,88,94,39,1
117706,3359,1713,1646,40,1
117706,15591,7129,8462,41,4
117706,15591,7129,8462,42,1
117706,13122,5938,7184,43,1
117706,2291,1112,1179,44,1
117706,10831,4826,6005,45,1
117706,2469,1191,1278,51,1
117706,1291,543,748,59,1
117706,9540,4283,5257,60,1
117715,7864,2427,5437,1,4
117715,7864,2427,5437,2,1
117715,6129,1877,4252,3,1
117715,918,366,552,4,1
117715,5211,1511,3700,5,1
117715,1735,550,1185,11,1
117715,1120,331,789,19,1
117715,4091,1180,2911,20,1
117715,1333,455,878,21,4
117715,1333,455,878,22,1
117715,1313,449,864,23,1
117715,220,86,134,24,1
117715,1093,363,730,25,1
117715,20,6,14,31,1
117715,177,52,125,39,1
117715,916,311,605,40,1
117715,6531,1972,4559,41,4
117715,6531,1972,4559,42,1
117715,4816,1428,3388,43,1
117715,698,280,418,44,1
117715,4118,1148,2970,45,1
117715,1715,544,1171,51,1
117715,943,279,664,59,1
117715,3175,869,2306,60,1
117724,13879,7313,6566,1,4
117724,13879,7313,6566,2,1
117724,12033,6401,5632,3,1
117724,1896,1161,735,4,1
117724,10137,5240,4897,5,1
117724,1846,912,934,11,1
117724,1561,853,708,19,1
117724,8576,4387,4189,20,1
117724,3447,1991,1456,21,4
117724,3447,1991,1456,22,1
117724,3390,1946,1444,23,1
117724,415,276,139,24,1
117724,2975,1670,1305,25,1
117724,57,45,12,31,1
117724,239,145,94,39,1
117724,2736,1525,1211,40,1
117724,10432,5322,5110,41,4
117724,10432,5322,5110,42,1
117724,8643,4455,4188,43,1
117724,1481,885,596,44,1
117724,7162,3570,3592,45,1
117724,1789,867,922,51,1
117724,1322,708,614,59,1
117724,5840,2862,2978,60,1
117733,18762,8086,10676,1,4
117733,18762,8086,10676,2,1
117733,16111,6919,9192,3,1
117733,2550,1206,1344,4,1
117733,13561,5713,7848,5,1
117733,2651,1167,1484,11,1
117733,1607,712,895,19,1
117733,11954,5001,6953,20,1
117733,4526,2008,2518,21,4
117733,4526,2008,2518,22,1
117733,4415,1960,2455,23,1
117733,804,392,412,24,1
117733,3611,1568,2043,25,1
117733,111,48,63,31,1
117733,242,141,101,39,1
117733,3369,1427,1942,40,1
117733,14236,6078,8158,41,4
117733,14236,6078,8158,42,1
117733,11696,4959,6737,43,1
117733,1746,814,932,44,1
117733,9950,4145,5805,45,1
117733,2540,1119,1421,51,1
117733,1365,571,794,59,1
117733,8585,3574,5011,60,1
117751,1499,941,558,1,4
117751,1112,589,523,2,1
117751,1112,589,523,3,1
117751,188,80,108,4,1
117751,924,509,415,5,1
117751,387,352,35,12,3
117751,127,87,40,19,1
117751,797,422,375,20,1
117751,1105,605,500,21,4
117751,981,491,490,22,1
117751,981,491,490,23,1
117751,188,80,108,24,1
117751,793,411,382,25,1
117751,124,114,10,32,3
117751,100,64,36,39,1
117751,693,347,346,40,1
117751,394,336,58,41,4
117751,131,98,33,42,1
117751,131,98,33,43,1
117751,131,98,33,45,1
117751,263,238,25,52,3
117751,27,23,4,59,1
117751,104,75,29,60,1
117788,19635,8680,10955,1,4
117788,19635,8680,10955,2,1
117788,16485,7245,9240,3,1
117788,2472,1172,1300,4,1
117788,14013,6073,7940,5,1
117788,3150,1435,1715,11,1
117788,2478,1046,1432,19,1
117788,11535,5027,6508,20,1
117788,4462,2007,2455,21,4
117788,4462,2007,2455,22,1
117788,4198,1893,2305,23,1
117788,716,337,379,24,1
117788,3482,1556,1926,25,1
117788,264,114,150,31,1
117788,377,173,204,39,1
117788,3105,1383,1722,40,1
117788,15173,6673,8500,41,4
117788,15173,6673,8500,42,1
117788,12287,5352,6935,43,1
117788,1756,835,921,44,1
117788,10531,4517,6014,45,1
117788,2886,1321,1565,51,1
117788,2101,873,1228,59,1
117788,8430,3644,4786,60,1
117803,185,41,144,1,4
117803,185,41,144,2,1
117803,182,40,142,3,1
117803,182,40,142,5,1
117803,3,1,2,11,1
117803,37,10,27,19,1
117803,145,30,115,20,1
117803,185,41,144,41,4
117803,185,41,144,42,1
117803,182,40,142,43,1
117803,182,40,142,45,1
117803,3,1,2,51,1
117803,37,10,27,59,1
117803,145,30,115,60,1
117867,8990,3602,5388,1,4
117867,8990,3602,5388,2,1
117867,7931,3109,4822,3,1
117867,1112,523,589,4,1
117867,6819,2586,4233,5,1
117867,1059,493,566,11,1
117867,709,276,433,19,1
117867,6110,2310,3800,20,1
117867,1941,765,1176,21,4
117867,1941,765,1176,22,1
117867,1893,740,1153,23,1
117867,302,144,158,24,1
117867,1591,596,995,25,1
117867,48,25,23,31,1
117867,82,31,51,39,1
117867,1509,565,944,40,1
117867,7049,2837,4212,41,4
117867,7049,2837,4212,42,1
117867,6038,2369,3669,43,1
117867,810,379,431,44,1
117867,5228,1990,3238,45,1
117867,1011,468,543,51,1
117867,627,245,382,59,1
117867,4601,1745,2856,60,1
117894,8525,3914,4611,1,4
117894,8525,3914,4611,2,1
117894,7502,3445,4057,3,1
117894,1260,635,625,4,1
117894,6242,2810,3432,5,1
117894,1023,469,554,11,1
117894,635,305,330,19,1
117894,5607,2505,3102,20,1
117894,2709,1291,1418,21,4
117894,2709,1291,1418,22,1
117894,2637,1257,1380,23,1
117894,535,269,266,24,1
117894,2102,988,1114,25,1
117894,72,34,38,31,1
117894,146,68,78,39,1
117894,1956,920,1036,40,1
117894,5816,2623,3193,41,4
117894,5816,2623,3193,42,1
117894,4865,2188,2677,43,1
117894,725,366,359,44,1
117894,4140,1822,2318,45,1
117894,951,435,516,51,1
117894,489,237,252,59,1
117894,3651,1585,2066,60,1
117928,1317,714,603,1,4
117928,1304,704,600,2,1
117928,1304,704,600,3,1
117928,240,133,107,4,1
117928,1064,571,493,5,1
117928,13,10,3,12,3
117928,190,88,102,19,1
117928,874,483,391,20,1
117928,820,460,360,21,4
117928,813,455,358,22,1
117928,813,455,358,23,1
117928,162,88,74,24,1
117928,651,367,284,25,1
117928,7,5,2,32,3
117928,112,49,63,39,1
117928,539,318,221,40,1
117928,497,254,243,41,4
117928,491,249,242,42,1
117928,491,249,242,43,1
117928,78,45,33,44,1
117928,413,204,209,45,1
117928,6,5,1,52,3
117928,78,39,39,59,1
117928,335,165,170,60,1
117946,9661,4026,5635,1,4
117946,6205,2675,3530,2,1
117946,6087,2594,3493,3,1
117946,1341,566,775,4,1
117946,4746,2028,2718,5,1
117946,118,81,37,11,1
117946,3456,1351,2105,12,3
117946,375,153,222,19,1
117946,4371,1875,2496,20,1
117946,8710,3589,5121,21,4
117946,5935,2521,3414,22,1
117946,5919,2511,3408,23,1
117946,1340,566,774,24,1
117946,4579,1945,2634,25,1
117946,16,10,6,31,1
117946,2775,1068,1707,32,3
117946,364,148,216,39,1
117946,4215,1797,2418,40,1
117946,951,437,514,41,4
117946,270,154,116,42,1
117946,168,83,85,43,1
117946,1,0,1,44,1
117946,167,83,84,45,1
117946,102,71,31,51,1
117946,681,283,398,52,3
117946,11,5,6,59,1
117946,156,78,78,60,1
117955,186,7,179,1,4
117955,186,7,179,2,1
117955,186,7,179,3,1
117955,53,0,53,4,1
117955,133,7,126,5,1
117955,133,7,126,20,1
117955,186,7,179,21,4
117955,186,7,179,22,1
117955,186,7,179,23,1
117955,53,0,53,24,1
117955,133,7,126,25,1
117955,133,7,126,40,1
118116,67,3,64,1,4
118116,67,3,64,2,1
118116,67,3,64,3,1
118116,57,3,54,4,1
118116,10,0,10,5,1
118116,10,0,10,20,1
118116,7,0,7,21,4
118116,7,0,7,22,1
118116,7,0,7,23,1
118116,5,0,5,24,1
118116,2,0,2,25,1
118116,2,0,2,40,1
118116,60,3,57,41,4
118116,60,3,57,42,1
118116,60,3,57,43,1
118116,52,3,49,44,1
118116,8,0,8,45,1
118116,8,0,8,60,1
118125,36,1,35,1,4
118125,36,1,35,2,1
118125,36,1,35,3,1
118125,30,1,29,4,1
118125,6,0,6,5,1
118125,6,0,6,20,1
118125,10,0,10,21,4
118125,10,0,10,22,1
118125,10,0,10,23,1
118125,9,0,9,24,1
118125,1,0,1,25,1
118125,1,0,1,40,1
118125,26,1,25,41,4
118125,26,1,25,42,1
118125,26,1,25,43,1
118125,21,1,20,44,1
118125,5,0,5,45,1
118125,5,0,5,60,1
118134,67,2,65,1,4
118134,67,2,65,2,1
118134,67,2,65,3,1
118134,9,0,9,4,1
118134,58,2,56,5,1
118134,58,2,56,20,1
118134,45,2,43,21,4
118134,45,2,43,22,1
118134,45,2,43,23,1
118134,4,0,4,24,1
118134,41,2,39,25,1
118134,41,2,39,40,1
118134,22,0,22,41,4
118134,22,0,22,42,1
118134,22,0,22,43,1
118134,5,0,5,44,1
118134,17,0,17,45,1
118134,17,0,17,60,1
118143,56,5,51,1,4
118143,56,5,51,2,1
118143,56,5,51,3,1
118143,5,1,4,4,1
118143,51,4,47,5,1
118143,51,4,47,20,1
118143,35,2,33,21,4
118143,35,2,33,22,1
118143,35,2,33,23,1
118143,4,1,3,24,1
118143,31,1,30,25,1
118143,31,1,30,40,1
118143,21,3,18,41,4
118143,21,3,18,42,1
118143,21,3,18,43,1
118143,1,0,1,44,1
118143,20,3,17,45,1
118143,20,3,17,60,1
118161,126,2,124,1,4
118161,126,2,124,2,1
118161,126,2,124,3,1
118161,16,1,15,4,1
118161,110,1,109,5,1
118161,110,1,109,20,1
118161,126,2,124,21,4
118161,126,2,124,22,1
118161,126,2,124,23,1
118161,16,1,15,24,1
118161,110,1,109,25,1
118161,110,1,109,40,1
118189,138,5,133,1,4
118189,138,5,133,2,1
118189,138,5,133,3,1
118189,126,5,121,4,1
118189,12,0,12,5,1
118189,12,0,12,20,1
118189,138,5,133,21,4
118189,138,5,133,22,1
118189,138,5,133,23,1
118189,126,5,121,24,1
118189,12,0,12,25,1
118189,12,0,12,40,1
118198,594,167,427,1,4
118198,594,167,427,2,1
118198,594,167,427,3,1
118198,253,51,202,4,1
118198,341,116,225,5,1
118198,264,77,187,19,1
118198,77,39,38,20,1
118198,594,167,427,21,4
118198,594,167,427,22,1
118198,594,167,427,23,1
118198,253,51,202,24,1
118198,341,116,225,25,1
118198,264,77,187,39,1
118198,77,39,38,40,1
118259,547,81,466,1,4
118259,547,81,466,2,1
118259,520,77,443,3,1
118259,65,8,57,4,1
118259,455,69,386,5,1
118259,27,4,23,11,1
118259,45,8,37,19,1
118259,410,61,349,20,1
118259,547,81,466,21,4
118259,547,81,466,22,1
118259,520,77,443,23,1
118259,65,8,57,24,1
118259,455,69,386,25,1
118259,27,4,23,31,1
118259,45,8,37,39,1
118259,410,61,349,40,1
118277,1354,334,1020,1,4
118277,1354,334,1020,2,1
118277,1335,332,1003,3,1
118277,113,27,86,4,1
118277,1222,305,917,5,1
118277,19,2,17,11,1
118277,208,60,148,19,1
118277,1014,245,769,20,1
118277,1354,334,1020,21,4
118277,1354,334,1020,22,1
118277,1335,332,1003,23,1
118277,113,27,86,24,1
118277,1222,305,917,25,1
118277,19,2,17,31,1
118277,208,60,148,39,1
118277,1014,245,769,40,1
118286,896,242,654,1,4
118286,896,242,654,2,1
118286,890,241,649,3,1
118286,180,31,149,4,1
118286,710,210,500,5,1
118286,6,1,5,11,1
118286,62,11,51,19,1
118286,648,199,449,20,1
118286,896,242,654,21,4
118286,896,242,654,22,1
118286,890,241,649,23,1
118286,180,31,149,24,1
118286,710,210,500,25,1
118286,6,1,5,31,1
118286,62,11,51,39,1
118286,648,199,449,40,1
118347,6077,2574,3503,1,4
118347,6077,2574,3503,2,1
118347,5040,2133,2907,3,1
118347,811,400,411,4,1
118347,4229,1733,2496,5,1
118347,1037,441,596,11,1
118347,409,178,231,19,1
118347,3820,1555,2265,20,1
118347,1281,640,641,21,4
118347,1281,640,641,22,1
118347,1233,610,623,23,1
118347,265,153,112,24,1
118347,968,457,511,25,1
118347,48,30,18,31,1
118347,84,42,42,39,1
118347,884,415,469,40,1
118347,4796,1934,2862,41,4
118347,4796,1934,2862,42,1
118347,3807,1523,2284,43,1
118347,546,247,299,44,1
118347,3261,1276,1985,45,1
118347,989,411,578,51,1
118347,325,136,189,59,1
118347,2936,1140,1796,60,1
118356,2405,177,2228,1,4
118356,2405,177,2228,2,1
118356,2405,177,2228,3,1
118356,750,46,704,4,1
118356,1655,131,1524,5,1
118356,1655,131,1524,20,1
118356,1872,145,1727,21,4
118356,1872,145,1727,22,1
118356,1872,145,1727,23,1
118356,565,34,531,24,1
118356,1307,111,1196,25,1
118356,1307,111,1196,40,1
118356,533,32,501,41,4
118356,533,32,501,42,1
118356,533,32,501,43,1
118356,185,12,173,44,1
118356,348,20,328,45,1
118356,348,20,328,60,1
118541,1037,463,574,1,4
118541,1033,463,570,2,1
118541,1033,463,570,3,1
118541,290,129,161,4,1
118541,743,334,409,5,1
118541,4,0,4,12,3
118541,92,46,46,19,1
118541,651,288,363,20,1
118541,1006,448,558,21,4
118541,1002,448,554,22,1
118541,1002,448,554,23,1
118541,288,127,161,24,1
118541,714,321,393,25,1
118541,4,0,4,32,3
118541,80,37,43,39,1
118541,634,284,350,40,1
118541,31,15,16,41,4
118541,31,15,16,42,1
118541,31,15,16,43,1
118541,2,2,0,44,1
118541,29,13,16,45,1
118541,12,9,3,59,1
118541,17,4,13,60,1
118684,3729,1513,2216,1,4
118684,3729,1513,2216,2,1
118684,3130,1252,1878,3,1
118684,417,245,172,4,1
118684,2713,1007,1706,5,1
118684,599,261,338,11,1
118684,256,110,146,19,1
118684,2457,897,1560,20,1
118684,1256,583,673,21,4
118684,1256,583,673,22,1
118684,1230,573,657,23,1
118684,240,144,96,24,1
118684,990,429,561,25,1
118684,26,10,16,31,1
118684,87,51,36,39,1
118684,903,378,525,40,1
118684,2473,930,1543,41,4
118684,2473,930,1543,42,1
118684,1900,679,1221,43,1
118684,177,101,76,44,1
118684,1723,578,1145,45,1
118684,573,251,322,51,1
118684,169,59,110,59,1
118684,1554,519,1035,60,1
118693,745,462,283,1,4
118693,745,462,283,2,1
118693,742,460,282,3,1
118693,134,85,49,4,1
118693,608,375,233,5,1
118693,3,2,1,11,1
118693,93,57,36,19,1
118693,515,318,197,20,1
118693,712,441,271,21,4
118693,712,441,271,22,1
118693,712,441,271,23,1
118693,134,85,49,24,1
118693,578,356,222,25,1
118693,92,57,35,39,1
118693,486,299,187,40,1
118693,33,21,12,41,4
118693,33,21,12,42,1
118693,30,19,11,43,1
118693,30,19,11,45,1
118693,3,2,1,51,1
118693,1,0,1,59,1
118693,29,19,10,60,1
118718,10205,4436,5769,1,4
118718,10205,4436,5769,2,1
118718,9163,3973,5190,3,1
118718,1737,848,889,4,1
118718,7426,3125,4301,5,1
118718,1042,463,579,11,1
118718,438,220,218,19,1
118718,6988,2905,4083,20,1
118718,4882,2167,2715,21,4
118718,4882,2167,2715,22,1
118718,4644,2063,2581,23,1
118718,1067,522,545,24,1
118718,3577,1541,2036,25,1
118718,238,104,134,31,1
118718,177,95,82,39,1
118718,3400,1446,1954,40,1
118718,5323,2269,3054,41,4
118718,5323,2269,3054,42,1
118718,4519,1910,2609,43,1
118718,670,326,344,44,1
118718,3849,1584,2265,45,1
118718,804,359,445,51,1
118718,261,125,136,59,1
118718,3588,1459,2129,60,1
118772,5887,2098,3789,1,4
118772,5887,2098,3789,2,1
118772,5435,1909,3526,3,1
118772,818,336,482,4,1
118772,4617,1573,3044,5,1
118772,452,189,263,11,1
118772,1132,404,728,19,1
118772,3485,1169,2316,20,1
118772,838,328,510,21,4
118772,838,328,510,22,1
118772,827,322,505,23,1
118772,161,70,91,24,1
118772,666,252,414,25,1
118772,11,6,5,31,1
118772,127,41,86,39,1
118772,539,211,328,40,1
118772,5049,1770,3279,41,4
118772,5049,1770,3279,42,1
118772,4608,1587,3021,43,1
118772,657,266,391,44,1
118772,3951,1321,2630,45,1
118772,441,183,258,51,1
118772,1005,363,642,59,1
118772,2946,958,1988,60,1
118888,1595,126,1469,1,4
118888,985,0,985,2,1
118888,974,0,974,3,1
118888,217,0,217,4,1
118888,757,0,757,5,1
118888,11,0,11,11,1
118888,610,126,484,12,3
118888,117,0,117,19,1
118888,640,0,640,20,1
118888,1424,115,1309,21,4
118888,922,0,922,22,1
118888,922,0,922,23,1
118888,217,0,217,24,1
118888,705,0,705,25,1
118888,502,115,387,32,3
118888,108,0,108,39,1
118888,597,0,597,40,1
118888,171,11,160,41,4
118888,63,0,63,42,1
118888,52,0,52,43,1
118888,52,0,52,45,1
118888,11,0,11,51,1
118888,108,11,97,52,3
118888,9,0,9,59,1
118888,43,0,43,60,1
118912,14537,6364,8173,1,4
118912,14537,6364,8173,2,1
118912,13846,6104,7742,3,1
118912,2695,1335,1360,4,1
118912,11151,4769,6382,5,1
118912,691,260,431,11,1
118912,1484,647,837,19,1
118912,9667,4122,5545,20,1
118912,6438,3102,3336,21,4
118912,6438,3102,3336,22,1
118912,6394,3074,3320,23,1
118912,1459,749,710,24,1
118912,4935,2325,2610,25,1
118912,44,28,16,31,1
118912,535,262,273,39,1
118912,4400,2063,2337,40,1
118912,8099,3262,4837,41,4
118912,8099,3262,4837,42,1
118912,7452,3030,4422,43,1
118912,1236,586,650,44,1
118912,6216,2444,3772,45,1
118912,647,232,415,51,1
118912,949,385,564,59,1
118912,5267,2059,3208,60,1
118921,616,49,567,1,4
118921,616,49,567,2,1
118921,616,49,567,3,1
118921,198,13,185,4,1
118921,418,36,382,5,1
118921,418,36,382,20,1
118921,456,41,415,21,4
118921,456,41,415,22,1
118921,456,41,415,23,1
118921,135,11,124,24,1
118921,321,30,291,25,1
118921,321,30,291,40,1
118921,160,8,152,41,4
118921,160,8,152,42,1
118921,160,8,152,43,1
118921,63,2,61,44,1
118921,97,6,91,45,1
118921,97,6,91,60,1
118930,9130,4083,5047,1,4
118930,9130,4083,5047,2,1
118930,7467,3395,4072,3,1
118930,907,467,440,4,1
118930,6560,2928,3632,5,1
118930,1663,688,975,11,1
118930,1085,508,577,19,1
118930,5475,2420,3055,20,1
118930,2417,1149,1268,21,4
118930,2417,1149,1268,22,1
118930,2197,1050,1147,23,1
118930,371,210,161,24,1
118930,1826,840,986,25,1
118930,220,99,121,31,1
118930,163,82,81,39,1
118930,1663,758,905,40,1
118930,6713,2934,3779,41,4
118930,6713,2934,3779,42,1
118930,5270,2345,2925,43,1
118930,536,257,279,44,1
118930,4734,2088,2646,45,1
118930,1443,589,854,51,1
118930,922,426,496,59,1
118930,3812,1662,2150,60,1
118958,48,6,42,1,4
118958,48,6,42,2,1
118958,48,6,42,3,1
118958,7,2,5,4,1
118958,41,4,37,5,1
118958,41,4,37,20,1
118958,48,6,42,21,4
118958,48,6,42,22,1
118958,48,6,42,23,1
118958,7,2,5,24,1
118958,41,4,37,25,1
118958,41,4,37,40,1
118967,792,368,424,1,4
118967,792,368,424,2,1
118967,786,366,420,3,1
118967,96,37,59,4,1
118967,690,329,361,5,1
118967,6,2,4,11,1
118967,58,35,23,19,1
118967,632,294,338,20,1
118967,792,368,424,21,4
118967,792,368,424,22,1
118967,786,366,420,23,1
118967,96,37,59,24,1
118967,690,329,361,25,1
118967,6,2,4,31,1
118967,58,35,23,39,1
118967,632,294,338,40,1
118976,17084,7383,9701,1,4
118976,17084,7383,9701,2,1
118976,15904,6863,9041,3,1
118976,3239,1593,1646,4,1
118976,12665,5270,7395,5,1
118976,1180,520,660,11,1
118976,747,313,434,19,1
118976,11918,4957,6961,20,1
118976,6241,2812,3429,21,4
118976,6241,2812,3429,22,1
118976,6133,2771,3362,23,1
118976,1629,800,829,24,1
118976,4504,1971,2533,25,1
118976,108,41,67,31,1
118976,252,119,133,39,1
118976,4252,1852,2400,40,1
118976,10843,4571,6272,41,4
118976,10843,4571,6272,42,1
118976,9771,4092,5679,43,1
118976,1610,793,817,44,1
118976,8161,3299,4862,45,1
118976,1072,479,593,51,1
118976,495,194,301,59,1
118976,7666,3105,4561,60,1
118994,76,74,2,1,4
118994,76,74,2,2,1
118994,76,74,2,3,1
118994,5,5,0,4,1
118994,71,69,2,5,1
118994,71,69,2,20,1
118994,76,74,2,21,4
118994,76,74,2,22,1
118994,76,74,2,23,1
118994,5,5,0,24,1
118994,71,69,2,25,1
118994,71,69,2,40,1
119058,731,257,474,1,4
119058,22,18,4,2,1
119058,22,18,4,3,1
119058,22,18,4,5,1
119058,709,239,470,12,3
119058,8,7,1,19,1
119058,14,11,3,20,1
119058,651,230,421,21,4
119058,20,17,3,22,1
119058,20,17,3,23,1
119058,20,17,3,25,1
119058,631,213,418,32,3
119058,8,7,1,39,1
119058,12,10,2,40,1
119058,80,27,53,41,4
119058,2,1,1,42,1
119058,2,1,1,43,1
119058,2,1,1,45,1
119058,78,26,52,52,3
119058,2,1,1,60,1
119067,9519,4935,4584,1,4
119067,9519,4935,4584,2,1
119067,8781,4624,4157,3,1
119067,1801,1080,721,4,1
119067,6980,3544,3436,5,1
119067,738,311,427,11,1
119067,1041,599,442,19,1
119067,5939,2945,2994,20,1
119067,2320,1122,1198,21,4
119067,2320,1122,1198,22,1
119067,2302,1114,1188,23,1
119067,415,220,195,24,1
119067,1887,894,993,25,1
119067,18,8,10,31,1
119067,190,96,94,39,1
119067,1697,798,899,40,1
119067,7199,3813,3386,41,4
119067,7199,3813,3386,42,1
119067,6479,3510,2969,43,1
119067,1386,860,526,44,1
119067,5093,2650,2443,45,1
119067,720,303,417,51,1
119067,851,503,348,59,1
119067,4242,2147,2095,60,1
119137,14206,6875,7331,1,4
119137,14206,6875,7331,2,1
119137,13437,6491,6946,3,1
119137,3051,1539,1512,4,1
119137,10386,4952,5434,5,1
119137,769,384,385,11,1
119137,1073,468,605,19,1
119137,9313,4484,4829,20,1
119137,5708,2893,2815,21,4
119137,5708,2893,2815,22,1
119137,5673,2865,2808,23,1
119137,1826,917,909,24,1
119137,3847,1948,1899,25,1
119137,35,28,7,31,1
119137,277,125,152,39,1
119137,3570,1823,1747,40,1
119137,8498,3982,4516,41,4
119137,8498,3982,4516,42,1
119137,7764,3626,4138,43,1
119137,1225,622,603,44,1
119137,6539,3004,3535,45,1
119137,734,356,378,51,1
119137,796,343,453,59,1
119137,5743,2661,3082,60,1
119164,28481,13874,14607,1,4
119164,28481,13874,14607,2,1
119164,25800,12569,13231,3,1
119164,4835,2452,2383,4,1
119164,20965,10117,10848,5,1
119164,2681,1305,1376,11,1
119164,1579,754,825,19,1
119164,19386,9363,10023,20,1
119164,10499,5257,5242,21,4
119164,10499,5257,5242,22,1
119164,10290,5153,5137,23,1
119164,2604,1285,1319,24,1
119164,7686,3868,3818,25,1
119164,209,104,105,31,1
119164,482,244,238,39,1
119164,7204,3624,3580,40,1
119164,17982,8617,9365,41,4
119164,17982,8617,9365,42,1
119164,15510,7416,8094,43,1
119164,2231,1167,1064,44,1
119164,13279,6249,7030,45,1
119164,2472,1201,1271,51,1
119164,1097,510,587,59,1
119164,12182,5739,6443,60,1
119173,3274,309,2965,1,4
119173,2625,168,2457,2,1
119173,2617,166,2451,3,1
119173,559,20,539,4,1
119173,2058,146,1912,5,1
119173,8,2,6,11,1
119173,649,141,508,12,3
119173,264,29,235,19,1
119173,1794,117,1677,20,1
119173,2508,184,2324,21,4
119173,2092,92,2000,22,1
119173,2091,92,1999,23,1
119173,554,19,535,24,1
119173,1537,73,1464,25,1
119173,1,0,1,31,1
119173,416,92,324,32,3
119173,178,19,159,39,1
119173,1359,54,1305,40,1
119173,766,125,641,41,4
119173,533,76,457,42,1
119173,526,74,452,43,1
119173,5,1,4,44,1
119173,521,73,448,45,1
119173,7,2,5,51,1
119173,233,49,184,52,3
119173,86,10,76,59,1
119173,435,63,372,60,1
119216,14170,6057,8113,1,4
119216,14170,6057,8113,2,1
119216,13324,5673,7651,3,1
119216,2536,1201,1335,4,1
119216,10788,4472,6316,5,1
119216,846,384,462,11,1
119216,972,414,558,19,1
119216,9816,4058,5758,20,1
119216,5105,2268,2837,21,4
119216,5105,2268,2837,22,1
119216,5046,2244,2802,23,1
119216,943,447,496,24,1
119216,4103,1797,2306,25,1
119216,59,24,35,31,1
119216,276,132,144,39,1
119216,3827,1665,2162,40,1
119216,9065,3789,5276,41,4
119216,9065,3789,5276,42,1
119216,8278,3429,4849,43,1
119216,1593,754,839,44,1
119216,6685,2675,4010,45,1
119216,787,360,427,51,1
119216,696,282,414,59,1
119216,5989,2393,3596,60,1
119234,105,54,51,1,4
119234,105,54,51,2,1
119234,105,54,51,3,1
119234,93,48,45,4,1
119234,12,6,6,5,1
119234,12,6,6,20,1
119234,24,10,14,21,4
119234,24,10,14,22,1
119234,24,10,14,23,1
119234,21,10,11,24,1
119234,3,0,3,25,1
119234,3,0,3,40,1
119234,81,44,37,41,4
119234,81,44,37,42,1
119234,81,44,37,43,1
119234,72,38,34,44,1
119234,9,6,3,45,1
119234,9,6,3,60,1
119270,1204,978,226,1,4
119270,1204,978,226,2,1
119270,1166,952,214,3,1
119270,450,369,81,4,1
119270,716,583,133,5,1
119270,38,26,12,11,1
119270,78,56,22,19,1
119270,638,527,111,20,1
119270,1037,848,189,21,4
119270,1037,848,189,22,1
119270,1020,838,182,23,1
119270,440,365,75,24,1
119270,580,473,107,25,1
119270,17,10,7,31,1
119270,76,55,21,39,1
119270,504,418,86,40,1
119270,167,130,37,41,4
119270,167,130,37,42,1
119270,146,114,32,43,1
119270,10,4,6,44,1
119270,136,110,26,45,1
119270,21,16,5,51,1
119270,2,1,1,59,1
119270,134,109,25,60,1
119331,6308,2762,3546,1,4
119331,6308,2762,3546,2,1
119331,5707,2494,3213,3,1
119331,1090,480,610,4,1
119331,4617,2014,2603,5,1
119331,601,268,333,11,1
119331,460,210,250,19,1
119331,4157,1804,2353,20,1
119331,2376,1080,1296,21,4
119331,2376,1080,1296,22,1
119331,2342,1062,1280,23,1
119331,517,222,295,24,1
119331,1825,840,985,25,1
119331,34,18,16,31,1
119331,159,81,78,39,1
119331,1666,759,907,40,1
119331,3932,1682,2250,41,4
119331,3932,1682,2250,42,1
119331,3365,1432,1933,43,1
119331,573,258,315,44,1
119331,2792,1174,1618,45,1
119331,567,250,317,51,1
119331,301,129,172,59,1
119331,2491,1045,1446,60,1
119340,267,51,216,1,4
119340,267,51,216,2,1
119340,267,51,216,3,1
119340,29,5,24,4,1
119340,238,46,192,5,1
119340,238,46,192,20,1
119340,267,51,216,21,4
119340,267,51,216,22,1
119340,267,51,216,23,1
119340,29,5,24,24,1
119340,238,46,192,25,1
119340,238,46,192,40,1
119359,696,174,522,1,4
119359,696,174,522,2,1
119359,696,174,522,3,1
119359,132,28,104,4,1
119359,564,146,418,5,1
119359,44,9,35,19,1
119359,520,137,383,20,1
119359,675,165,510,21,4
119359,675,165,510,22,1
119359,675,165,510,23,1
119359,132,28,104,24,1
119359,543,137,406,25,1
119359,42,7,35,39,1
119359,501,130,371,40,1
119359,21,9,12,41,4
119359,21,9,12,42,1
119359,21,9,12,43,1
119359,21,9,12,45,1
119359,2,2,0,59,1
119359,19,7,12,60,1
119368,232,59,173,1,4
119368,232,59,173,2,1
119368,232,59,173,3,1
119368,20,5,15,4,1
119368,212,54,158,5,1
119368,9,2,7,19,1
119368,203,52,151,20,1
119368,223,54,169,21,4
119368,223,54,169,22,1
119368,223,54,169,23,1
119368,20,5,15,24,1
119368,203,49,154,25,1
119368,9,2,7,39,1
119368,194,47,147,40,1
119368,9,5,4,41,4
119368,9,5,4,42,1
119368,9,5,4,43,1
119368,9,5,4,45,1
119368,9,5,4,60,1
119438,172,22,150,1,4
119438,172,22,150,2,1
119438,172,22,150,3,1
119438,19,2,17,4,1
119438,153,20,133,5,1
119438,153,20,133,20,1
119438,172,22,150,21,4
119438,172,22,150,22,1
119438,172,22,150,23,1
119438,19,2,17,24,1
119438,153,20,133,25,1
119438,153,20,133,40,1
119456,494,74,420,1,4
119456,494,74,420,2,1
119456,494,74,420,3,1
119456,87,14,73,4,1
119456,407,60,347,5,1
119456,407,60,347,20,1
119456,494,74,420,21,4
119456,494,74,420,22,1
119456,494,74,420,23,1
119456,87,14,73,24,1
119456,407,60,347,25,1
119456,407,60,347,40,1
119465,561,139,422,1,4
119465,561,139,422,2,1
119465,561,139,422,3,1
119465,71,25,46,4,1
119465,490,114,376,5,1
119465,490,114,376,20,1
119465,561,139,422,21,4
119465,561,139,422,22,1
119465,561,139,422,23,1
119465,71,25,46,24,1
119465,490,114,376,25,1
119465,490,114,376,40,1
119508,747,329,418,1,4
119508,747,329,418,2,1
119508,747,329,418,3,1
119508,119,53,66,4,1
119508,628,276,352,5,1
119508,83,30,53,19,1
119508,545,246,299,20,1
119508,688,310,378,21,4
119508,688,310,378,22,1
119508,688,310,378,23,1
119508,119,53,66,24,1
119508,569,257,312,25,1
119508,66,25,41,39,1
119508,503,232,271,40,1
119508,59,19,40,41,4
119508,59,19,40,42,1
119508,59,19,40,43,1
119508,59,19,40,45,1
119508,17,5,12,59,1
119508,42,14,28,60,1
119544,813,216,597,1,4
119544,509,133,376,2,1
119544,434,109,325,3,1
119544,32,5,27,4,1
119544,402,104,298,5,1
119544,75,24,51,11,1
119544,304,83,221,12,3
119544,43,10,33,19,1
119544,359,94,265,20,1
119544,389,89,300,21,4
119544,238,55,183,22,1
119544,238,55,183,23,1
119544,27,5,22,24,1
119544,211,50,161,25,1
119544,151,34,117,32,3
119544,22,1,21,39,1
119544,189,49,140,40,1
119544,424,127,297,41,4
119544,271,78,193,42,1
119544,196,54,142,43,1
119544,5,0,5,44,1
119544,191,54,137,45,1
119544,75,24,51,51,1
119544,153,49,104,52,3
119544,21,9,12,59,1
119544,170,45,125,60,1
119553,764,265,499,1,4
119553,764,265,499,2,1
119553,764,265,499,3,1
119553,176,63,113,4,1
119553,588,202,386,5,1
119553,588,202,386,20,1
119553,735,252,483,21,4
119553,735,252,483,22,1
119553,735,252,483,23,1
119553,176,63,113,24,1
119553,559,189,370,25,1
119553,559,189,370,40,1
119553,29,13,16,41,4
119553,29,13,16,42,1
119553,29,13,16,43,1
119553,29,13,16,45,1
119553,29,13,16,60,1
119605,18207,7236,10971,1,4
119605,10074,4361,5713,2,1
119605,9788,4228,5560,3,1
119605,809,368,441,4,1
119605,8979,3860,5119,5,1
119605,286,133,153,11,1
119605,8133,2875,5258,12,3
119605,3995,1743,2252,19,1
119605,4984,2117,2867,20,1
119605,8877,3431,5446,21,4
119605,3724,1667,2057,22,1
119605,3710,1659,2051,23,1
119605,143,66,77,24,1
119605,3567,1593,1974,25,1
119605,14,8,6,31,1
119605,5153,1764,3389,32,3
119605,1375,622,753,39,1
119605,2192,971,1221,40,1
119605,9330,3805,5525,41,4
119605,6350,2694,3656,42,1
119605,6078,2569,3509,43,1
119605,666,302,364,44,1
119605,5412,2267,3145,45,1
119605,272,125,147,51,1
119605,2980,1111,1869,52,3
119605,2620,1121,1499,59,1
119605,2792,1146,1646,60,1
119678,2870,2466,404,1,4
119678,2870,2466,404,12,3
119678,1674,1493,181,21,4
119678,1674,1493,181,32,3
119678,1196,973,223,41,4
119678,1196,973,223,52,3
119775,514,363,151,1,4
119775,375,278,97,2,1
119775,375,278,97,3,1
119775,28,16,12,4,1
119775,347,262,85,5,1
119775,139,85,54,12,3
119775,64,47,17,19,1
119775,283,215,68,20,1
119775,445,319,126,21,4
119775,334,245,89,22,1
119775,334,245,89,23,1
119775,26,14,12,24,1
119775,308,231,77,25,1
119775,111,74,37,32,3
119775,59,43,16,39,1
119775,249,188,61,40,1
119775,69,44,25,41,4
119775,41,33,8,42,1
119775,41,33,8,43,1
119775,2,2,0,44,1
119775,39,31,8,45,1
119775,28,11,17,52,3
119775,5,4,1,59,1
119775,34,27,7,60,1
119845,153,3,150,1,4
119845,153,3,150,2,1
119845,153,3,150,3,1
119845,32,0,32,4,1
119845,121,3,118,5,1
119845,121,3,118,20,1
119845,102,3,99,21,4
119845,102,3,99,22,1
119845,102,3,99,23,1
119845,26,0,26,24,1
119845,76,3,73,25,1
119845,76,3,73,40,1
119845,51,0,51,41,4
119845,51,0,51,42,1
119845,51,0,51,43,1
119845,6,0,6,44,1
119845,45,0,45,45,1
119845,45,0,45,60,1
119951,275,7,268,1,4
119951,275,7,268,2,1
119951,275,7,268,3,1
119951,43,0,43,4,1
119951,232,7,225,5,1
119951,232,7,225,20,1
119951,275,7,268,21,4
119951,275,7,268,22,1
119951,275,7,268,23,1
119951,43,0,43,24,1
119951,232,7,225,25,1
119951,232,7,225,40,1
120069,280,34,246,1,4
120069,280,34,246,2,1
120069,280,34,246,3,1
120069,71,5,66,4,1
120069,209,29,180,5,1
120069,209,29,180,20,1
120069,280,34,246,21,4
120069,280,34,246,22,1
120069,280,34,246,23,1
120069,71,5,66,24,1
120069,209,29,180,25,1
120069,209,29,180,40,1
120078,550,93,457,1,4
120078,550,93,457,2,1
120078,550,93,457,3,1
120078,176,31,145,4,1
120078,374,62,312,5,1
120078,374,62,312,20,1
120078,550,93,457,21,4
120078,550,93,457,22,1
120078,550,93,457,23,1
120078,176,31,145,24,1
120078,374,62,312,25,1
120078,374,62,312,40,1
120087,193,36,157,1,4
120087,193,36,157,2,1
120087,193,36,157,3,1
120087,39,5,34,4,1
120087,154,31,123,5,1
120087,154,31,123,20,1
120087,193,36,157,21,4
120087,193,36,157,22,1
120087,193,36,157,23,1
120087,39,5,34,24,1
120087,154,31,123,25,1
120087,154,31,123,40,1
120166,988,586,402,1,4
120166,183,115,68,2,1
120166,183,115,68,3,1
120166,52,34,18,4,1
120166,131,81,50,5,1
120166,805,471,334,12,3
120166,131,81,50,20,1
120166,837,514,323,21,4
120166,165,103,62,22,1
120166,165,103,62,23,1
120166,47,30,17,24,1
120166,118,73,45,25,1
120166,672,411,261,32,3
120166,118,73,45,40,1
120166,151,72,79,41,4
120166,18,12,6,42,1
120166,18,12,6,43,1
120166,5,4,1,44,1
120166,13,8,5,45,1
120166,133,60,73,52,3
120166,13,8,5,60,1
120184,2030,609,1421,1,4
120184,1213,405,808,2,1
120184,1209,404,805,3,1
120184,172,61,111,4,1
120184,1037,343,694,5,1
120184,4,1,3,11,1
120184,817,204,613,12,3
120184,168,59,109,19,1
120184,869,284,585,20,1
120184,1071,340,731,21,4
120184,826,288,538,22,1
120184,826,288,538,23,1
120184,172,61,111,24,1
120184,654,227,427,25,1
120184,245,52,193,32,3
120184,92,41,51,39,1
120184,562,186,376,40,1
120184,959,269,690,41,4
120184,387,117,270,42,1
120184,383,116,267,43,1
120184,383,116,267,45,1
120184,4,1,3,51,1
120184,572,152,420,52,3
120184,76,18,58,59,1
120184,307,98,209,60,1
120254,2128,930,1198,1,4
120254,2128,930,1198,2,1
120254,2101,922,1179,3,1
120254,548,233,315,4,1
120254,1553,689,864,5,1
120254,27,8,19,11,1
120254,33,15,18,19,1
120254,1520,674,846,20,1
120254,2113,924,1189,21,4
120254,2113,924,1189,22,1
120254,2089,916,1173,23,1
120254,548,233,315,24,1
120254,1541,683,858,25,1
120254,24,8,16,31,1
120254,32,15,17,39,1
120254,1509,668,841,40,1
120254,15,6,9,41,4
120254,15,6,9,42,1
120254,12,6,6,43,1
120254,12,6,6,45,1
120254,3,0,3,51,1
120254,1,0,1,59,1
120254,11,6,5,60,1
120272,70,6,64,1,4
120272,70,6,64,2,1
120272,70,6,64,3,1
120272,14,3,11,4,1
120272,56,3,53,5,1
120272,56,3,53,20,1
120272,70,6,64,21,4
120272,70,6,64,22,1
120272,70,6,64,23,1
120272,14,3,11,24,1
120272,56,3,53,25,1
120272,56,3,53,40,1
120290,10310,5191,5119,1,4
120290,10310,5191,5119,2,1
120290,9184,4651,4533,3,1
120290,1839,900,939,4,1
120290,7345,3751,3594,5,1
120290,1126,540,586,11,1
120290,998,575,423,19,1
120290,6347,3176,3171,20,1
120290,3219,1611,1608,21,4
120290,3219,1611,1608,22,1
120290,3125,1569,1556,23,1
120290,776,386,390,24,1
120290,2349,1183,1166,25,1
120290,94,42,52,31,1
120290,157,76,81,39,1
120290,2192,1107,1085,40,1
120290,7091,3580,3511,41,4
120290,7091,3580,3511,42,1
120290,6059,3082,2977,43,1
120290,1063,514,549,44,1
120290,4996,2568,2428,45,1
120290,1032,498,534,51,1
120290,841,499,342,59,1
120290,4155,2069,2086,60,1
120342,21886,11344,10542,1,4
120342,21886,11344,10542,2,1
120342,20521,10634,9887,3,1
120342,3677,1958,1719,4,1
120342,16844,8676,8168,5,1
120342,1365,710,655,11,1
120342,1874,954,920,19,1
120342,14970,7722,7248,20,1
120342,8497,4551,3946,21,4
120342,8497,4551,3946,22,1
120342,8386,4499,3887,23,1
120342,1930,1041,889,24,1
120342,6456,3458,2998,25,1
120342,111,52,59,31,1
120342,435,254,181,39,1
120342,6021,3204,2817,40,1
120342,13389,6793,6596,41,4
120342,13389,6793,6596,42,1
120342,12135,6135,6000,43,1
120342,1747,917,830,44,1
120342,10388,5218,5170,45,1
120342,1254,658,596,51,1
120342,1439,700,739,59,1
120342,8949,4518,4431,60,1
120403,1086,381,705,1,4
120403,1032,366,666,2,1
120403,1029,365,664,3,1
120403,160,50,110,4,1
120403,869,315,554,5,1
120403,3,1,2,11,1
120403,54,15,39,12,3
120403,109,49,60,19,1
120403,760,266,494,20,1
120403,1061,372,689,21,4
120403,1018,359,659,22,1
120403,1015,358,657,23,1
120403,160,50,110,24,1
120403,855,308,547,25,1
120403,3,1,2,31,1
120403,43,13,30,32,3
120403,109,49,60,39,1
120403,746,259,487,40,1
120403,25,9,16,41,4
120403,14,7,7,42,1
120403,14,7,7,43,1
120403,14,7,7,45,1
120403,11,2,9,52,3
120403,14,7,7,60,1
120421,6939,3167,3772,1,4
120421,6939,3167,3772,2,1
120421,6450,2946,3504,3,1
120421,1055,524,531,4,1
120421,5395,2422,2973,5,1
120421,489,221,268,11,1
120421,802,366,436,19,1
120421,4593,2056,2537,20,1
120421,1933,869,1064,21,4
120421,1933,869,1064,22,1
120421,1911,861,1050,23,1
120421,523,238,285,24,1
120421,1388,623,765,25,1
120421,22,8,14,31,1
120421,128,60,68,39,1
120421,1260,563,697,40,1
120421,5006,2298,2708,41,4
120421,5006,2298,2708,42,1
120421,4539,2085,2454,43,1
120421,532,286,246,44,1
120421,4007,1799,2208,45,1
120421,467,213,254,51,1
120421,674,306,368,59,1
120421,3333,1493,1840,60,1
120537,1356,589,767,1,4
120537,925,416,509,2,1
120537,872,389,483,3,1
120537,85,38,47,4,1
120537,787,351,436,5,1
120537,53,27,26,11,1
120537,431,173,258,12,3
120537,129,62,67,19,1
120537,658,289,369,20,1
120537,935,392,543,21,4
120537,678,300,378,22,1
120537,671,298,373,23,1
120537,76,33,43,24,1
120537,595,265,330,25,1
120537,7,2,5,31,1
120537,257,92,165,32,3
120537,90,42,48,39,1
120537,505,223,282,40,1
120537,421,197,224,41,4
120537,247,116,131,42,1
120537,201,91,110,43,1
120537,9,5,4,44,1
120537,192,86,106,45,1
120537,46,25,21,51,1
120537,174,81,93,52,3
120537,39,20,19,59,1
120537,153,66,87,60,1
120661,895,265,630,1,4
120661,895,265,630,2,1
120661,895,265,630,3,1
120661,266,70,196,4,1
120661,629,195,434,5,1
120661,629,195,434,20,1
120661,895,265,630,21,4
120661,895,265,630,22,1
120661,895,265,630,23,1
120661,266,70,196,24,1
120661,629,195,434,25,1
120661,629,195,434,40,1
120698,948,205,743,1,4
120698,191,63,128,2,1
120698,191,63,128,3,1
120698,191,63,128,5,1
120698,757,142,615,12,3
120698,115,37,78,19,1
120698,76,26,50,20,1
120698,870,194,676,21,4
120698,188,62,126,22,1
120698,188,62,126,23,1
120698,188,62,126,25,1
120698,682,132,550,32,3
120698,115,37,78,39,1
120698,73,25,48,40,1
120698,78,11,67,41,4
120698,3,1,2,42,1
120698,3,1,2,43,1
120698,3,1,2,45,1
120698,75,10,65,52,3
120698,3,1,2,60,1
120740,99,51,48,1,4
120740,99,51,48,12,3
120740,90,49,41,21,4
120740,90,49,41,32,3
120740,9,2,7,41,4
120740,9,2,7,52,3
120768,1072,74,998,1,4
120768,415,29,386,2,1
120768,415,29,386,3,1
120768,415,29,386,5,1
120768,657,45,612,12,3
120768,151,12,139,19,1
120768,264,17,247,20,1
120768,81,3,78,21,4
120768,53,2,51,22,1
120768,53,2,51,23,1
120768,53,2,51,25,1
120768,28,1,27,32,3
120768,18,2,16,39,1
120768,35,0,35,40,1
120768,991,71,920,41,4
120768,362,27,335,42,1
120768,362,27,335,43,1
120768,362,27,335,45,1
120768,629,44,585,52,3
120768,133,10,123,59,1
120768,229,17,212,60,1
120795,183,80,103,1,4
120795,183,80,103,12,3
120795,118,51,67,21,4
120795,118,51,67,32,3
120795,65,29,36,41,4
120795,65,29,36,52,3
120838,173,85,88,1,4
120838,14,10,4,2,1
120838,14,10,4,3,1
120838,14,10,4,5,1
120838,159,75,84,12,3
120838,3,1,2,19,1
120838,11,9,2,20,1
120838,173,85,88,21,4
120838,14,10,4,22,1
120838,14,10,4,23,1
120838,14,10,4,25,1
120838,159,75,84,32,3
120838,3,1,2,39,1
120838,11,9,2,40,1
120865,1647,725,922,1,4
120865,1645,724,921,2,1
120865,1601,703,898,3,1
120865,335,145,190,4,1
120865,1266,558,708,5,1
120865,44,21,23,11,1
120865,2,1,1,12,3
120865,141,55,86,19,1
120865,1125,503,622,20,1
120865,1456,658,798,21,4
120865,1454,657,797,22,1
120865,1454,657,797,23,1
120865,334,145,189,24,1
120865,1120,512,608,25,1
120865,2,1,1,32,3
120865,136,55,81,39,1
120865,984,457,527,40,1
120865,191,67,124,41,4
120865,191,67,124,42,1
120865,147,46,101,43,1
120865,1,0,1,44,1
120865,146,46,100,45,1
120865,44,21,23,51,1
120865,5,0,5,59,1
120865,141,46,95,60,1
120883,6421,2960,3461,1,4
120883,3877,1859,2018,2,1
120883,3869,1854,2015,3,1
120883,958,452,506,4,1
120883,2911,1402,1509,5,1
120883,8,5,3,11,1
120883,2544,1101,1443,12,3
120883,178,86,92,19,1
120883,2733,1316,1417,20,1
120883,5749,2671,3078,21,4
120883,3780,1811,1969,22,1
120883,3777,1809,1968,23,1
120883,958,452,506,24,1
120883,2819,1357,1462,25,1
120883,3,2,1,31,1
120883,1969,860,1109,32,3
120883,173,84,89,39,1
120883,2646,1273,1373,40,1
120883,672,289,383,41,4
120883,97,48,49,42,1
120883,92,45,47,43,1
120883,92,45,47,45,1
120883,5,3,2,51,1
120883,575,241,334,52,3
120883,5,2,3,59,1
120883,87,43,44,60,1
120953,3253,2494,759,1,4
120953,3253,2494,759,2,1
120953,2946,2297,649,3,1
120953,731,516,215,4,1
120953,2215,1781,434,5,1
120953,307,197,110,11,1
120953,193,158,35,19,1
120953,2022,1623,399,20,1
120953,424,209,215,21,4
120953,424,209,215,22,1
120953,398,196,202,23,1
120953,62,23,39,24,1
120953,336,173,163,25,1
120953,26,13,13,31,1
120953,8,3,5,39,1
120953,328,170,158,40,1
120953,2829,2285,544,41,4
120953,2829,2285,544,42,1
120953,2548,2101,447,43,1
120953,669,493,176,44,1
120953,1879,1608,271,45,1
120953,281,184,97,51,1
120953,185,155,30,59,1
120953,1694,1453,241,60,1
120971,24665,13773,10892,1,4
120971,24665,13773,10892,2,1
120971,22535,12708,9827,3,1
120971,4166,2410,1756,4,1
120971,18369,10298,8071,5,1
120971,2130,1065,1065,11,1
120971,1805,999,806,19,1
120971,16564,9299,7265,20,1
120971,8252,4647,3605,21,4
120971,8252,4647,3605,22,1
120971,8107,4566,3541,23,1
120971,2029,1127,902,24,1
120971,6078,3439,2639,25,1
120971,145,81,64,31,1
120971,520,310,210,39,1
120971,5558,3129,2429,40,1
120971,16413,9126,7287,41,4
120971,16413,9126,7287,42,1
120971,14428,8142,6286,43,1
120971,2137,1283,854,44,1
120971,12291,6859,5432,45,1
120971,1985,984,1001,51,1
120971,1285,689,596,59,1
120971,11006,6170,4836,60,1
121017,99,4,95,1,4
121017,99,4,95,2,1
121017,99,4,95,3,1
121017,44,0,44,4,1
121017,55,4,51,5,1
121017,55,4,51,20,1
121017,28,1,27,21,4
121017,28,1,27,22,1
121017,28,1,27,23,1
121017,13,0,13,24,1
121017,15,1,14,25,1
121017,15,1,14,40,1
121017,71,3,68,41,4
121017,71,3,68,42,1
121017,71,3,68,43,1
121017,31,0,31,44,1
121017,40,3,37,45,1
121017,40,3,37,60,1
121044,25268,12172,13096,1,4
121044,25268,12172,13096,2,1
121044,23437,11223,12214,3,1
121044,6090,3006,3084,4,1
121044,17347,8217,9130,5,1
121044,1831,949,882,11,1
121044,1688,761,927,19,1
121044,15659,7456,8203,20,1
121044,9463,4732,4731,21,4
121044,9463,4732,4731,22,1
121044,9358,4674,4684,23,1
121044,3343,1682,1661,24,1
121044,6015,2992,3023,25,1
121044,105,58,47,31,1
121044,379,199,180,39,1
121044,5636,2793,2843,40,1
121044,15805,7440,8365,41,4
121044,15805,7440,8365,42,1
121044,14079,6549,7530,43,1
121044,2747,1324,1423,44,1
121044,11332,5225,6107,45,1
121044,1726,891,835,51,1
121044,1309,562,747,59,1
121044,10023,4663,5360,60,1
121150,7315,2925,4390,1,4
121150,3538,1463,2075,2,1
121150,3516,1449,2067,3,1
121150,784,309,475,4,1
121150,2732,1140,1592,5,1
121150,22,14,8,11,1
121150,3777,1462,2315,12,3
121150,162,74,88,19,1
121150,2570,1066,1504,20,1
121150,5414,2187,3227,21,4
121150,3172,1270,1902,22,1
121150,3165,1265,1900,23,1
121150,783,308,475,24,1
121150,2382,957,1425,25,1
121150,7,5,2,31,1
121150,2242,917,1325,32,3
121150,116,50,66,39,1
121150,2266,907,1359,40,1
121150,1901,738,1163,41,4
121150,366,193,173,42,1
121150,351,184,167,43,1
121150,1,1,0,44,1
121150,350,183,167,45,1
121150,15,9,6,51,1
121150,1535,545,990,52,3
121150,46,24,22,59,1
121150,304,159,145,60,1
121257,1081,433,648,1,4
121257,1081,433,648,2,1
121257,1081,433,648,3,1
121257,265,118,147,4,1
121257,816,315,501,5,1
121257,26,14,12,19,1
121257,790,301,489,20,1
121257,1044,417,627,21,4
121257,1044,417,627,22,1
121257,1044,417,627,23,1
121257,265,118,147,24,1
121257,779,299,480,25,1
121257,23,12,11,39,1
121257,756,287,469,40,1
121257,37,16,21,41,4
121257,37,16,21,42,1
121257,37,16,21,43,1
121257,37,16,21,45,1
121257,3,2,1,59,1
121257,34,14,20,60,1
121275,370,272,98,1,4
121275,370,272,98,2,1
121275,369,271,98,3,1
121275,72,49,23,4,1
121275,297,222,75,5,1
121275,1,1,0,11,1
121275,297,222,75,20,1
121275,370,272,98,21,4
121275,370,272,98,22,1
121275,369,271,98,23,1
121275,72,49,23,24,1
121275,297,222,75,25,1
121275,1,1,0,31,1
121275,297,222,75,40,1
121309,3359,1185,2174,1,4
121309,2556,957,1599,2,1
121309,2543,954,1589,3,1
121309,647,226,421,4,1
121309,1896,728,1168,5,1
121309,13,3,10,11,1
121309,803,228,575,12,3
121309,144,73,71,19,1
121309,1752,655,1097,20,1
121309,2669,981,1688,21,4
121309,2483,924,1559,22,1
121309,2482,924,1558,23,1
121309,645,225,420,24,1
121309,1837,699,1138,25,1
121309,1,0,1,31,1
121309,186,57,129,32,3
121309,140,69,71,39,1
121309,1697,630,1067,40,1
121309,690,204,486,41,4
121309,73,33,40,42,1
121309,61,30,31,43,1
121309,2,1,1,44,1
121309,59,29,30,45,1
121309,12,3,9,51,1
121309,617,171,446,52,3
121309,4,4,0,59,1
121309,55,25,30,60,1
121345,1610,773,837,1,4
121345,1610,773,837,2,1
121345,1587,762,825,3,1
121345,397,188,209,4,1
121345,1190,574,616,5,1
121345,23,11,12,11,1
121345,13,7,6,19,1
121345,1177,567,610,20,1
121345,1596,766,830,21,4
121345,1596,766,830,22,1
121345,1583,761,822,23,1
121345,396,188,208,24,1
121345,1187,573,614,25,1
121345,13,5,8,31,1
121345,13,7,6,39,1
121345,1174,566,608,40,1
121345,14,7,7,41,4
121345,14,7,7,42,1
121345,4,1,3,43,1
121345,1,0,1,44,1
121345,3,1,2,45,1
121345,10,6,4,51,1
121345,3,1,2,60,1
121363,3810,1486,2324,1,4
121363,3810,1486,2324,2,1
121363,3339,1323,2016,3,1
121363,678,335,343,4,1
121363,2661,988,1673,5,1
121363,471,163,308,11,1
121363,184,76,108,19,1
121363,2477,912,1565,20,1
121363,1662,711,951,21,4
121363,1662,711,951,22,1
121363,1600,686,914,23,1
121363,433,207,226,24,1
121363,1167,479,688,25,1
121363,62,25,37,31,1
121363,66,37,29,39,1
121363,1101,442,659,40,1
121363,2148,775,1373,41,4
121363,2148,775,1373,42,1
121363,1739,637,1102,43,1
121363,245,128,117,44,1
121363,1494,509,985,45,1
121363,409,138,271,51,1
121363,118,39,79,59,1
121363,1376,470,906,60,1
121381,571,253,318,1,4
121381,571,253,318,2,1
121381,571,253,318,3,1
121381,51,19,32,4,1
121381,520,234,286,5,1
121381,520,234,286,20,1
121381,459,199,260,21,4
121381,459,199,260,22,1
121381,459,199,260,23,1
121381,49,17,32,24,1
121381,410,182,228,25,1
121381,410,182,228,40,1
121381,112,54,58,41,4
121381,112,54,58,42,1
121381,112,54,58,43,1
121381,2,2,0,44,1
121381,110,52,58,45,1
121381,110,52,58,60,1
121433,108,7,101,1,4
121433,108,7,101,2,1
121433,108,7,101,3,1
121433,15,0,15,4,1
121433,93,7,86,5,1
121433,93,7,86,20,1
121433,108,7,101,21,4
121433,108,7,101,22,1
121433,108,7,101,23,1
121433,15,0,15,24,1
121433,93,7,86,25,1
121433,93,7,86,40,1
121619,28598,18484,10114,1,4
121619,28598,18484,10114,2,1
121619,25559,16788,8771,3,1
121619,3936,2282,1654,4,1
121619,21623,14506,7117,5,1
121619,3039,1696,1343,11,1
121619,1968,1139,829,19,1
121619,19655,13367,6288,20,1
121619,3435,1814,1621,21,4
121619,3435,1814,1621,22,1
121619,3383,1790,1593,23,1
121619,1011,502,509,24,1
121619,2372,1288,1084,25,1
121619,52,24,28,31,1
121619,194,124,70,39,1
121619,2178,1164,1014,40,1
121619,25163,16670,8493,41,4
121619,25163,16670,8493,42,1
121619,22176,14998,7178,43,1
121619,2925,1780,1145,44,1
121619,19251,13218,6033,45,1
121619,2987,1672,1315,51,1
121619,1774,1015,759,59,1
121619,17477,12203,5274,60,1
121628,102,54,48,1,4
121628,102,54,48,12,3
121628,102,54,48,21,4
121628,102,54,48,32,3
121637,71,3,68,1,4
121637,71,3,68,2,1
121637,71,3,68,3,1
121637,15,0,15,4,1
121637,56,3,53,5,1
121637,56,3,53,20,1
121637,71,3,68,21,4
121637,71,3,68,22,1
121637,71,3,68,23,1
121637,15,0,15,24,1
121637,56,3,53,25,1
121637,56,3,53,40,1
121691,5147,2342,2805,1,4
121691,3607,1615,1992,2,1
121691,3462,1541,1921,3,1
121691,663,290,373,4,1
121691,2799,1251,1548,5,1
121691,145,74,71,11,1
121691,1540,727,813,12,3
121691,197,98,99,19,1
121691,2602,1153,1449,20,1
121691,3907,1730,2177,21,4
121691,2702,1162,1540,22,1
121691,2694,1159,1535,23,1
121691,662,290,372,24,1
121691,2032,869,1163,25,1
121691,8,3,5,31,1
121691,1205,568,637,32,3
121691,98,49,49,39,1
121691,1934,820,1114,40,1
121691,1240,612,628,41,4
121691,905,453,452,42,1
121691,768,382,386,43,1
121691,1,0,1,44,1
121691,767,382,385,45,1
121691,137,71,66,51,1
121691,335,159,176,52,3
121691,99,49,50,59,1
121691,668,333,335,60,1
121707,4938,2170,2768,1,4
121707,4938,2170,2768,2,1
121707,2585,1158,1427,3,1
121707,582,305,277,4,1
121707,2003,853,1150,5,1
121707,2353,1012,1341,11,1
121707,273,139,134,19,1
121707,1730,714,1016,20,1
121707,1901,931,970,21,4
121707,1901,931,970,22,1
121707,1112,540,572,23,1
121707,310,159,151,24,1
121707,802,381,421,25,1
121707,789,391,398,31,1
121707,137,86,51,39,1
121707,665,295,370,40,1
121707,3037,1239,1798,41,4
121707,3037,1239,1798,42,1
121707,1473,618,855,43,1
121707,272,146,126,44,1
121707,1201,472,729,45,1
121707,1564,621,943,51,1
121707,136,53,83,59,1
121707,1065,419,646,60,1
121859,228,9,219,1,4
121859,228,9,219,2,1
121859,228,9,219,3,1
121859,75,1,74,4,1
121859,153,8,145,5,1
121859,153,8,145,20,1
121859,156,7,149,21,4
121859,156,7,149,22,1
121859,156,7,149,23,1
121859,41,0,41,24,1
121859,115,7,108,25,1
121859,115,7,108,40,1
121859,72,2,70,41,4
121859,72,2,70,42,1
121859,72,2,70,43,1
121859,34,1,33,44,1
121859,38,1,37,45,1
121859,38,1,37,60,1
121868,129,3,126,1,4
121868,129,3,126,2,1
121868,129,3,126,3,1
121868,47,2,45,4,1
121868,82,1,81,5,1
121868,82,1,81,20,1
121868,128,3,125,21,4
121868,128,3,125,22,1
121868,128,3,125,23,1
121868,46,2,44,24,1
121868,82,1,81,25,1
121868,82,1,81,40,1
121868,1,0,1,41,4
121868,1,0,1,42,1
121868,1,0,1,43,1
121868,1,0,1,44,1
121886,16548,8911,7637,1,4
121886,16548,8911,7637,2,1
121886,14709,8047,6662,3,1
121886,2638,1536,1102,4,1
121886,12071,6511,5560,5,1
121886,1839,864,975,11,1
121886,1181,722,459,19,1
121886,10890,5789,5101,20,1
121886,4389,2227,2162,21,4
121886,4389,2227,2162,22,1
121886,4284,2169,2115,23,1
121886,966,503,463,24,1
121886,3318,1666,1652,25,1
121886,105,58,47,31,1
121886,233,124,109,39,1
121886,3085,1542,1543,40,1
121886,12159,6684,5475,41,4
121886,12159,6684,5475,42,1
121886,10425,5878,4547,43,1
121886,1672,1033,639,44,1
121886,8753,4845,3908,45,1
121886,1734,806,928,51,1
121886,948,598,350,59,1
121886,7805,4247,3558,60,1
121901,18165,8017,10148,1,4
121901,18165,8017,10148,2,1
121901,16243,7160,9083,3,1
121901,3265,1543,1722,4,1
121901,12978,5617,7361,5,1
121901,1922,857,1065,11,1
121901,1424,590,834,19,1
121901,11554,5027,6527,20,1
121901,4863,2267,2596,21,4
121901,4863,2267,2596,22,1
121901,4748,2213,2535,23,1
121901,1415,671,744,24,1
121901,3333,1542,1791,25,1
121901,115,54,61,31,1
121901,269,123,146,39,1
121901,3064,1419,1645,40,1
121901,13302,5750,7552,41,4
121901,13302,5750,7552,42,1
121901,11495,4947,6548,43,1
121901,1850,872,978,44,1
121901,9645,4075,5570,45,1
121901,1807,803,1004,51,1
121901,1155,467,688,59,1
121901,8490,3608,4882,60,1
121983,559,152,407,1,4
121983,171,48,123,2,1
121983,168,47,121,3,1
121983,7,4,3,4,1
121983,161,43,118,5,1
121983,3,1,2,11,1
121983,388,104,284,12,3
121983,34,12,22,19,1
121983,127,31,96,20,1
121983,114,31,83,21,4
121983,27,8,19,22,1
121983,25,8,17,23,1
121983,25,8,17,25,1
121983,2,0,2,31,1
121983,87,23,64,32,3
121983,7,3,4,39,1
121983,18,5,13,40,1
121983,445,121,324,41,4
121983,144,40,104,42,1
121983,143,39,104,43,1
121983,7,4,3,44,1
121983,136,35,101,45,1
121983,1,1,0,51,1
121983,301,81,220,52,3
121983,27,9,18,59,1
121983,109,26,83,60,1
121992,210,42,168,1,4
121992,210,42,168,2,1
121992,210,42,168,3,1
121992,203,41,162,4,1
121992,7,1,6,5,1
121992,7,1,6,20,1
121992,175,35,140,21,4
121992,175,35,140,22,1
121992,175,35,140,23,1
121992,171,34,137,24,1
121992,4,1,3,25,1
121992,4,1,3,40,1
121992,35,7,28,41,4
121992,35,7,28,42,1
121992,35,7,28,43,1
121992,32,7,25,44,1
121992,3,0,3,45,1
121992,3,0,3,60,1
122117,179,72,107,1,4
122117,9,2,7,2,1
122117,9,2,7,3,1
122117,9,2,7,5,1
122117,170,70,100,12,3
122117,9,2,7,20,1
122117,123,44,79,21,4
122117,8,2,6,22,1
122117,8,2,6,23,1
122117,8,2,6,25,1
122117,115,42,73,32,3
122117,8,2,6,40,1
122117,56,28,28,41,4
122117,1,0,1,42,1
122117,1,0,1,43,1
122117,1,0,1,45,1
122117,55,28,27,52,3
122117,1,0,1,60,1
122180,23509,10309,13200,1,4
122180,23509,10309,13200,2,1
122180,21765,9604,12161,3,1
122180,4645,2031,2614,4,1
122180,17120,7573,9547,5,1
122180,1744,705,1039,11,1
122180,2422,1060,1362,19,1
122180,14698,6513,8185,20,1
122180,6144,2911,3233,21,4
122180,6144,2911,3233,22,1
122180,5969,2843,3126,23,1
122180,1271,625,646,24,1
122180,4698,2218,2480,25,1
122180,175,68,107,31,1
122180,448,219,229,39,1
122180,4250,1999,2251,40,1
122180,17365,7398,9967,41,4
122180,17365,7398,9967,42,1
122180,15796,6761,9035,43,1
122180,3374,1406,1968,44,1
122180,12422,5355,7067,45,1
122180,1569,637,932,51,1
122180,1974,841,1133,59,1
122180,10448,4514,5934,60,1
122205,20871,9593,11278,1,4
122205,20871,9593,11278,2,1
122205,19229,8817,10412,3,1
122205,3394,1752,1642,4,1
122205,15835,7065,8770,5,1
122205,1642,776,866,11,1
122205,1704,712,992,19,1
122205,14131,6353,7778,20,1
122205,6334,3308,3026,21,4
122205,6334,3308,3026,22,1
122205,6239,3252,2987,23,1
122205,1596,842,754,24,1
122205,4643,2410,2233,25,1
122205,95,56,39,31,1
122205,384,195,189,39,1
122205,4259,2215,2044,40,1
122205,14537,6285,8252,41,4
122205,14537,6285,8252,42,1
122205,12990,5565,7425,43,1
122205,1798,910,888,44,1
122205,11192,4655,6537,45,1
122205,1547,720,827,51,1
122205,1320,517,803,59,1
122205,9872,4138,5734,60,1
122250,92,92,0,1,4
122250,3,3,0,2,1
122250,3,3,0,3,1
122250,3,3,0,5,1
122250,89,89,0,12,3
122250,3,3,0,20,1
122250,92,92,0,21,4
122250,3,3,0,22,1
122250,3,3,0,23,1
122250,3,3,0,25,1
122250,89,89,0,32,3
122250,3,3,0,40,1
122296,1542,385,1157,1,4
122296,589,91,498,2,1
122296,506,75,431,3,1
122296,506,75,431,5,1
122296,83,16,67,11,1
122296,953,294,659,12,3
122296,110,16,94,19,1
122296,396,59,337,20,1
122296,1172,301,871,21,4
122296,494,74,420,22,1
122296,492,73,419,23,1
122296,492,73,419,25,1
122296,2,1,1,31,1
122296,678,227,451,32,3
122296,110,16,94,39,1
122296,382,57,325,40,1
122296,370,84,286,41,4
122296,95,17,78,42,1
122296,14,2,12,43,1
122296,14,2,12,45,1
122296,81,15,66,51,1
122296,275,67,208,52,3
122296,14,2,12,60,1
122339,16310,7722,8588,1,4
122339,16310,7722,8588,2,1
122339,14054,6711,7343,3,1
122339,2220,1115,1105,4,1
122339,11834,5596,6238,5,1
122339,2256,1011,1245,11,1
122339,2310,1149,1161,19,1
122339,9524,4447,5077,20,1
122339,3828,1714,2114,21,4
122339,3828,1714,2114,22,1
122339,3676,1651,2025,23,1
122339,866,405,461,24,1
122339,2810,1246,1564,25,1
122339,152,63,89,31,1
122339,332,178,154,39,1
122339,2478,1068,1410,40,1
122339,12482,6008,6474,41,4
122339,12482,6008,6474,42,1
122339,10378,5060,5318,43,1
122339,1354,710,644,44,1
122339,9024,4350,4674,45,1
122339,2104,948,1156,51,1
122339,1978,971,1007,59,1
122339,7046,3379,3667,60,1
122366,230,224,6,1,4
122366,230,224,6,2,1
122366,230,224,6,3,1
122366,80,78,2,4,1
122366,150,146,4,5,1
122366,150,146,4,20,1
122366,215,210,5,21,4
122366,215,210,5,22,1
122366,215,210,5,23,1
122366,76,75,1,24,1
122366,139,135,4,25,1
122366,139,135,4,40,1
122366,15,14,1,41,4
122366,15,14,1,42,1
122366,15,14,1,43,1
122366,4,3,1,44,1
122366,11,11,0,45,1
122366,11,11,0,60,1
122375,24251,11692,12559,1,4
122375,24251,11692,12559,2,1
122375,21314,10265,11049,3,1
122375,3690,1897,1793,4,1
122375,17624,8368,9256,5,1
122375,2937,1427,1510,11,1
122375,3259,1512,1747,19,1
122375,14365,6856,7509,20,1
122375,6409,3396,3013,21,4
122375,6409,3396,3013,22,1
122375,6279,3322,2957,23,1
122375,1412,730,682,24,1
122375,4867,2592,2275,25,1
122375,130,74,56,31,1
122375,661,353,308,39,1
122375,4206,2239,1967,40,1
122375,17842,8296,9546,41,4
122375,17842,8296,9546,42,1
122375,15035,6943,8092,43,1
122375,2278,1167,1111,44,1
122375,12757,5776,6981,45,1
122375,2807,1353,1454,51,1
122375,2598,1159,1439,59,1
122375,10159,4617,5542,60,1
122384,11891,6587,5304,1,4
122384,11891,6587,5304,2,1
122384,10709,5999,4710,3,1
122384,1687,941,746,4,1
122384,9022,5058,3964,5,1
122384,1182,588,594,11,1
122384,1950,993,957,19,1
122384,7072,4065,3007,20,1
122384,2271,1359,912,21,4
122384,2271,1359,912,22,1
122384,2195,1324,871,23,1
122384,600,346,254,24,1
122384,1595,978,617,25,1
122384,76,35,41,31,1
122384,279,189,90,39,1
122384,1316,789,527,40,1
122384,9620,5228,4392,41,4
122384,9620,5228,4392,42,1
122384,8514,4675,3839,43,1
122384,1087,595,492,44,1
122384,7427,4080,3347,45,1
122384,1106,553,553,51,1
122384,1671,804,867,59,1
122384,5756,3276,2480,60,1
122409,31899,14160,17739,1,4
122409,27099,12246,14853,2,1
122409,26625,12011,14614,3,1
122409,4671,2055,2616,4,1
122409,21954,9956,11998,5,1
122409,474,235,239,11,1
122409,4800,1914,2886,12,3
122409,3431,1638,1793,19,1
122409,18523,8318,10205,20,1
122409,26859,11818,15041,21,4
122409,24037,10764,13273,22,1
122409,23839,10681,13158,23,1
122409,4432,1937,2495,24,1
122409,19407,8744,10663,25,1
122409,198,83,115,31,1
122409,2822,1054,1768,32,3
122409,2998,1452,1546,39,1
122409,16409,7292,9117,40,1
122409,5040,2342,2698,41,4
122409,3062,1482,1580,42,1
122409,2786,1330,1456,43,1
122409,239,118,121,44,1
122409,2547,1212,1335,45,1
122409,276,152,124,51,1
122409,1978,860,1118,52,3
122409,433,186,247,59,1
122409,2114,1026,1088,60,1
122436,8321,3575,4746,1,4
122436,5665,2548,3117,2,1
122436,5573,2501,3072,3,1
122436,1238,493,745,4,1
122436,4335,2008,2327,5,1
122436,92,47,45,11,1
122436,2656,1027,1629,12,3
122436,319,166,153,19,1
122436,4016,1842,2174,20,1
122436,7066,3063,4003,21,4
122436,5486,2459,3027,22,1
122436,5430,2428,3002,23,1
122436,1238,493,745,24,1
122436,4192,1935,2257,25,1
122436,56,31,25,31,1
122436,1580,604,976,32,3
122436,306,158,148,39,1
122436,3886,1777,2109,40,1
122436,1255,512,743,41,4
122436,179,89,90,42,1
122436,143,73,70,43,1
122436,143,73,70,45,1
122436,36,16,20,51,1
122436,1076,423,653,52,3
122436,13,8,5,59,1
122436,130,65,65,60,1
122454,680,284,396,1,4
122454,478,206,272,2,1
122454,468,203,265,3,1
122454,72,27,45,4,1
122454,396,176,220,5,1
122454,10,3,7,11,1
122454,202,78,124,12,3
122454,88,41,47,19,1
122454,308,135,173,20,1
122454,622,268,354,21,4
122454,444,195,249,22,1
122454,440,194,246,23,1
122454,72,27,45,24,1
122454,368,167,201,25,1
122454,4,1,3,31,1
122454,178,73,105,32,3
122454,83,39,44,39,1
122454,285,128,157,40,1
122454,58,16,42,41,4
122454,34,11,23,42,1
122454,28,9,19,43,1
122454,28,9,19,45,1
122454,6,2,4,51,1
122454,24,5,19,52,3
122454,5,2,3,59,1
122454,23,7,16,60,1
122506,399,185,214,1,4
122506,174,88,86,2,1
122506,172,87,85,3,1
122506,33,15,18,4,1
122506,139,72,67,5,1
122506,2,1,1,11,1
122506,225,97,128,12,3
122506,15,7,8,19,1
122506,124,65,59,20,1
122506,396,183,213,21,4
122506,171,86,85,22,1
122506,171,86,85,23,1
122506,33,15,18,24,1
122506,138,71,67,25,1
122506,225,97,128,32,3
122506,15,7,8,39,1
122506,123,64,59,40,1
122506,3,2,1,41,4
122506,3,2,1,42,1
122506,1,1,0,43,1
122506,1,1,0,45,1
122506,2,1,1,51,1
122506,1,1,0,60,1
122597,29905,12709,17196,1,4
122597,26156,11350,14806,2,1
122597,25271,11012,14259,3,1
122597,3612,1384,2228,4,1
122597,21659,9628,12031,5,1
122597,885,338,547,11,1
122597,3749,1359,2390,12,3
122597,3766,1775,1991,19,1
122597,17893,7853,10040,20,1
122597,24422,10200,14222,21,4
122597,22111,9399,12712,22,1
122597,21836,9300,12536,23,1
122597,3550,1343,2207,24,1
122597,18286,7957,10329,25,1
122597,275,99,176,31,1
122597,2311,801,1510,32,3
122597,3112,1455,1657,39,1
122597,15174,6502,8672,40,1
122597,5483,2509,2974,41,4
122597,4045,1951,2094,42,1
122597,3435,1712,1723,43,1
122597,62,41,21,44,1
122597,3373,1671,1702,45,1
122597,610,239,371,51,1
122597,1438,558,880,52,3
122597,654,320,334,59,1
122597,2719,1351,1368,60,1
122603,167,94,73,1,4
122603,167,94,73,12,3
122603,69,39,30,21,4
122603,69,39,30,32,3
122603,98,55,43,41,4
122603,98,55,43,52,3
122612,10112,3752,6360,1,4
122612,6392,2434,3958,2,1
122612,6308,2394,3914,3,1
122612,1148,415,733,4,1
122612,5160,1979,3181,5,1
122612,84,40,44,11,1
122612,3720,1318,2402,12,3
122612,517,222,295,19,1
122612,4643,1757,2886,20,1
122612,9255,3443,5812,21,4
122612,6111,2306,3805,22,1
122612,6074,2299,3775,23,1
122612,1146,413,733,24,1
122612,4928,1886,3042,25,1
122612,37,7,30,31,1
122612,3144,1137,2007,32,3
122612,491,213,278,39,1
122612,4437,1673,2764,40,1
122612,857,309,548,41,4
122612,281,128,153,42,1
122612,234,95,139,43,1
122612,2,2,0,44,1
122612,232,93,139,45,1
122612,47,33,14,51,1
122612,576,181,395,52,3
122612,26,9,17,59,1
122612,206,84,122,60,1
122649,194,103,91,1,4
122649,194,103,91,12,3
122649,44,22,22,21,4
122649,44,22,22,32,3
122649,150,81,69,41,4
122649,150,81,69,52,3
122658,17629,7543,10086,1,4
122658,17629,7543,10086,2,1
122658,15393,6617,8776,3,1
122658,2899,1416,1483,4,1
122658,12494,5201,7293,5,1
122658,2236,926,1310,11,1
122658,783,311,472,19,1
122658,11711,4890,6821,20,1
122658,7062,3215,3847,21,4
122658,7062,3215,3847,22,1
122658,6791,3102,3689,23,1
122658,1683,816,867,24,1
122658,5108,2286,2822,25,1
122658,271,113,158,31,1
122658,284,119,165,39,1
122658,4824,2167,2657,40,1
122658,10567,4328,6239,41,4
122658,10567,4328,6239,42,1
122658,8602,3515,5087,43,1
122658,1216,600,616,44,1
122658,7386,2915,4471,45,1
122658,1965,813,1152,51,1
122658,499,192,307,59,1
122658,6887,2723,4164,60,1
122685,1616,361,1255,1,4
122685,1616,361,1255,2,1
122685,1616,361,1255,3,1
122685,148,34,114,4,1
122685,1468,327,1141,5,1
122685,170,48,122,19,1
122685,1298,279,1019,20,1
122685,1616,361,1255,21,4
122685,1616,361,1255,22,1
122685,1616,361,1255,23,1
122685,148,34,114,24,1
122685,1468,327,1141,25,1
122685,170,48,122,39,1
122685,1298,279,1019,40,1
122694,642,180,462,1,4
122694,642,180,462,2,1
122694,642,180,462,3,1
122694,62,19,43,4,1
122694,580,161,419,5,1
122694,54,13,41,19,1
122694,526,148,378,20,1
122694,642,180,462,21,4
122694,642,180,462,22,1
122694,642,180,462,23,1
122694,62,19,43,24,1
122694,580,161,419,25,1
122694,54,13,41,39,1
122694,526,148,378,40,1
122728,1095,426,669,1,4
122728,1047,420,627,2,1
122728,1029,410,619,3,1
122728,165,59,106,4,1
122728,864,351,513,5,1
122728,18,10,8,11,1
122728,48,6,42,12,3
122728,188,77,111,19,1
122728,676,274,402,20,1
122728,859,323,536,21,4
122728,837,321,516,22,1
122728,837,321,516,23,1
122728,160,58,102,24,1
122728,677,263,414,25,1
122728,22,2,20,32,3
122728,154,61,93,39,1
122728,523,202,321,40,1
122728,236,103,133,41,4
122728,210,99,111,42,1
122728,192,89,103,43,1
122728,5,1,4,44,1
122728,187,88,99,45,1
122728,18,10,8,51,1
122728,26,4,22,52,3
122728,34,16,18,59,1
122728,153,72,81,60,1
122746,9446,4244,5202,1,4
122746,9446,4244,5202,2,1
122746,7960,3602,4358,3,1
122746,1078,499,579,4,1
122746,6882,3103,3779,5,1
122746,1486,642,844,11,1
122746,1229,572,657,19,1
122746,5653,2531,3122,20,1
122746,2432,1145,1287,21,4
122746,2432,1145,1287,22,1
122746,2284,1076,1208,23,1
122746,521,253,268,24,1
122746,1763,823,940,25,1
122746,148,69,79,31,1
122746,254,114,140,39,1
122746,1509,709,800,40,1
122746,7014,3099,3915,41,4
122746,7014,3099,3915,42,1
122746,5676,2526,3150,43,1
122746,557,246,311,44,1
122746,5119,2280,2839,45,1
122746,1338,573,765,51,1
122746,975,458,517,59,1
122746,4144,1822,2322,60,1
122755,31278,15413,15865,1,4
122755,25862,13208,12654,2,1
122755,25723,13154,12569,3,1
122755,3736,1991,1745,4,1
122755,21987,11163,10824,5,1
122755,139,54,85,11,1
122755,5416,2205,3211,12,3
122755,3766,1876,1890,19,1
122755,18221,9287,8934,20,1
122755,24196,11971,12225,21,4
122755,20852,10628,10224,22,1
122755,20772,10601,10171,23,1
122755,3644,1943,1701,24,1
122755,17128,8658,8470,25,1
122755,80,27,53,31,1
122755,3344,1343,2001,32,3
122755,2569,1279,1290,39,1
122755,14559,7379,7180,40,1
122755,7082,3442,3640,41,4
122755,5010,2580,2430,42,1
122755,4951,2553,2398,43,1
122755,92,48,44,44,1
122755,4859,2505,2354,45,1
122755,59,27,32,51,1
122755,2072,862,1210,52,3
122755,1197,597,600,59,1
122755,3662,1908,1754,60,1
122791,9377,4818,4559,1,4
122791,9377,4818,4559,2,1
122791,8378,4350,4028,3,1
122791,1650,891,759,4,1
122791,6728,3459,3269,5,1
122791,999,468,531,11,1
122791,1128,579,549,19,1
122791,5600,2880,2720,20,1
122791,2521,1363,1158,21,4
122791,2521,1363,1158,22,1
122791,2479,1343,1136,23,1
122791,838,451,387,24,1
122791,1641,892,749,25,1
122791,42,20,22,31,1
122791,185,110,75,39,1
122791,1456,782,674,40,1
122791,6856,3455,3401,41,4
122791,6856,3455,3401,42,1
122791,5899,3007,2892,43,1
122791,812,440,372,44,1
122791,5087,2567,2520,45,1
122791,957,448,509,51,1
122791,943,469,474,59,1
122791,4144,2098,2046,60,1
122834,543,173,370,1,4
122834,543,173,370,2,1
122834,543,173,370,3,1
122834,63,17,46,4,1
122834,480,156,324,5,1
122834,220,59,161,19,1
122834,260,97,163,20,1
122834,543,173,370,21,4
122834,543,173,370,22,1
122834,543,173,370,23,1
122834,63,17,46,24,1
122834,480,156,324,25,1
122834,220,59,161,39,1
122834,260,97,163,40,1
122843,672,336,336,1,4
122843,661,333,328,2,1
122843,661,333,328,3,1
122843,60,25,35,4,1
122843,601,308,293,5,1
122843,11,3,8,12,3
122843,1,1,0,19,1
122843,600,307,293,20,1
122843,496,239,257,21,4
122843,494,239,255,22,1
122843,494,239,255,23,1
122843,59,25,34,24,1
122843,435,214,221,25,1
122843,2,0,2,32,3
122843,1,1,0,39,1
122843,434,213,221,40,1
122843,176,97,79,41,4
122843,167,94,73,42,1
122843,167,94,73,43,1
122843,1,0,1,44,1
122843,166,94,72,45,1
122843,9,3,6,52,3
122843,166,94,72,60,1
122852,188,28,160,1,4
122852,188,28,160,2,1
122852,188,28,160,3,1
122852,19,4,15,4,1
122852,169,24,145,5,1
122852,95,11,84,19,1
122852,74,13,61,20,1
122852,188,28,160,21,4
122852,188,28,160,22,1
122852,188,28,160,23,1
122852,19,4,15,24,1
122852,169,24,145,25,1
122852,95,11,84,39,1
122852,74,13,61,40,1
122889,19331,8964,10367,1,4
122889,19331,8964,10367,2,1
122889,16042,7382,8660,3,1
122889,3460,1628,1832,4,1
122889,12582,5754,6828,5,1
122889,3289,1582,1707,11,1
122889,1315,564,751,19,1
122889,11267,5190,6077,20,1
122889,8516,4293,4223,21,4
122889,8516,4293,4223,22,1
122889,8242,4131,4111,23,1
122889,2366,1136,1230,24,1
122889,5876,2995,2881,25,1
122889,274,162,112,31,1
122889,500,279,221,39,1
122889,5376,2716,2660,40,1
122889,10815,4671,6144,41,4
122889,10815,4671,6144,42,1
122889,7800,3251,4549,43,1
122889,1094,492,602,44,1
122889,6706,2759,3947,45,1
122889,3015,1420,1595,51,1
122889,815,285,530,59,1
122889,5891,2474,3417,60,1
122931,8770,4479,4291,1,4
122931,5435,2724,2711,2,1
122931,5404,2711,2693,3,1
122931,1291,632,659,4,1
122931,4113,2079,2034,5,1
122931,31,13,18,11,1
122931,3335,1755,1580,12,3
122931,146,53,93,19,1
122931,3967,2026,1941,20,1
122931,7225,3624,3601,21,4
122931,5338,2673,2665,22,1
122931,5314,2666,2648,23,1
122931,1291,632,659,24,1
122931,4023,2034,1989,25,1
122931,24,7,17,31,1
122931,1887,951,936,32,3
122931,144,53,91,39,1
122931,3879,1981,1898,40,1
122931,1545,855,690,41,4
122931,97,51,46,42,1
122931,90,45,45,43,1
122931,90,45,45,45,1
122931,7,6,1,51,1
122931,1448,804,644,52,3
122931,2,0,2,59,1
122931,88,45,43,60,1
122977,29999,14306,15693,1,4
122977,29999,14306,15693,2,1
122977,27747,13164,14583,3,1
122977,6128,3043,3085,4,1
122977,21619,10121,11498,5,1
122977,2252,1142,1110,11,1
122977,1881,853,1028,19,1
122977,19738,9268,10470,20,1
122977,10720,5414,5306,21,4
122977,10720,5414,5306,22,1
122977,10548,5313,5235,23,1
122977,3102,1558,1544,24,1
122977,7446,3755,3691,25,1
122977,172,101,71,31,1
122977,444,231,213,39,1
122977,7002,3524,3478,40,1
122977,19279,8892,10387,41,4
122977,19279,8892,10387,42,1
122977,17199,7851,9348,43,1
122977,3026,1485,1541,44,1
122977,14173,6366,7807,45,1
122977,2080,1041,1039,51,1
122977,1437,622,815,59,1
122977,12736,5744,6992,60,1
123013,22094,10069,12025,1,4
123013,22094,10069,12025,2,1
123013,19533,8924,10609,3,1
123013,2866,1460,1406,4,1
123013,16667,7464,9203,5,1
123013,2561,1145,1416,11,1
123013,1074,552,522,19,1
123013,15593,6912,8681,20,1
123013,6712,3239,3473,21,4
123013,6712,3239,3473,22,1
123013,6572,3179,3393,23,1
123013,1395,685,710,24,1
123013,5177,2494,2683,25,1
123013,140,60,80,31,1
123013,297,166,131,39,1
123013,4880,2328,2552,40,1
123013,15382,6830,8552,41,4
123013,15382,6830,8552,42,1
123013,12961,5745,7216,43,1
123013,1471,775,696,44,1
123013,11490,4970,6520,45,1
123013,2421,1085,1336,51,1
123013,777,386,391,59,1
123013,10713,4584,6129,60,1
123095,589,149,440,1,4
123095,589,149,440,12,3
123095,589,149,440,21,4
123095,589,149,440,32,3
123165,1009,11,998,1,4
123165,990,3,987,2,1
123165,980,0,980,3,1
123165,272,0,272,4,1
123165,708,0,708,5,1
123165,10,3,7,11,1
123165,19,8,11,12,3
123165,4,0,4,19,1
123165,704,0,704,20,1
123165,996,8,988,21,4
123165,979,0,979,22,1
123165,975,0,975,23,1
123165,272,0,272,24,1
123165,703,0,703,25,1
123165,4,0,4,31,1
123165,17,8,9,32,3
123165,4,0,4,39,1
123165,699,0,699,40,1
123165,13,3,10,41,4
123165,11,3,8,42,1
123165,5,0,5,43,1
123165,5,0,5,45,1
123165,6,3,3,51,1
123165,2,0,2,52,3
123165,5,0,5,60,1
123208,1199,1154,45,1,4
123208,1199,1154,45,2,1
123208,1199,1154,45,3,1
123208,133,130,3,4,1
123208,1066,1024,42,5,1
123208,86,86,0,19,1
123208,980,938,42,20,1
123208,1199,1154,45,21,4
123208,1199,1154,45,22,1
123208,1199,1154,45,23,1
123208,133,130,3,24,1
123208,1066,1024,42,25,1
123208,86,86,0,39,1
123208,980,938,42,40,1
123217,10720,4781,5939,1,4
123217,10720,4781,5939,2,1
123217,9747,4343,5404,3,1
123217,2124,1037,1087,4,1
123217,7623,3306,4317,5,1
123217,973,438,535,11,1
123217,527,282,245,19,1
123217,7096,3024,4072,20,1
123217,4928,2297,2631,21,4
123217,4928,2297,2631,22,1
123217,4807,2232,2575,23,1
123217,1371,658,713,24,1
123217,3436,1574,1862,25,1
123217,121,65,56,31,1
123217,201,118,83,39,1
123217,3235,1456,1779,40,1
123217,5792,2484,3308,41,4
123217,5792,2484,3308,42,1
123217,4940,2111,2829,43,1
123217,753,379,374,44,1
123217,4187,1732,2455,45,1
123217,852,373,479,51,1
123217,326,164,162,59,1
123217,3861,1568,2293,60,1
123280,53,35,18,1,4
123280,46,30,16,2,1
123280,45,29,16,3,1
123280,14,9,5,4,1
123280,31,20,11,5,1
123280,1,1,0,11,1
123280,7,5,2,12,3
123280,31,20,11,20,1
123280,32,22,10,21,4
123280,30,21,9,22,1
123280,30,21,9,23,1
123280,10,6,4,24,1
123280,20,15,5,25,1
123280,2,1,1,32,3
123280,20,15,5,40,1
123280,21,13,8,41,4
123280,16,9,7,42,1
123280,15,8,7,43,1
123280,4,3,1,44,1
123280,11,5,6,45,1
123280,1,1,0,51,1
123280,5,4,1,52,3
123280,11,5,6,60,1
123299,8479,3577,4902,1,4
123299,8479,3577,4902,2,1
123299,7358,3089,4269,3,1
123299,1454,737,717,4,1
123299,5904,2352,3552,5,1
123299,1121,488,633,11,1
123299,392,182,210,19,1
123299,5512,2170,3342,20,1
123299,3817,1700,2117,21,4
123299,3817,1700,2117,22,1
123299,3666,1626,2040,23,1
123299,867,439,428,24,1
123299,2799,1187,1612,25,1
123299,151,74,77,31,1
123299,170,90,80,39,1
123299,2629,1097,1532,40,1
123299,4662,1877,2785,41,4
123299,4662,1877,2785,42,1
123299,3692,1463,2229,43,1
123299,587,298,289,44,1
123299,3105,1165,1940,45,1
123299,970,414,556,51,1
123299,222,92,130,59,1
123299,2883,1073,1810,60,1
123341,18374,8482,9892,1,4
123341,18374,8482,9892,2,1
123341,17195,7935,9260,3,1
123341,3497,1783,1714,4,1
123341,13698,6152,7546,5,1
123341,1179,547,632,11,1
123341,1274,611,663,19,1
123341,12424,5541,6883,20,1
123341,6951,3300,3651,21,4
123341,6951,3300,3651,22,1
123341,6761,3218,3543,23,1
123341,1764,897,867,24,1
123341,4997,2321,2676,25,1
123341,190,82,108,31,1
123341,412,212,200,39,1
123341,4585,2109,2476,40,1
123341,11423,5182,6241,41,4
123341,11423,5182,6241,42,1
123341,10434,4717,5717,43,1
123341,1733,886,847,44,1
123341,8701,3831,4870,45,1
123341,989,465,524,51,1
123341,862,399,463,59,1
123341,7839,3432,4407,60,1
123350,181,17,164,1,4
123350,181,17,164,2,1
123350,181,17,164,3,1
123350,34,15,19,4,1
123350,147,2,145,5,1
123350,147,2,145,20,1
123350,152,15,137,21,4
123350,152,15,137,22,1
123350,152,15,137,23,1
123350,34,15,19,24,1
123350,118,0,118,25,1
123350,118,0,118,40,1
123350,29,2,27,41,4
123350,29,2,27,42,1
123350,29,2,27,43,1
123350,29,2,27,45,1
123350,29,2,27,60,1
123396,137,9,128,1,4
123396,137,9,128,2,1
123396,137,9,128,3,1
123396,9,1,8,4,1
123396,128,8,120,5,1
123396,128,8,120,20,1
123396,137,9,128,21,4
123396,137,9,128,22,1
123396,137,9,128,23,1
123396,9,1,8,24,1
123396,128,8,120,25,1
123396,128,8,120,40,1
123448,216,104,112,1,4
123448,216,104,112,12,3
123448,142,69,73,21,4
123448,142,69,73,32,3
123448,74,35,39,41,4
123448,74,35,39,52,3
123457,1255,427,828,1,4
123457,1024,344,680,2,1
123457,1024,344,680,3,1
123457,149,43,106,4,1
123457,875,301,574,5,1
123457,231,83,148,12,3
123457,181,67,114,19,1
123457,694,234,460,20,1
123457,1088,358,730,21,4
123457,993,331,662,22,1
123457,993,331,662,23,1
123457,149,43,106,24,1
123457,844,288,556,25,1
123457,95,27,68,32,3
123457,166,63,103,39,1
123457,678,225,453,40,1
123457,167,69,98,41,4
123457,31,13,18,42,1
123457,31,13,18,43,1
123457,31,13,18,45,1
123457,136,56,80,52,3
123457,15,4,11,59,1
123457,16,9,7,60,1
123484,2533,1311,1222,1,4
123484,2533,1311,1222,2,1
123484,2168,1153,1015,3,1
123484,510,361,149,4,1
123484,1658,792,866,5,1
123484,365,158,207,11,1
123484,308,208,100,19,1
123484,1350,584,766,20,1
123484,1002,566,436,21,4
123484,1002,566,436,22,1
123484,971,546,425,23,1
123484,244,167,77,24,1
123484,727,379,348,25,1
123484,31,20,11,31,1
123484,111,78,33,39,1
123484,616,301,315,40,1
123484,1531,745,786,41,4
123484,1531,745,786,42,1
123484,1197,607,590,43,1
123484,266,194,72,44,1
123484,931,413,518,45,1
123484,334,138,196,51,1
123484,197,130,67,59,1
123484,734,283,451,60,1
123493,1032,609,423,1,4
123493,1032,609,423,2,1
123493,1032,609,423,3,1
123493,749,433,316,4,1
123493,283,176,107,5,1
123493,283,176,107,20,1
123493,869,505,364,21,4
123493,869,505,364,22,1
123493,869,505,364,23,1
123493,663,375,288,24,1
123493,206,130,76,25,1
123493,206,130,76,40,1
123493,163,104,59,41,4
123493,163,104,59,42,1
123493,163,104,59,43,1
123493,86,58,28,44,1
123493,77,46,31,45,1
123493,77,46,31,60,1
123509,10067,4786,5281,1,4
123509,10067,4786,5281,2,1
123509,8859,4223,4636,3,1
123509,1321,722,599,4,1
123509,7538,3501,4037,5,1
123509,1208,563,645,11,1
123509,1239,561,678,19,1
123509,6299,2940,3359,20,1
123509,2598,1365,1233,21,4
123509,2598,1365,1233,22,1
123509,2533,1324,1209,23,1
123509,598,339,259,24,1
123509,1935,985,950,25,1
123509,65,41,24,31,1
123509,206,107,99,39,1
123509,1729,878,851,40,1
123509,7469,3421,4048,41,4
123509,7469,3421,4048,42,1
123509,6326,2899,3427,43,1
123509,723,383,340,44,1
123509,5603,2516,3087,45,1
123509,1143,522,621,51,1
123509,1033,454,579,59,1
123509,4570,2062,2508,60,1
123527,12329,5496,6833,1,4
123527,12329,5496,6833,2,1
123527,11057,4924,6133,3,1
123527,1981,959,1022,4,1
123527,9076,3965,5111,5,1
123527,1272,572,700,11,1
123527,893,420,473,19,1
123527,8183,3545,4638,20,1
123527,4413,2049,2364,21,4
123527,4413,2049,2364,22,1
123527,4325,2013,2312,23,1
123527,804,376,428,24,1
123527,3521,1637,1884,25,1
123527,88,36,52,31,1
123527,260,125,135,39,1
123527,3261,1512,1749,40,1
123527,7916,3447,4469,41,4
123527,7916,3447,4469,42,1
123527,6732,2911,3821,43,1
123527,1177,583,594,44,1
123527,5555,2328,3227,45,1
123527,1184,536,648,51,1
123527,633,295,338,59,1
123527,4922,2033,2889,60,1
123554,4257,1667,2590,1,4
123554,3055,1256,1799,2,1
123554,3039,1249,1790,3,1
123554,622,255,367,4,1
123554,2417,994,1423,5,1
123554,16,7,9,11,1
123554,1202,411,791,12,3
123554,171,78,93,19,1
123554,2246,916,1330,20,1
123554,3490,1426,2064,21,4
123554,2823,1156,1667,22,1
123554,2819,1154,1665,23,1
123554,622,255,367,24,1
123554,2197,899,1298,25,1
123554,4,2,2,31,1
123554,667,270,397,32,3
123554,170,78,92,39,1
123554,2027,821,1206,40,1
123554,767,241,526,41,4
123554,232,100,132,42,1
123554,220,95,125,43,1
123554,220,95,125,45,1
123554,12,5,7,51,1
123554,535,141,394,52,3
123554,1,0,1,59,1
123554,219,95,124,60,1
123563,9583,3950,5633,1,4
123563,9583,3950,5633,2,1
123563,8341,3399,4942,3,1
123563,1410,668,742,4,1
123563,6931,2731,4200,5,1
123563,1242,551,691,11,1
123563,668,245,423,19,1
123563,6263,2486,3777,20,1
123563,3249,1425,1824,21,4
123563,3249,1425,1824,22,1
123563,3154,1382,1772,23,1
123563,785,366,419,24,1
123563,2369,1016,1353,25,1
123563,95,43,52,31,1
123563,208,82,126,39,1
123563,2161,934,1227,40,1
123563,6334,2525,3809,41,4
123563,6334,2525,3809,42,1
123563,5187,2017,3170,43,1
123563,625,302,323,44,1
123563,4562,1715,2847,45,1
123563,1147,508,639,51,1
123563,460,163,297,59,1
123563,4102,1552,2550,60,1
123572,9120,3458,5662,1,4
123572,8391,3254,5137,2,1
123572,8321,3227,5094,3,1
123572,1807,603,1204,4,1
123572,6514,2624,3890,5,1
123572,70,27,43,11,1
123572,729,204,525,12,3
123572,852,342,510,19,1
123572,5662,2282,3380,20,1
123572,8052,3039,5013,21,4
123572,7679,2940,4739,22,1
123572,7658,2932,4726,23,1
123572,1767,587,1180,24,1
123572,5891,2345,3546,25,1
123572,21,8,13,31,1
123572,373,99,274,32,3
123572,704,273,431,39,1
123572,5187,2072,3115,40,1
123572,1068,419,649,41,4
123572,712,314,398,42,1
123572,663,295,368,43,1
123572,40,16,24,44,1
123572,623,279,344,45,1
123572,49,19,30,51,1
123572,356,105,251,52,3
123572,148,69,79,59,1
123572,475,210,265,60,1
123581,147,130,17,1,4
123581,147,130,17,2,1
123581,147,130,17,3,1
123581,36,34,2,4,1
123581,111,96,15,5,1
123581,111,96,15,20,1
123581,147,130,17,21,4
123581,147,130,17,22,1
123581,147,130,17,23,1
123581,36,34,2,24,1
123581,111,96,15,25,1
123581,111,96,15,40,1
123633,647,260,387,1,4
123633,125,38,87,2,1
123633,125,38,87,3,1
123633,125,38,87,5,1
123633,522,222,300,12,3
123633,24,7,17,19,1
123633,101,31,70,20,1
123633,647,260,387,21,4
123633,125,38,87,22,1
123633,125,38,87,23,1
123633,125,38,87,25,1
123633,522,222,300,32,3
123633,24,7,17,39,1
123633,101,31,70,40,1
123642,374,37,337,1,4
123642,374,37,337,2,1
123642,374,37,337,3,1
123642,41,8,33,4,1
123642,333,29,304,5,1
123642,74,7,67,19,1
123642,259,22,237,20,1
123642,243,23,220,21,4
123642,243,23,220,22,1
123642,243,23,220,23,1
123642,30,5,25,24,1
123642,213,18,195,25,1
123642,49,6,43,39,1
123642,164,12,152,40,1
123642,131,14,117,41,4
123642,131,14,117,42,1
123642,131,14,117,43,1
123642,11,3,8,44,1
123642,120,11,109,45,1
123642,25,1,24,59,1
123642,95,10,85,60,1
123651,2415,762,1653,1,4
123651,2135,687,1448,2,1
123651,2057,680,1377,3,1
123651,401,121,280,4,1
123651,1656,559,1097,5,1
123651,78,7,71,11,1
123651,280,75,205,12,3
123651,252,84,168,19,1
123651,1404,475,929,20,1
123651,1678,554,1124,21,4
123651,1576,533,1043,22,1
123651,1576,533,1043,23,1
123651,390,117,273,24,1
123651,1186,416,770,25,1
123651,102,21,81,32,3
123651,115,49,66,39,1
123651,1071,367,704,40,1
123651,737,208,529,41,4
123651,559,154,405,42,1
123651,481,147,334,43,1
123651,11,4,7,44,1
123651,470,143,327,45,1
123651,78,7,71,51,1
123651,178,54,124,52,3
123651,137,35,102,59,1
123651,333,108,225,60,1
123679,898,246,652,1,4
123679,898,246,652,2,1
123679,898,246,652,3,1
123679,217,54,163,4,1
123679,681,192,489,5,1
123679,681,192,489,20,1
123679,898,246,652,21,4
123679,898,246,652,22,1
123679,898,246,652,23,1
123679,217,54,163,24,1
123679,681,192,489,25,1
123679,681,192,489,40,1
123800,19591,9232,10359,1,4
123800,19591,9232,10359,2,1
123800,17611,8334,9277,3,1
123800,3161,1624,1537,4,1
123800,14450,6710,7740,5,1
123800,1980,898,1082,11,1
123800,1203,537,666,19,1
123800,13247,6173,7074,20,1
123800,7672,3659,4013,21,4
123800,7672,3659,4013,22,1
123800,7301,3499,3802,23,1
123800,1743,890,853,24,1
123800,5558,2609,2949,25,1
123800,371,160,211,31,1
123800,349,167,182,39,1
123800,5209,2442,2767,40,1
123800,11919,5573,6346,41,4
123800,11919,5573,6346,42,1
123800,10310,4835,5475,43,1
123800,1418,734,684,44,1
123800,8892,4101,4791,45,1
123800,1609,738,871,51,1
123800,854,370,484,59,1
123800,8038,3731,4307,60,1
123855,108,101,7,1,4
123855,108,101,7,12,3
123855,97,94,3,21,4
123855,97,94,3,32,3
123855,11,7,4,41,4
123855,11,7,4,52,3
123916,90,24,66,1,4
123916,90,24,66,12,3
123916,34,9,25,21,4
123916,34,9,25,32,3
123916,56,15,41,41,4
123916,56,15,41,52,3
123943,397,111,286,1,4
123943,397,111,286,12,3
123943,397,111,286,21,4
123943,397,111,286,32,3
123952,493,309,184,1,4
123952,237,155,82,2,1
123952,237,155,82,3,1
123952,32,21,11,4,1
123952,205,134,71,5,1
123952,256,154,102,12,3
123952,205,134,71,20,1
123952,478,299,179,21,4
123952,227,149,78,22,1
123952,227,149,78,23,1
123952,32,21,11,24,1
123952,195,128,67,25,1
123952,251,150,101,32,3
123952,195,128,67,40,1
123952,15,10,5,41,4
123952,10,6,4,42,1
123952,10,6,4,43,1
123952,10,6,4,45,1
123952,5,4,1,52,3
123952,10,6,4,60,1
123961,41368,19897,21471,1,4
123961,18445,9157,9288,2,1
123961,18087,8950,9137,3,1
123961,2922,1420,1502,4,1
123961,15165,7530,7635,5,1
123961,358,207,151,11,1
123961,22923,10740,12183,12,3
123961,1448,756,692,19,1
123961,13717,6774,6943,20,1
123961,35895,17013,18882,21,4
123961,17729,8743,8986,22,1
123961,17578,8664,8914,23,1
123961,2920,1418,1502,24,1
123961,14658,7246,7412,25,1
123961,151,79,72,31,1
123961,18166,8270,9896,32,3
123961,1438,749,689,39,1
123961,13220,6497,6723,40,1
123961,5473,2884,2589,41,4
123961,716,414,302,42,1
123961,509,286,223,43,1
123961,2,2,0,44,1
123961,507,284,223,45,1
123961,207,128,79,51,1
123961,4757,2470,2287,52,3
123961,10,7,3,59,1
123961,497,277,220,60,1
123970,1146,523,623,1,4
123970,1146,523,623,12,3
123970,720,322,398,21,4
123970,720,322,398,32,3
123970,426,201,225,41,4
123970,426,201,225,52,3
124113,5444,3128,2316,1,4
124113,5444,3128,2316,2,1
124113,5047,2975,2072,3,1
124113,1279,879,400,4,1
124113,3768,2096,1672,5,1
124113,397,153,244,11,1
124113,800,437,363,19,1
124113,2968,1659,1309,20,1
124113,1193,461,732,21,4
124113,1193,461,732,22,1
124113,1125,436,689,23,1
124113,342,158,184,24,1
124113,783,278,505,25,1
124113,68,25,43,31,1
124113,87,21,66,39,1
124113,696,257,439,40,1
124113,4251,2667,1584,41,4
124113,4251,2667,1584,42,1
124113,3922,2539,1383,43,1
124113,937,721,216,44,1
124113,2985,1818,1167,45,1
124113,329,128,201,51,1
124113,713,416,297,59,1
124113,2272,1402,870,60,1
124283,272,134,138,1,4
124283,272,134,138,12,3
124283,118,56,62,21,4
124283,118,56,62,32,3
124283,154,78,76,41,4
124283,154,78,76,52,3
124292,366,185,181,1,4
124292,366,185,181,2,1
124292,366,185,181,3,1
124292,88,44,44,4,1
124292,278,141,137,5,1
124292,15,11,4,19,1
124292,263,130,133,20,1
124292,366,185,181,21,4
124292,366,185,181,22,1
124292,366,185,181,23,1
124292,88,44,44,24,1
124292,278,141,137,25,1
124292,15,11,4,39,1
124292,263,130,133,40,1
124344,567,13,554,1,4
124344,567,13,554,2,1
124344,567,13,554,3,1
124344,134,0,134,4,1
124344,433,13,420,5,1
124344,433,13,420,20,1
124344,536,12,524,21,4
124344,536,12,524,22,1
124344,536,12,524,23,1
124344,134,0,134,24,1
124344,402,12,390,25,1
124344,402,12,390,40,1
124344,31,1,30,41,4
124344,31,1,30,42,1
124344,31,1,30,43,1
124344,31,1,30,45,1
124344,31,1,30,60,1
124487,265,131,134,1,4
124487,265,131,134,2,1
124487,263,130,133,3,1
124487,29,20,9,4,1
124487,234,110,124,5,1
124487,2,1,1,11,1
124487,14,7,7,19,1
124487,220,103,117,20,1
124487,90,51,39,21,4
124487,90,51,39,22,1
124487,90,51,39,23,1
124487,4,4,0,24,1
124487,86,47,39,25,1
124487,3,3,0,39,1
124487,83,44,39,40,1
124487,175,80,95,41,4
124487,175,80,95,42,1
124487,173,79,94,43,1
124487,25,16,9,44,1
124487,148,63,85,45,1
124487,2,1,1,51,1
124487,11,4,7,59,1
124487,137,59,78,60,1
124681,2732,1049,1683,1,4
124681,2732,1049,1683,2,1
124681,2732,1049,1683,3,1
124681,925,385,540,4,1
124681,1807,664,1143,5,1
124681,1807,664,1143,20,1
124681,2732,1049,1683,21,4
124681,2732,1049,1683,22,1
124681,2732,1049,1683,23,1
124681,925,385,540,24,1
124681,1807,664,1143,25,1
124681,1807,664,1143,40,1
124706,753,159,594,1,4
124706,753,159,594,2,1
124706,753,159,594,3,1
124706,182,33,149,4,1
124706,571,126,445,5,1
124706,571,126,445,20,1
124706,753,159,594,21,4
124706,753,159,594,22,1
124706,753,159,594,23,1
124706,182,33,149,24,1
124706,571,126,445,25,1
124706,571,126,445,40,1
124779,33,3,30,1,4
124779,33,3,30,2,1
124779,33,3,30,3,1
124779,5,0,5,4,1
124779,28,3,25,5,1
124779,28,3,25,20,1
124779,29,3,26,21,4
124779,29,3,26,22,1
124779,29,3,26,23,1
124779,3,0,3,24,1
124779,26,3,23,25,1
124779,26,3,23,40,1
124779,4,0,4,41,4
124779,4,0,4,42,1
124779,4,0,4,43,1
124779,2,0,2,44,1
124779,2,0,2,45,1
124779,2,0,2,60,1
124937,925,260,665,1,4
124937,925,260,665,2,1
124937,925,260,665,3,1
124937,304,54,250,4,1
124937,621,206,415,5,1
124937,621,206,415,20,1
124937,925,260,665,21,4
124937,925,260,665,22,1
124937,925,260,665,23,1
124937,304,54,250,24,1
124937,621,206,415,25,1
124937,621,206,415,40,1
125028,12908,5830,7078,1,4
125028,12908,5830,7078,2,1
125028,11784,5329,6455,3,1
125028,2224,1195,1029,4,1
125028,9560,4134,5426,5,1
125028,1124,501,623,11,1
125028,896,390,506,19,1
125028,8664,3744,4920,20,1
125028,4387,2049,2338,21,4
125028,4387,2049,2338,22,1
125028,4341,2029,2312,23,1
125028,1283,649,634,24,1
125028,3058,1380,1678,25,1
125028,46,20,26,31,1
125028,159,75,84,39,1
125028,2899,1305,1594,40,1
125028,8521,3781,4740,41,4
125028,8521,3781,4740,42,1
125028,7443,3300,4143,43,1
125028,941,546,395,44,1
125028,6502,2754,3748,45,1
125028,1078,481,597,51,1
125028,737,315,422,59,1
125028,5765,2439,3326,60,1
125037,107,48,59,1,4
125037,107,48,59,12,3
125037,107,48,59,41,4
125037,107,48,59,52,3
125082,105,1,104,1,4
125082,105,1,104,2,1
125082,105,1,104,3,1
125082,29,0,29,4,1
125082,76,1,75,5,1
125082,76,1,75,20,1
125082,101,1,100,21,4
125082,101,1,100,22,1
125082,101,1,100,23,1
125082,28,0,28,24,1
125082,73,1,72,25,1
125082,73,1,72,40,1
125082,4,0,4,41,4
125082,4,0,4,42,1
125082,4,0,4,43,1
125082,1,0,1,44,1
125082,3,0,3,45,1
125082,3,0,3,60,1
125091,11504,4980,6524,1,4
125091,11504,4980,6524,2,1
125091,9981,4320,5661,3,1
125091,2051,1022,1029,4,1
125091,7930,3298,4632,5,1
125091,1523,660,863,11,1
125091,656,293,363,19,1
125091,7274,3005,4269,20,1
125091,4030,1870,2160,21,4
125091,4030,1870,2160,22,1
125091,3885,1798,2087,23,1
125091,992,496,496,24,1
125091,2893,1302,1591,25,1
125091,145,72,73,31,1
125091,261,130,131,39,1
125091,2632,1172,1460,40,1
125091,7474,3110,4364,41,4
125091,7474,3110,4364,42,1
125091,6096,2522,3574,43,1
125091,1059,526,533,44,1
125091,5037,1996,3041,45,1
125091,1378,588,790,51,1
125091,395,163,232,59,1
125091,4642,1833,2809,60,1
125170,6471,2917,3554,1,4
125170,6471,2917,3554,2,1
125170,6036,2715,3321,3,1
125170,1260,597,663,4,1
125170,4776,2118,2658,5,1
125170,435,202,233,11,1
125170,1175,525,650,19,1
125170,3601,1593,2008,20,1
125170,1049,512,537,21,4
125170,1049,512,537,22,1
125170,1041,506,535,23,1
125170,309,146,163,24,1
125170,732,360,372,25,1
125170,8,6,2,31,1
125170,135,66,69,39,1
125170,597,294,303,40,1
125170,5422,2405,3017,41,4
125170,5422,2405,3017,42,1
125170,4995,2209,2786,43,1
125170,951,451,500,44,1
125170,4044,1758,2286,45,1
125170,427,196,231,51,1
125170,1040,459,581,59,1
125170,3004,1299,1705,60,1
125231,51016,11696,39320,1,4
125231,8205,1922,6283,2,1
125231,8064,1852,6212,3,1
125231,229,74,155,4,1
125231,7835,1778,6057,5,1
125231,141,70,71,11,1
125231,42811,9774,33037,12,3
125231,1451,246,1205,19,1
125231,6384,1532,4852,20,1
125231,29437,6544,22893,21,4
125231,815,163,652,22,1
125231,814,162,652,23,1
125231,3,0,3,24,1
125231,811,162,649,25,1
125231,1,1,0,31,1
125231,28622,6381,22241,32,3
125231,24,7,17,39,1
125231,787,155,632,40,1
125231,21579,5152,16427,41,4
125231,7390,1759,5631,42,1
125231,7250,1690,5560,43,1
125231,226,74,152,44,1
125231,7024,1616,5408,45,1
125231,140,69,71,51,1
125231,14189,3393,10796,52,3
125231,1427,239,1188,59,1
125231,5597,1377,4220,60,1
125310,42,1,41,1,4
125310,42,1,41,2,1
125310,42,1,41,3,1
125310,10,0,10,4,1
125310,32,1,31,5,1
125310,32,1,31,20,1
125310,30,1,29,21,4
125310,30,1,29,22,1
125310,30,1,29,23,1
125310,6,0,6,24,1
125310,24,1,23,25,1
125310,24,1,23,40,1
125310,12,0,12,41,4
125310,12,0,12,42,1
125310,12,0,12,43,1
125310,4,0,4,44,1
125310,8,0,8,45,1
125310,8,0,8,60,1
125462,3055,1224,1831,1,4
125462,3055,1224,1831,2,1
125462,2793,1122,1671,3,1
125462,638,303,335,4,1
125462,2155,819,1336,5,1
125462,262,102,160,11,1
125462,427,143,284,19,1
125462,1728,676,1052,20,1
125462,951,451,500,21,4
125462,951,451,500,22,1
125462,944,445,499,23,1
125462,278,144,134,24,1
125462,666,301,365,25,1
125462,7,6,1,31,1
125462,81,37,44,39,1
125462,585,264,321,40,1
125462,2104,773,1331,41,4
125462,2104,773,1331,42,1
125462,1849,677,1172,43,1
125462,360,159,201,44,1
125462,1489,518,971,45,1
125462,255,96,159,51,1
125462,346,106,240,59,1
125462,1143,412,731,60,1
125471,10767,4347,6420,1,4
125471,10767,4347,6420,2,1
125471,9464,3801,5663,3,1
125471,1401,662,739,4,1
125471,8063,3139,4924,5,1
125471,1303,546,757,11,1
125471,1574,602,972,19,1
125471,6489,2537,3952,20,1
125471,2160,975,1185,21,4
125471,2160,975,1185,22,1
125471,2129,961,1168,23,1
125471,338,164,174,24,1
125471,1791,797,994,25,1
125471,31,14,17,31,1
125471,194,83,111,39,1
125471,1597,714,883,40,1
125471,8607,3372,5235,41,4
125471,8607,3372,5235,42,1
125471,7335,2840,4495,43,1
125471,1063,498,565,44,1
125471,6272,2342,3930,45,1
125471,1272,532,740,51,1
125471,1380,519,861,59,1
125471,4892,1823,3069,60,1
125499,9636,4334,5302,1,4
125499,9636,4334,5302,2,1
125499,8470,3839,4631,3,1
125499,1335,658,677,4,1
125499,7135,3181,3954,5,1
125499,1166,495,671,11,1
125499,1021,422,599,19,1
125499,6114,2759,3355,20,1
125499,3065,1571,1494,21,4
125499,3065,1571,1494,22,1
125499,2923,1509,1414,23,1
125499,682,367,315,24,1
125499,2241,1142,1099,25,1
125499,142,62,80,31,1
125499,252,116,136,39,1
125499,1989,1026,963,40,1
125499,6571,2763,3808,41,4
125499,6571,2763,3808,42,1
125499,5547,2330,3217,43,1
125499,653,291,362,44,1
125499,4894,2039,2855,45,1
125499,1024,433,591,51,1
125499,769,306,463,59,1
125499,4125,1733,2392,60,1
125532,1267,180,1087,1,4
125532,1267,180,1087,2,1
125532,1267,180,1087,3,1
125532,60,14,46,4,1
125532,1207,166,1041,5,1
125532,166,24,142,19,1
125532,1041,142,899,20,1
125532,1145,165,980,21,4
125532,1145,165,980,22,1
125532,1145,165,980,23,1
125532,59,14,45,24,1
125532,1086,151,935,25,1
125532,137,18,119,39,1
125532,949,133,816,40,1
125532,122,15,107,41,4
125532,122,15,107,42,1
125532,122,15,107,43,1
125532,1,0,1,44,1
125532,121,15,106,45,1
125532,29,6,23,59,1
125532,92,9,83,60,1
125718,143,136,7,1,4
125718,143,136,7,12,3
125718,111,104,7,21,4
125718,111,104,7,32,3
125718,32,32,0,41,4
125718,32,32,0,52,3
125727,1321,508,813,1,4
125727,1308,508,800,2,1
125727,1295,505,790,3,1
125727,279,112,167,4,1
125727,1016,393,623,5,1
125727,13,3,10,11,1
125727,13,0,13,12,3
125727,55,23,32,19,1
125727,961,370,591,20,1
125727,1311,503,808,21,4
125727,1298,503,795,22,1
125727,1292,503,789,23,1
125727,279,112,167,24,1
125727,1013,391,622,25,1
125727,6,0,6,31,1
125727,13,0,13,32,3
125727,55,23,32,39,1
125727,958,368,590,40,1
125727,10,5,5,41,4
125727,10,5,5,42,1
125727,3,2,1,43,1
125727,3,2,1,45,1
125727,7,3,4,51,1
125727,3,2,1,60,1
125763,2339,1042,1297,1,4
125763,1656,731,925,2,1
125763,1651,728,923,3,1
125763,441,171,270,4,1
125763,1210,557,653,5,1
125763,5,3,2,11,1
125763,683,311,372,12,3
125763,57,31,26,19,1
125763,1153,526,627,20,1
125763,2065,923,1142,21,4
125763,1623,714,909,22,1
125763,1619,712,907,23,1
125763,440,170,270,24,1
125763,1179,542,637,25,1
125763,4,2,2,31,1
125763,442,209,233,32,3
125763,56,31,25,39,1
125763,1123,511,612,40,1
125763,274,119,155,41,4
125763,33,17,16,42,1
125763,32,16,16,43,1
125763,1,1,0,44,1
125763,31,15,16,45,1
125763,1,1,0,51,1
125763,241,102,139,52,3
125763,1,0,1,59,1
125763,30,15,15,60,1
125897,1607,779,828,1,4
125897,1357,663,694,2,1
125897,1353,659,694,3,1
125897,100,41,59,4,1
125897,1253,618,635,5,1
125897,4,4,0,11,1
125897,250,116,134,12,3
125897,192,90,102,19,1
125897,1061,528,533,20,1
125897,1393,689,704,21,4
125897,1175,588,587,22,1
125897,1175,588,587,23,1
125897,96,41,55,24,1
125897,1079,547,532,25,1
125897,218,101,117,32,3
125897,173,83,90,39,1
125897,906,464,442,40,1
125897,214,90,124,41,4
125897,182,75,107,42,1
125897,178,71,107,43,1
125897,4,0,4,44,1
125897,174,71,103,45,1
125897,4,4,0,51,1
125897,32,15,17,52,3
125897,19,7,12,59,1
125897,155,64,91,60,1
126012,434,111,323,1,4
126012,434,111,323,12,3
126012,434,111,323,21,4
126012,434,111,323,32,3
126030,431,209,222,1,4
126030,431,209,222,12,3
126030,280,137,143,21,4
126030,280,137,143,32,3
126030,151,72,79,41,4
126030,151,72,79,52,3
126049,1036,522,514,1,4
126049,1036,522,514,12,3
126049,606,297,309,21,4
126049,606,297,309,32,3
126049,430,225,205,41,4
126049,430,225,205,52,3
126076,131,131,0,1,4
126076,131,131,0,2,1
126076,131,131,0,3,1
126076,46,46,0,4,1
126076,85,85,0,5,1
126076,26,26,0,19,1
126076,59,59,0,20,1
126076,131,131,0,21,4
126076,131,131,0,22,1
126076,131,131,0,23,1
126076,46,46,0,24,1
126076,85,85,0,25,1
126076,26,26,0,39,1
126076,59,59,0,40,1
126119,6874,2748,4126,1,4
126119,6874,2748,4126,2,1
126119,6345,2516,3829,3,1
126119,1329,599,730,4,1
126119,5016,1917,3099,5,1
126119,529,232,297,11,1
126119,515,184,331,19,1
126119,4501,1733,2768,20,1
126119,2672,1123,1549,21,4
126119,2672,1123,1549,22,1
126119,2617,1098,1519,23,1
126119,671,303,368,24,1
126119,1946,795,1151,25,1
126119,55,25,30,31,1
126119,130,54,76,39,1
126119,1816,741,1075,40,1
126119,4202,1625,2577,41,4
126119,4202,1625,2577,42,1
126119,3728,1418,2310,43,1
126119,658,296,362,44,1
126119,3070,1122,1948,45,1
126119,474,207,267,51,1
126119,385,130,255,59,1
126119,2685,992,1693,60,1
126164,90,1,89,1,4
126164,90,1,89,2,1
126164,90,1,89,3,1
126164,14,0,14,4,1
126164,76,1,75,5,1
126164,76,1,75,20,1
126164,90,1,89,21,4
126164,90,1,89,22,1
126164,90,1,89,23,1
126164,14,0,14,24,1
126164,76,1,75,25,1
126164,76,1,75,40,1
126182,3211,1406,1805,1,4
126182,2284,1133,1151,2,1
126182,2227,1112,1115,3,1
126182,527,285,242,4,1
126182,1700,827,873,5,1
126182,57,21,36,11,1
126182,927,273,654,12,3
126182,257,129,128,19,1
126182,1443,698,745,20,1
126182,2185,1053,1132,21,4
126182,1873,990,883,22,1
126182,1868,989,879,23,1
126182,513,276,237,24,1
126182,1355,713,642,25,1
126182,5,1,4,31,1
126182,312,63,249,32,3
126182,169,103,66,39,1
126182,1186,610,576,40,1
126182,1026,353,673,41,4
126182,411,143,268,42,1
126182,359,123,236,43,1
126182,14,9,5,44,1
126182,345,114,231,45,1
126182,52,20,32,51,1
126182,615,210,405,52,3
126182,88,26,62,59,1
126182,257,88,169,60,1
126207,4955,2138,2817,1,4
126207,4955,2138,2817,2,1
126207,3852,1650,2202,3,1
126207,663,342,321,4,1
126207,3189,1308,1881,5,1
126207,1103,488,615,11,1
126207,436,200,236,19,1
126207,2753,1108,1645,20,1
126207,2056,978,1078,21,4
126207,2056,978,1078,22,1
126207,1962,933,1029,23,1
126207,378,224,154,24,1
126207,1584,709,875,25,1
126207,94,45,49,31,1
126207,230,111,119,39,1
126207,1354,598,756,40,1
126207,2899,1160,1739,41,4
126207,2899,1160,1739,42,1
126207,1890,717,1173,43,1
126207,285,118,167,44,1
126207,1605,599,1006,45,1
126207,1009,443,566,51,1
126207,206,89,117,59,1
126207,1399,510,889,60,1
126289,11621,5682,5939,1,4
126289,11621,5682,5939,2,1
126289,8920,4325,4595,3,1
126289,983,478,505,4,1
126289,7937,3847,4090,5,1
126289,2701,1357,1344,11,1
126289,1091,440,651,19,1
126289,6846,3407,3439,20,1
126289,2295,1058,1237,21,4
126289,2295,1058,1237,22,1
126289,2145,987,1158,23,1
126289,407,208,199,24,1
126289,1738,779,959,25,1
126289,150,71,79,31,1
126289,298,144,154,39,1
126289,1440,635,805,40,1
126289,9326,4624,4702,41,4
126289,9326,4624,4702,42,1
126289,6775,3338,3437,43,1
126289,576,270,306,44,1
126289,6199,3068,3131,45,1
126289,2551,1286,1265,51,1
126289,793,296,497,59,1
126289,5406,2772,2634,60,1
126359,576,71,505,1,4
126359,576,71,505,2,1
126359,576,71,505,3,1
126359,116,12,104,4,1
126359,460,59,401,5,1
126359,460,59,401,20,1
126359,576,71,505,21,4
126359,576,71,505,22,1
126359,576,71,505,23,1
126359,116,12,104,24,1
126359,460,59,401,25,1
126359,460,59,401,40,1
126401,389,115,274,1,4
126401,389,115,274,2,1
126401,389,115,274,3,1
126401,28,4,24,4,1
126401,361,111,250,5,1
126401,69,17,52,19,1
126401,292,94,198,20,1
126401,310,73,237,21,4
126401,310,73,237,22,1
126401,310,73,237,23,1
126401,24,1,23,24,1
126401,286,72,214,25,1
126401,55,10,45,39,1
126401,231,62,169,40,1
126401,79,42,37,41,4
126401,79,42,37,42,1
126401,79,42,37,43,1
126401,4,3,1,44,1
126401,75,39,36,45,1
126401,14,7,7,59,1
126401,61,32,29,60,1
126562,22206,9657,12549,1,4
126562,13010,6060,6950,2,1
126562,10470,5004,5466,3,1
126562,1180,521,659,4,1
126562,9290,4483,4807,5,1
126562,2540,1056,1484,11,1
126562,9196,3597,5599,12,3
126562,1645,759,886,19,1
126562,7645,3724,3921,20,1
126562,11800,5476,6324,21,4
126562,7782,3716,4066,22,1
126562,7759,3708,4051,23,1
126562,1081,475,606,24,1
126562,6678,3233,3445,25,1
126562,23,8,15,31,1
126562,4018,1760,2258,32,3
126562,1263,580,683,39,1
126562,5415,2653,2762,40,1
126562,10406,4181,6225,41,4
126562,5228,2344,2884,42,1
126562,2711,1296,1415,43,1
126562,99,46,53,44,1
126562,2612,1250,1362,45,1
126562,2517,1048,1469,51,1
126562,5178,1837,3341,52,3
126562,382,179,203,59,1
126562,2230,1071,1159,60,1
126580,11321,5304,6017,1,4
126580,9220,4357,4863,2,1
126580,8888,4182,4706,3,1
126580,1618,808,810,4,1
126580,7270,3374,3896,5,1
126580,332,175,157,11,1
126580,2101,947,1154,12,3
126580,1122,516,606,19,1
126580,6148,2858,3290,20,1
126580,7450,3533,3917,21,4
126580,6962,3331,3631,22,1
126580,6946,3320,3626,23,1
126580,1515,748,767,24,1
126580,5431,2572,2859,25,1
126580,16,11,5,31,1
126580,488,202,286,32,3
126580,795,400,395,39,1
126580,4636,2172,2464,40,1
126580,3871,1771,2100,41,4
126580,2258,1026,1232,42,1
126580,1942,862,1080,43,1
126580,103,60,43,44,1
126580,1839,802,1037,45,1
126580,316,164,152,51,1
126580,1613,745,868,52,3
126580,327,116,211,59,1
126580,1512,686,826,60,1
126605,434,404,30,1,4
126605,434,404,30,2,1
126605,434,404,30,3,1
126605,91,84,7,4,1
126605,343,320,23,5,1
126605,343,320,23,20,1
126605,392,364,28,21,4
126605,392,364,28,22,1
126605,392,364,28,23,1
126605,90,83,7,24,1
126605,302,281,21,25,1
126605,302,281,21,40,1
126605,42,40,2,41,4
126605,42,40,2,42,1
126605,42,40,2,43,1
126605,1,1,0,44,1
126605,41,39,2,45,1
126605,41,39,2,60,1
126614,32017,17671,14346,1,4
126614,26096,14306,11790,2,1
126614,25461,14012,11449,3,1
126614,5840,3155,2685,4,1
126614,19621,10857,8764,5,1
126614,635,294,341,11,1
126614,5921,3365,2556,12,3
126614,1290,734,556,19,1
126614,18331,10123,8208,20,1
126614,26242,14381,11861,21,4
126614,23948,13092,10856,22,1
126614,23793,13008,10785,23,1
126614,5789,3125,2664,24,1
126614,18004,9883,8121,25,1
126614,155,84,71,31,1
126614,2294,1289,1005,32,3
126614,1202,685,517,39,1
126614,16802,9198,7604,40,1
126614,5775,3290,2485,41,4
126614,2148,1214,934,42,1
126614,1668,1004,664,43,1
126614,51,30,21,44,1
126614,1617,974,643,45,1
126614,480,210,270,51,1
126614,3627,2076,1551,52,3
126614,88,49,39,59,1
126614,1529,925,604,60,1
126669,5368,1838,3530,1,4
126669,4973,1705,3268,2,1
126669,3614,1141,2473,3,1
126669,530,187,343,4,1
126669,3084,954,2130,5,1
126669,1359,564,795,11,1
126669,395,133,262,12,3
126669,529,153,376,19,1
126669,2555,801,1754,20,1
126669,1583,562,1021,21,4
126669,1472,543,929,22,1
126669,1417,514,903,23,1
126669,360,127,233,24,1
126669,1057,387,670,25,1
126669,55,29,26,31,1
126669,111,19,92,32,3
126669,121,42,79,39,1
126669,936,345,591,40,1
126669,3785,1276,2509,41,4
126669,3501,1162,2339,42,1
126669,2197,627,1570,43,1
126669,170,60,110,44,1
126669,2027,567,1460,45,1
126669,1304,535,769,51,1
126669,284,114,170,52,3
126669,408,111,297,59,1
126669,1619,456,1163,60,1
126678,2061,928,1133,1,4
126678,2041,921,1120,2,1
126678,2025,914,1111,3,1
126678,522,224,298,4,1
126678,1503,690,813,5,1
126678,16,7,9,11,1
126678,20,7,13,12,3
126678,36,15,21,19,1
126678,1467,675,792,20,1
126678,2044,920,1124,21,4
126678,2025,914,1111,22,1
126678,2025,914,1111,23,1
126678,522,224,298,24,1
126678,1503,690,813,25,1
126678,19,6,13,32,3
126678,36,15,21,39,1
126678,1467,675,792,40,1
126678,17,8,9,41,4
126678,16,7,9,42,1
126678,16,7,9,51,1
126678,1,1,0,52,3
126687,847,121,726,1,4
126687,847,121,726,2,1
126687,847,121,726,3,1
126687,189,28,161,4,1
126687,658,93,565,5,1
126687,658,93,565,20,1
126687,847,121,726,21,4
126687,847,121,726,22,1
126687,847,121,726,23,1
126687,189,28,161,24,1
126687,658,93,565,25,1
126687,658,93,565,40,1
126702,1794,986,808,1,4
126702,1794,986,808,2,1
126702,1794,986,808,3,1
126702,289,180,109,4,1
126702,1505,806,699,5,1
126702,334,184,150,19,1
126702,1171,622,549,20,1
126702,1145,657,488,21,4
126702,1145,657,488,22,1
126702,1145,657,488,23,1
126702,225,136,89,24,1
126702,920,521,399,25,1
126702,230,136,94,39,1
126702,690,385,305,40,1
126702,649,329,320,41,4
126702,649,329,320,42,1
126702,649,329,320,43,1
126702,64,44,20,44,1
126702,585,285,300,45,1
126702,104,48,56,59,1
126702,481,237,244,60,1
126711,5893,2598,3295,1,4
126711,5893,2598,3295,2,1
126711,3559,1625,1934,3,1
126711,640,377,263,4,1
126711,2919,1248,1671,5,1
126711,2334,973,1361,11,1
126711,300,155,145,19,1
126711,2619,1093,1526,20,1
126711,1990,1087,903,21,4
126711,1990,1087,903,22,1
126711,1693,924,769,23,1
126711,402,257,145,24,1
126711,1291,667,624,25,1
126711,297,163,134,31,1
126711,192,110,82,39,1
126711,1099,557,542,40,1
126711,3903,1511,2392,41,4
126711,3903,1511,2392,42,1
126711,1866,701,1165,43,1
126711,238,120,118,44,1
126711,1628,581,1047,45,1
126711,2037,810,1227,51,1
126711,108,45,63,59,1
126711,1520,536,984,60,1
126748,1138,472,666,1,4
126748,1138,472,666,2,1
126748,649,226,423,3,1
126748,170,78,92,4,1
126748,479,148,331,5,1
126748,489,246,243,11,1
126748,124,41,83,19,1
126748,355,107,248,20,1
126748,490,203,287,21,4
126748,490,203,287,22,1
126748,428,180,248,23,1
126748,129,71,58,24,1
126748,299,109,190,25,1
126748,62,23,39,31,1
126748,77,34,43,39,1
126748,222,75,147,40,1
126748,648,269,379,41,4
126748,648,269,379,42,1
126748,221,46,175,43,1
126748,41,7,34,44,1
126748,180,39,141,45,1
126748,427,223,204,51,1
126748,47,7,40,59,1
126748,133,32,101,60,1
126775,5790,4137,1653,1,4
126775,4291,3137,1154,2,1
126775,4197,3058,1139,3,1
126775,954,682,272,4,1
126775,3243,2376,867,5,1
126775,94,79,15,11,1
126775,1499,1000,499,12,3
126775,144,107,37,19,1
126775,3099,2269,830,20,1
126775,5188,3788,1400,21,4
126775,4080,2967,1113,22,1
126775,4026,2921,1105,23,1
126775,954,682,272,24,1
126775,3072,2239,833,25,1
126775,54,46,8,31,1
126775,1108,821,287,32,3
126775,132,98,34,39,1
126775,2940,2141,799,40,1
126775,602,349,253,41,4
126775,211,170,41,42,1
126775,171,137,34,43,1
126775,171,137,34,45,1
126775,40,33,7,51,1
126775,391,179,212,52,3
126775,12,9,3,59,1
126775,159,128,31,60,1
126784,182,180,2,1,4
126784,182,180,2,2,1
126784,182,180,2,3,1
126784,60,60,0,4,1
126784,122,120,2,5,1
126784,122,120,2,20,1
126784,182,180,2,21,4
126784,182,180,2,22,1
126784,182,180,2,23,1
126784,60,60,0,24,1
126784,122,120,2,25,1
126784,122,120,2,40,1
126818,31186,15194,15992,1,4
126818,23548,11440,12108,2,1
126818,22482,10960,11522,3,1
126818,4435,2015,2420,4,1
126818,18047,8945,9102,5,1
126818,1066,480,586,11,1
126818,7638,3754,3884,12,3
126818,1426,744,682,19,1
126818,16621,8201,8420,20,1
126818,23371,10978,12393,21,4
126818,20400,9766,10634,22,1
126818,20180,9654,10526,23,1
126818,4322,1954,2368,24,1
126818,15858,7700,8158,25,1
126818,220,112,108,31,1
126818,2971,1212,1759,32,3
126818,1216,633,583,39,1
126818,14642,7067,7575,40,1
126818,7815,4216,3599,41,4
126818,3148,1674,1474,42,1
126818,2302,1306,996,43,1
126818,113,61,52,44,1
126818,2189,1245,944,45,1
126818,846,368,478,51,1
126818,4667,2542,2125,52,3
126818,210,111,99,59,1
126818,1979,1134,845,60,1
126827,2049,1336,713,1,4
126827,1216,790,426,2,1
126827,1200,775,425,3,1
126827,78,45,33,4,1
126827,1122,730,392,5,1
126827,16,15,1,11,1
126827,833,546,287,12,3
126827,126,65,61,19,1
126827,996,665,331,20,1
126827,1296,866,430,21,4
126827,713,477,236,22,1
126827,704,469,235,23,1
126827,57,35,22,24,1
126827,647,434,213,25,1
126827,9,8,1,31,1
126827,583,389,194,32,3
126827,88,49,39,39,1
126827,559,385,174,40,1
126827,753,470,283,41,4
126827,503,313,190,42,1
126827,496,306,190,43,1
126827,21,10,11,44,1
126827,475,296,179,45,1
126827,7,7,0,51,1
126827,250,157,93,52,3
126827,38,16,22,59,1
126827,437,280,157,60,1
126854,62,3,59,1,4
126854,62,3,59,2,1
126854,62,3,59,3,1
126854,25,2,23,4,1
126854,37,1,36,5,1
126854,37,1,36,20,1
126854,62,3,59,21,4
126854,62,3,59,22,1
126854,62,3,59,23,1
126854,25,2,23,24,1
126854,37,1,36,25,1
126854,37,1,36,40,1
126863,7874,3328,4546,1,4
126863,7874,3328,4546,2,1
126863,5694,2293,3401,3,1
126863,1087,450,637,4,1
126863,4607,1843,2764,5,1
126863,2180,1035,1145,11,1
126863,723,295,428,19,1
126863,3884,1548,2336,20,1
126863,1636,823,813,21,4
126863,1636,823,813,22,1
126863,1481,756,725,23,1
126863,358,184,174,24,1
126863,1123,572,551,25,1
126863,155,67,88,31,1
126863,218,115,103,39,1
126863,905,457,448,40,1
126863,6238,2505,3733,41,4
126863,6238,2505,3733,42,1
126863,4213,1537,2676,43,1
126863,729,266,463,44,1
126863,3484,1271,2213,45,1
126863,2025,968,1057,51,1
126863,505,180,325,59,1
126863,2979,1091,1888,60,1
126872,497,107,390,1,4
126872,497,107,390,2,1
126872,497,107,390,3,1
126872,107,17,90,4,1
126872,390,90,300,5,1
126872,5,0,5,19,1
126872,385,90,295,20,1
126872,497,107,390,21,4
126872,497,107,390,22,1
126872,497,107,390,23,1
126872,107,17,90,24,1
126872,390,90,300,25,1
126872,5,0,5,39,1
126872,385,90,295,40,1
126915,423,135,288,1,4
126915,423,135,288,2,1
126915,262,86,176,3,1
126915,193,63,130,4,1
126915,69,23,46,5,1
126915,161,49,112,11,1
126915,69,23,46,20,1
126915,129,48,81,21,4
126915,129,48,81,22,1
126915,129,48,81,23,1
126915,103,38,65,24,1
126915,26,10,16,25,1
126915,26,10,16,40,1
126915,294,87,207,41,4
126915,294,87,207,42,1
126915,133,38,95,43,1
126915,90,25,65,44,1
126915,43,13,30,45,1
126915,161,49,112,51,1
126915,43,13,30,60,1
126924,34,3,31,1,4
126924,34,3,31,2,1
126924,34,3,31,3,1
126924,34,3,31,5,1
126924,34,3,31,20,1
126924,34,3,31,21,4
126924,34,3,31,22,1
126924,34,3,31,23,1
126924,34,3,31,25,1
126924,34,3,31,40,1
126942,10432,4613,5819,1,4
126942,10432,4613,5819,2,1
126942,8003,3498,4505,3,1
126942,1504,740,764,4,1
126942,6499,2758,3741,5,1
126942,2429,1115,1314,11,1
126942,905,408,497,19,1
126942,5594,2350,3244,20,1
126942,2415,1187,1228,21,4
126942,2415,1187,1228,22,1
126942,2288,1129,1159,23,1
126942,407,212,195,24,1
126942,1881,917,964,25,1
126942,127,58,69,31,1
126942,259,149,110,39,1
126942,1622,768,854,40,1
126942,8017,3426,4591,41,4
126942,8017,3426,4591,42,1
126942,5715,2369,3346,43,1
126942,1097,528,569,44,1
126942,4618,1841,2777,45,1
126942,2302,1057,1245,51,1
126942,646,259,387,59,1
126942,3972,1582,2390,60,1
126951,1262,1209,53,1,4
126951,1262,1209,53,2,1
126951,1262,1209,53,3,1
126951,335,318,17,4,1
126951,927,891,36,5,1
126951,1,1,0,19,1
126951,926,890,36,20,1
126951,1262,1209,53,21,4
126951,1262,1209,53,22,1
126951,1262,1209,53,23,1
126951,335,318,17,24,1
126951,927,891,36,25,1
126951,1,1,0,39,1
126951,926,890,36,40,1
126979,990,582,408,1,4
126979,990,582,408,12,3
126979,553,364,189,21,4
126979,553,364,189,32,3
126979,437,218,219,41,4
126979,437,218,219,52,3
127024,438,256,182,1,4
127024,438,256,182,2,1
127024,438,256,182,3,1
127024,33,19,14,4,1
127024,405,237,168,5,1
127024,405,237,168,20,1
127024,310,175,135,21,4
127024,310,175,135,22,1
127024,310,175,135,23,1
127024,28,15,13,24,1
127024,282,160,122,25,1
127024,282,160,122,40,1
127024,128,81,47,41,4
127024,128,81,47,42,1
127024,128,81,47,43,1
127024,5,4,1,44,1
127024,123,77,46,45,1
127024,123,77,46,60,1
127060,11778,5128,6650,1,4
127060,5517,2499,3018,2,1
127060,5505,2494,3011,3,1
127060,1407,667,740,4,1
127060,4098,1827,2271,5,1
127060,12,5,7,11,1
127060,6261,2629,3632,12,3
127060,221,109,112,19,1
127060,3877,1718,2159,20,1
127060,8411,3620,4791,21,4
127060,5129,2353,2776,22,1
127060,5119,2349,2770,23,1
127060,1399,662,737,24,1
127060,3720,1687,2033,25,1
127060,10,4,6,31,1
127060,3282,1267,2015,32,3
127060,182,92,90,39,1
127060,3538,1595,1943,40,1
127060,3367,1508,1859,41,4
127060,388,146,242,42,1
127060,386,145,241,43,1
127060,8,5,3,44,1
127060,378,140,238,45,1
127060,2,1,1,51,1
127060,2979,1362,1617,52,3
127060,39,17,22,59,1
127060,339,123,216,60,1
127158,2802,1951,851,1,4
127158,2802,1951,851,2,1
127158,2802,1951,851,3,1
127158,497,222,275,4,1
127158,2305,1729,576,5,1
127158,2305,1729,576,20,1
127158,502,242,260,21,4
127158,502,242,260,22,1
127158,502,242,260,23,1
127158,177,69,108,24,1
127158,325,173,152,25,1
127158,325,173,152,40,1
127158,2300,1709,591,41,4
127158,2300,1709,591,42,1
127158,2300,1709,591,43,1
127158,320,153,167,44,1
127158,1980,1556,424,45,1
127158,1980,1556,424,60,1
127185,4021,2050,1971,1,4
127185,3984,2043,1941,2,1
127185,3859,1979,1880,3,1
127185,873,465,408,4,1
127185,2986,1514,1472,5,1
127185,125,64,61,11,1
127185,37,7,30,12,3
127185,414,220,194,19,1
127185,2572,1294,1278,20,1
127185,3670,1871,1799,21,4
127185,3670,1871,1799,22,1
127185,3592,1831,1761,23,1
127185,862,461,401,24,1
127185,2730,1370,1360,25,1
127185,78,40,38,31,1
127185,382,205,177,39,1
127185,2348,1165,1183,40,1
127185,351,179,172,41,4
127185,314,172,142,42,1
127185,267,148,119,43,1
127185,11,4,7,44,1
127185,256,144,112,45,1
127185,47,24,23,51,1
127185,37,7,30,52,3
127185,32,15,17,59,1
127185,224,129,95,60,1
127200,19619,8537,11082,1,4
127200,19619,8537,11082,2,1
127200,16297,7031,9266,3,1
127200,2511,1221,1290,4,1
127200,13786,5810,7976,5,1
127200,3322,1506,1816,11,1
127200,1899,883,1016,19,1
127200,11887,4927,6960,20,1
127200,6120,2974,3146,21,4
127200,6120,2974,3146,22,1
127200,5713,2753,2960,23,1
127200,1088,599,489,24,1
127200,4625,2154,2471,25,1
127200,407,221,186,31,1
127200,683,355,328,39,1
127200,3942,1799,2143,40,1
127200,13499,5563,7936,41,4
127200,13499,5563,7936,42,1
127200,10584,4278,6306,43,1
127200,1423,622,801,44,1
127200,9161,3656,5505,45,1
127200,2915,1285,1630,51,1
127200,1216,528,688,59,1
127200,7945,3128,4817,60,1
127219,53,1,52,1,4
127219,53,1,52,2,1
127219,53,1,52,3,1
127219,25,0,25,4,1
127219,28,1,27,5,1
127219,28,1,27,20,1
127219,46,1,45,21,4
127219,46,1,45,22,1
127219,46,1,45,23,1
127219,22,0,22,24,1
127219,24,1,23,25,1
127219,24,1,23,40,1
127219,7,0,7,41,4
127219,7,0,7,42,1
127219,7,0,7,43,1
127219,3,0,3,44,1
127219,4,0,4,45,1
127219,4,0,4,60,1
127228,174,9,165,1,4
127228,174,9,165,2,1
127228,174,9,165,3,1
127228,55,4,51,4,1
127228,119,5,114,5,1
127228,119,5,114,20,1
127228,174,9,165,21,4
127228,174,9,165,22,1
127228,174,9,165,23,1
127228,55,4,51,24,1
127228,119,5,114,25,1
127228,119,5,114,40,1
127273,349,148,201,1,4
127273,349,148,201,12,3
127273,182,79,103,21,4
127273,182,79,103,32,3
127273,167,69,98,41,4
127273,167,69,98,52,3
127316,205,42,163,1,4
127316,205,42,163,2,1
127316,205,42,163,3,1
127316,13,3,10,4,1
127316,192,39,153,5,1
127316,192,39,153,20,1
127316,136,24,112,21,4
127316,136,24,112,22,1
127316,136,24,112,23,1
127316,11,2,9,24,1
127316,125,22,103,25,1
127316,125,22,103,40,1
127316,69,18,51,41,4
127316,69,18,51,42,1
127316,69,18,51,43,1
127316,2,1,1,44,1
127316,67,17,50,45,1
127316,67,17,50,60,1
127389,902,390,512,1,4
127389,902,390,512,2,1
127389,538,217,321,3,1
127389,162,74,88,4,1
127389,376,143,233,5,1
127389,364,173,191,11,1
127389,64,29,35,19,1
127389,312,114,198,20,1
127389,463,206,257,21,4
127389,463,206,257,22,1
127389,393,180,213,23,1
127389,142,70,72,24,1
127389,251,110,141,25,1
127389,70,26,44,31,1
127389,44,24,20,39,1
127389,207,86,121,40,1
127389,439,184,255,41,4
127389,439,184,255,42,1
127389,145,37,108,43,1
127389,20,4,16,44,1
127389,125,33,92,45,1
127389,294,147,147,51,1
127389,20,5,15,59,1
127389,105,28,77,60,1
127556,9676,4330,5346,1,4
127556,9576,4292,5284,2,1
127556,8733,3995,4738,3,1
127556,2208,1099,1109,4,1
127556,6525,2896,3629,5,1
127556,843,297,546,11,1
127556,100,38,62,12,3
127556,579,252,327,19,1
127556,5946,2644,3302,20,1
127556,7284,3447,3837,21,4
127556,7267,3437,3830,22,1
127556,7212,3416,3796,23,1
127556,2081,1043,1038,24,1
127556,5131,2373,2758,25,1
127556,55,21,34,31,1
127556,17,10,7,32,3
127556,469,215,254,39,1
127556,4662,2158,2504,40,1
127556,2392,883,1509,41,4
127556,2309,855,1454,42,1
127556,1521,579,942,43,1
127556,127,56,71,44,1
127556,1394,523,871,45,1
127556,788,276,512,51,1
127556,83,28,55,52,3
127556,110,37,73,59,1
127556,1284,486,798,60,1
127565,22752,10441,12311,1,4
127565,22289,10328,11961,2,1
127565,21696,10120,11576,3,1
127565,2234,1154,1080,4,1
127565,19462,8966,10496,5,1
127565,593,208,385,11,1
127565,463,113,350,12,3
127565,2860,1245,1615,19,1
127565,16602,7721,8881,20,1
127565,13508,6375,7133,21,4
127565,13202,6305,6897,22,1
127565,13030,6236,6794,23,1
127565,1726,887,839,24,1
127565,11304,5349,5955,25,1
127565,172,69,103,31,1
127565,306,70,236,32,3
127565,1784,802,982,39,1
127565,9520,4547,4973,40,1
127565,9244,4066,5178,41,4
127565,9087,4023,5064,42,1
127565,8666,3884,4782,43,1
127565,508,267,241,44,1
127565,8158,3617,4541,45,1
127565,421,139,282,51,1
127565,157,43,114,52,3
127565,1076,443,633,59,1
127565,7082,3174,3908,60,1
127617,1851,654,1197,1,4
127617,1851,654,1197,2,1
127617,937,259,678,3,1
127617,193,69,124,4,1
127617,744,190,554,5,1
127617,914,395,519,11,1
127617,59,13,46,19,1
127617,685,177,508,20,1
127617,425,153,272,21,4
127617,425,153,272,22,1
127617,337,107,230,23,1
127617,53,23,30,24,1
127617,284,84,200,25,1
127617,88,46,42,31,1
127617,21,4,17,39,1
127617,263,80,183,40,1
127617,1426,501,925,41,4
127617,1426,501,925,42,1
127617,600,152,448,43,1
127617,140,46,94,44,1
127617,460,106,354,45,1
127617,826,349,477,51,1
127617,38,9,29,59,1
127617,422,97,325,60,1
127653,992,328,664,1,4
127653,383,138,245,2,1
127653,380,137,243,3,1
127653,37,17,20,4,1
127653,343,120,223,5,1
127653,3,1,2,11,1
127653,609,190,419,12,3
127653,92,36,56,19,1
127653,251,84,167,20,1
127653,799,260,539,21,4
127653,358,123,235,22,1
127653,356,123,233,23,1
127653,37,17,20,24,1
127653,319,106,213,25,1
127653,2,0,2,31,1
127653,441,137,304,32,3
127653,87,31,56,39,1
127653,232,75,157,40,1
127653,193,68,125,41,4
127653,25,15,10,42,1
127653,24,14,10,43,1
127653,24,14,10,45,1
127653,1,1,0,51,1
127653,168,53,115,52,3
127653,5,5,0,59,1
127653,19,9,10,60,1
127680,281,110,171,1,4
127680,281,110,171,2,1
127680,281,110,171,3,1
127680,21,11,10,4,1
127680,260,99,161,5,1
127680,55,15,40,19,1
127680,205,84,121,20,1
127680,57,24,33,21,4
127680,57,24,33,22,1
127680,57,24,33,23,1
127680,4,2,2,24,1
127680,53,22,31,25,1
127680,12,2,10,39,1
127680,41,20,21,40,1
127680,224,86,138,41,4
127680,224,86,138,42,1
127680,224,86,138,43,1
127680,17,9,8,44,1
127680,207,77,130,45,1
127680,43,13,30,59,1
127680,164,64,100,60,1
127699,258,58,200,1,4
127699,258,58,200,2,1
127699,258,58,200,3,1
127699,15,5,10,4,1
127699,243,53,190,5,1
127699,64,19,45,19,1
127699,179,34,145,20,1
127699,55,11,44,21,4
127699,55,11,44,22,1
127699,55,11,44,23,1
127699,1,0,1,24,1
127699,54,11,43,25,1
127699,10,4,6,39,1
127699,44,7,37,40,1
127699,203,47,156,41,4
127699,203,47,156,42,1
127699,203,47,156,43,1
127699,14,5,9,44,1
127699,189,42,147,45,1
127699,54,15,39,59,1
127699,135,27,108,60,1
127714,889,542,347,1,4
127714,889,542,347,2,1
127714,889,542,347,3,1
127714,39,28,11,4,1
127714,850,514,336,5,1
127714,236,140,96,19,1
127714,614,374,240,20,1
127714,174,104,70,21,4
127714,174,104,70,22,1
127714,174,104,70,23,1
127714,14,11,3,24,1
127714,160,93,67,25,1
127714,26,14,12,39,1
127714,134,79,55,40,1
127714,715,438,277,41,4
127714,715,438,277,42,1
127714,715,438,277,43,1
127714,25,17,8,44,1
127714,690,421,269,45,1
127714,210,126,84,59,1
127714,480,295,185,60,1
127732,1962,802,1160,1,4
127732,1962,802,1160,2,1
127732,1257,588,669,3,1
127732,313,168,145,4,1
127732,944,420,524,5,1
127732,705,214,491,11,1
127732,72,33,39,19,1
127732,872,387,485,20,1
127732,966,483,483,21,4
127732,966,483,483,22,1
127732,957,478,479,23,1
127732,267,140,127,24,1
127732,690,338,352,25,1
127732,9,5,4,31,1
127732,46,26,20,39,1
127732,644,312,332,40,1
127732,996,319,677,41,4
127732,996,319,677,42,1
127732,300,110,190,43,1
127732,46,28,18,44,1
127732,254,82,172,45,1
127732,696,209,487,51,1
127732,26,7,19,59,1
127732,228,75,153,60,1
127741,12710,4446,8264,1,4
127741,9947,3686,6261,2,1
127741,9525,3517,6008,3,1
127741,1982,725,1257,4,1
127741,7543,2792,4751,5,1
127741,422,169,253,11,1
127741,2763,760,2003,12,3
127741,798,270,528,19,1
127741,6745,2522,4223,20,1
127741,9735,3637,6098,21,4
127741,8733,3296,5437,22,1
127741,8644,3265,5379,23,1
127741,1967,720,1247,24,1
127741,6677,2545,4132,25,1
127741,89,31,58,31,1
127741,1002,341,661,32,3
127741,630,249,381,39,1
127741,6047,2296,3751,40,1
127741,2975,809,2166,41,4
127741,1214,390,824,42,1
127741,881,252,629,43,1
127741,15,5,10,44,1
127741,866,247,619,45,1
127741,333,138,195,51,1
127741,1761,419,1342,52,3
127741,168,21,147,59,1
127741,698,226,472,60,1
127778,1449,617,832,1,4
127778,1449,617,832,2,1
127778,1011,430,581,3,1
127778,249,135,114,4,1
127778,762,295,467,5,1
127778,438,187,251,11,1
127778,115,49,66,19,1
127778,647,246,401,20,1
127778,679,328,351,21,4
127778,679,328,351,22,1
127778,653,316,337,23,1
127778,211,119,92,24,1
127778,442,197,245,25,1
127778,26,12,14,31,1
127778,62,33,29,39,1
127778,380,164,216,40,1
127778,770,289,481,41,4
127778,770,289,481,42,1
127778,358,114,244,43,1
127778,38,16,22,44,1
127778,320,98,222,45,1
127778,412,175,237,51,1
127778,53,16,37,59,1
127778,267,82,185,60,1
127787,371,74,297,1,4
127787,371,74,297,2,1
127787,371,74,297,3,1
127787,33,5,28,4,1
127787,338,69,269,5,1
127787,44,15,29,19,1
127787,294,54,240,20,1
127787,288,38,250,21,4
127787,288,38,250,22,1
127787,288,38,250,23,1
127787,33,5,28,24,1
127787,255,33,222,25,1
127787,35,7,28,39,1
127787,220,26,194,40,1
127787,83,36,47,41,4
127787,83,36,47,42,1
127787,83,36,47,43,1
127787,83,36,47,45,1
127787,9,8,1,59,1
127787,74,28,46,60,1
127820,14634,6261,8373,1,4
127820,14634,6261,8373,2,1
127820,12747,5380,7367,3,1
127820,2547,1255,1292,4,1
127820,10200,4125,6075,5,1
127820,1887,881,1006,11,1
127820,1442,552,890,19,1
127820,8758,3573,5185,20,1
127820,5547,2539,3008,21,4
127820,5547,2539,3008,22,1
127820,5262,2406,2856,23,1
127820,1206,615,591,24,1
127820,4056,1791,2265,25,1
127820,285,133,152,31,1
127820,600,254,346,39,1
127820,3456,1537,1919,40,1
127820,9087,3722,5365,41,4
127820,9087,3722,5365,42,1
127820,7485,2974,4511,43,1
127820,1341,640,701,44,1
127820,6144,2334,3810,45,1
127820,1602,748,854,51,1
127820,842,298,544,59,1
127820,5302,2036,3266,60,1
127839,339,90,249,1,4
127839,339,90,249,2,1
127839,339,90,249,3,1
127839,11,2,9,4,1
127839,328,88,240,5,1
127839,12,2,10,19,1
127839,316,86,230,20,1
127839,339,90,249,21,4
127839,339,90,249,22,1
127839,339,90,249,23,1
127839,11,2,9,24,1
127839,328,88,240,25,1
127839,12,2,10,39,1
127839,316,86,230,40,1
127884,6718,3044,3674,1,4
127884,6718,3044,3674,2,1
127884,4922,1884,3038,3,1
127884,849,364,485,4,1
127884,4073,1520,2553,5,1
127884,1796,1160,636,11,1
127884,425,155,270,19,1
127884,3648,1365,2283,20,1
127884,2521,1217,1304,21,4
127884,2521,1217,1304,22,1
127884,2041,919,1122,23,1
127884,394,205,189,24,1
127884,1647,714,933,25,1
127884,480,298,182,31,1
127884,150,70,80,39,1
127884,1497,644,853,40,1
127884,4197,1827,2370,41,4
127884,4197,1827,2370,42,1
127884,2881,965,1916,43,1
127884,455,159,296,44,1
127884,2426,806,1620,45,1
127884,1316,862,454,51,1
127884,275,85,190,59,1
127884,2151,721,1430,60,1
127909,8599,4275,4324,1,4
127909,8599,4275,4324,2,1
127909,8224,4069,4155,3,1
127909,1330,699,631,4,1
127909,6894,3370,3524,5,1
127909,375,206,169,11,1
127909,1105,541,564,19,1
127909,5789,2829,2960,20,1
127909,2765,1550,1215,21,4
127909,2765,1550,1215,22,1
127909,2703,1514,1189,23,1
127909,505,285,220,24,1
127909,2198,1229,969,25,1
127909,62,36,26,31,1
127909,349,202,147,39,1
127909,1849,1027,822,40,1
127909,5834,2725,3109,41,4
127909,5834,2725,3109,42,1
127909,5521,2555,2966,43,1
127909,825,414,411,44,1
127909,4696,2141,2555,45,1
127909,313,170,143,51,1
127909,756,339,417,59,1
127909,3940,1802,2138,60,1
127918,9722,3526,6196,1,4
127918,5172,1929,3243,2,1
127918,4930,1809,3121,3,1
127918,390,135,255,4,1
127918,4540,1674,2866,5,1
127918,242,120,122,11,1
127918,4550,1597,2953,12,3
127918,507,211,296,19,1
127918,4033,1463,2570,20,1
127918,5251,1897,3354,21,4
127918,2508,936,1572,22,1
127918,2498,934,1564,23,1
127918,389,134,255,24,1
127918,2109,800,1309,25,1
127918,10,2,8,31,1
127918,2743,961,1782,32,3
127918,183,83,100,39,1
127918,1926,717,1209,40,1
127918,4471,1629,2842,41,4
127918,2664,993,1671,42,1
127918,2432,875,1557,43,1
127918,1,1,0,44,1
127918,2431,874,1557,45,1
127918,232,118,114,51,1
127918,1807,636,1171,52,3
127918,324,128,196,59,1
127918,2107,746,1361,60,1
127945,775,284,491,1,4
127945,739,272,467,2,1
127945,722,262,460,3,1
127945,64,27,37,4,1
127945,658,235,423,5,1
127945,17,10,7,11,1
127945,36,12,24,12,3
127945,222,87,135,19,1
127945,436,148,288,20,1
127945,562,200,362,21,4
127945,554,195,359,22,1
127945,553,194,359,23,1
127945,47,18,29,24,1
127945,506,176,330,25,1
127945,1,1,0,31,1
127945,8,5,3,32,3
127945,139,56,83,39,1
127945,367,120,247,40,1
127945,213,84,129,41,4
127945,185,77,108,42,1
127945,169,68,101,43,1
127945,17,9,8,44,1
127945,152,59,93,45,1
127945,16,9,7,51,1
127945,28,7,21,52,3
127945,83,31,52,59,1
127945,69,28,41,60,1
127954,79,6,73,1,4
127954,11,0,11,2,1
127954,11,0,11,3,1
127954,3,0,3,4,1
127954,8,0,8,5,1
127954,68,6,62,12,3
127954,8,0,8,20,1
127954,79,6,73,21,4
127954,11,0,11,22,1
127954,11,0,11,23,1
127954,3,0,3,24,1
127954,8,0,8,25,1
127954,68,6,62,32,3
127954,8,0,8,40,1
128106,7089,2688,4401,1,4
128106,5207,2314,2893,2,1
128106,4375,2023,2352,3,1
128106,793,382,411,4,1
128106,3582,1641,1941,5,1
128106,832,291,541,11,1
128106,1882,374,1508,12,3
128106,411,174,237,19,1
128106,3171,1467,1704,20,1
128106,4051,1854,2197,21,4
128106,3742,1774,1968,22,1
128106,3728,1767,1961,23,1
128106,765,364,401,24,1
128106,2963,1403,1560,25,1
128106,14,7,7,31,1
128106,309,80,229,32,3
128106,307,140,167,39,1
128106,2656,1263,1393,40,1
128106,3038,834,2204,41,4
128106,1465,540,925,42,1
128106,647,256,391,43,1
128106,28,18,10,44,1
128106,619,238,381,45,1
128106,818,284,534,51,1
128106,1573,294,1279,52,3
128106,104,34,70,59,1
128106,515,204,311,60,1
128151,1184,668,516,1,4
128151,1184,668,516,2,1
128151,1184,668,516,3,1
128151,128,76,52,4,1
128151,1056,592,464,5,1
128151,1056,592,464,20,1
128151,1054,615,439,21,4
128151,1054,615,439,22,1
128151,1054,615,439,23,1
128151,106,70,36,24,1
128151,948,545,403,25,1
128151,948,545,403,40,1
128151,130,53,77,41,4
128151,130,53,77,42,1
128151,130,53,77,43,1
128151,22,6,16,44,1
128151,108,47,61,45,1
128151,108,47,61,60,1
128179,815,665,150,1,4
128179,815,665,150,2,1
128179,815,665,150,3,1
128179,182,142,40,4,1
128179,633,523,110,5,1
128179,633,523,110,20,1
128179,815,665,150,21,4
128179,815,665,150,22,1
128179,815,665,150,23,1
128179,182,142,40,24,1
128179,633,523,110,25,1
128179,633,523,110,40,1
128188,536,134,402,1,4
128188,536,134,402,2,1
128188,536,134,402,3,1
128188,74,19,55,4,1
128188,462,115,347,5,1
128188,81,19,62,19,1
128188,381,96,285,20,1
128188,536,134,402,21,4
128188,536,134,402,22,1
128188,536,134,402,23,1
128188,74,19,55,24,1
128188,462,115,347,25,1
128188,81,19,62,39,1
128188,381,96,285,40,1
128258,1791,825,966,1,4
128258,1791,825,966,2,1
128258,1307,602,705,3,1
128258,320,183,137,4,1
128258,987,419,568,5,1
128258,484,223,261,11,1
128258,151,72,79,19,1
128258,836,347,489,20,1
128258,900,471,429,21,4
128258,900,471,429,22,1
128258,875,455,420,23,1
128258,266,161,105,24,1
128258,609,294,315,25,1
128258,25,16,9,31,1
128258,105,59,46,39,1
128258,504,235,269,40,1
128258,891,354,537,41,4
128258,891,354,537,42,1
128258,432,147,285,43,1
128258,54,22,32,44,1
128258,378,125,253,45,1
128258,459,207,252,51,1
128258,46,13,33,59,1
128258,332,112,220,60,1
128328,3993,3097,896,1,4
128328,3993,3097,896,2,1
128328,3993,3097,896,3,1
128328,1154,887,267,4,1
128328,2839,2210,629,5,1
128328,2839,2210,629,20,1
128328,3993,3097,896,21,4
128328,3993,3097,896,22,1
128328,3993,3097,896,23,1
128328,1154,887,267,24,1
128328,2839,2210,629,25,1
128328,2839,2210,629,40,1
128337,161,6,155,1,4
128337,161,6,155,2,1
128337,161,6,155,3,1
128337,61,4,57,4,1
128337,100,2,98,5,1
128337,100,2,98,20,1
128337,121,4,117,21,4
128337,121,4,117,22,1
128337,121,4,117,23,1
128337,47,3,44,24,1
128337,74,1,73,25,1
128337,74,1,73,40,1
128337,40,2,38,41,4
128337,40,2,38,42,1
128337,40,2,38,43,1
128337,14,1,13,44,1
128337,26,1,25,45,1
128337,26,1,25,60,1
128391,2404,1330,1074,1,4
128391,2193,1269,924,2,1
128391,1956,1157,799,3,1
128391,469,256,213,4,1
128391,1487,901,586,5,1
128391,237,112,125,11,1
128391,211,61,150,12,3
128391,155,96,59,19,1
128391,1332,805,527,20,1
128391,1993,1164,829,21,4
128391,1869,1115,754,22,1
128391,1847,1098,749,23,1
128391,466,253,213,24,1
128391,1381,845,536,25,1
128391,22,17,5,31,1
128391,124,49,75,32,3
128391,148,94,54,39,1
128391,1233,751,482,40,1
128391,411,166,245,41,4
128391,324,154,170,42,1
128391,109,59,50,43,1
128391,3,3,0,44,1
128391,106,56,50,45,1
128391,215,95,120,51,1
128391,87,12,75,52,3
128391,7,2,5,59,1
128391,99,54,45,60,1
128425,18,18,0,1,4
128425,16,16,0,2,1
128425,16,16,0,3,1
128425,7,7,0,4,1
128425,9,9,0,5,1
128425,2,2,0,12,3
128425,9,9,0,20,1
128425,18,18,0,21,4
128425,16,16,0,22,1
128425,16,16,0,23,1
128425,7,7,0,24,1
128425,9,9,0,25,1
128425,2,2,0,32,3
128425,9,9,0,40,1
128498,1582,520,1062,1,4
128498,1278,443,835,2,1
128498,1278,443,835,3,1
128498,143,65,78,4,1
128498,1135,378,757,5,1
128498,304,77,227,12,3
128498,144,52,92,19,1
128498,991,326,665,20,1
128498,1469,503,966,21,4
128498,1199,427,772,22,1
128498,1199,427,772,23,1
128498,137,62,75,24,1
128498,1062,365,697,25,1
128498,270,76,194,32,3
128498,138,50,88,39,1
128498,924,315,609,40,1
128498,113,17,96,41,4
128498,79,16,63,42,1
128498,79,16,63,43,1
128498,6,3,3,44,1
128498,73,13,60,45,1
128498,34,1,33,52,3
128498,6,2,4,59,1
128498,67,11,56,60,1
128540,127,7,120,1,4
128540,127,7,120,2,1
128540,127,7,120,3,1
128540,15,1,14,4,1
128540,112,6,106,5,1
128540,112,6,106,20,1
128540,89,6,83,21,4
128540,89,6,83,22,1
128540,89,6,83,23,1
128540,10,1,9,24,1
128540,79,5,74,25,1
128540,79,5,74,40,1
128540,38,1,37,41,4
128540,38,1,37,42,1
128540,38,1,37,43,1
128540,5,0,5,44,1
128540,33,1,32,45,1
128540,33,1,32,60,1
128577,1715,819,896,1,4
128577,1715,819,896,2,1
128577,1360,679,681,3,1
128577,298,184,114,4,1
128577,1062,495,567,5,1
128577,355,140,215,11,1
128577,170,80,90,19,1
128577,892,415,477,20,1
128577,703,416,287,21,4
128577,703,416,287,22,1
128577,697,412,285,23,1
128577,228,150,78,24,1
128577,469,262,207,25,1
128577,6,4,2,31,1
128577,86,52,34,39,1
128577,383,210,173,40,1
128577,1012,403,609,41,4
128577,1012,403,609,42,1
128577,663,267,396,43,1
128577,70,34,36,44,1
128577,593,233,360,45,1
128577,349,136,213,51,1
128577,84,28,56,59,1
128577,509,205,304,60,1
128586,59,59,0,1,4
128586,59,59,0,2,1
128586,59,59,0,3,1
128586,15,15,0,4,1
128586,44,44,0,5,1
128586,44,44,0,20,1
128586,59,59,0,21,4
128586,59,59,0,22,1
128586,59,59,0,23,1
128586,15,15,0,24,1
128586,44,44,0,25,1
128586,44,44,0,40,1
128674,524,139,385,1,4
128674,524,139,385,2,1
128674,524,139,385,3,1
128674,363,92,271,4,1
128674,161,47,114,5,1
128674,161,47,114,20,1
128674,357,99,258,21,4
128674,357,99,258,22,1
128674,357,99,258,23,1
128674,245,66,179,24,1
128674,112,33,79,25,1
128674,112,33,79,40,1
128674,167,40,127,41,4
128674,167,40,127,42,1
128674,167,40,127,43,1
128674,118,26,92,44,1
128674,49,14,35,45,1
128674,49,14,35,60,1
128683,837,216,621,1,4
128683,837,216,621,2,1
128683,837,216,621,3,1
128683,179,67,112,4,1
128683,658,149,509,5,1
128683,80,22,58,19,1
128683,578,127,451,20,1
128683,494,147,347,21,4
128683,494,147,347,22,1
128683,494,147,347,23,1
128683,166,64,102,24,1
128683,328,83,245,25,1
128683,52,15,37,39,1
128683,276,68,208,40,1
128683,343,69,274,41,4
128683,343,69,274,42,1
128683,343,69,274,43,1
128683,13,3,10,44,1
128683,330,66,264,45,1
128683,28,7,21,59,1
128683,302,59,243,60,1
128726,171,37,134,1,4
128726,171,37,134,2,1
128726,171,37,134,3,1
128726,116,21,95,4,1
128726,55,16,39,5,1
128726,55,16,39,20,1
128726,158,31,127,21,4
128726,158,31,127,22,1
128726,158,31,127,23,1
128726,105,17,88,24,1
128726,53,14,39,25,1
128726,53,14,39,40,1
128726,13,6,7,41,4
128726,13,6,7,42,1
128726,13,6,7,43,1
128726,11,4,7,44,1
128726,2,2,0,45,1
128726,2,2,0,60,1
128744,4842,1820,3022,1,4
128744,2835,959,1876,2,1
128744,2835,959,1876,3,1
128744,542,212,330,4,1
128744,2293,747,1546,5,1
128744,2007,861,1146,12,3
128744,254,89,165,19,1
128744,2039,658,1381,20,1
128744,3159,1350,1809,21,4
128744,2035,800,1235,22,1
128744,2035,800,1235,23,1
128744,538,208,330,24,1
128744,1497,592,905,25,1
128744,1124,550,574,32,3
128744,215,75,140,39,1
128744,1282,517,765,40,1
128744,1683,470,1213,41,4
128744,800,159,641,42,1
128744,800,159,641,43,1
128744,4,4,0,44,1
128744,796,155,641,45,1
128744,883,311,572,52,3
128744,39,14,25,59,1
128744,757,141,616,60,1
128771,11865,5828,6037,1,4
128771,9771,5108,4663,2,1
128771,9512,4956,4556,3,1
128771,1293,678,615,4,1
128771,8219,4278,3941,5,1
128771,259,152,107,11,1
128771,2094,720,1374,12,3
128771,1072,521,551,19,1
128771,7147,3757,3390,20,1
128771,8208,4201,4007,21,4
128771,7624,4003,3621,22,1
128771,7602,3993,3609,23,1
128771,1278,667,611,24,1
128771,6324,3326,2998,25,1
128771,22,10,12,31,1
128771,584,198,386,32,3
128771,814,406,408,39,1
128771,5510,2920,2590,40,1
128771,3657,1627,2030,41,4
128771,2147,1105,1042,42,1
128771,1910,963,947,43,1
128771,15,11,4,44,1
128771,1895,952,943,45,1
128771,237,142,95,51,1
128771,1510,522,988,52,3
128771,258,115,143,59,1
128771,1637,837,800,60,1
128780,1580,542,1038,1,4
128780,1580,542,1038,2,1
128780,1471,508,963,3,1
128780,1471,508,963,5,1
128780,109,34,75,11,1
128780,463,178,285,19,1
128780,1008,330,678,20,1
128780,301,96,205,21,4
128780,301,96,205,22,1
128780,298,95,203,23,1
128780,298,95,203,25,1
128780,3,1,2,31,1
128780,116,39,77,39,1
128780,182,56,126,40,1
128780,1279,446,833,41,4
128780,1279,446,833,42,1
128780,1173,413,760,43,1
128780,1173,413,760,45,1
128780,106,33,73,51,1
128780,347,139,208,59,1
128780,826,274,552,60,1
128896,304,75,229,1,4
128896,304,75,229,2,1
128896,304,75,229,3,1
128896,74,22,52,4,1
128896,230,53,177,5,1
128896,230,53,177,20,1
128896,67,24,43,21,4
128896,67,24,43,22,1
128896,67,24,43,23,1
128896,20,8,12,24,1
128896,47,16,31,25,1
128896,47,16,31,40,1
128896,237,51,186,41,4
128896,237,51,186,42,1
128896,237,51,186,43,1
128896,54,14,40,44,1
128896,183,37,146,45,1
128896,183,37,146,60,1
128902,1922,759,1163,1,4
128902,1915,755,1160,2,1
128902,1878,742,1136,3,1
128902,489,181,308,4,1
128902,1389,561,828,5,1
128902,37,13,24,11,1
128902,7,4,3,12,3
128902,14,5,9,19,1
128902,1375,556,819,20,1
128902,1881,745,1136,21,4
128902,1877,742,1135,22,1
128902,1873,742,1131,23,1
128902,489,181,308,24,1
128902,1384,561,823,25,1
128902,4,0,4,31,1
128902,4,3,1,32,3
128902,14,5,9,39,1
128902,1370,556,814,40,1
128902,41,14,27,41,4
128902,38,13,25,42,1
128902,5,0,5,43,1
128902,5,0,5,45,1
128902,33,13,20,51,1
128902,3,1,2,52,3
128902,5,0,5,60,1
128957,151,24,127,1,4
128957,151,24,127,2,1
128957,151,24,127,3,1
128957,10,2,8,4,1
128957,141,22,119,5,1
128957,141,22,119,20,1
128957,115,21,94,21,4
128957,115,21,94,22,1
128957,115,21,94,23,1
128957,6,2,4,24,1
128957,109,19,90,25,1
128957,109,19,90,40,1
128957,36,3,33,41,4
128957,36,3,33,42,1
128957,36,3,33,43,1
128957,4,0,4,44,1
128957,32,3,29,45,1
128957,32,3,29,60,1
129002,298,199,99,1,4
129002,298,199,99,2,1
129002,298,199,99,3,1
129002,66,51,15,4,1
129002,232,148,84,5,1
129002,232,148,84,20,1
129002,182,112,70,21,4
129002,182,112,70,22,1
129002,182,112,70,23,1
129002,48,34,14,24,1
129002,134,78,56,25,1
129002,134,78,56,40,1
129002,116,87,29,41,4
129002,116,87,29,42,1
129002,116,87,29,43,1
129002,18,17,1,44,1
129002,98,70,28,45,1
129002,98,70,28,60,1
129020,25911,12957,12954,1,4
129020,18032,9177,8855,2,1
129020,17684,8957,8727,3,1
129020,3755,1866,1889,4,1
129020,13929,7091,6838,5,1
129020,348,220,128,11,1
129020,7879,3780,4099,12,3
129020,785,376,409,19,1
129020,13144,6715,6429,20,1
129020,22482,11147,11335,21,4
129020,17219,8707,8512,22,1
129020,17083,8631,8452,23,1
129020,3741,1856,1885,24,1
129020,13342,6775,6567,25,1
129020,136,76,60,31,1
129020,5263,2440,2823,32,3
129020,754,362,392,39,1
129020,12588,6413,6175,40,1
129020,3429,1810,1619,41,4
129020,813,470,343,42,1
129020,601,326,275,43,1
129020,14,10,4,44,1
129020,587,316,271,45,1
129020,212,144,68,51,1
129020,2616,1340,1276,52,3
129020,31,14,17,59,1
129020,556,302,254,60,1
129154,3388,581,2807,1,4
129154,3388,581,2807,2,1
129154,3269,531,2738,3,1
129154,250,50,200,4,1
129154,3019,481,2538,5,1
129154,119,50,69,11,1
129154,708,131,577,19,1
129154,2311,350,1961,20,1
129154,593,131,462,21,4
129154,593,131,462,22,1
129154,582,127,455,23,1
129154,116,19,97,24,1
129154,466,108,358,25,1
129154,11,4,7,31,1
129154,154,29,125,39,1
129154,312,79,233,40,1
129154,2795,450,2345,41,4
129154,2795,450,2345,42,1
129154,2687,404,2283,43,1
129154,134,31,103,44,1
129154,2553,373,2180,45,1
129154,108,46,62,51,1
129154,554,102,452,59,1
129154,1999,271,1728,60,1
129181,655,630,25,1,4
129181,655,630,25,2,1
129181,655,630,25,3,1
129181,274,264,10,4,1
129181,381,366,15,5,1
129181,381,366,15,20,1
129181,456,443,13,21,4
129181,456,443,13,22,1
129181,456,443,13,23,1
129181,155,151,4,24,1
129181,301,292,9,25,1
129181,301,292,9,40,1
129181,199,187,12,41,4
129181,199,187,12,42,1
129181,199,187,12,43,1
129181,119,113,6,44,1
129181,80,74,6,45,1
129181,80,74,6,60,1
129215,5368,2444,2924,1,4
129215,5179,2396,2783,2,1
129215,4920,2263,2657,3,1
129215,985,430,555,4,1
129215,3935,1833,2102,5,1
129215,259,133,126,11,1
129215,189,48,141,12,3
129215,499,240,259,19,1
129215,3436,1593,1843,20,1
129215,4462,2033,2429,21,4
129215,4395,2023,2372,22,1
129215,4394,2022,2372,23,1
129215,963,414,549,24,1
129215,3431,1608,1823,25,1
129215,1,1,0,31,1
129215,67,10,57,32,3
129215,426,212,214,39,1
129215,3005,1396,1609,40,1
129215,906,411,495,41,4
129215,784,373,411,42,1
129215,526,241,285,43,1
129215,22,16,6,44,1
129215,504,225,279,45,1
129215,258,132,126,51,1
129215,122,38,84,52,3
129215,73,28,45,59,1
129215,431,197,234,60,1
129242,4919,1905,3014,1,4
129242,3873,1566,2307,2,1
129242,3721,1504,2217,3,1
129242,963,374,589,4,1
129242,2758,1130,1628,5,1
129242,152,62,90,11,1
129242,1046,339,707,12,3
129242,41,27,14,19,1
129242,2717,1103,1614,20,1
129242,3930,1553,2377,21,4
129242,3546,1426,2120,22,1
129242,3541,1421,2120,23,1
129242,963,374,589,24,1
129242,2578,1047,1531,25,1
129242,5,5,0,31,1
129242,384,127,257,32,3
129242,41,27,14,39,1
129242,2537,1020,1517,40,1
129242,989,352,637,41,4
129242,327,140,187,42,1
129242,180,83,97,43,1
129242,180,83,97,45,1
129242,147,57,90,51,1
129242,662,212,450,52,3
129242,180,83,97,60,1
129349,156,10,146,1,4
129349,156,10,146,2,1
129349,156,10,146,3,1
129349,36,1,35,4,1
129349,120,9,111,5,1
129349,120,9,111,20,1
129349,126,8,118,21,4
129349,126,8,118,22,1
129349,126,8,118,23,1
129349,33,1,32,24,1
129349,93,7,86,25,1
129349,93,7,86,40,1
129349,30,2,28,41,4
129349,30,2,28,42,1
129349,30,2,28,43,1
129349,3,0,3,44,1
129349,27,2,25,45,1
129349,27,2,25,60,1
129367,4168,1229,2939,1,4
129367,4168,1229,2939,2,1
129367,3732,1089,2643,3,1
129367,660,238,422,4,1
129367,3072,851,2221,5,1
129367,436,140,296,11,1
129367,347,112,235,19,1
129367,2725,739,1986,20,1
129367,993,353,640,21,4
129367,993,353,640,22,1
129367,984,349,635,23,1
129367,312,116,196,24,1
129367,672,233,439,25,1
129367,9,4,5,31,1
129367,104,38,66,39,1
129367,568,195,373,40,1
129367,3175,876,2299,41,4
129367,3175,876,2299,42,1
129367,2748,740,2008,43,1
129367,348,122,226,44,1
129367,2400,618,1782,45,1
129367,427,136,291,51,1
129367,243,74,169,59,1
129367,2157,544,1613,60,1
129428,281,224,57,1,4
129428,281,224,57,12,3
129428,11,9,2,21,4
129428,11,9,2,32,3
129428,270,215,55,41,4
129428,270,215,55,52,3
129482,327,37,290,1,4
129482,327,37,290,2,1
129482,327,37,290,3,1
129482,41,7,34,4,1
129482,286,30,256,5,1
129482,286,30,256,20,1
129482,327,37,290,21,4
129482,327,37,290,22,1
129482,327,37,290,23,1
129482,41,7,34,24,1
129482,286,30,256,25,1
129482,286,30,256,40,1
129491,123,67,56,1,4
129491,123,67,56,12,3
129491,36,22,14,21,4
129491,36,22,14,32,3
129491,87,45,42,41,4
129491,87,45,42,52,3
129525,6820,3228,3592,1,4
129525,5187,2589,2598,2,1
129525,5026,2511,2515,3,1
129525,1267,645,622,4,1
129525,3759,1866,1893,5,1
129525,161,78,83,11,1
129525,1633,639,994,12,3
129525,226,109,117,19,1
129525,3533,1757,1776,20,1
129525,5213,2577,2636,21,4
129525,4495,2300,2195,22,1
129525,4490,2297,2193,23,1
129525,1267,645,622,24,1
129525,3223,1652,1571,25,1
129525,5,3,2,31,1
129525,718,277,441,32,3
129525,190,98,92,39,1
129525,3033,1554,1479,40,1
129525,1607,651,956,41,4
129525,692,289,403,42,1
129525,536,214,322,43,1
129525,536,214,322,45,1
129525,156,75,81,51,1
129525,915,362,553,52,3
129525,36,11,25,59,1
129525,500,203,297,60,1
129534,385,269,116,1,4
129534,58,32,26,2,1
129534,48,26,22,3,1
129534,1,0,1,4,1
129534,47,26,21,5,1
129534,10,6,4,11,1
129534,327,237,90,12,3
129534,2,2,0,19,1
129534,45,24,21,20,1
129534,123,103,20,21,4
129534,36,21,15,22,1
129534,35,20,15,23,1
129534,35,20,15,25,1
129534,1,1,0,31,1
129534,87,82,5,32,3
129534,2,2,0,39,1
129534,33,18,15,40,1
129534,262,166,96,41,4
129534,22,11,11,42,1
129534,13,6,7,43,1
129534,1,0,1,44,1
129534,12,6,6,45,1
129534,9,5,4,51,1
129534,240,155,85,52,3
129534,12,6,6,60,1
129543,5813,2231,3582,1,4
129543,5813,2231,3582,2,1
129543,5288,2038,3250,3,1
129543,994,467,527,4,1
129543,4294,1571,2723,5,1
129543,525,193,332,11,1
129543,377,113,264,19,1
129543,3917,1458,2459,20,1
129543,1843,851,992,21,4
129543,1843,851,992,22,1
129543,1836,845,991,23,1
129543,574,287,287,24,1
129543,1262,558,704,25,1
129543,7,6,1,31,1
129543,154,56,98,39,1
129543,1108,502,606,40,1
129543,3970,1380,2590,41,4
129543,3970,1380,2590,42,1
129543,3452,1193,2259,43,1
129543,420,180,240,44,1
129543,3032,1013,2019,45,1
129543,518,187,331,51,1
129543,223,57,166,59,1
129543,2809,956,1853,60,1
129613,62,5,57,1,4
129613,62,5,57,2,1
129613,62,5,57,3,1
129613,62,5,57,5,1
129613,62,5,57,20,1
129613,48,5,43,21,4
129613,48,5,43,22,1
129613,48,5,43,23,1
129613,48,5,43,25,1
129613,48,5,43,40,1
129613,14,0,14,41,4
129613,14,0,14,42,1
129613,14,0,14,43,1
129613,14,0,14,45,1
129613,14,0,14,60,1
129686,77,28,49,1,4
129686,77,28,49,2,1
129686,77,28,49,3,1
129686,17,6,11,4,1
129686,60,22,38,5,1
129686,5,1,4,19,1
129686,55,21,34,20,1
129686,69,27,42,21,4
129686,69,27,42,22,1
129686,69,27,42,23,1
129686,17,6,11,24,1
129686,52,21,31,25,1
129686,5,1,4,39,1
129686,47,20,27,40,1
129686,8,1,7,41,4
129686,8,1,7,42,1
129686,8,1,7,43,1
129686,8,1,7,45,1
129686,8,1,7,60,1
129695,7571,3564,4007,1,4
129695,7571,3564,4007,2,1
129695,6773,3207,3566,3,1
129695,1616,874,742,4,1
129695,5157,2333,2824,5,1
129695,798,357,441,11,1
129695,820,358,462,19,1
129695,4337,1975,2362,20,1
129695,2712,1403,1309,21,4
129695,2712,1403,1309,22,1
129695,2656,1369,1287,23,1
129695,958,522,436,24,1
129695,1698,847,851,25,1
129695,56,34,22,31,1
129695,291,146,145,39,1
129695,1407,701,706,40,1
129695,4859,2161,2698,41,4
129695,4859,2161,2698,42,1
129695,4117,1838,2279,43,1
129695,658,352,306,44,1
129695,3459,1486,1973,45,1
129695,742,323,419,51,1
129695,529,212,317,59,1
129695,2930,1274,1656,60,1
129729,7294,3059,4235,1,4
129729,7294,3059,4235,2,1
129729,6627,2774,3853,3,1
129729,1527,728,799,4,1
129729,5100,2046,3054,5,1
129729,667,285,382,11,1
129729,541,230,311,19,1
129729,4559,1816,2743,20,1
129729,2603,1310,1293,21,4
129729,2603,1310,1293,22,1
129729,2587,1302,1285,23,1
129729,949,473,476,24,1
129729,1638,829,809,25,1
129729,16,8,8,31,1
129729,255,134,121,39,1
129729,1383,695,688,40,1
129729,4691,1749,2942,41,4
129729,4691,1749,2942,42,1
129729,4040,1472,2568,43,1
129729,578,255,323,44,1
129729,3462,1217,2245,45,1
129729,651,277,374,51,1
129729,286,96,190,59,1
129729,3176,1121,2055,60,1
129756,2900,1271,1629,1,4
129756,2900,1271,1629,2,1
129756,2403,1058,1345,3,1
129756,566,280,286,4,1
129756,1837,778,1059,5,1
129756,497,213,284,11,1
129756,320,123,197,19,1
129756,1517,655,862,20,1
129756,1089,552,537,21,4
129756,1089,552,537,22,1
129756,1039,521,518,23,1
129756,346,178,168,24,1
129756,693,343,350,25,1
129756,50,31,19,31,1
129756,117,47,70,39,1
129756,576,296,280,40,1
129756,1811,719,1092,41,4
129756,1811,719,1092,42,1
129756,1364,537,827,43,1
129756,220,102,118,44,1
129756,1144,435,709,45,1
129756,447,182,265,51,1
129756,203,76,127,59,1
129756,941,359,582,60,1
129774,866,464,402,1,4
129774,866,464,402,2,1
129774,802,426,376,3,1
129774,178,101,77,4,1
129774,624,325,299,5,1
129774,64,38,26,11,1
129774,76,37,39,19,1
129774,548,288,260,20,1
129774,747,406,341,21,4
129774,747,406,341,22,1
129774,747,406,341,23,1
129774,176,100,76,24,1
129774,571,306,265,25,1
129774,71,34,37,39,1
129774,500,272,228,40,1
129774,119,58,61,41,4
129774,119,58,61,42,1
129774,55,20,35,43,1
129774,2,1,1,44,1
129774,53,19,34,45,1
129774,64,38,26,51,1
129774,5,3,2,59,1
129774,48,16,32,60,1
129808,4749,1944,2805,1,4
129808,4749,1944,2805,2,1
129808,4384,1783,2601,3,1
129808,938,430,508,4,1
129808,3446,1353,2093,5,1
129808,365,161,204,11,1
129808,340,133,207,19,1
129808,3106,1220,1886,20,1
129808,1609,799,810,21,4
129808,1609,799,810,22,1
129808,1586,788,798,23,1
129808,550,257,293,24,1
129808,1036,531,505,25,1
129808,23,11,12,31,1
129808,148,74,74,39,1
129808,888,457,431,40,1
129808,3140,1145,1995,41,4
129808,3140,1145,1995,42,1
129808,2798,995,1803,43,1
129808,388,173,215,44,1
129808,2410,822,1588,45,1
129808,342,150,192,51,1
129808,192,59,133,59,1
129808,2218,763,1455,60,1
129923,465,192,273,1,4
129923,465,192,273,2,1
129923,465,192,273,3,1
129923,109,58,51,4,1
129923,356,134,222,5,1
129923,356,134,222,20,1
129923,279,102,177,21,4
129923,279,102,177,22,1
129923,279,102,177,23,1
129923,77,37,40,24,1
129923,202,65,137,25,1
129923,202,65,137,40,1
129923,186,90,96,41,4
129923,186,90,96,42,1
129923,186,90,96,43,1
129923,32,21,11,44,1
129923,154,69,85,45,1
129923,154,69,85,60,1
129932,302,294,8,1,4
129932,302,294,8,2,1
129932,302,294,8,3,1
129932,235,228,7,4,1
129932,67,66,1,5,1
129932,67,66,1,20,1
129932,160,152,8,21,4
129932,160,152,8,22,1
129932,160,152,8,23,1
129932,142,135,7,24,1
129932,18,17,1,25,1
129932,18,17,1,40,1
129932,142,142,0,41,4
129932,142,142,0,42,1
129932,142,142,0,43,1
129932,93,93,0,44,1
129932,49,49,0,45,1
129932,49,49,0,60,1
129941,6555,3300,3255,1,4
129941,4864,2457,2407,2,1
129941,4759,2408,2351,3,1
129941,1174,556,618,4,1
129941,3585,1852,1733,5,1
129941,105,49,56,11,1
129941,1691,843,848,12,3
129941,263,147,116,19,1
129941,3322,1705,1617,20,1
129941,5342,2659,2683,21,4
129941,4407,2203,2204,22,1
129941,4407,2203,2204,23,1
129941,1159,551,608,24,1
129941,3248,1652,1596,25,1
129941,935,456,479,32,3
129941,241,137,104,39,1
129941,3007,1515,1492,40,1
129941,1213,641,572,41,4
129941,457,254,203,42,1
129941,352,205,147,43,1
129941,15,5,10,44,1
129941,337,200,137,45,1
129941,105,49,56,51,1
129941,756,387,369,52,3
129941,22,10,12,59,1
129941,315,190,125,60,1
129969,295,64,231,1,4
129969,295,64,231,2,1
129969,295,64,231,3,1
129969,111,30,81,4,1
129969,184,34,150,5,1
129969,184,34,150,20,1
129969,295,64,231,21,4
129969,295,64,231,22,1
129969,295,64,231,23,1
129969,111,30,81,24,1
129969,184,34,150,25,1
129969,184,34,150,40,1
130004,6556,2782,3774,1,4
130004,6556,2782,3774,2,1
130004,5133,2189,2944,3,1
130004,981,521,460,4,1
130004,4152,1668,2484,5,1
130004,1423,593,830,11,1
130004,425,186,239,19,1
130004,3727,1482,2245,20,1
130004,2180,1098,1082,21,4
130004,2180,1098,1082,22,1
130004,2016,1018,998,23,1
130004,646,356,290,24,1
130004,1370,662,708,25,1
130004,164,80,84,31,1
130004,187,100,87,39,1
130004,1183,562,621,40,1
130004,4376,1684,2692,41,4
130004,4376,1684,2692,42,1
130004,3117,1171,1946,43,1
130004,335,165,170,44,1
130004,2782,1006,1776,45,1
130004,1259,513,746,51,1
130004,238,86,152,59,1
130004,2544,920,1624,60,1
130040,1549,535,1014,1,4
130040,1549,535,1014,2,1
130040,1233,439,794,3,1
130040,260,110,150,4,1
130040,973,329,644,5,1
130040,316,96,220,11,1
130040,146,40,106,19,1
130040,827,289,538,20,1
130040,457,184,273,21,4
130040,457,184,273,22,1
130040,457,184,273,23,1
130040,192,80,112,24,1
130040,265,104,161,25,1
130040,57,14,43,39,1
130040,208,90,118,40,1
130040,1092,351,741,41,4
130040,1092,351,741,42,1
130040,776,255,521,43,1
130040,68,30,38,44,1
130040,708,225,483,45,1
130040,316,96,220,51,1
130040,89,26,63,59,1
130040,619,199,420,60,1
130110,155,52,103,1,4
130110,155,52,103,2,1
130110,137,40,97,3,1
130110,20,5,15,4,1
130110,117,35,82,5,1
130110,18,12,6,11,1
130110,12,1,11,19,1
130110,105,34,71,20,1
130110,112,33,79,21,4
130110,112,33,79,22,1
130110,100,27,73,23,1
130110,18,4,14,24,1
130110,82,23,59,25,1
130110,12,6,6,31,1
130110,6,1,5,39,1
130110,76,22,54,40,1
130110,43,19,24,41,4
130110,43,19,24,42,1
130110,37,13,24,43,1
130110,2,1,1,44,1
130110,35,12,23,45,1
130110,6,6,0,51,1
130110,6,0,6,59,1
130110,29,12,17,60,1
130129,503,66,437,1,4
130129,503,66,437,2,1
130129,503,66,437,3,1
130129,55,5,50,4,1
130129,448,61,387,5,1
130129,448,61,387,20,1
130129,402,56,346,21,4
130129,402,56,346,22,1
130129,402,56,346,23,1
130129,43,3,40,24,1
130129,359,53,306,25,1
130129,359,53,306,40,1
130129,101,10,91,41,4
130129,101,10,91,42,1
130129,101,10,91,43,1
130129,12,2,10,44,1
130129,89,8,81,45,1
130129,89,8,81,60,1
130174,2630,1710,920,1,4
130174,2630,1710,920,2,1
130174,2630,1710,920,3,1
130174,721,478,243,4,1
130174,1909,1232,677,5,1
130174,1909,1232,677,20,1
130174,1756,1128,628,21,4
130174,1756,1128,628,22,1
130174,1756,1128,628,23,1
130174,523,350,173,24,1
130174,1233,778,455,25,1
130174,1233,778,455,40,1
130174,874,582,292,41,4
130174,874,582,292,42,1
130174,874,582,292,43,1
130174,198,128,70,44,1
130174,676,454,222,45,1
130174,676,454,222,60,1
130183,8082,3253,4829,1,4
130183,7371,3032,4339,2,1
130183,6616,2757,3859,3,1
130183,1036,357,679,4,1
130183,5580,2400,3180,5,1
130183,755,275,480,11,1
130183,711,221,490,12,3
130183,909,445,464,19,1
130183,4671,1955,2716,20,1
130183,3155,1214,1941,21,4
130183,2903,1123,1780,22,1
130183,2821,1092,1729,23,1
130183,460,198,262,24,1
130183,2361,894,1467,25,1
130183,82,31,51,31,1
130183,252,91,161,32,3
130183,306,111,195,39,1
130183,2055,783,1272,40,1
130183,4927,2039,2888,41,4
130183,4468,1909,2559,42,1
130183,3795,1665,2130,43,1
130183,576,159,417,44,1
130183,3219,1506,1713,45,1
130183,673,244,429,51,1
130183,459,130,329,52,3
130183,603,334,269,59,1
130183,2616,1172,1444,60,1
130217,1929,745,1184,1,4
130217,1929,745,1184,2,1
130217,1796,694,1102,3,1
130217,477,217,260,4,1
130217,1319,477,842,5,1
130217,133,51,82,11,1
130217,161,67,94,19,1
130217,1158,410,748,20,1
130217,677,320,357,21,4
130217,677,320,357,22,1
130217,673,317,356,23,1
130217,279,134,145,24,1
130217,394,183,211,25,1
130217,4,3,1,31,1
130217,64,34,30,39,1
130217,330,149,181,40,1
130217,1252,425,827,41,4
130217,1252,425,827,42,1
130217,1123,377,746,43,1
130217,198,83,115,44,1
130217,925,294,631,45,1
130217,129,48,81,51,1
130217,97,33,64,59,1
130217,828,261,567,60,1
130226,8803,3275,5528,1,4
130226,6542,2496,4046,2,1
130226,6486,2478,4008,3,1
130226,1800,664,1136,4,1
130226,4686,1814,2872,5,1
130226,56,18,38,11,1
130226,2261,779,1482,12,3
130226,207,77,130,19,1
130226,4479,1737,2742,20,1
130226,7602,2807,4795,21,4
130226,6307,2404,3903,22,1
130226,6307,2404,3903,23,1
130226,1795,662,1133,24,1
130226,4512,1742,2770,25,1
130226,1295,403,892,32,3
130226,188,74,114,39,1
130226,4324,1668,2656,40,1
130226,1201,468,733,41,4
130226,235,92,143,42,1
130226,179,74,105,43,1
130226,5,2,3,44,1
130226,174,72,102,45,1
130226,56,18,38,51,1
130226,966,376,590,52,3
130226,19,3,16,59,1
130226,155,69,86,60,1
130253,6983,2265,4718,1,4
130253,4489,1621,2868,2,1
130253,4409,1582,2827,3,1
130253,1267,444,823,4,1
130253,3142,1138,2004,5,1
130253,80,39,41,11,1
130253,2494,644,1850,12,3
130253,102,51,51,19,1
130253,3040,1087,1953,20,1
130253,4542,1659,2883,21,4
130253,3773,1408,2365,22,1
130253,3771,1406,2365,23,1
130253,1267,444,823,24,1
130253,2504,962,1542,25,1
130253,2,2,0,31,1
130253,769,251,518,32,3
130253,97,49,48,39,1
130253,2407,913,1494,40,1
130253,2441,606,1835,41,4
130253,716,213,503,42,1
130253,638,176,462,43,1
130253,638,176,462,45,1
130253,78,37,41,51,1
130253,1725,393,1332,52,3
130253,5,2,3,59,1
130253,633,174,459,60,1
130314,2640,271,2369,1,4
130314,1049,21,1028,2,1
130314,971,12,959,3,1
130314,153,0,153,4,1
130314,818,12,806,5,1
130314,78,9,69,11,1
130314,1591,250,1341,12,3
130314,97,3,94,19,1
130314,721,9,712,20,1
130314,1220,97,1123,21,4
130314,794,6,788,22,1
130314,793,5,788,23,1
130314,153,0,153,24,1
130314,640,5,635,25,1
130314,1,1,0,31,1
130314,426,91,335,32,3
130314,53,1,52,39,1
130314,587,4,583,40,1
130314,1420,174,1246,41,4
130314,255,15,240,42,1
130314,178,7,171,43,1
130314,178,7,171,45,1
130314,77,8,69,51,1
130314,1165,159,1006,52,3
130314,44,2,42,59,1
130314,134,5,129,60,1
130396,8186,3409,4777,1,4
130396,8186,3409,4777,2,1
130396,7275,3037,4238,3,1
130396,1570,771,799,4,1
130396,5705,2266,3439,5,1
130396,911,372,539,11,1
130396,880,358,522,19,1
130396,4825,1908,2917,20,1
130396,2689,1322,1367,21,4
130396,2689,1322,1367,22,1
130396,2622,1285,1337,23,1
130396,835,409,426,24,1
130396,1787,876,911,25,1
130396,67,37,30,31,1
130396,359,170,189,39,1
130396,1428,706,722,40,1
130396,5497,2087,3410,41,4
130396,5497,2087,3410,42,1
130396,4653,1752,2901,43,1
130396,735,362,373,44,1
130396,3918,1390,2528,45,1
130396,844,335,509,51,1
130396,521,188,333,59,1
130396,3397,1202,2195,60,1
130448,827,103,724,1,4
130448,827,103,724,2,1
130448,772,94,678,3,1
130448,18,2,16,4,1
130448,754,92,662,5,1
130448,55,9,46,11,1
130448,124,12,112,19,1
130448,630,80,550,20,1
130448,165,24,141,21,4
130448,165,24,141,22,1
130448,152,23,129,23,1
130448,14,2,12,24,1
130448,138,21,117,25,1
130448,13,1,12,31,1
130448,56,5,51,39,1
130448,82,16,66,40,1
130448,662,79,583,41,4
130448,662,79,583,42,1
130448,620,71,549,43,1
130448,4,0,4,44,1
130448,616,71,545,45,1
130448,42,8,34,51,1
130448,68,7,61,59,1
130448,548,64,484,60,1
130493,10804,3887,6917,1,4
130493,8257,3253,5004,2,1
130493,8257,3253,5004,3,1
130493,1380,459,921,4,1
130493,6877,2794,4083,5,1
130493,2547,634,1913,12,3
130493,922,377,545,19,1
130493,5955,2417,3538,20,1
130493,7892,2868,5024,21,4
130493,7016,2676,4340,22,1
130493,7016,2676,4340,23,1
130493,1361,449,912,24,1
130493,5655,2227,3428,25,1
130493,876,192,684,32,3
130493,764,312,452,39,1
130493,4891,1915,2976,40,1
130493,2912,1019,1893,41,4
130493,1241,577,664,42,1
130493,1241,577,664,43,1
130493,19,10,9,44,1
130493,1222,567,655,45,1
130493,1671,442,1229,52,3
130493,158,65,93,59,1
130493,1064,502,562,60,1
130509,422,44,378,1,4
130509,422,44,378,2,1
130509,422,44,378,3,1
130509,185,24,161,4,1
130509,237,20,217,5,1
130509,237,20,217,20,1
130509,311,32,279,21,4
130509,311,32,279,22,1
130509,311,32,279,23,1
130509,151,18,133,24,1
130509,160,14,146,25,1
130509,160,14,146,40,1
130509,111,12,99,41,4
130509,111,12,99,42,1
130509,111,12,99,43,1
130509,34,6,28,44,1
130509,77,6,71,45,1
130509,77,6,71,60,1
130581,112,32,80,1,4
130581,112,32,80,12,3
130581,90,26,64,21,4
130581,90,26,64,32,3
130581,22,6,16,41,4
130581,22,6,16,52,3
130590,2390,1217,1173,1,4
130590,2301,1176,1125,2,1
130590,2239,1150,1089,3,1
130590,604,317,287,4,1
130590,1635,833,802,5,1
130590,62,26,36,11,1
130590,89,41,48,12,3
130590,30,16,14,19,1
130590,1605,817,788,20,1
130590,2188,1115,1073,21,4
130590,2184,1115,1069,22,1
130590,2139,1099,1040,23,1
130590,604,317,287,24,1
130590,1535,782,753,25,1
130590,45,16,29,31,1
130590,4,0,4,32,3
130590,15,10,5,39,1
130590,1520,772,748,40,1
130590,202,102,100,41,4
130590,117,61,56,42,1
130590,100,51,49,43,1
130590,100,51,49,45,1
130590,17,10,7,51,1
130590,85,41,44,52,3
130590,15,6,9,59,1
130590,85,45,40,60,1
130606,4547,1989,2558,1,4
130606,4547,1989,2558,2,1
130606,3781,1660,2121,3,1
130606,803,383,420,4,1
130606,2978,1277,1701,5,1
130606,766,329,437,11,1
130606,369,152,217,19,1
130606,2609,1125,1484,20,1
130606,1688,804,884,21,4
130606,1688,804,884,22,1
130606,1634,771,863,23,1
130606,526,254,272,24,1
130606,1108,517,591,25,1
130606,54,33,21,31,1
130606,173,74,99,39,1
130606,935,443,492,40,1
130606,2859,1185,1674,41,4
130606,2859,1185,1674,42,1
130606,2147,889,1258,43,1
130606,277,129,148,44,1
130606,1870,760,1110,45,1
130606,712,296,416,51,1
130606,196,78,118,59,1
130606,1674,682,992,60,1
130624,902,597,305,1,4
130624,902,597,305,2,1
130624,902,597,305,3,1
130624,217,140,77,4,1
130624,685,457,228,5,1
130624,685,457,228,20,1
130624,902,597,305,21,4
130624,902,597,305,22,1
130624,902,597,305,23,1
130624,217,140,77,24,1
130624,685,457,228,25,1
130624,685,457,228,40,1
130697,3205,1539,1666,1,4
130697,2906,1402,1504,2,1
130697,2888,1396,1492,3,1
130697,741,344,397,4,1
130697,2147,1052,1095,5,1
130697,18,6,12,11,1
130697,299,137,162,12,3
130697,50,27,23,19,1
130697,2097,1025,1072,20,1
130697,3091,1496,1595,21,4
130697,2899,1401,1498,22,1
130697,2888,1396,1492,23,1
130697,741,344,397,24,1
130697,2147,1052,1095,25,1
130697,11,5,6,31,1
130697,192,95,97,32,3
130697,50,27,23,39,1
130697,2097,1025,1072,40,1
130697,114,43,71,41,4
130697,7,1,6,42,1
130697,7,1,6,51,1
130697,107,42,65,52,3
130776,6025,2752,3273,1,4
130776,5492,2563,2929,2,1
130776,5184,2378,2806,3,1
130776,797,389,408,4,1
130776,4387,1989,2398,5,1
130776,308,185,123,11,1
130776,533,189,344,12,3
130776,567,270,297,19,1
130776,3820,1719,2101,20,1
130776,4465,2093,2372,21,4
130776,4394,2069,2325,22,1
130776,4388,2064,2324,23,1
130776,784,381,403,24,1
130776,3604,1683,1921,25,1
130776,6,5,1,31,1
130776,71,24,47,32,3
130776,451,232,219,39,1
130776,3153,1451,1702,40,1
130776,1560,659,901,41,4
130776,1098,494,604,42,1
130776,796,314,482,43,1
130776,13,8,5,44,1
130776,783,306,477,45,1
130776,302,180,122,51,1
130776,462,165,297,52,3
130776,116,38,78,59,1
130776,667,268,399,60,1
130785,10,1,9,1,4
130785,10,1,9,12,3
130785,10,1,9,21,4
130785,10,1,9,32,3
130794,12109,6148,5961,1,4
130794,5430,2753,2677,2,1
130794,5422,2745,2677,3,1
130794,1358,677,681,4,1
130794,4064,2068,1996,5,1
130794,8,8,0,11,1
130794,6679,3395,3284,12,3
130794,26,15,11,19,1
130794,4038,2053,1985,20,1
130794,11927,6075,5852,21,4
130794,5424,2748,2676,22,1
130794,5416,2740,2676,23,1
130794,1358,677,681,24,1
130794,4058,2063,1995,25,1
130794,8,8,0,31,1
130794,6503,3327,3176,32,3
130794,26,15,11,39,1
130794,4032,2048,1984,40,1
130794,182,73,109,41,4
130794,6,5,1,42,1
130794,6,5,1,43,1
130794,6,5,1,45,1
130794,176,68,108,52,3
130794,6,5,1,60,1
130837,55,5,50,1,4
130837,55,5,50,2,1
130837,55,5,50,3,1
130837,55,5,50,5,1
130837,55,5,50,20,1
130837,55,5,50,21,4
130837,55,5,50,22,1
130837,55,5,50,23,1
130837,55,5,50,25,1
130837,55,5,50,40,1
130873,638,50,588,1,4
130873,638,50,588,2,1
130873,638,50,588,3,1
130873,81,7,74,4,1
130873,557,43,514,5,1
130873,557,43,514,20,1
130873,638,50,588,21,4
130873,638,50,588,22,1
130873,638,50,588,23,1
130873,81,7,74,24,1
130873,557,43,514,25,1
130873,557,43,514,40,1
130891,4429,1675,2754,1,4
130891,4429,1675,2754,2,1
130891,3978,1494,2484,3,1
130891,881,406,475,4,1
130891,3097,1088,2009,5,1
130891,451,181,270,11,1
130891,165,76,89,19,1
130891,2932,1012,1920,20,1
130891,1980,867,1113,21,4
130891,1980,867,1113,22,1
130891,1975,864,1111,23,1
130891,733,336,397,24,1
130891,1242,528,714,25,1
130891,5,3,2,31,1
130891,90,49,41,39,1
130891,1152,479,673,40,1
130891,2449,808,1641,41,4
130891,2449,808,1641,42,1
130891,2003,630,1373,43,1
130891,148,70,78,44,1
130891,1855,560,1295,45,1
130891,446,178,268,51,1
130891,75,27,48,59,1
130891,1780,533,1247,60,1
130907,3031,1130,1901,1,4
130907,3031,1130,1901,2,1
130907,2857,1065,1792,3,1
130907,659,292,367,4,1
130907,2198,773,1425,5,1
130907,174,65,109,11,1
130907,145,54,91,19,1
130907,2053,719,1334,20,1
130907,1444,601,843,21,4
130907,1444,601,843,22,1
130907,1431,592,839,23,1
130907,523,230,293,24,1
130907,908,362,546,25,1
130907,13,9,4,31,1
130907,82,33,49,39,1
130907,826,329,497,40,1
130907,1587,529,1058,41,4
130907,1587,529,1058,42,1
130907,1426,473,953,43,1
130907,136,62,74,44,1
130907,1290,411,879,45,1
130907,161,56,105,51,1
130907,63,21,42,59,1
130907,1227,390,837,60,1
130916,7030,2920,4110,1,4
130916,7030,2920,4110,2,1
130916,6492,2667,3825,3,1
130916,1304,622,682,4,1
130916,5188,2045,3143,5,1
130916,538,253,285,11,1
130916,288,132,156,19,1
130916,4900,1913,2987,20,1
130916,2615,1243,1372,21,4
130916,2615,1243,1372,22,1
130916,2569,1222,1347,23,1
130916,953,464,489,24,1
130916,1616,758,858,25,1
130916,46,21,25,31,1
130916,147,77,70,39,1
130916,1469,681,788,40,1
130916,4415,1677,2738,41,4
130916,4415,1677,2738,42,1
130916,3923,1445,2478,43,1
130916,351,158,193,44,1
130916,3572,1287,2285,45,1
130916,492,232,260,51,1
130916,141,55,86,59,1
130916,3431,1232,2199,60,1
130934,4336,1618,2718,1,4
130934,3892,1463,2429,2,1
130934,3719,1400,2319,3,1
130934,922,344,578,4,1
130934,2797,1056,1741,5,1
130934,173,63,110,11,1
130934,444,155,289,12,3
130934,216,92,124,19,1
130934,2581,964,1617,20,1
130934,3926,1457,2469,21,4
130934,3579,1334,2245,22,1
130934,3487,1298,2189,23,1
130934,907,337,570,24,1
130934,2580,961,1619,25,1
130934,92,36,56,31,1
130934,347,123,224,32,3
130934,181,81,100,39,1
130934,2399,880,1519,40,1
130934,410,161,249,41,4
130934,313,129,184,42,1
130934,232,102,130,43,1
130934,15,7,8,44,1
130934,217,95,122,45,1
130934,81,27,54,51,1
130934,97,32,65,52,3
130934,35,11,24,59,1
130934,182,84,98,60,1
130943,22166,9778,12388,1,4
130943,18487,7954,10533,2,1
130943,17729,7594,10135,3,1
130943,4224,1746,2478,4,1
130943,13505,5848,7657,5,1
130943,758,360,398,11,1
130943,3679,1824,1855,12,3
130943,484,216,268,19,1
130943,13021,5632,7389,20,1
130943,19685,8607,11078,21,4
130943,16852,7173,9679,22,1
130943,16846,7170,9676,23,1
130943,4210,1740,2470,24,1
130943,12636,5430,7206,25,1
130943,6,3,3,31,1
130943,2833,1434,1399,32,3
130943,422,199,223,39,1
130943,12214,5231,6983,40,1
130943,2481,1171,1310,41,4
130943,1635,781,854,42,1
130943,883,424,459,43,1
130943,14,6,8,44,1
130943,869,418,451,45,1
130943,752,357,395,51,1
130943,846,390,456,52,3
130943,62,17,45,59,1
130943,807,401,406,60,1
130989,1868,1129,739,1,4
130989,554,256,298,2,1
130989,548,256,292,3,1
130989,100,42,58,4,1
130989,448,214,234,5,1
130989,6,0,6,11,1
130989,1314,873,441,12,3
130989,58,34,24,19,1
130989,390,180,210,20,1
130989,429,204,225,21,4
130989,401,193,208,22,1
130989,401,193,208,23,1
130989,93,39,54,24,1
130989,308,154,154,25,1
130989,28,11,17,32,3
130989,43,29,14,39,1
130989,265,125,140,40,1
130989,1439,925,514,41,4
130989,153,63,90,42,1
130989,147,63,84,43,1
130989,7,3,4,44,1
130989,140,60,80,45,1
130989,6,0,6,51,1
130989,1286,862,424,52,3
130989,15,5,10,59,1
130989,125,55,70,60,1
131061,146,3,143,1,4
131061,146,3,143,2,1
131061,146,3,143,3,1
131061,70,2,68,4,1
131061,76,1,75,5,1
131061,76,1,75,20,1
131061,95,2,93,21,4
131061,95,2,93,22,1
131061,95,2,93,23,1
131061,53,1,52,24,1
131061,42,1,41,25,1
131061,42,1,41,40,1
131061,51,1,50,41,4
131061,51,1,50,42,1
131061,51,1,50,43,1
131061,17,1,16,44,1
131061,34,0,34,45,1
131061,34,0,34,60,1
131098,1655,777,878,1,4
131098,1600,761,839,2,1
131098,1481,678,803,3,1
131098,463,245,218,4,1
131098,1018,433,585,5,1
131098,119,83,36,11,1
131098,55,16,39,12,3
131098,132,52,80,19,1
131098,886,381,505,20,1
131098,1463,670,793,21,4
131098,1416,657,759,22,1
131098,1407,655,752,23,1
131098,463,245,218,24,1
131098,944,410,534,25,1
131098,9,2,7,31,1
131098,47,13,34,32,3
131098,123,48,75,39,1
131098,821,362,459,40,1
131098,192,107,85,41,4
131098,184,104,80,42,1
131098,74,23,51,43,1
131098,74,23,51,45,1
131098,110,81,29,51,1
131098,8,3,5,52,3
131098,9,4,5,59,1
131098,65,19,46,60,1
131113,13621,4640,8981,1,4
131113,8611,3033,5578,2,1
131113,8475,2975,5500,3,1
131113,840,383,457,4,1
131113,7635,2592,5043,5,1
131113,136,58,78,11,1
131113,5010,1607,3403,12,3
131113,1406,463,943,19,1
131113,6229,2129,4100,20,1
131113,4698,1905,2793,21,4
131113,3509,1446,2063,22,1
131113,3507,1445,2062,23,1
131113,368,189,179,24,1
131113,3139,1256,1883,25,1
131113,2,1,1,31,1
131113,1189,459,730,32,3
131113,668,266,402,39,1
131113,2471,990,1481,40,1
131113,8923,2735,6188,41,4
131113,5102,1587,3515,42,1
131113,4968,1530,3438,43,1
131113,472,194,278,44,1
131113,4496,1336,3160,45,1
131113,134,57,77,51,1
131113,3821,1148,2673,52,3
131113,738,197,541,59,1
131113,3758,1139,2619,60,1
131159,12818,5041,7777,1,4
131159,7340,2885,4455,2,1
131159,6829,2662,4167,3,1
131159,1626,556,1070,4,1
131159,5203,2106,3097,5,1
131159,511,223,288,11,1
131159,5478,2156,3322,12,3
131159,271,128,143,19,1
131159,4932,1978,2954,20,1
131159,10233,3989,6244,21,4
131159,6985,2714,4271,22,1
131159,6593,2555,4038,23,1
131159,1623,556,1067,24,1
131159,4970,1999,2971,25,1
131159,392,159,233,31,1
131159,3248,1275,1973,32,3
131159,248,122,126,39,1
131159,4722,1877,2845,40,1
131159,2585,1052,1533,41,4
131159,355,171,184,42,1
131159,236,107,129,43,1
131159,3,0,3,44,1
131159,233,107,126,45,1
131159,119,64,55,51,1
131159,2230,881,1349,52,3
131159,23,6,17,59,1
131159,210,101,109,60,1
131283,6725,3188,3537,1,4
131283,3713,1701,2012,2,1
131283,3641,1677,1964,3,1
131283,837,401,436,4,1
131283,2804,1276,1528,5,1
131283,72,24,48,11,1
131283,3012,1487,1525,12,3
131283,93,60,33,19,1
131283,2711,1216,1495,20,1
131283,4756,2289,2467,21,4
131283,3456,1605,1851,22,1
131283,3446,1599,1847,23,1
131283,836,400,436,24,1
131283,2610,1199,1411,25,1
131283,10,6,4,31,1
131283,1300,684,616,32,3
131283,90,57,33,39,1
131283,2520,1142,1378,40,1
131283,1969,899,1070,41,4
131283,257,96,161,42,1
131283,195,78,117,43,1
131283,1,1,0,44,1
131283,194,77,117,45,1
131283,62,18,44,51,1
131283,1712,803,909,52,3
131283,3,3,0,59,1
131283,191,74,117,60,1
131308,548,138,410,1,4
131308,323,99,224,2,1
131308,275,90,185,3,1
131308,36,10,26,4,1
131308,239,80,159,5,1
131308,48,9,39,11,1
131308,225,39,186,12,3
131308,32,14,18,19,1
131308,207,66,141,20,1
131308,362,108,254,21,4
131308,224,83,141,22,1
131308,224,83,141,23,1
131308,36,10,26,24,1
131308,188,73,115,25,1
131308,138,25,113,32,3
131308,22,12,10,39,1
131308,166,61,105,40,1
131308,186,30,156,41,4
131308,99,16,83,42,1
131308,51,7,44,43,1
131308,51,7,44,45,1
131308,48,9,39,51,1
131308,87,14,73,52,3
131308,10,2,8,59,1
131308,41,5,36,60,1
131399,5011,1851,3160,1,4
131399,4712,1721,2991,2,1
131399,4487,1634,2853,3,1
131399,562,235,327,4,1
131399,3925,1399,2526,5,1
131399,225,87,138,11,1
131399,299,130,169,12,3
131399,386,172,214,19,1
131399,3539,1227,2312,20,1
131399,2199,921,1278,21,4
131399,1986,835,1151,22,1
131399,1968,827,1141,23,1
131399,241,123,118,24,1
131399,1727,704,1023,25,1
131399,18,8,10,31,1
131399,213,86,127,32,3
131399,218,115,103,39,1
131399,1509,589,920,40,1
131399,2812,930,1882,41,4
131399,2726,886,1840,42,1
131399,2519,807,1712,43,1
131399,321,112,209,44,1
131399,2198,695,1503,45,1
131399,207,79,128,51,1
131399,86,44,42,52,3
131399,168,57,111,59,1
131399,2030,638,1392,60,1
131405,119,98,21,1,4
131405,119,98,21,12,3
131405,84,80,4,21,4
131405,84,80,4,32,3
131405,35,18,17,41,4
131405,35,18,17,52,3
131450,1561,622,939,1,4
131450,1077,500,577,2,1
131450,1053,490,563,3,1
131450,201,87,114,4,1
131450,852,403,449,5,1
131450,24,10,14,11,1
131450,484,122,362,12,3
131450,85,32,53,19,1
131450,767,371,396,20,1
131450,1367,549,818,21,4
131450,1006,467,539,22,1
131450,1006,467,539,23,1
131450,200,86,114,24,1
131450,806,381,425,25,1
131450,361,82,279,32,3
131450,84,31,53,39,1
131450,722,350,372,40,1
131450,194,73,121,41,4
131450,71,33,38,42,1
131450,47,23,24,43,1
131450,1,1,0,44,1
131450,46,22,24,45,1
131450,24,10,14,51,1
131450,123,40,83,52,3
131450,1,1,0,59,1
131450,45,21,24,60,1
131469,25264,11115,14149,1,4
131469,10357,4627,5730,2,1
131469,10121,4515,5606,3,1
131469,2356,1084,1272,4,1
131469,7765,3431,4334,5,1
131469,236,112,124,11,1
131469,14907,6488,8419,12,3
131469,438,191,247,19,1
131469,7327,3240,4087,20,1
131469,17109,7598,9511,21,4
131469,9609,4215,5394,22,1
131469,9525,4182,5343,23,1
131469,2348,1078,1270,24,1
131469,7177,3104,4073,25,1
131469,84,33,51,31,1
131469,7500,3383,4117,32,3
131469,338,143,195,39,1
131469,6839,2961,3878,40,1
131469,8155,3517,4638,41,4
131469,748,412,336,42,1
131469,596,333,263,43,1
131469,8,6,2,44,1
131469,588,327,261,45,1
131469,152,79,73,51,1
131469,7407,3105,4302,52,3
131469,100,48,52,59,1
131469,488,279,209,60,1
131496,17849,8264,9585,1,4
131496,7636,3430,4206,2,1
131496,7261,3282,3979,3,1
131496,1594,723,871,4,1
131496,5667,2559,3108,5,1
131496,375,148,227,11,1
131496,10213,4834,5379,12,3
131496,225,123,102,19,1
131496,5442,2436,3006,20,1
131496,14407,6862,7545,21,4
131496,7300,3274,4026,22,1
131496,7057,3180,3877,23,1
131496,1593,722,871,24,1
131496,5464,2458,3006,25,1
131496,243,94,149,31,1
131496,7107,3588,3519,32,3
131496,225,123,102,39,1
131496,5239,2335,2904,40,1
131496,3442,1402,2040,41,4
131496,336,156,180,42,1
131496,204,102,102,43,1
131496,1,1,0,44,1
131496,203,101,102,45,1
131496,132,54,78,51,1
131496,3106,1246,1860,52,3
131496,203,101,102,60,1
131520,10297,3576,6721,1,4
131520,6974,2288,4686,2,1
131520,6855,2236,4619,3,1
131520,1594,464,1130,4,1
131520,5261,1772,3489,5,1
131520,119,52,67,11,1
131520,3323,1288,2035,12,3
131520,340,123,217,19,1
131520,4921,1649,3272,20,1
131520,9123,3114,6009,21,4
131520,6495,2087,4408,22,1
131520,6435,2055,4380,23,1
131520,1576,456,1120,24,1
131520,4859,1599,3260,25,1
131520,60,32,28,31,1
131520,2628,1027,1601,32,3
131520,296,102,194,39,1
131520,4563,1497,3066,40,1
131520,1174,462,712,41,4
131520,479,201,278,42,1
131520,420,181,239,43,1
131520,18,8,10,44,1
131520,402,173,229,45,1
131520,59,20,39,51,1
131520,695,261,434,52,3
131520,44,21,23,59,1
131520,358,152,206,60,1
131742,1373,195,1178,1,4
131742,1373,195,1178,2,1
131742,1373,195,1178,3,1
131742,442,46,396,4,1
131742,931,149,782,5,1
131742,53,5,48,19,1
131742,878,144,734,20,1
131742,1373,195,1178,21,4
131742,1373,195,1178,22,1
131742,1373,195,1178,23,1
131742,442,46,396,24,1
131742,931,149,782,25,1
131742,53,5,48,39,1
131742,878,144,734,40,1
131803,1372,534,838,1,4
131803,883,346,537,2,1
131803,871,340,531,3,1
131803,105,42,63,4,1
131803,766,298,468,5,1
131803,12,6,6,11,1
131803,489,188,301,12,3
131803,79,30,49,19,1
131803,687,268,419,20,1
131803,236,114,122,21,4
131803,111,61,50,22,1
131803,109,60,49,23,1
131803,10,6,4,24,1
131803,99,54,45,25,1
131803,2,1,1,31,1
131803,125,53,72,32,3
131803,11,7,4,39,1
131803,88,47,41,40,1
131803,1136,420,716,41,4
131803,772,285,487,42,1
131803,762,280,482,43,1
131803,95,36,59,44,1
131803,667,244,423,45,1
131803,10,5,5,51,1
131803,364,135,229,52,3
131803,68,23,45,59,1
131803,599,221,378,60,1
131830,37,18,19,1,4
131830,37,18,19,2,1
131830,37,18,19,3,1
131830,4,2,2,4,1
131830,33,16,17,5,1
131830,33,16,17,20,1
131830,37,18,19,21,4
131830,37,18,19,22,1
131830,37,18,19,23,1
131830,4,2,2,24,1
131830,33,16,17,25,1
131830,33,16,17,40,1
131876,2506,197,2309,1,4
131876,1853,84,1769,2,1
131876,1810,76,1734,3,1
131876,274,2,272,4,1
131876,1536,74,1462,5,1
131876,43,8,35,11,1
131876,653,113,540,12,3
131876,260,19,241,19,1
131876,1276,55,1221,20,1
131876,1301,43,1258,21,4
131876,1199,22,1177,22,1
131876,1199,22,1177,23,1
131876,266,0,266,24,1
131876,933,22,911,25,1
131876,102,21,81,32,3
131876,137,5,132,39,1
131876,796,17,779,40,1
131876,1205,154,1051,41,4
131876,654,62,592,42,1
131876,611,54,557,43,1
131876,8,2,6,44,1
131876,603,52,551,45,1
131876,43,8,35,51,1
131876,551,92,459,52,3
131876,123,14,109,59,1
131876,480,38,442,60,1
131973,628,320,308,1,4
131973,628,320,308,12,3
131973,393,227,166,21,4
131973,393,227,166,32,3
131973,235,93,142,41,4
131973,235,93,142,52,3
132268,689,655,34,1,4
132268,689,655,34,2,1
132268,689,655,34,3,1
132268,197,190,7,4,1
132268,492,465,27,5,1
132268,5,5,0,19,1
132268,487,460,27,20,1
132268,689,655,34,21,4
132268,689,655,34,22,1
132268,689,655,34,23,1
132268,197,190,7,24,1
132268,492,465,27,25,1
132268,5,5,0,39,1
132268,487,460,27,40,1
132338,1924,925,999,1,4
132338,1924,925,999,2,1
132338,1924,925,999,3,1
132338,422,210,212,4,1
132338,1502,715,787,5,1
132338,182,65,117,19,1
132338,1320,650,670,20,1
132338,1112,540,572,21,4
132338,1112,540,572,22,1
132338,1112,540,572,23,1
132338,337,173,164,24,1
132338,775,367,408,25,1
132338,140,56,84,39,1
132338,635,311,324,40,1
132338,812,385,427,41,4
132338,812,385,427,42,1
132338,812,385,427,43,1
132338,85,37,48,44,1
132338,727,348,379,45,1
132338,42,9,33,59,1
132338,685,339,346,60,1
132374,902,538,364,1,4
132374,902,538,364,2,1
132374,902,538,364,3,1
132374,512,306,206,4,1
132374,390,232,158,5,1
132374,390,232,158,20,1
132374,902,538,364,21,4
132374,902,538,364,22,1
132374,902,538,364,23,1
132374,512,306,206,24,1
132374,390,232,158,25,1
132374,390,232,158,40,1
132408,529,339,190,1,4
132408,507,321,186,2,1
132408,499,315,184,3,1
132408,48,22,26,4,1
132408,451,293,158,5,1
132408,8,6,2,11,1
132408,22,18,4,12,3
132408,56,37,19,19,1
132408,395,256,139,20,1
132408,398,246,152,21,4
132408,387,237,150,22,1
132408,385,236,149,23,1
132408,43,20,23,24,1
132408,342,216,126,25,1
132408,2,1,1,31,1
132408,11,9,2,32,3
132408,41,26,15,39,1
132408,301,190,111,40,1
132408,131,93,38,41,4
132408,120,84,36,42,1
132408,114,79,35,43,1
132408,5,2,3,44,1
132408,109,77,32,45,1
132408,6,5,1,51,1
132408,11,9,2,52,3
132408,15,11,4,59,1
132408,94,66,28,60,1
132471,9030,3069,5961,1,4
132471,4341,1657,2684,2,1
132471,4284,1630,2654,3,1
132471,564,194,370,4,1
132471,3720,1436,2284,5,1
132471,57,27,30,11,1
132471,4689,1412,3277,12,3
132471,709,282,427,19,1
132471,3011,1154,1857,20,1
132471,5887,2150,3737,21,4
132471,3619,1327,2292,22,1
132471,3592,1316,2276,23,1
132471,562,193,369,24,1
132471,3030,1123,1907,25,1
132471,27,11,16,31,1
132471,2268,823,1445,32,3
132471,506,180,326,39,1
132471,2524,943,1581,40,1
132471,3143,919,2224,41,4
132471,722,330,392,42,1
132471,692,314,378,43,1
132471,2,1,1,44,1
132471,690,313,377,45,1
132471,30,16,14,51,1
132471,2421,589,1832,52,3
132471,203,102,101,59,1
132471,487,211,276,60,1
132523,35,15,20,1,4
132523,35,15,20,12,3
132523,35,15,20,21,4
132523,35,15,20,32,3
132602,3787,1548,2239,1,4
132602,3724,1516,2208,2,1
132602,3723,1516,2207,3,1
132602,1023,416,607,4,1
132602,2700,1100,1600,5,1
132602,1,0,1,11,1
132602,63,32,31,12,3
132602,173,83,90,19,1
132602,2527,1017,1510,20,1
132602,3671,1503,2168,21,4
132602,3611,1472,2139,22,1
132602,3610,1472,2138,23,1
132602,1017,413,604,24,1
132602,2593,1059,1534,25,1
132602,1,0,1,31,1
132602,60,31,29,32,3
132602,167,78,89,39,1
132602,2426,981,1445,40,1
132602,116,45,71,41,4
132602,113,44,69,42,1
132602,113,44,69,43,1
132602,6,3,3,44,1
132602,107,41,66,45,1
132602,3,1,2,52,3
132602,6,5,1,59,1
132602,101,36,65,60,1
132657,2297,1174,1123,1,4
132657,1785,945,840,2,1
132657,1732,917,815,3,1
132657,456,245,211,4,1
132657,1276,672,604,5,1
132657,53,28,25,11,1
132657,512,229,283,12,3
132657,173,107,66,19,1
132657,1103,565,538,20,1
132657,1945,990,955,21,4
132657,1634,865,769,22,1
132657,1633,864,769,23,1
132657,451,243,208,24,1
132657,1182,621,561,25,1
132657,1,1,0,31,1
132657,311,125,186,32,3
132657,162,99,63,39,1
132657,1020,522,498,40,1
132657,352,184,168,41,4
132657,151,80,71,42,1
132657,99,53,46,43,1
132657,5,2,3,44,1
132657,94,51,43,45,1
132657,52,27,25,51,1
132657,201,104,97,52,3
132657,11,8,3,59,1
132657,83,43,40,60,1
132666,129,39,90,1,4
132666,129,39,90,2,1
132666,129,39,90,3,1
132666,8,1,7,4,1
132666,121,38,83,5,1
132666,121,38,83,20,1
132666,129,39,90,21,4
132666,129,39,90,22,1
132666,129,39,90,23,1
132666,8,1,7,24,1
132666,121,38,83,25,1
132666,121,38,83,40,1
132675,140,76,64,1,4
132675,140,76,64,2,1
132675,139,75,64,3,1
132675,92,45,47,4,1
132675,47,30,17,5,1
132675,1,1,0,11,1
132675,47,30,17,20,1
132675,120,70,50,21,4
132675,120,70,50,22,1
132675,120,70,50,23,1
132675,82,43,39,24,1
132675,38,27,11,25,1
132675,38,27,11,40,1
132675,20,6,14,41,4
132675,20,6,14,42,1
132675,19,5,14,43,1
132675,10,2,8,44,1
132675,9,3,6,45,1
132675,1,1,0,51,1
132675,9,3,6,60,1
132693,16711,7042,9669,1,4
132693,16711,7042,9669,2,1
132693,12736,5533,7203,3,1
132693,2501,1210,1291,4,1
132693,10235,4323,5912,5,1
132693,3975,1509,2466,11,1
132693,656,276,380,19,1
132693,9579,4047,5532,20,1
132693,5929,2862,3067,21,4
132693,5929,2862,3067,22,1
132693,5350,2635,2715,23,1
132693,1581,776,805,24,1
132693,3769,1859,1910,25,1
132693,579,227,352,31,1
132693,324,163,161,39,1
132693,3445,1696,1749,40,1
132693,10782,4180,6602,41,4
132693,10782,4180,6602,42,1
132693,7386,2898,4488,43,1
132693,920,434,486,44,1
132693,6466,2464,4002,45,1
132693,3396,1282,2114,51,1
132693,332,113,219,59,1
132693,6134,2351,3783,60,1
132709,43883,18035,25848,1,4
132709,43883,18035,25848,2,1
132709,39162,16273,22889,3,1
132709,8052,3733,4319,4,1
132709,31110,12540,18570,5,1
132709,4721,1762,2959,11,1
132709,1878,774,1104,19,1
132709,29232,11766,17466,20,1
132709,13342,6048,7294,21,4
132709,13342,6048,7294,22,1
132709,12560,5740,6820,23,1
132709,4003,1904,2099,24,1
132709,8557,3836,4721,25,1
132709,782,308,474,31,1
132709,615,311,304,39,1
132709,7942,3525,4417,40,1
132709,30541,11987,18554,41,4
132709,30541,11987,18554,42,1
132709,26602,10533,16069,43,1
132709,4049,1829,2220,44,1
132709,22553,8704,13849,45,1
132709,3939,1454,2485,51,1
132709,1263,463,800,59,1
132709,21290,8241,13049,60,1
132806,59,20,39,1,4
132806,59,20,39,2,1
132806,59,20,39,3,1
132806,59,20,39,5,1
132806,59,20,39,20,1
132806,59,20,39,21,4
132806,59,20,39,22,1
132806,59,20,39,23,1
132806,59,20,39,25,1
132806,59,20,39,40,1
132842,991,200,791,1,4
132842,294,75,219,2,1
132842,263,64,199,3,1
132842,10,4,6,4,1
132842,253,60,193,5,1
132842,31,11,20,11,1
132842,697,125,572,12,3
132842,53,11,42,19,1
132842,200,49,151,20,1
132842,591,131,460,21,4
132842,175,50,125,22,1
132842,147,40,107,23,1
132842,9,4,5,24,1
132842,138,36,102,25,1
132842,28,10,18,31,1
132842,416,81,335,32,3
132842,34,9,25,39,1
132842,104,27,77,40,1
132842,400,69,331,41,4
132842,119,25,94,42,1
132842,116,24,92,43,1
132842,1,0,1,44,1
132842,115,24,91,45,1
132842,3,1,2,51,1
132842,281,44,237,52,3
132842,19,2,17,59,1
132842,96,22,74,60,1
132851,8162,3089,5073,1,4
132851,8162,3089,5073,2,1
132851,7113,2707,4406,3,1
132851,1375,595,780,4,1
132851,5738,2112,3626,5,1
132851,1049,382,667,11,1
132851,188,76,112,19,1
132851,5550,2036,3514,20,1
132851,3048,1273,1775,21,4
132851,3048,1273,1775,22,1
132851,2840,1199,1641,23,1
132851,827,359,468,24,1
132851,2013,840,1173,25,1
132851,208,74,134,31,1
132851,65,23,42,39,1
132851,1948,817,1131,40,1
132851,5114,1816,3298,41,4
132851,5114,1816,3298,42,1
132851,4273,1508,2765,43,1
132851,548,236,312,44,1
132851,3725,1272,2453,45,1
132851,841,308,533,51,1
132851,123,53,70,59,1
132851,3602,1219,2383,60,1
132879,302,156,146,1,4
132879,302,156,146,2,1
132879,299,154,145,3,1
132879,47,30,17,4,1
132879,252,124,128,5,1
132879,3,2,1,11,1
132879,38,23,15,19,1
132879,214,101,113,20,1
132879,232,126,106,21,4
132879,232,126,106,22,1
132879,232,126,106,23,1
132879,44,29,15,24,1
132879,188,97,91,25,1
132879,26,16,10,39,1
132879,162,81,81,40,1
132879,70,30,40,41,4
132879,70,30,40,42,1
132879,67,28,39,43,1
132879,3,1,2,44,1
132879,64,27,37,45,1
132879,3,2,1,51,1
132879,12,7,5,59,1
132879,52,20,32,60,1
132903,59589,26844,32745,1,4
132903,51333,23288,28045,2,1
132903,50919,23111,27808,3,1
132903,6047,2718,3329,4,1
132903,44872,20393,24479,5,1
132903,414,177,237,11,1
132903,8256,3556,4700,12,3
132903,7531,3200,4331,19,1
132903,37341,17193,20148,20,1
132903,39966,18105,21861,21,4
132903,36229,16510,19719,22,1
132903,36096,16452,19644,23,1
132903,5833,2634,3199,24,1
132903,30263,13818,16445,25,1
132903,133,58,75,31,1
132903,3737,1595,2142,32,3
132903,4499,1979,2520,39,1
132903,25764,11839,13925,40,1
132903,19623,8739,10884,41,4
132903,15104,6778,8326,42,1
132903,14823,6659,8164,43,1
132903,214,84,130,44,1
132903,14609,6575,8034,45,1
132903,281,119,162,51,1
132903,4519,1961,2558,52,3
132903,3032,1221,1811,59,1
132903,11577,5354,6223,60,1
132976,567,276,291,1,4
132976,567,276,291,2,1
132976,225,91,134,3,1
132976,128,50,78,4,1
132976,97,41,56,5,1
132976,342,185,157,11,1
132976,97,41,56,20,1
132976,225,91,134,21,4
132976,225,91,134,22,1
132976,225,91,134,23,1
132976,128,50,78,24,1
132976,97,41,56,25,1
132976,97,41,56,40,1
132976,342,185,157,41,4
132976,342,185,157,42,1
132976,342,185,157,51,1
133021,2160,795,1365,1,4
133021,2160,795,1365,2,1
133021,1635,604,1031,3,1
133021,407,166,241,4,1
133021,1228,438,790,5,1
133021,525,191,334,11,1
133021,122,34,88,19,1
133021,1106,404,702,20,1
133021,942,382,560,21,4
133021,942,382,560,22,1
133021,909,372,537,23,1
133021,340,138,202,24,1
133021,569,234,335,25,1
133021,33,10,23,31,1
133021,53,19,34,39,1
133021,516,215,301,40,1
133021,1218,413,805,41,4
133021,1218,413,805,42,1
133021,726,232,494,43,1
133021,67,28,39,44,1
133021,659,204,455,45,1
133021,492,181,311,51,1
133021,69,15,54,59,1
133021,590,189,401,60,1
133085,505,261,244,1,4
133085,495,256,239,2,1
133085,491,254,237,3,1
133085,126,65,61,4,1
133085,365,189,176,5,1
133085,4,2,2,11,1
133085,10,5,5,12,3
133085,47,25,22,19,1
133085,318,164,154,20,1
133085,479,248,231,21,4
133085,475,247,228,22,1
133085,474,247,227,23,1
133085,125,65,60,24,1
133085,349,182,167,25,1
133085,1,0,1,31,1
133085,4,1,3,32,3
133085,46,25,21,39,1
133085,303,157,146,40,1
133085,26,13,13,41,4
133085,20,9,11,42,1
133085,17,7,10,43,1
133085,1,0,1,44,1
133085,16,7,9,45,1
133085,3,2,1,51,1
133085,6,4,2,52,3
133085,1,0,1,59,1
133085,15,7,8,60,1
133155,614,270,344,1,4
133155,614,270,344,2,1
133155,614,270,344,3,1
133155,303,133,170,4,1
133155,311,137,174,5,1
133155,311,137,174,20,1
133155,307,145,162,21,4
133155,307,145,162,22,1
133155,307,145,162,23,1
133155,144,67,77,24,1
133155,163,78,85,25,1
133155,163,78,85,40,1
133155,307,125,182,41,4
133155,307,125,182,42,1
133155,307,125,182,43,1
133155,159,66,93,44,1
133155,148,59,89,45,1
133155,148,59,89,60,1
133386,14865,6001,8864,1,4
133386,14865,6001,8864,2,1
133386,12993,5359,7634,3,1
133386,2325,1099,1226,4,1
133386,10668,4260,6408,5,1
133386,1872,642,1230,11,1
133386,909,392,517,19,1
133386,9759,3868,5891,20,1
133386,6156,2788,3368,21,4
133386,6156,2788,3368,22,1
133386,5708,2638,3070,23,1
133386,1497,713,784,24,1
133386,4211,1925,2286,25,1
133386,448,150,298,31,1
133386,457,222,235,39,1
133386,3754,1703,2051,40,1
133386,8709,3213,5496,41,4
133386,8709,3213,5496,42,1
133386,7285,2721,4564,43,1
133386,828,386,442,44,1
133386,6457,2335,4122,45,1
133386,1424,492,932,51,1
133386,452,170,282,59,1
133386,6005,2165,3840,60,1
133465,1109,256,853,1,4
133465,973,235,738,2,1
133465,972,235,737,3,1
133465,61,22,39,4,1
133465,911,213,698,5,1
133465,1,0,1,11,1
133465,136,21,115,12,3
133465,237,54,183,19,1
133465,674,159,515,20,1
133465,488,140,348,21,4
133465,467,134,333,22,1
133465,467,134,333,23,1
133465,31,11,20,24,1
133465,436,123,313,25,1
133465,21,6,15,32,3
133465,91,29,62,39,1
133465,345,94,251,40,1
133465,621,116,505,41,4
133465,506,101,405,42,1
133465,505,101,404,43,1
133465,30,11,19,44,1
133465,475,90,385,45,1
133465,1,0,1,51,1
133465,115,15,100,52,3
133465,146,25,121,59,1
133465,329,65,264,60,1
133492,2173,844,1329,1,4
133492,2173,844,1329,2,1
133492,2163,840,1323,3,1
133492,455,162,293,4,1
133492,1708,678,1030,5,1
133492,10,4,6,11,1
133492,88,34,54,19,1
133492,1620,644,976,20,1
133492,1947,761,1186,21,4
133492,1947,761,1186,22,1
133492,1941,759,1182,23,1
133492,452,162,290,24,1
133492,1489,597,892,25,1
133492,6,2,4,31,1
133492,68,28,40,39,1
133492,1421,569,852,40,1
133492,226,83,143,41,4
133492,226,83,143,42,1
133492,222,81,141,43,1
133492,3,0,3,44,1
133492,219,81,138,45,1
133492,4,2,2,51,1
133492,20,6,14,59,1
133492,199,75,124,60,1
133508,15423,6163,9260,1,4
133508,15423,6163,9260,2,1
133508,12850,5203,7647,3,1
133508,2926,1337,1589,4,1
133508,9924,3866,6058,5,1
133508,2573,960,1613,11,1
133508,722,294,428,19,1
133508,9202,3572,5630,20,1
133508,5040,2132,2908,21,4
133508,5040,2132,2908,22,1
133508,4717,2035,2682,23,1
133508,1779,804,975,24,1
133508,2938,1231,1707,25,1
133508,323,97,226,31,1
133508,270,136,134,39,1
133508,2668,1095,1573,40,1
133508,10383,4031,6352,41,4
133508,10383,4031,6352,42,1
133508,8133,3168,4965,43,1
133508,1147,533,614,44,1
133508,6986,2635,4351,45,1
133508,2250,863,1387,51,1
133508,452,158,294,59,1
133508,6534,2477,4057,60,1
133526,862,461,401,1,4
133526,862,461,401,2,1
133526,862,461,401,3,1
133526,208,129,79,4,1
133526,654,332,322,5,1
133526,10,7,3,19,1
133526,644,325,319,20,1
133526,845,451,394,21,4
133526,845,451,394,22,1
133526,845,451,394,23,1
133526,204,127,77,24,1
133526,641,324,317,25,1
133526,10,7,3,39,1
133526,631,317,314,40,1
133526,17,10,7,41,4
133526,17,10,7,42,1
133526,17,10,7,43,1
133526,4,2,2,44,1
133526,13,8,5,45,1
133526,13,8,5,60,1
133553,5279,4323,956,1,4
133553,4679,3885,794,2,1
133553,4666,3875,791,3,1
133553,944,763,181,4,1
133553,3722,3112,610,5,1
133553,13,10,3,11,1
133553,600,438,162,12,3
133553,282,240,42,19,1
133553,3440,2872,568,20,1
133553,4831,3964,867,21,4
133553,4359,3619,740,22,1
133553,4355,3616,739,23,1
133553,941,761,180,24,1
133553,3414,2855,559,25,1
133553,4,3,1,31,1
133553,472,345,127,32,3
133553,277,235,42,39,1
133553,3137,2620,517,40,1
133553,448,359,89,41,4
133553,320,266,54,42,1
133553,311,259,52,43,1
133553,3,2,1,44,1
133553,308,257,51,45,1
133553,9,7,2,51,1
133553,128,93,35,52,3
133553,5,5,0,59,1
133553,303,252,51,60,1
133650,10743,4136,6607,1,4
133650,8930,3466,5464,2,1
133650,8825,3407,5418,3,1
133650,1277,467,810,4,1
133650,7548,2940,4608,5,1
133650,105,59,46,11,1
133650,1813,670,1143,12,3
133650,396,169,227,19,1
133650,7152,2771,4381,20,1
133650,9597,3668,5929,21,4
133650,8040,3081,4959,22,1
133650,8022,3067,4955,23,1
133650,1273,465,808,24,1
133650,6749,2602,4147,25,1
133650,18,14,4,31,1
133650,1557,587,970,32,3
133650,344,151,193,39,1
133650,6405,2451,3954,40,1
133650,1146,468,678,41,4
133650,890,385,505,42,1
133650,803,340,463,43,1
133650,4,2,2,44,1
133650,799,338,461,45,1
133650,87,45,42,51,1
133650,256,83,173,52,3
133650,52,18,34,59,1
133650,747,320,427,60,1
133669,30759,13178,17581,1,4
133669,25790,11296,14494,2,1
133669,24685,10726,13959,3,1
133669,3458,1538,1920,4,1
133669,21227,9188,12039,5,1
133669,1105,570,535,11,1
133669,4969,1882,3087,12,3
133669,3276,1333,1943,19,1
133669,17951,7855,10096,20,1
133669,17779,8017,9762,21,4
133669,15891,7187,8704,22,1
133669,15566,7023,8543,23,1
133669,3298,1456,1842,24,1
133669,12268,5567,6701,25,1
133669,325,164,161,31,1
133669,1888,830,1058,32,3
133669,1584,712,872,39,1
133669,10684,4855,5829,40,1
133669,12980,5161,7819,41,4
133669,9899,4109,5790,42,1
133669,9119,3703,5416,43,1
133669,160,82,78,44,1
133669,8959,3621,5338,45,1
133669,780,406,374,51,1
133669,3081,1052,2029,52,3
133669,1692,621,1071,59,1
133669,7267,3000,4267,60,1
133702,28134,11532,16602,1,4
133702,28134,11532,16602,2,1
133702,25018,10338,14680,3,1
133702,3866,1753,2113,4,1
133702,21152,8585,12567,5,1
133702,3116,1194,1922,11,1
133702,1561,676,885,19,1
133702,19591,7909,11682,20,1
133702,9217,4039,5178,21,4
133702,9217,4039,5178,22,1
133702,8676,3866,4810,23,1
133702,1923,901,1022,24,1
133702,6753,2965,3788,25,1
133702,541,173,368,31,1
133702,634,280,354,39,1
133702,6119,2685,3434,40,1
133702,18917,7493,11424,41,4
133702,18917,7493,11424,42,1
133702,16342,6472,9870,43,1
133702,1943,852,1091,44,1
133702,14399,5620,8779,45,1
133702,2575,1021,1554,51,1
133702,927,396,531,59,1
133702,13472,5224,8248,60,1
133711,2839,1177,1662,1,4
133711,2839,1177,1662,2,1
133711,2839,1177,1662,3,1
133711,708,287,421,4,1
133711,2131,890,1241,5,1
133711,186,97,89,19,1
133711,1945,793,1152,20,1
133711,2746,1133,1613,21,4
133711,2746,1133,1613,22,1
133711,2746,1133,1613,23,1
133711,708,287,421,24,1
133711,2038,846,1192,25,1
133711,184,95,89,39,1
133711,1854,751,1103,40,1
133711,93,44,49,41,4
133711,93,44,49,42,1
133711,93,44,49,43,1
133711,93,44,49,45,1
133711,2,2,0,59,1
133711,91,42,49,60,1
133809,558,279,279,1,4
133809,558,279,279,2,1
133809,558,279,279,3,1
133809,198,99,99,4,1
133809,360,180,180,5,1
133809,27,18,9,19,1
133809,333,162,171,20,1
133809,533,267,266,21,4
133809,533,267,266,22,1
133809,533,267,266,23,1
133809,196,98,98,24,1
133809,337,169,168,25,1
133809,26,17,9,39,1
133809,311,152,159,40,1
133809,25,12,13,41,4
133809,25,12,13,42,1
133809,25,12,13,43,1
133809,2,1,1,44,1
133809,23,11,12,45,1
133809,1,1,0,59,1
133809,22,10,12,60,1
133845,630,87,543,1,4
133845,630,87,543,2,1
133845,630,87,543,3,1
133845,174,22,152,4,1
133845,456,65,391,5,1
133845,456,65,391,20,1
133845,630,87,543,21,4
133845,630,87,543,22,1
133845,630,87,543,23,1
133845,174,22,152,24,1
133845,456,65,391,25,1
133845,456,65,391,40,1
133854,508,86,422,1,4
133854,508,86,422,2,1
133854,508,86,422,3,1
133854,126,20,106,4,1
133854,382,66,316,5,1
133854,382,66,316,20,1
133854,508,86,422,21,4
133854,508,86,422,22,1
133854,508,86,422,23,1
133854,126,20,106,24,1
133854,382,66,316,25,1
133854,382,66,316,40,1
133863,454,91,363,1,4
133863,454,91,363,2,1
133863,454,91,363,3,1
133863,121,28,93,4,1
133863,333,63,270,5,1
133863,333,63,270,20,1
133863,454,91,363,21,4
133863,454,91,363,22,1
133863,454,91,363,23,1
133863,121,28,93,24,1
133863,333,63,270,25,1
133863,333,63,270,40,1
133872,2293,500,1793,1,4
133872,2160,466,1694,2,1
133872,2064,420,1644,3,1
133872,59,15,44,4,1
133872,2005,405,1600,5,1
133872,96,46,50,11,1
133872,133,34,99,12,3
133872,448,90,358,19,1
133872,1557,315,1242,20,1
133872,737,177,560,21,4
133872,604,143,461,22,1
133872,597,141,456,23,1
133872,45,10,35,24,1
133872,552,131,421,25,1
133872,7,2,5,31,1
133872,133,34,99,32,3
133872,178,40,138,39,1
133872,374,91,283,40,1
133872,1556,323,1233,41,4
133872,1556,323,1233,42,1
133872,1467,279,1188,43,1
133872,14,5,9,44,1
133872,1453,274,1179,45,1
133872,89,44,45,51,1
133872,270,50,220,59,1
133872,1183,224,959,60,1
133881,5644,3786,1858,1,4
133881,3257,2372,885,2,1
133881,3191,2322,869,3,1
133881,783,573,210,4,1
133881,2408,1749,659,5,1
133881,66,50,16,11,1
133881,2387,1414,973,12,3
133881,239,174,65,19,1
133881,2169,1575,594,20,1
133881,4138,2854,1284,21,4
133881,3068,2233,835,22,1
133881,3063,2229,834,23,1
133881,781,571,210,24,1
133881,2282,1658,624,25,1
133881,5,4,1,31,1
133881,1070,621,449,32,3
133881,224,162,62,39,1
133881,2058,1496,562,40,1
133881,1506,932,574,41,4
133881,189,139,50,42,1
133881,128,93,35,43,1
133881,2,2,0,44,1
133881,126,91,35,45,1
133881,61,46,15,51,1
133881,1317,793,524,52,3
133881,15,12,3,59,1
133881,111,79,32,60,1
133942,68,9,59,1,4
133942,68,9,59,2,1
133942,68,9,59,3,1
133942,68,9,59,5,1
133942,68,9,59,20,1
133942,68,9,59,21,4
133942,68,9,59,22,1
133942,68,9,59,23,1
133942,68,9,59,25,1
133942,68,9,59,40,1
133951,47663,21064,26599,1,4
133951,39142,17427,21715,2,1
133951,38234,17100,21134,3,1
133951,4524,2068,2456,4,1
133951,33710,15032,18678,5,1
133951,908,327,581,11,1
133951,8521,3637,4884,12,3
133951,5614,2399,3215,19,1
133951,28096,12633,15463,20,1
133951,31932,14100,17832,21,4
133951,25954,11419,14535,22,1
133951,25645,11304,14341,23,1
133951,4304,1948,2356,24,1
133951,21341,9356,11985,25,1
133951,309,115,194,31,1
133951,5978,2681,3297,32,3
133951,3658,1598,2060,39,1
133951,17683,7758,9925,40,1
133951,15731,6964,8767,41,4
133951,13188,6008,7180,42,1
133951,12589,5796,6793,43,1
133951,220,120,100,44,1
133951,12369,5676,6693,45,1
133951,599,212,387,51,1
133951,2543,956,1587,52,3
133951,1956,801,1155,59,1
133951,10413,4875,5538,60,1
133960,1139,515,624,1,4
133960,1139,515,624,2,1
133960,964,449,515,3,1
133960,223,115,108,4,1
133960,741,334,407,5,1
133960,175,66,109,11,1
133960,18,10,8,19,1
133960,723,324,399,20,1
133960,435,216,219,21,4
133960,435,216,219,22,1
133960,414,212,202,23,1
133960,143,72,71,24,1
133960,271,140,131,25,1
133960,21,4,17,31,1
133960,7,4,3,39,1
133960,264,136,128,40,1
133960,704,299,405,41,4
133960,704,299,405,42,1
133960,550,237,313,43,1
133960,80,43,37,44,1
133960,470,194,276,45,1
133960,154,62,92,51,1
133960,11,6,5,59,1
133960,459,188,271,60,1
133979,1560,606,954,1,4
133979,1517,589,928,2,1
133979,1517,589,928,3,1
133979,412,170,242,4,1
133979,1105,419,686,5,1
133979,43,17,26,12,3
133979,89,37,52,19,1
133979,1016,382,634,20,1
133979,1430,550,880,21,4
133979,1414,543,871,22,1
133979,1414,543,871,23,1
133979,400,163,237,24,1
133979,1014,380,634,25,1
133979,16,7,9,32,3
133979,83,31,52,39,1
133979,931,349,582,40,1
133979,130,56,74,41,4
133979,103,46,57,42,1
133979,103,46,57,43,1
133979,12,7,5,44,1
133979,91,39,52,45,1
133979,27,10,17,52,3
133979,6,6,0,59,1
133979,85,33,52,60,1
133997,5818,2028,3790,1,4
133997,5818,2028,3790,2,1
133997,5818,2028,3790,3,1
133997,3134,1122,2012,4,1
133997,2684,906,1778,5,1
133997,2684,906,1778,20,1
133997,5818,2028,3790,21,4
133997,5818,2028,3790,22,1
133997,5818,2028,3790,23,1
133997,3134,1122,2012,24,1
133997,2684,906,1778,25,1
133997,2684,906,1778,40,1
134024,70,16,54,1,4
134024,70,16,54,2,1
134024,70,16,54,3,1
134024,19,3,16,4,1
134024,51,13,38,5,1
134024,51,13,38,20,1
134024,69,15,54,21,4
134024,69,15,54,22,1
134024,69,15,54,23,1
134024,19,3,16,24,1
134024,50,12,38,25,1
134024,50,12,38,40,1
134024,1,1,0,41,4
134024,1,1,0,42,1
134024,1,1,0,43,1
134024,1,1,0,45,1
134024,1,1,0,60,1
134079,2619,1015,1604,1,4
134079,2416,948,1468,2,1
134079,2379,932,1447,3,1
134079,635,233,402,4,1
134079,1744,699,1045,5,1
134079,37,16,21,11,1
134079,203,67,136,12,3
134079,157,64,93,19,1
134079,1587,635,952,20,1
134079,2283,917,1366,21,4
134079,2126,862,1264,22,1
134079,2124,860,1264,23,1
134079,633,233,400,24,1
134079,1491,627,864,25,1
134079,2,2,0,31,1
134079,157,55,102,32,3
134079,112,54,58,39,1
134079,1379,573,806,40,1
134079,336,98,238,41,4
134079,290,86,204,42,1
134079,255,72,183,43,1
134079,2,0,2,44,1
134079,253,72,181,45,1
134079,35,14,21,51,1
134079,46,12,34,52,3
134079,45,10,35,59,1
134079,208,62,146,60,1
134097,40909,18407,22502,1,4
134097,32528,14627,17901,2,1
134097,32086,14441,17645,3,1
134097,6032,2476,3556,4,1
134097,26054,11965,14089,5,1
134097,442,186,256,11,1
134097,8381,3780,4601,12,3
134097,2348,1226,1122,19,1
134097,23706,10739,12967,20,1
134097,34882,15584,19298,21,4
134097,28910,12669,16241,22,1
134097,28709,12600,16109,23,1
134097,5980,2447,3533,24,1
134097,22729,10153,12576,25,1
134097,201,69,132,31,1
134097,5972,2915,3057,32,3
134097,1961,1008,953,39,1
134097,20768,9145,11623,40,1
134097,6027,2823,3204,41,4
134097,3618,1958,1660,42,1
134097,3377,1841,1536,43,1
134097,52,29,23,44,1
134097,3325,1812,1513,45,1
134097,241,117,124,51,1
134097,2409,865,1544,52,3
134097,387,218,169,59,1
134097,2938,1594,1344,60,1
134112,4330,1401,2929,1,4
134112,4330,1401,2929,2,1
134112,4330,1401,2929,3,1
134112,3789,1233,2556,4,1
134112,541,168,373,5,1
134112,541,168,373,20,1
134112,4330,1401,2929,21,4
134112,4330,1401,2929,22,1
134112,4330,1401,2929,23,1
134112,3789,1233,2556,24,1
134112,541,168,373,25,1
134112,541,168,373,40,1
134121,103,25,78,1,4
134121,99,25,74,2,1
134121,99,25,74,3,1
134121,18,5,13,4,1
134121,81,20,61,5,1
134121,4,0,4,12,3
134121,16,6,10,19,1
134121,65,14,51,20,1
134121,103,25,78,21,4
134121,99,25,74,22,1
134121,99,25,74,23,1
134121,18,5,13,24,1
134121,81,20,61,25,1
134121,4,0,4,32,3
134121,16,6,10,39,1
134121,65,14,51,40,1
134130,49878,23028,26850,1,4
134130,33168,14979,18189,2,1
134130,32346,14582,17764,3,1
134130,6370,2656,3714,4,1
134130,25976,11926,14050,5,1
134130,822,397,425,11,1
134130,16710,8049,8661,12,3
134130,1806,940,866,19,1
134130,24170,10986,13184,20,1
134130,42490,19474,23016,21,4
134130,30314,13427,16887,22,1
134130,30054,13303,16751,23,1
134130,6348,2646,3702,24,1
134130,23706,10657,13049,25,1
134130,260,124,136,31,1
134130,12176,6047,6129,32,3
134130,1583,831,752,39,1
134130,22123,9826,12297,40,1
134130,7388,3554,3834,41,4
134130,2854,1552,1302,42,1
134130,2292,1279,1013,43,1
134130,22,10,12,44,1
134130,2270,1269,1001,45,1
134130,562,273,289,51,1
134130,4534,2002,2532,52,3
134130,223,109,114,59,1
134130,2047,1160,887,60,1
134149,2054,520,1534,1,4
134149,1746,443,1303,2,1
134149,1746,443,1303,3,1
134149,37,9,28,4,1
134149,1709,434,1275,5,1
134149,308,77,231,12,3
134149,313,69,244,19,1
134149,1396,365,1031,20,1
134149,1166,278,888,21,4
134149,1080,259,821,22,1
134149,1080,259,821,23,1
134149,36,8,28,24,1
134149,1044,251,793,25,1
134149,86,19,67,32,3
134149,227,46,181,39,1
134149,817,205,612,40,1
134149,888,242,646,41,4
134149,666,184,482,42,1
134149,666,184,482,43,1
134149,1,1,0,44,1
134149,665,183,482,45,1
134149,222,58,164,52,3
134149,86,23,63,59,1
134149,579,160,419,60,1
134228,28,7,21,1,4
134228,28,7,21,2,1
134228,28,7,21,3,1
134228,23,7,16,4,1
134228,5,0,5,5,1
134228,5,0,5,20,1
134228,24,7,17,21,4
134228,24,7,17,22,1
134228,24,7,17,23,1
134228,20,7,13,24,1
134228,4,0,4,25,1
134228,4,0,4,40,1
134228,4,0,4,41,4
134228,4,0,4,42,1
134228,4,0,4,43,1
134228,3,0,3,44,1
134228,1,0,1,45,1
134228,1,0,1,60,1
134237,20949,15170,5779,1,4
134237,18880,14205,4675,2,1
134237,18880,14205,4675,3,1
134237,2807,2133,674,4,1
134237,16073,12072,4001,5,1
134237,2069,965,1104,12,3
134237,16073,12072,4001,20,1
134237,20949,15170,5779,21,4
134237,18880,14205,4675,22,1
134237,18880,14205,4675,23,1
134237,2807,2133,674,24,1
134237,16073,12072,4001,25,1
134237,2069,965,1104,32,3
134237,16073,12072,4001,40,1
134291,675,517,158,1,4
134291,675,517,158,2,1
134291,675,517,158,3,1
134291,377,286,91,4,1
134291,298,231,67,5,1
134291,298,231,67,20,1
134291,556,416,140,21,4
134291,556,416,140,22,1
134291,556,416,140,23,1
134291,312,232,80,24,1
134291,244,184,60,25,1
134291,244,184,60,40,1
134291,119,101,18,41,4
134291,119,101,18,42,1
134291,119,101,18,43,1
134291,65,54,11,44,1
134291,54,47,7,45,1
134291,54,47,7,60,1
134307,710,685,25,1,4
134307,710,685,25,2,1
134307,710,685,25,3,1
134307,208,203,5,4,1
134307,502,482,20,5,1
134307,502,482,20,20,1
134307,321,309,12,21,4
134307,321,309,12,22,1
134307,321,309,12,23,1
134307,118,115,3,24,1
134307,203,194,9,25,1
134307,203,194,9,40,1
134307,389,376,13,41,4
134307,389,376,13,42,1
134307,389,376,13,43,1
134307,90,88,2,44,1
134307,299,288,11,45,1
134307,299,288,11,60,1
134343,6271,2450,3821,1,4
134343,6271,2450,3821,2,1
134343,3643,1566,2077,3,1
134343,853,412,441,4,1
134343,2790,1154,1636,5,1
134343,2628,884,1744,11,1
134343,165,65,100,19,1
134343,2625,1089,1536,20,1
134343,2224,931,1293,21,4
134343,2224,931,1293,22,1
134343,1659,741,918,23,1
134343,536,261,275,24,1
134343,1123,480,643,25,1
134343,565,190,375,31,1
134343,78,31,47,39,1
134343,1045,449,596,40,1
134343,4047,1519,2528,41,4
134343,4047,1519,2528,42,1
134343,1984,825,1159,43,1
134343,317,151,166,44,1
134343,1667,674,993,45,1
134343,2063,694,1369,51,1
134343,87,34,53,59,1
134343,1580,640,940,60,1
134422,68,4,64,1,4
134422,68,4,64,2,1
134422,68,4,64,3,1
134422,14,2,12,4,1
134422,54,2,52,5,1
134422,9,0,9,19,1
134422,45,2,43,20,1
134422,68,4,64,21,4
134422,68,4,64,22,1
134422,68,4,64,23,1
134422,14,2,12,24,1
134422,54,2,52,25,1
134422,9,0,9,39,1
134422,45,2,43,40,1
134495,26590,11565,15025,1,4
134495,26590,11565,15025,2,1
134495,23596,10343,13253,3,1
134495,4977,2324,2653,4,1
134495,18619,8019,10600,5,1
134495,2994,1222,1772,11,1
134495,2033,932,1101,19,1
134495,16586,7087,9499,20,1
134495,11532,5576,5956,21,4
134495,11532,5576,5956,22,1
134495,11202,5404,5798,23,1
134495,3385,1624,1761,24,1
134495,7817,3780,4037,25,1
134495,330,172,158,31,1
134495,1103,574,529,39,1
134495,6714,3206,3508,40,1
134495,15058,5989,9069,41,4
134495,15058,5989,9069,42,1
134495,12394,4939,7455,43,1
134495,1592,700,892,44,1
134495,10802,4239,6563,45,1
134495,2664,1050,1614,51,1
134495,930,358,572,59,1
134495,9872,3881,5991,60,1
134510,200,108,92,1,4
134510,200,108,92,2,1
134510,194,104,90,3,1
134510,34,19,15,4,1
134510,160,85,75,5,1
134510,6,4,2,11,1
134510,17,12,5,19,1
134510,143,73,70,20,1
134510,95,45,50,21,4
134510,95,45,50,22,1
134510,95,45,50,23,1
134510,19,10,9,24,1
134510,76,35,41,25,1
134510,3,2,1,39,1
134510,73,33,40,40,1
134510,105,63,42,41,4
134510,105,63,42,42,1
134510,99,59,40,43,1
134510,15,9,6,44,1
134510,84,50,34,45,1
134510,6,4,2,51,1
134510,14,10,4,59,1
134510,70,40,30,60,1
134529,73,5,68,1,4
134529,73,5,68,2,1
134529,73,5,68,3,1
134529,18,3,15,4,1
134529,55,2,53,5,1
134529,55,2,53,20,1
134529,73,5,68,21,4
134529,73,5,68,22,1
134529,73,5,68,23,1
134529,18,3,15,24,1
134529,55,2,53,25,1
134529,55,2,53,40,1
134574,173,52,121,1,4
134574,173,52,121,2,1
134574,173,52,121,3,1
134574,66,20,46,4,1
134574,107,32,75,5,1
134574,107,32,75,20,1
134574,108,34,74,21,4
134574,108,34,74,22,1
134574,108,34,74,23,1
134574,39,12,27,24,1
134574,69,22,47,25,1
134574,69,22,47,40,1
134574,65,18,47,41,4
134574,65,18,47,42,1
134574,65,18,47,43,1
134574,27,8,19,44,1
134574,38,10,28,45,1
134574,38,10,28,60,1
134608,17248,6977,10271,1,4
134608,17248,6977,10271,2,1
134608,13993,5694,8299,3,1
134608,2564,1243,1321,4,1
134608,11429,4451,6978,5,1
134608,3255,1283,1972,11,1
134608,453,184,269,19,1
134608,10976,4267,6709,20,1
134608,5940,2788,3152,21,4
134608,5940,2788,3152,22,1
134608,5326,2551,2775,23,1
134608,1519,763,756,24,1
134608,3807,1788,2019,25,1
134608,614,237,377,31,1
134608,185,89,96,39,1
134608,3622,1699,1923,40,1
134608,11308,4189,7119,41,4
134608,11308,4189,7119,42,1
134608,8667,3143,5524,43,1
134608,1045,480,565,44,1
134608,7622,2663,4959,45,1
134608,2641,1046,1595,51,1
134608,268,95,173,59,1
134608,7354,2568,4786,60,1
134680,474,238,236,1,4
134680,474,238,236,2,1
134680,474,238,236,3,1
134680,45,25,20,4,1
134680,429,213,216,5,1
134680,23,9,14,19,1
134680,406,204,202,20,1
134680,397,210,187,21,4
134680,397,210,187,22,1
134680,397,210,187,23,1
134680,35,20,15,24,1
134680,362,190,172,25,1
134680,20,9,11,39,1
134680,342,181,161,40,1
134680,77,28,49,41,4
134680,77,28,49,42,1
134680,77,28,49,43,1
134680,10,5,5,44,1
134680,67,23,44,45,1
134680,3,0,3,59,1
134680,64,23,41,60,1
134714,257,58,199,1,4
134714,257,58,199,2,1
134714,257,58,199,3,1
134714,83,18,65,4,1
134714,174,40,134,5,1
134714,174,40,134,20,1
134714,104,31,73,21,4
134714,104,31,73,22,1
134714,104,31,73,23,1
134714,34,9,25,24,1
134714,70,22,48,25,1
134714,70,22,48,40,1
134714,153,27,126,41,4
134714,153,27,126,42,1
134714,153,27,126,43,1
134714,49,9,40,44,1
134714,104,18,86,45,1
134714,104,18,86,60,1
134811,3208,1284,1924,1,4
134811,3167,1265,1902,2,1
134811,3167,1265,1902,3,1
134811,494,202,292,4,1
134811,2673,1063,1610,5,1
134811,41,19,22,12,3
134811,429,149,280,19,1
134811,2244,914,1330,20,1
134811,2435,977,1458,21,4
134811,2426,972,1454,22,1
134811,2426,972,1454,23,1
134811,446,182,264,24,1
134811,1980,790,1190,25,1
134811,9,5,4,32,3
134811,360,124,236,39,1
134811,1620,666,954,40,1
134811,773,307,466,41,4
134811,741,293,448,42,1
134811,741,293,448,43,1
134811,48,20,28,44,1
134811,693,273,420,45,1
134811,32,14,18,52,3
134811,69,25,44,59,1
134811,624,248,376,60,1
134909,463,310,153,1,4
134909,463,310,153,2,1
134909,463,310,153,3,1
134909,60,46,14,4,1
134909,403,264,139,5,1
134909,5,1,4,19,1
134909,398,263,135,20,1
134909,314,226,88,21,4
134909,314,226,88,22,1
134909,314,226,88,23,1
134909,52,41,11,24,1
134909,262,185,77,25,1
134909,4,1,3,39,1
134909,258,184,74,40,1
134909,149,84,65,41,4
134909,149,84,65,42,1
134909,149,84,65,43,1
134909,8,5,3,44,1
134909,141,79,62,45,1
134909,1,0,1,59,1
134909,140,79,61,60,1
134945,4157,1497,2660,1,4
134945,3425,1291,2134,2,1
134945,3360,1251,2109,3,1
134945,539,285,254,4,1
134945,2821,966,1855,5,1
134945,65,40,25,11,1
134945,732,206,526,12,3
134945,607,131,476,19,1
134945,2214,835,1379,20,1
134945,2388,1151,1237,21,4
134945,2201,1068,1133,22,1
134945,2195,1067,1128,23,1
134945,532,282,250,24,1
134945,1663,785,878,25,1
134945,6,1,5,31,1
134945,187,83,104,32,3
134945,268,94,174,39,1
134945,1395,691,704,40,1
134945,1769,346,1423,41,4
134945,1224,223,1001,42,1
134945,1165,184,981,43,1
134945,7,3,4,44,1
134945,1158,181,977,45,1
134945,59,39,20,51,1
134945,545,123,422,52,3
134945,339,37,302,59,1
134945,819,144,675,60,1
135063,449,84,365,1,4
135063,449,84,365,2,1
135063,445,81,364,3,1
135063,15,4,11,4,1
135063,430,77,353,5,1
135063,4,3,1,11,1
135063,36,5,31,19,1
135063,394,72,322,20,1
135063,64,15,49,21,4
135063,64,15,49,22,1
135063,64,15,49,23,1
135063,3,0,3,24,1
135063,61,15,46,25,1
135063,10,2,8,39,1
135063,51,13,38,40,1
135063,385,69,316,41,4
135063,385,69,316,42,1
135063,381,66,315,43,1
135063,12,4,8,44,1
135063,369,62,307,45,1
135063,4,3,1,51,1
135063,26,3,23,59,1
135063,343,59,284,60,1
135081,17129,5432,11697,1,4
135081,16039,5061,10978,2,1
135081,15788,4981,10807,3,1
135081,2289,723,1566,4,1
135081,13499,4258,9241,5,1
135081,251,80,171,11,1
135081,1090,371,719,12,3
135081,224,66,158,19,1
135081,13275,4192,9083,20,1
135081,12264,4024,8240,21,4
135081,12007,3926,8081,22,1
135081,11898,3897,8001,23,1
135081,2014,641,1373,24,1
135081,9884,3256,6628,25,1
135081,109,29,80,31,1
135081,257,98,159,32,3
135081,82,26,56,39,1
135081,9802,3230,6572,40,1
135081,4865,1408,3457,41,4
135081,4032,1135,2897,42,1
135081,3890,1084,2806,43,1
135081,275,82,193,44,1
135081,3615,1002,2613,45,1
135081,142,51,91,51,1
135081,833,273,560,52,3
135081,142,40,102,59,1
135081,3473,962,2511,60,1
135124,614,143,471,1,4
135124,614,143,471,2,1
135124,614,143,471,3,1
135124,178,43,135,4,1
135124,436,100,336,5,1
135124,15,0,15,19,1
135124,421,100,321,20,1
135124,614,143,471,21,4
135124,614,143,471,22,1
135124,614,143,471,23,1
135124,178,43,135,24,1
135124,436,100,336,25,1
135124,15,0,15,39,1
135124,421,100,321,40,1
135142,290,8,282,1,4
135142,290,8,282,2,1
135142,290,8,282,3,1
135142,72,2,70,4,1
135142,218,6,212,5,1
135142,218,6,212,20,1
135142,49,3,46,21,4
135142,49,3,46,22,1
135142,49,3,46,23,1
135142,7,0,7,24,1
135142,42,3,39,25,1
135142,42,3,39,40,1
135142,241,5,236,41,4
135142,241,5,236,42,1
135142,241,5,236,43,1
135142,65,2,63,44,1
135142,176,3,173,45,1
135142,176,3,173,60,1
135160,3057,1061,1996,1,4
135160,3057,1061,1996,2,1
135160,2234,781,1453,3,1
135160,583,232,351,4,1
135160,1651,549,1102,5,1
135160,823,280,543,11,1
135160,161,62,99,19,1
135160,1490,487,1003,20,1
135160,951,356,595,21,4
135160,951,356,595,22,1
135160,838,323,515,23,1
135160,318,124,194,24,1
135160,520,199,321,25,1
135160,113,33,80,31,1
135160,60,27,33,39,1
135160,460,172,288,40,1
135160,2106,705,1401,41,4
135160,2106,705,1401,42,1
135160,1396,458,938,43,1
135160,265,108,157,44,1
135160,1131,350,781,45,1
135160,710,247,463,51,1
135160,101,35,66,59,1
135160,1030,315,715,60,1
135179,637,291,346,1,4
135179,637,291,346,2,1
135179,637,291,346,3,1
135179,337,168,169,4,1
135179,300,123,177,5,1
135179,300,123,177,20,1
135179,428,206,222,21,4
135179,428,206,222,22,1
135179,428,206,222,23,1
135179,264,137,127,24,1
135179,164,69,95,25,1
135179,164,69,95,40,1
135179,209,85,124,41,4
135179,209,85,124,42,1
135179,209,85,124,43,1
135179,73,31,42,44,1
135179,136,54,82,45,1
135179,136,54,82,60,1
135188,4288,1665,2623,1,4
135188,4288,1665,2623,2,1
135188,3510,1370,2140,3,1
135188,895,405,490,4,1
135188,2615,965,1650,5,1
135188,778,295,483,11,1
135188,136,59,77,19,1
135188,2479,906,1573,20,1
135188,1246,533,713,21,4
135188,1246,533,713,22,1
135188,1188,507,681,23,1
135188,474,214,260,24,1
135188,714,293,421,25,1
135188,58,26,32,31,1
135188,52,28,24,39,1
135188,662,265,397,40,1
135188,3042,1132,1910,41,4
135188,3042,1132,1910,42,1
135188,2322,863,1459,43,1
135188,421,191,230,44,1
135188,1901,672,1229,45,1
135188,720,269,451,51,1
135188,84,31,53,59,1
135188,1817,641,1176,60,1
135267,816,575,241,1,4
135267,816,575,241,2,1
135267,705,467,238,3,1
135267,327,220,107,4,1
135267,378,247,131,5,1
135267,111,108,3,11,1
135267,378,247,131,20,1
135267,705,467,238,21,4
135267,705,467,238,22,1
135267,705,467,238,23,1
135267,327,220,107,24,1
135267,378,247,131,25,1
135267,378,247,131,40,1
135267,111,108,3,41,4
135267,111,108,3,42,1
135267,111,108,3,51,1
135276,1017,647,370,1,4
135276,1017,647,370,2,1
135276,1017,647,370,3,1
135276,558,342,216,4,1
135276,459,305,154,5,1
135276,459,305,154,20,1
135276,700,432,268,21,4
135276,700,432,268,22,1
135276,700,432,268,23,1
135276,377,223,154,24,1
135276,323,209,114,25,1
135276,323,209,114,40,1
135276,317,215,102,41,4
135276,317,215,102,42,1
135276,317,215,102,43,1
135276,181,119,62,44,1
135276,136,96,40,45,1
135276,136,96,40,60,1
135294,890,526,364,1,4
135294,890,526,364,2,1
135294,890,526,364,3,1
135294,382,241,141,4,1
135294,508,285,223,5,1
135294,508,285,223,20,1
135294,574,328,246,21,4
135294,574,328,246,22,1
135294,574,328,246,23,1
135294,193,113,80,24,1
135294,381,215,166,25,1
135294,381,215,166,40,1
135294,316,198,118,41,4
135294,316,198,118,42,1
135294,316,198,118,43,1
135294,189,128,61,44,1
135294,127,70,57,45,1
135294,127,70,57,60,1
135337,209,22,187,1,4
135337,209,22,187,2,1
135337,209,22,187,3,1
135337,12,3,9,4,1
135337,197,19,178,5,1
135337,197,19,178,20,1
135337,151,13,138,21,4
135337,151,13,138,22,1
135337,151,13,138,23,1
135337,10,1,9,24,1
135337,141,12,129,25,1
135337,141,12,129,40,1
135337,58,9,49,41,4
135337,58,9,49,42,1
135337,58,9,49,43,1
135337,2,2,0,44,1
135337,56,7,49,45,1
135337,56,7,49,60,1
135364,1277,914,363,1,4
135364,511,339,172,2,1
135364,510,338,172,3,1
135364,19,15,4,4,1
135364,491,323,168,5,1
135364,1,1,0,11,1
135364,766,575,191,12,3
135364,83,53,30,19,1
135364,408,270,138,20,1
135364,285,202,83,21,4
135364,122,89,33,22,1
135364,122,89,33,23,1
135364,3,3,0,24,1
135364,119,86,33,25,1
135364,163,113,50,32,3
135364,13,9,4,39,1
135364,106,77,29,40,1
135364,992,712,280,41,4
135364,389,250,139,42,1
135364,388,249,139,43,1
135364,16,12,4,44,1
135364,372,237,135,45,1
135364,1,1,0,51,1
135364,603,462,141,52,3
135364,70,44,26,59,1
135364,302,193,109,60,1
135391,10533,4126,6407,1,4
135391,10533,4126,6407,2,1
135391,9421,3704,5717,3,1
135391,1790,799,991,4,1
135391,7631,2905,4726,5,1
135391,1112,422,690,11,1
135391,545,215,330,19,1
135391,7086,2690,4396,20,1
135391,4381,1872,2509,21,4
135391,4381,1872,2509,22,1
135391,4078,1771,2307,23,1
135391,1121,513,608,24,1
135391,2957,1258,1699,25,1
135391,303,101,202,31,1
135391,231,109,122,39,1
135391,2726,1149,1577,40,1
135391,6152,2254,3898,41,4
135391,6152,2254,3898,42,1
135391,5343,1933,3410,43,1
135391,669,286,383,44,1
135391,4674,1647,3027,45,1
135391,809,321,488,51,1
135391,314,106,208,59,1
135391,4360,1541,2819,60,1
135407,1252,616,636,1,4
135407,1252,616,636,2,1
135407,1252,616,636,3,1
135407,905,480,425,4,1
135407,347,136,211,5,1
135407,347,136,211,20,1
135407,1249,615,634,21,4
135407,1249,615,634,22,1
135407,1249,615,634,23,1
135407,903,479,424,24,1
135407,346,136,210,25,1
135407,346,136,210,40,1
135407,3,1,2,41,4
135407,3,1,2,42,1
135407,3,1,2,43,1
135407,2,1,1,44,1
135407,1,0,1,45,1
135407,1,0,1,60,1
135416,254,47,207,1,4
135416,254,47,207,2,1
135416,254,47,207,3,1
135416,50,6,44,4,1
135416,204,41,163,5,1
135416,204,41,163,20,1
135416,254,47,207,21,4
135416,254,47,207,22,1
135416,254,47,207,23,1
135416,50,6,44,24,1
135416,204,41,163,25,1
135416,204,41,163,40,1
135522,446,200,246,1,4
135522,446,200,246,2,1
135522,446,200,246,3,1
135522,236,126,110,4,1
135522,210,74,136,5,1
135522,210,74,136,20,1
135522,325,143,182,21,4
135522,325,143,182,22,1
135522,325,143,182,23,1
135522,205,96,109,24,1
135522,120,47,73,25,1
135522,120,47,73,40,1
135522,121,57,64,41,4
135522,121,57,64,42,1
135522,121,57,64,43,1
135522,31,30,1,44,1
135522,90,27,63,45,1
135522,90,27,63,60,1
135610,347,115,232,1,4
135610,258,83,175,2,1
135610,257,83,174,3,1
135610,257,83,174,5,1
135610,1,0,1,11,1
135610,89,32,57,12,3
135610,13,3,10,19,1
135610,244,80,164,20,1
135610,113,36,77,21,4
135610,106,32,74,22,1
135610,106,32,74,23,1
135610,106,32,74,25,1
135610,7,4,3,32,3
135610,106,32,74,40,1
135610,234,79,155,41,4
135610,152,51,101,42,1
135610,151,51,100,43,1
135610,151,51,100,45,1
135610,1,0,1,51,1
135610,82,28,54,52,3
135610,13,3,10,59,1
135610,138,48,90,60,1
135647,1158,839,319,1,4
135647,1158,839,319,2,1
135647,1158,839,319,3,1
135647,368,261,107,4,1
135647,790,578,212,5,1
135647,790,578,212,20,1
135647,747,533,214,21,4
135647,747,533,214,22,1
135647,747,533,214,23,1
135647,272,184,88,24,1
135647,475,349,126,25,1
135647,475,349,126,40,1
135647,411,306,105,41,4
135647,411,306,105,42,1
135647,411,306,105,43,1
135647,96,77,19,44,1
135647,315,229,86,45,1
135647,315,229,86,60,1
135717,66298,27724,38574,1,4
135717,66298,27724,38574,2,1
135717,61684,25993,35691,3,1
135717,12642,5729,6913,4,1
135717,49042,20264,28778,5,1
135717,4614,1731,2883,11,1
135717,1613,729,884,19,1
135717,47429,19535,27894,20,1
135717,26579,11469,15110,21,4
135717,26579,11469,15110,22,1
135717,26099,11283,14816,23,1
135717,8738,3972,4766,24,1
135717,17361,7311,10050,25,1
135717,480,186,294,31,1
135717,759,373,386,39,1
135717,16602,6938,9664,40,1
135717,39719,16255,23464,41,4
135717,39719,16255,23464,42,1
135717,35585,14710,20875,43,1
135717,3904,1757,2147,44,1
135717,31681,12953,18728,45,1
135717,4134,1545,2589,51,1
135717,854,356,498,59,1
135717,30827,12597,18230,60,1
135726,16935,8268,8667,1,4
135726,11380,5533,5847,2,1
135726,11246,5481,5765,3,1
135726,2151,1044,1107,4,1
135726,9095,4437,4658,5,1
135726,134,52,82,11,1
135726,5555,2735,2820,12,3
135726,599,265,334,19,1
135726,8496,4172,4324,20,1
135726,15597,7747,7850,21,4
135726,10637,5229,5408,22,1
135726,10517,5179,5338,23,1
135726,2115,1022,1093,24,1
135726,8402,4157,4245,25,1
135726,120,50,70,31,1
135726,4960,2518,2442,32,3
135726,551,248,303,39,1
135726,7851,3909,3942,40,1
135726,1338,521,817,41,4
135726,743,304,439,42,1
135726,729,302,427,43,1
135726,36,22,14,44,1
135726,693,280,413,45,1
135726,14,2,12,51,1
135726,595,217,378,52,3
135726,48,17,31,59,1
135726,645,263,382,60,1
135735,2025,1789,236,1,4
135735,2025,1789,236,2,1
135735,1460,1358,102,3,1
135735,515,474,41,4,1
135735,945,884,61,5,1
135735,565,431,134,11,1
135735,945,884,61,20,1
135735,1289,1198,91,21,4
135735,1289,1198,91,22,1
135735,1235,1161,74,23,1
135735,404,380,24,24,1
135735,831,781,50,25,1
135735,54,37,17,31,1
135735,831,781,50,40,1
135735,736,591,145,41,4
135735,736,591,145,42,1
135735,225,197,28,43,1
135735,111,94,17,44,1
135735,114,103,11,45,1
135735,511,394,117,51,1
135735,114,103,11,60,1
135771,631,131,500,1,4
135771,631,131,500,2,1
135771,631,131,500,3,1
135771,141,27,114,4,1
135771,490,104,386,5,1
135771,490,104,386,20,1
135771,631,131,500,21,4
135771,631,131,500,22,1
135771,631,131,500,23,1
135771,141,27,114,24,1
135771,490,104,386,25,1
135771,490,104,386,40,1
135939,189,68,121,1,4
135939,189,68,121,2,1
135939,189,68,121,3,1
135939,65,24,41,4,1
135939,124,44,80,5,1
135939,4,1,3,19,1
135939,120,43,77,20,1
135939,189,68,121,21,4
135939,189,68,121,22,1
135939,189,68,121,23,1
135939,65,24,41,24,1
135939,124,44,80,25,1
135939,4,1,3,39,1
135939,120,43,77,40,1
135957,768,260,508,1,4
135957,768,260,508,2,1
135957,768,260,508,3,1
135957,98,36,62,4,1
135957,670,224,446,5,1
135957,66,20,46,19,1
135957,604,204,400,20,1
135957,669,228,441,21,4
135957,669,228,441,22,1
135957,669,228,441,23,1
135957,98,36,62,24,1
135957,571,192,379,25,1
135957,53,15,38,39,1
135957,518,177,341,40,1
135957,99,32,67,41,4
135957,99,32,67,42,1
135957,99,32,67,43,1
135957,99,32,67,45,1
135957,13,5,8,59,1
135957,86,27,59,60,1
136048,98,6,92,1,4
136048,98,6,92,2,1
136048,98,6,92,3,1
136048,27,3,24,4,1
136048,71,3,68,5,1
136048,71,3,68,20,1
136048,63,5,58,21,4
136048,63,5,58,22,1
136048,63,5,58,23,1
136048,21,2,19,24,1
136048,42,3,39,25,1
136048,42,3,39,40,1
136048,35,1,34,41,4
136048,35,1,34,42,1
136048,35,1,34,43,1
136048,6,1,5,44,1
136048,29,0,29,45,1
136048,29,0,29,60,1
136066,738,466,272,1,4
136066,738,466,272,2,1
136066,738,466,272,3,1
136066,190,113,77,4,1
136066,548,353,195,5,1
136066,548,353,195,20,1
136066,681,438,243,21,4
136066,681,438,243,22,1
136066,681,438,243,23,1
136066,180,108,72,24,1
136066,501,330,171,25,1
136066,501,330,171,40,1
136066,57,28,29,41,4
136066,57,28,29,42,1
136066,57,28,29,43,1
136066,10,5,5,44,1
136066,47,23,24,45,1
136066,47,23,24,60,1
136075,39,2,37,1,4
136075,39,2,37,2,1
136075,39,2,37,3,1
136075,39,2,37,5,1
136075,39,2,37,20,1
136075,39,2,37,21,4
136075,39,2,37,22,1
136075,39,2,37,23,1
136075,39,2,37,25,1
136075,39,2,37,40,1
136109,166,7,159,1,4
136109,166,7,159,2,1
136109,166,7,159,3,1
136109,28,1,27,4,1
136109,138,6,132,5,1
136109,138,6,132,20,1
136109,106,5,101,21,4
136109,106,5,101,22,1
136109,106,5,101,23,1
136109,24,1,23,24,1
136109,82,4,78,25,1
136109,82,4,78,40,1
136109,60,2,58,41,4
136109,60,2,58,42,1
136109,60,2,58,43,1
136109,4,0,4,44,1
136109,56,2,54,45,1
136109,56,2,54,60,1
136145,1179,368,811,1,4
136145,1179,368,811,2,1
136145,898,262,636,3,1
136145,239,87,152,4,1
136145,659,175,484,5,1
136145,281,106,175,11,1
136145,52,15,37,19,1
136145,607,160,447,20,1
136145,482,140,342,21,4
136145,482,140,342,22,1
136145,451,133,318,23,1
136145,168,56,112,24,1
136145,283,77,206,25,1
136145,31,7,24,31,1
136145,22,5,17,39,1
136145,261,72,189,40,1
136145,697,228,469,41,4
136145,697,228,469,42,1
136145,447,129,318,43,1
136145,71,31,40,44,1
136145,376,98,278,45,1
136145,250,99,151,51,1
136145,30,10,20,59,1
136145,346,88,258,60,1
136172,16083,7093,8990,1,4
136172,14263,6401,7862,2,1
136172,14006,6308,7698,3,1
136172,1609,744,865,4,1
136172,12397,5564,6833,5,1
136172,257,93,164,11,1
136172,1820,692,1128,12,3
136172,1964,864,1100,19,1
136172,10433,4700,5733,20,1
136172,10829,4734,6095,21,4
136172,10088,4464,5624,22,1
136172,9990,4437,5553,23,1
136172,1573,723,850,24,1
136172,8417,3714,4703,25,1
136172,98,27,71,31,1
136172,741,270,471,32,3
136172,1331,592,739,39,1
136172,7086,3122,3964,40,1
136172,5254,2359,2895,41,4
136172,4175,1937,2238,42,1
136172,4016,1871,2145,43,1
136172,36,21,15,44,1
136172,3980,1850,2130,45,1
136172,159,66,93,51,1
136172,1079,422,657,52,3
136172,633,272,361,59,1
136172,3347,1578,1769,60,1
136206,646,390,256,1,4
136206,612,372,240,2,1
136206,609,371,238,3,1
136206,124,72,52,4,1
136206,485,299,186,5,1
136206,3,1,2,11,1
136206,34,18,16,12,3
136206,126,90,36,19,1
136206,359,209,150,20,1
136206,555,347,208,21,4
136206,538,336,202,22,1
136206,536,335,201,23,1
136206,124,72,52,24,1
136206,412,263,149,25,1
136206,2,1,1,31,1
136206,17,11,6,32,3
136206,115,83,32,39,1
136206,297,180,117,40,1
136206,91,43,48,41,4
136206,74,36,38,42,1
136206,73,36,37,43,1
136206,73,36,37,45,1
136206,1,0,1,51,1
136206,17,7,10,52,3
136206,11,7,4,59,1
136206,62,29,33,60,1
136215,25670,7844,17826,1,4
136215,5156,1515,3641,2,1
136215,5053,1505,3548,3,1
136215,654,210,444,4,1
136215,4399,1295,3104,5,1
136215,103,10,93,11,1
136215,20514,6329,14185,12,3
136215,853,222,631,19,1
136215,3546,1073,2473,20,1
136215,13390,4319,9071,21,4
136215,3452,1109,2343,22,1
136215,3452,1109,2343,23,1
136215,614,200,414,24,1
136215,2838,909,1929,25,1
136215,9938,3210,6728,32,3
136215,584,156,428,39,1
136215,2254,753,1501,40,1
136215,12280,3525,8755,41,4
136215,1704,406,1298,42,1
136215,1601,396,1205,43,1
136215,40,10,30,44,1
136215,1561,386,1175,45,1
136215,103,10,93,51,1
136215,10576,3119,7457,52,3
136215,269,66,203,59,1
136215,1292,320,972,60,1
136233,6708,2842,3866,1,4
136233,6708,2842,3866,2,1
136233,5549,2315,3234,3,1
136233,949,455,494,4,1
136233,4600,1860,2740,5,1
136233,1159,527,632,11,1
136233,455,196,259,19,1
136233,4145,1664,2481,20,1
136233,2677,1194,1483,21,4
136233,2677,1194,1483,22,1
136233,2531,1136,1395,23,1
136233,629,308,321,24,1
136233,1902,828,1074,25,1
136233,146,58,88,31,1
136233,197,91,106,39,1
136233,1705,737,968,40,1
136233,4031,1648,2383,41,4
136233,4031,1648,2383,42,1
136233,3018,1179,1839,43,1
136233,320,147,173,44,1
136233,2698,1032,1666,45,1
136233,1013,469,544,51,1
136233,258,105,153,59,1
136233,2440,927,1513,60,1
136288,759,245,514,1,4
136288,714,233,481,2,1
136288,714,233,481,3,1
136288,38,6,32,4,1
136288,676,227,449,5,1
136288,45,12,33,12,3
136288,92,33,59,19,1
136288,584,194,390,20,1
136288,563,167,396,21,4
136288,539,162,377,22,1
136288,539,162,377,23,1
136288,35,5,30,24,1
136288,504,157,347,25,1
136288,24,5,19,32,3
136288,73,21,52,39,1
136288,431,136,295,40,1
136288,196,78,118,41,4
136288,175,71,104,42,1
136288,175,71,104,43,1
136288,3,1,2,44,1
136288,172,70,102,45,1
136288,21,7,14,52,3
136288,19,12,7,59,1
136288,153,58,95,60,1
136303,540,198,342,1,4
136303,540,198,342,2,1
136303,392,136,256,3,1
136303,233,63,170,4,1
136303,159,73,86,5,1
136303,148,62,86,11,1
136303,159,73,86,20,1
136303,225,53,172,21,4
136303,225,53,172,22,1
136303,225,53,172,23,1
136303,136,25,111,24,1
136303,89,28,61,25,1
136303,89,28,61,40,1
136303,315,145,170,41,4
136303,315,145,170,42,1
136303,167,83,84,43,1
136303,97,38,59,44,1
136303,70,45,25,45,1
136303,148,62,86,51,1
136303,70,45,25,60,1
136330,3764,1350,2414,1,4
136330,2887,1058,1829,2,1
136330,2501,879,1622,3,1
136330,578,194,384,4,1
136330,1923,685,1238,5,1
136330,386,179,207,11,1
136330,877,292,585,12,3
136330,320,114,206,19,1
136330,1603,571,1032,20,1
136330,2989,1013,1976,21,4
136330,2358,815,1543,22,1
136330,2358,815,1543,23,1
136330,578,194,384,24,1
136330,1780,621,1159,25,1
136330,631,198,433,32,3
136330,301,103,198,39,1
136330,1479,518,961,40,1
136330,775,337,438,41,4
136330,529,243,286,42,1
136330,143,64,79,43,1
136330,143,64,79,45,1
136330,386,179,207,51,1
136330,246,94,152,52,3
136330,19,11,8,59,1
136330,124,53,71,60,1
136358,29763,12887,16876,1,4
136358,29763,12887,16876,2,1
136358,26106,11497,14609,3,1
136358,5328,2536,2792,4,1
136358,20778,8961,11817,5,1
136358,3657,1390,2267,11,1
136358,1518,726,792,19,1
136358,19260,8235,11025,20,1
136358,9460,4509,4951,21,4
136358,9460,4509,4951,22,1
136358,9073,4387,4686,23,1
136358,2506,1218,1288,24,1
136358,6567,3169,3398,25,1
136358,387,122,265,31,1
136358,584,340,244,39,1
136358,5983,2829,3154,40,1
136358,20303,8378,11925,41,4
136358,20303,8378,11925,42,1
136358,17033,7110,9923,43,1
136358,2822,1318,1504,44,1
136358,14211,5792,8419,45,1
136358,3270,1268,2002,51,1
136358,934,386,548,59,1
136358,13277,5406,7871,60,1
136400,10206,3960,6246,1,4
136400,10206,3960,6246,2,1
136400,8211,3254,4957,3,1
136400,2367,1037,1330,4,1
136400,5844,2217,3627,5,1
136400,1995,706,1289,11,1
136400,318,123,195,19,1
136400,5526,2094,3432,20,1
136400,4004,1753,2251,21,4
136400,4004,1753,2251,22,1
136400,3837,1698,2139,23,1
136400,1525,691,834,24,1
136400,2312,1007,1305,25,1
136400,167,55,112,31,1
136400,133,62,71,39,1
136400,2179,945,1234,40,1
136400,6202,2207,3995,41,4
136400,6202,2207,3995,42,1
136400,4374,1556,2818,43,1
136400,842,346,496,44,1
136400,3532,1210,2322,45,1
136400,1828,651,1177,51,1
136400,185,61,124,59,1
136400,3347,1149,2198,60,1
136473,11235,4457,6778,1,4
136473,11235,4457,6778,2,1
136473,9026,3595,5431,3,1
136473,1784,828,956,4,1
136473,7242,2767,4475,5,1
136473,2209,862,1347,11,1
136473,692,253,439,19,1
136473,6550,2514,4036,20,1
136473,4467,1899,2568,21,4
136473,4467,1899,2568,22,1
136473,4025,1738,2287,23,1
136473,1207,565,642,24,1
136473,2818,1173,1645,25,1
136473,442,161,281,31,1
136473,299,135,164,39,1
136473,2519,1038,1481,40,1
136473,6768,2558,4210,41,4
136473,6768,2558,4210,42,1
136473,5001,1857,3144,43,1
136473,577,263,314,44,1
136473,4424,1594,2830,45,1
136473,1767,701,1066,51,1
136473,393,118,275,59,1
136473,4031,1476,2555,60,1
136491,1044,735,309,1,4
136491,1044,735,309,2,1
136491,1044,735,309,3,1
136491,207,161,46,4,1
136491,837,574,263,5,1
136491,837,574,263,20,1
136491,1024,733,291,21,4
136491,1024,733,291,22,1
136491,1024,733,291,23,1
136491,205,159,46,24,1
136491,819,574,245,25,1
136491,819,574,245,40,1
136491,20,2,18,41,4
136491,20,2,18,42,1
136491,20,2,18,43,1
136491,2,2,0,44,1
136491,18,0,18,45,1
136491,18,0,18,60,1
136516,11085,4193,6892,1,4
136516,11085,4193,6892,2,1
136516,9443,3555,5888,3,1
136516,1736,783,953,4,1
136516,7707,2772,4935,5,1
136516,1642,638,1004,11,1
136516,477,175,302,19,1
136516,7230,2597,4633,20,1
136516,3841,1627,2214,21,4
136516,3841,1627,2214,22,1
136516,3537,1500,2037,23,1
136516,977,459,518,24,1
136516,2560,1041,1519,25,1
136516,304,127,177,31,1
136516,185,73,112,39,1
136516,2375,968,1407,40,1
136516,7244,2566,4678,41,4
136516,7244,2566,4678,42,1
136516,5906,2055,3851,43,1
136516,759,324,435,44,1
136516,5147,1731,3416,45,1
136516,1338,511,827,51,1
136516,292,102,190,59,1
136516,4855,1629,3226,60,1
136659,744,419,325,1,4
136659,744,419,325,2,1
136659,277,170,107,3,1
136659,168,86,82,4,1
136659,109,84,25,5,1
136659,467,249,218,11,1
136659,109,84,25,20,1
136659,157,90,67,21,4
136659,157,90,67,22,1
136659,157,90,67,23,1
136659,83,36,47,24,1
136659,74,54,20,25,1
136659,74,54,20,40,1
136659,587,329,258,41,4
136659,587,329,258,42,1
136659,120,80,40,43,1
136659,85,50,35,44,1
136659,35,30,5,45,1
136659,467,249,218,51,1
136659,35,30,5,60,1
136701,106,101,5,1,4
136701,106,101,5,12,3
136701,101,99,2,21,4
136701,101,99,2,32,3
136701,5,2,3,41,4
136701,5,2,3,52,3
136765,717,387,330,1,4
136765,717,387,330,2,1
136765,717,387,330,3,1
136765,557,307,250,4,1
136765,160,80,80,5,1
136765,160,80,80,20,1
136765,522,265,257,21,4
136765,522,265,257,22,1
136765,522,265,257,23,1
136765,412,214,198,24,1
136765,110,51,59,25,1
136765,110,51,59,40,1
136765,195,122,73,41,4
136765,195,122,73,42,1
136765,195,122,73,43,1
136765,145,93,52,44,1
136765,50,29,21,45,1
136765,50,29,21,60,1
136774,1253,486,767,1,4
136774,1253,486,767,2,1
136774,1253,486,767,3,1
136774,257,106,151,4,1
136774,996,380,616,5,1
136774,84,30,54,19,1
136774,912,350,562,20,1
136774,1212,475,737,21,4
136774,1212,475,737,22,1
136774,1212,475,737,23,1
136774,257,106,151,24,1
136774,955,369,586,25,1
136774,84,30,54,39,1
136774,871,339,532,40,1
136774,41,11,30,41,4
136774,41,11,30,42,1
136774,41,11,30,43,1
136774,41,11,30,45,1
136774,41,11,30,60,1
136783,32,4,28,1,4
136783,32,4,28,2,1
136783,32,4,28,3,1
136783,8,1,7,4,1
136783,24,3,21,5,1
136783,24,3,21,20,1
136783,32,4,28,21,4
136783,32,4,28,22,1
136783,32,4,28,23,1
136783,8,1,7,24,1
136783,24,3,21,25,1
136783,24,3,21,40,1
136826,816,475,341,1,4
136826,816,475,341,2,1
136826,816,475,341,3,1
136826,324,182,142,4,1
136826,492,293,199,5,1
136826,492,293,199,20,1
136826,572,354,218,21,4
136826,572,354,218,22,1
136826,572,354,218,23,1
136826,216,134,82,24,1
136826,356,220,136,25,1
136826,356,220,136,40,1
136826,244,121,123,41,4
136826,244,121,123,42,1
136826,244,121,123,43,1
136826,108,48,60,44,1
136826,136,73,63,45,1
136826,136,73,63,60,1
136950,3153,1288,1865,1,4
136950,2608,1052,1556,2,1
136950,2608,1052,1556,3,1
136950,477,192,285,4,1
136950,2131,860,1271,5,1
136950,545,236,309,12,3
136950,71,38,33,19,1
136950,2060,822,1238,20,1
136950,2589,1062,1527,21,4
136950,2366,960,1406,22,1
136950,2366,960,1406,23,1
136950,477,192,285,24,1
136950,1889,768,1121,25,1
136950,223,102,121,32,3
136950,71,38,33,39,1
136950,1818,730,1088,40,1
136950,564,226,338,41,4
136950,242,92,150,42,1
136950,242,92,150,43,1
136950,242,92,150,45,1
136950,322,134,188,52,3
136950,242,92,150,60,1
137023,631,312,319,1,4
137023,631,312,319,2,1
137023,631,312,319,3,1
137023,259,133,126,4,1
137023,372,179,193,5,1
137023,372,179,193,20,1
137023,406,172,234,21,4
137023,406,172,234,22,1
137023,406,172,234,23,1
137023,130,63,67,24,1
137023,276,109,167,25,1
137023,276,109,167,40,1
137023,225,140,85,41,4
137023,225,140,85,42,1
137023,225,140,85,43,1
137023,129,70,59,44,1
137023,96,70,26,45,1
137023,96,70,26,60,1
137032,16275,6773,9502,1,4
137032,12640,5345,7295,2,1
137032,11993,5046,6947,3,1
137032,639,260,379,4,1
137032,11354,4786,6568,5,1
137032,647,299,348,11,1
137032,3635,1428,2207,12,3
137032,1475,597,878,19,1
137032,9879,4189,5690,20,1
137032,12228,5162,7066,21,4
137032,8663,3748,4915,22,1
137032,8426,3628,4798,23,1
137032,639,260,379,24,1
137032,7787,3368,4419,25,1
137032,237,120,117,31,1
137032,3565,1414,2151,32,3
137032,1111,435,676,39,1
137032,6676,2933,3743,40,1
137032,4047,1611,2436,41,4
137032,3977,1597,2380,42,1
137032,3567,1418,2149,43,1
137032,3567,1418,2149,45,1
137032,410,179,231,51,1
137032,70,14,56,52,3
137032,364,162,202,59,1
137032,3203,1256,1947,60,1
137078,31820,12600,19220,1,4
137078,31820,12600,19220,2,1
137078,27166,10658,16508,3,1
137078,4202,1969,2233,4,1
137078,22964,8689,14275,5,1
137078,4654,1942,2712,11,1
137078,1708,634,1074,19,1
137078,21256,8055,13201,20,1
137078,9118,4239,4879,21,4
137078,9118,4239,4879,22,1
137078,8252,3883,4369,23,1
137078,2058,1046,1012,24,1
137078,6194,2837,3357,25,1
137078,866,356,510,31,1
137078,632,281,351,39,1
137078,5562,2556,3006,40,1
137078,22702,8361,14341,41,4
137078,22702,8361,14341,42,1
137078,18914,6775,12139,43,1
137078,2144,923,1221,44,1
137078,16770,5852,10918,45,1
137078,3788,1586,2202,51,1
137078,1076,353,723,59,1
137078,15694,5499,10195,60,1
137087,1128,629,499,1,4
137087,1128,629,499,2,1
137087,1128,629,499,3,1
137087,218,141,77,4,1
137087,910,488,422,5,1
137087,910,488,422,20,1
137087,1116,623,493,21,4
137087,1116,623,493,22,1
137087,1116,623,493,23,1
137087,216,139,77,24,1
137087,900,484,416,25,1
137087,900,484,416,40,1
137087,12,6,6,41,4
137087,12,6,6,42,1
137087,12,6,6,43,1
137087,2,2,0,44,1
137087,10,4,6,45,1
137087,10,4,6,60,1
137096,15113,6738,8375,1,4
137096,15113,6738,8375,2,1
137096,13764,6224,7540,3,1
137096,2975,1455,1520,4,1
137096,10789,4769,6020,5,1
137096,1349,514,835,11,1
137096,1435,701,734,19,1
137096,9354,4068,5286,20,1
137096,6059,2946,3113,21,4
137096,6059,2946,3113,22,1
137096,5503,2748,2755,23,1
137096,1418,739,679,24,1
137096,4085,2009,2076,25,1
137096,556,198,358,31,1
137096,683,355,328,39,1
137096,3402,1654,1748,40,1
137096,9054,3792,5262,41,4
137096,9054,3792,5262,42,1
137096,8261,3476,4785,43,1
137096,1557,716,841,44,1
137096,6704,2760,3944,45,1
137096,793,316,477,51,1
137096,752,346,406,59,1
137096,5952,2414,3538,60,1
137120,670,423,247,1,4
137120,670,423,247,2,1
137120,670,423,247,3,1
137120,370,201,169,4,1
137120,300,222,78,5,1
137120,300,222,78,20,1
137120,420,249,171,21,4
137120,420,249,171,22,1
137120,420,249,171,23,1
137120,247,121,126,24,1
137120,173,128,45,25,1
137120,173,128,45,40,1
137120,250,174,76,41,4
137120,250,174,76,42,1
137120,250,174,76,43,1
137120,123,80,43,44,1
137120,127,94,33,45,1
137120,127,94,33,60,1
137148,793,201,592,1,4
137148,131,37,94,2,1
137148,128,37,91,3,1
137148,16,5,11,4,1
137148,112,32,80,5,1
137148,3,0,3,11,1
137148,662,164,498,12,3
137148,17,5,12,19,1
137148,95,27,68,20,1
137148,58,19,39,21,4
137148,10,4,6,22,1
137148,10,4,6,23,1
137148,2,0,2,24,1
137148,8,4,4,25,1
137148,48,15,33,32,3
137148,3,1,2,39,1
137148,5,3,2,40,1
137148,735,182,553,41,4
137148,121,33,88,42,1
137148,118,33,85,43,1
137148,14,5,9,44,1
137148,104,28,76,45,1
137148,3,0,3,51,1
137148,614,149,465,52,3
137148,14,4,10,59,1
137148,90,24,66,60,1
137209,18427,8003,10424,1,4
137209,18427,8003,10424,2,1
137209,16567,7118,9449,3,1
137209,3226,1577,1649,4,1
137209,13341,5541,7800,5,1
137209,1860,885,975,11,1
137209,1302,498,804,19,1
137209,12039,5043,6996,20,1
137209,6885,3376,3509,21,4
137209,6885,3376,3509,22,1
137209,6799,3334,3465,23,1
137209,2140,1093,1047,24,1
137209,4659,2241,2418,25,1
137209,86,42,44,31,1
137209,510,233,277,39,1
137209,4149,2008,2141,40,1
137209,11542,4627,6915,41,4
137209,11542,4627,6915,42,1
137209,9768,3784,5984,43,1
137209,1086,484,602,44,1
137209,8682,3300,5382,45,1
137209,1774,843,931,51,1
137209,792,265,527,59,1
137209,7890,3035,4855,60,1
137245,1244,606,638,1,4
137245,1244,606,638,2,1
137245,1244,606,638,3,1
137245,667,314,353,4,1
137245,577,292,285,5,1
137245,577,292,285,20,1
137245,1244,606,638,21,4
137245,1244,606,638,22,1
137245,1244,606,638,23,1
137245,667,314,353,24,1
137245,577,292,285,25,1
137245,577,292,285,40,1
137272,94,93,1,1,4
137272,77,76,1,2,1
137272,77,76,1,3,1
137272,17,16,1,4,1
137272,60,60,0,5,1
137272,17,17,0,12,3
137272,8,8,0,19,1
137272,52,52,0,20,1
137272,94,93,1,21,4
137272,77,76,1,22,1
137272,77,76,1,23,1
137272,17,16,1,24,1
137272,60,60,0,25,1
137272,17,17,0,32,3
137272,8,8,0,39,1
137272,52,52,0,40,1
137281,6127,2320,3807,1,4
137281,6127,2320,3807,2,1
137281,5173,1966,3207,3,1
137281,1105,485,620,4,1
137281,4068,1481,2587,5,1
137281,954,354,600,11,1
137281,370,152,218,19,1
137281,3698,1329,2369,20,1
137281,2292,965,1327,21,4
137281,2292,965,1327,22,1
137281,2183,923,1260,23,1
137281,697,299,398,24,1
137281,1486,624,862,25,1
137281,109,42,67,31,1
137281,143,78,65,39,1
137281,1343,546,797,40,1
137281,3835,1355,2480,41,4
137281,3835,1355,2480,42,1
137281,2990,1043,1947,43,1
137281,408,186,222,44,1
137281,2582,857,1725,45,1
137281,845,312,533,51,1
137281,227,74,153,59,1
137281,2355,783,1572,60,1
137315,2699,1034,1665,1,4
137315,2699,1034,1665,2,1
137315,2031,785,1246,3,1
137315,568,245,323,4,1
137315,1463,540,923,5,1
137315,668,249,419,11,1
137315,23,8,15,19,1
137315,1440,532,908,20,1
137315,970,439,531,21,4
137315,970,439,531,22,1
137315,874,399,475,23,1
137315,339,160,179,24,1
137315,535,239,296,25,1
137315,96,40,56,31,1
137315,9,5,4,39,1
137315,526,234,292,40,1
137315,1729,595,1134,41,4
137315,1729,595,1134,42,1
137315,1157,386,771,43,1
137315,229,85,144,44,1
137315,928,301,627,45,1
137315,572,209,363,51,1
137315,14,3,11,59,1
137315,914,298,616,60,1
137351,41428,17988,23440,1,4
137351,31100,13867,17233,2,1
137351,30376,13521,16855,3,1
137351,3736,1631,2105,4,1
137351,26640,11890,14750,5,1
137351,724,346,378,11,1
137351,10328,4121,6207,12,3
137351,3355,1480,1875,19,1
137351,23285,10410,12875,20,1
137351,29437,12963,16474,21,4
137351,23734,10434,13300,22,1
137351,23440,10282,13158,23,1
137351,3696,1608,2088,24,1
137351,19744,8674,11070,25,1
137351,294,152,142,31,1
137351,5703,2529,3174,32,3
137351,2351,1063,1288,39,1
137351,17393,7611,9782,40,1
137351,11991,5025,6966,41,4
137351,7366,3433,3933,42,1
137351,6936,3239,3697,43,1
137351,40,23,17,44,1
137351,6896,3216,3680,45,1
137351,430,194,236,51,1
137351,4625,1592,3033,52,3
137351,1004,417,587,59,1
137351,5892,2799,3093,60,1
137476,2315,1010,1305,1,4
137476,1035,463,572,2,1
137476,1035,463,572,3,1
137476,195,76,119,4,1
137476,840,387,453,5,1
137476,1280,547,733,12,3
137476,134,72,62,19,1
137476,706,315,391,20,1
137476,1817,821,996,21,4
137476,963,430,533,22,1
137476,963,430,533,23,1
137476,194,76,118,24,1
137476,769,354,415,25,1
137476,854,391,463,32,3
137476,121,67,54,39,1
137476,648,287,361,40,1
137476,498,189,309,41,4
137476,72,33,39,42,1
137476,72,33,39,43,1
137476,1,0,1,44,1
137476,71,33,38,45,1
137476,426,156,270,52,3
137476,13,5,8,59,1
137476,58,28,30,60,1
137537,226,25,201,1,4
137537,226,25,201,2,1
137537,226,25,201,3,1
137537,20,3,17,4,1
137537,206,22,184,5,1
137537,206,22,184,20,1
137537,117,12,105,21,4
137537,117,12,105,22,1
137537,117,12,105,23,1
137537,19,2,17,24,1
137537,98,10,88,25,1
137537,98,10,88,40,1
137537,109,13,96,41,4
137537,109,13,96,42,1
137537,109,13,96,43,1
137537,1,1,0,44,1
137537,108,12,96,45,1
137537,108,12,96,60,1
137546,4044,1792,2252,1,4
137546,2729,1182,1547,2,1
137546,2711,1175,1536,3,1
137546,852,352,500,4,1
137546,1859,823,1036,5,1
137546,18,7,11,11,1
137546,1315,610,705,12,3
137546,83,42,41,19,1
137546,1776,781,995,20,1
137546,3828,1689,2139,21,4
137546,2692,1158,1534,22,1
137546,2677,1153,1524,23,1
137546,852,352,500,24,1
137546,1825,801,1024,25,1
137546,15,5,10,31,1
137546,1136,531,605,32,3
137546,79,40,39,39,1
137546,1746,761,985,40,1
137546,216,103,113,41,4
137546,37,24,13,42,1
137546,34,22,12,43,1
137546,34,22,12,45,1
137546,3,2,1,51,1
137546,179,79,100,52,3
137546,4,2,2,59,1
137546,30,20,10,60,1
137564,3434,1519,1915,1,4
137564,3083,1394,1689,2,1
137564,2633,1197,1436,3,1
137564,865,432,433,4,1
137564,1768,765,1003,5,1
137564,450,197,253,11,1
137564,351,125,226,12,3
137564,274,129,145,19,1
137564,1494,636,858,20,1
137564,2634,1173,1461,21,4
137564,2473,1121,1352,22,1
137564,2471,1119,1352,23,1
137564,842,422,420,24,1
137564,1629,697,932,25,1
137564,2,2,0,31,1
137564,161,52,109,32,3
137564,260,122,138,39,1
137564,1369,575,794,40,1
137564,800,346,454,41,4
137564,610,273,337,42,1
137564,162,78,84,43,1
137564,23,10,13,44,1
137564,139,68,71,45,1
137564,448,195,253,51,1
137564,190,73,117,52,3
137564,14,7,7,59,1
137564,125,61,64,60,1
137591,281,70,211,1,4
137591,281,70,211,2,1
137591,281,70,211,3,1
137591,77,15,62,4,1
137591,204,55,149,5,1
137591,204,55,149,20,1
137591,281,70,211,21,4
137591,281,70,211,22,1
137591,281,70,211,23,1
137591,77,15,62,24,1
137591,204,55,149,25,1
137591,204,55,149,40,1
137713,142,45,97,1,4
137713,142,45,97,2,1
137713,142,45,97,3,1
137713,114,40,74,4,1
137713,28,5,23,5,1
137713,28,5,23,20,1
137713,105,36,69,21,4
137713,105,36,69,22,1
137713,105,36,69,23,1
137713,93,36,57,24,1
137713,12,0,12,25,1
137713,12,0,12,40,1
137713,37,9,28,41,4
137713,37,9,28,42,1
137713,37,9,28,43,1
137713,21,4,17,44,1
137713,16,5,11,45,1
137713,16,5,11,60,1
137759,13509,6310,7199,1,4
137759,13509,6310,7199,2,1
137759,12249,5810,6439,3,1
137759,3020,1536,1484,4,1
137759,9229,4274,4955,5,1
137759,1260,500,760,11,1
137759,1091,600,491,19,1
137759,8138,3674,4464,20,1
137759,6355,3295,3060,21,4
137759,6355,3295,3060,22,1
137759,6215,3229,2986,23,1
137759,2158,1114,1044,24,1
137759,4057,2115,1942,25,1
137759,140,66,74,31,1
137759,649,383,266,39,1
137759,3408,1732,1676,40,1
137759,7154,3015,4139,41,4
137759,7154,3015,4139,42,1
137759,6034,2581,3453,43,1
137759,862,422,440,44,1
137759,5172,2159,3013,45,1
137759,1120,434,686,51,1
137759,442,217,225,59,1
137759,4730,1942,2788,60,1
137777,44,44,0,1,4
137777,32,32,0,2,1
137777,32,32,0,3,1
137777,4,4,0,4,1
137777,28,28,0,5,1
137777,12,12,0,12,3
137777,7,7,0,19,1
137777,21,21,0,20,1
137777,44,44,0,21,4
137777,32,32,0,22,1
137777,32,32,0,23,1
137777,4,4,0,24,1
137777,28,28,0,25,1
137777,12,12,0,32,3
137777,7,7,0,39,1
137777,21,21,0,40,1
137801,770,419,351,1,4
137801,738,404,334,2,1
137801,738,404,334,3,1
137801,71,46,25,4,1
137801,667,358,309,5,1
137801,32,15,17,12,3
137801,77,49,28,19,1
137801,590,309,281,20,1
137801,630,356,274,21,4
137801,609,347,262,22,1
137801,609,347,262,23,1
137801,71,46,25,24,1
137801,538,301,237,25,1
137801,21,9,12,32,3
137801,71,45,26,39,1
137801,467,256,211,40,1
137801,140,63,77,41,4
137801,129,57,72,42,1
137801,129,57,72,43,1
137801,129,57,72,45,1
137801,11,6,5,52,3
137801,6,4,2,59,1
137801,123,53,70,60,1
137810,486,140,346,1,4
137810,468,137,331,2,1
137810,468,137,331,3,1
137810,47,6,41,4,1
137810,421,131,290,5,1
137810,18,3,15,12,3
137810,51,14,37,19,1
137810,370,117,253,20,1
137810,368,97,271,21,4
137810,367,97,270,22,1
137810,367,97,270,23,1
137810,47,6,41,24,1
137810,320,91,229,25,1
137810,1,0,1,32,3
137810,39,9,30,39,1
137810,281,82,199,40,1
137810,118,43,75,41,4
137810,101,40,61,42,1
137810,101,40,61,43,1
137810,101,40,61,45,1
137810,17,3,14,52,3
137810,12,5,7,59,1
137810,89,35,54,60,1
137847,7260,3274,3986,1,4
137847,6499,2910,3589,2,1
137847,6476,2897,3579,3,1
137847,1592,667,925,4,1
137847,4884,2230,2654,5,1
137847,23,13,10,11,1
137847,761,364,397,12,3
137847,500,275,225,19,1
137847,4384,1955,2429,20,1
137847,6450,2894,3556,21,4
137847,6188,2759,3429,22,1
137847,6184,2755,3429,23,1
137847,1590,666,924,24,1
137847,4594,2089,2505,25,1
137847,4,4,0,31,1
137847,262,135,127,32,3
137847,439,241,198,39,1
137847,4155,1848,2307,40,1
137847,810,380,430,41,4
137847,311,151,160,42,1
137847,292,142,150,43,1
137847,2,1,1,44,1
137847,290,141,149,45,1
137847,19,9,10,51,1
137847,499,229,270,52,3
137847,61,34,27,59,1
137847,229,107,122,60,1
137856,58,46,12,1,4
137856,58,46,12,2,1
137856,58,46,12,3,1
137856,22,14,8,4,1
137856,36,32,4,5,1
137856,36,32,4,20,1
137856,48,37,11,21,4
137856,48,37,11,22,1
137856,48,37,11,23,1
137856,17,10,7,24,1
137856,31,27,4,25,1
137856,31,27,4,40,1
137856,10,9,1,41,4
137856,10,9,1,42,1
137856,10,9,1,43,1
137856,5,4,1,44,1
137856,5,5,0,45,1
137856,5,5,0,60,1
137865,421,205,216,1,4
137865,421,205,216,2,1
137865,421,205,216,3,1
137865,82,35,47,4,1
137865,339,170,169,5,1
137865,339,170,169,20,1
137865,385,179,206,21,4
137865,385,179,206,22,1
137865,385,179,206,23,1
137865,77,31,46,24,1
137865,308,148,160,25,1
137865,308,148,160,40,1
137865,36,26,10,41,4
137865,36,26,10,42,1
137865,36,26,10,43,1
137865,5,4,1,44,1
137865,31,22,9,45,1
137865,31,22,9,60,1
137953,323,190,133,1,4
137953,301,173,128,2,1
137953,289,167,122,3,1
137953,83,52,31,4,1
137953,206,115,91,5,1
137953,12,6,6,11,1
137953,22,17,5,12,3
137953,40,19,21,19,1
137953,166,96,70,20,1
137953,236,136,100,21,4
137953,236,136,100,22,1
137953,236,136,100,23,1
137953,75,48,27,24,1
137953,161,88,73,25,1
137953,34,15,19,39,1
137953,127,73,54,40,1
137953,87,54,33,41,4
137953,65,37,28,42,1
137953,53,31,22,43,1
137953,8,4,4,44,1
137953,45,27,18,45,1
137953,12,6,6,51,1
137953,22,17,5,52,3
137953,6,4,2,59,1
137953,39,23,16,60,1
137962,224,135,89,1,4
137962,224,135,89,2,1
137962,222,134,88,3,1
137962,24,17,7,4,1
137962,198,117,81,5,1
137962,2,1,1,11,1
137962,52,33,19,19,1
137962,146,84,62,20,1
137962,202,121,81,21,4
137962,202,121,81,22,1
137962,202,121,81,23,1
137962,24,17,7,24,1
137962,178,104,74,25,1
137962,50,32,18,39,1
137962,128,72,56,40,1
137962,22,14,8,41,4
137962,22,14,8,42,1
137962,20,13,7,43,1
137962,20,13,7,45,1
137962,2,1,1,51,1
137962,2,1,1,59,1
137962,18,12,6,60,1
138132,79,4,75,1,4
138132,79,4,75,2,1
138132,79,4,75,3,1
138132,65,4,61,4,1
138132,14,0,14,5,1
138132,14,0,14,20,1
138132,59,3,56,21,4
138132,59,3,56,22,1
138132,59,3,56,23,1
138132,47,3,44,24,1
138132,12,0,12,25,1
138132,12,0,12,40,1
138132,20,1,19,41,4
138132,20,1,19,42,1
138132,20,1,19,43,1
138132,18,1,17,44,1
138132,2,0,2,45,1
138132,2,0,2,60,1
138187,42180,18843,23337,1,4
138187,42180,18843,23337,2,1
138187,34819,15797,19022,3,1
138187,8167,3853,4314,4,1
138187,26652,11944,14708,5,1
138187,7361,3046,4315,11,1
138187,3538,1671,1867,19,1
138187,23114,10273,12841,20,1
138187,16523,7712,8811,21,4
138187,16523,7712,8811,22,1
138187,15250,7135,8115,23,1
138187,5443,2589,2854,24,1
138187,9807,4546,5261,25,1
138187,1273,577,696,31,1
138187,1565,784,781,39,1
138187,8242,3762,4480,40,1
138187,25657,11131,14526,41,4
138187,25657,11131,14526,42,1
138187,19569,8662,10907,43,1
138187,2724,1264,1460,44,1
138187,16845,7398,9447,45,1
138187,6088,2469,3619,51,1
138187,1973,887,1086,59,1
138187,14872,6511,8361,60,1
138275,1162,537,625,1,4
138275,1043,499,544,2,1
138275,1023,489,534,3,1
138275,179,99,80,4,1
138275,844,390,454,5,1
138275,20,10,10,11,1
138275,119,38,81,12,3
138275,166,78,88,19,1
138275,678,312,366,20,1
138275,975,474,501,21,4
138275,888,442,446,22,1
138275,887,441,446,23,1
138275,171,97,74,24,1
138275,716,344,372,25,1
138275,1,1,0,31,1
138275,87,32,55,32,3
138275,142,74,68,39,1
138275,574,270,304,40,1
138275,187,63,124,41,4
138275,155,57,98,42,1
138275,136,48,88,43,1
138275,8,2,6,44,1
138275,128,46,82,45,1
138275,19,9,10,51,1
138275,32,6,26,52,3
138275,24,4,20,59,1
138275,104,42,62,60,1
138284,349,184,165,1,4
138284,349,184,165,2,1
138284,349,184,165,3,1
138284,163,94,69,4,1
138284,186,90,96,5,1
138284,186,90,96,20,1
138284,318,159,159,21,4
138284,318,159,159,22,1
138284,318,159,159,23,1
138284,146,82,64,24,1
138284,172,77,95,25,1
138284,172,77,95,40,1
138284,31,25,6,41,4
138284,31,25,6,42,1
138284,31,25,6,43,1
138284,17,12,5,44,1
138284,14,13,1,45,1
138284,14,13,1,60,1
138293,715,478,237,1,4
138293,667,457,210,2,1
138293,662,456,206,3,1
138293,205,157,48,4,1
138293,457,299,158,5,1
138293,5,1,4,11,1
138293,48,21,27,12,3
138293,91,55,36,19,1
138293,366,244,122,20,1
138293,671,454,217,21,4
138293,633,437,196,22,1
138293,628,436,192,23,1
138293,205,157,48,24,1
138293,423,279,144,25,1
138293,5,1,4,31,1
138293,38,17,21,32,3
138293,91,55,36,39,1
138293,332,224,108,40,1
138293,44,24,20,41,4
138293,34,20,14,42,1
138293,34,20,14,43,1
138293,34,20,14,45,1
138293,10,4,6,52,3
138293,34,20,14,60,1
138309,5640,1441,4199,1,4
138309,5640,1441,4199,2,1
138309,5627,1440,4187,3,1
138309,341,98,243,4,1
138309,5286,1342,3944,5,1
138309,13,1,12,11,1
138309,1005,234,771,19,1
138309,4281,1108,3173,20,1
138309,3304,833,2471,21,4
138309,3304,833,2471,22,1
138309,3302,833,2469,23,1
138309,241,64,177,24,1
138309,3061,769,2292,25,1
138309,2,0,2,31,1
138309,742,171,571,39,1
138309,2319,598,1721,40,1
138309,2336,608,1728,41,4
138309,2336,608,1728,42,1
138309,2325,607,1718,43,1
138309,100,34,66,44,1
138309,2225,573,1652,45,1
138309,11,1,10,51,1
138309,263,63,200,59,1
138309,1962,510,1452,60,1
138354,12588,5224,7364,1,4
138354,10158,4361,5797,2,1
138354,9906,4256,5650,3,1
138354,1333,587,746,4,1
138354,8573,3669,4904,5,1
138354,252,105,147,11,1
138354,2430,863,1567,12,3
138354,1208,503,705,19,1
138354,7365,3166,4199,20,1
138354,8183,3498,4685,21,4
138354,7581,3287,4294,22,1
138354,7464,3227,4237,23,1
138354,1316,580,736,24,1
138354,6148,2647,3501,25,1
138354,117,60,57,31,1
138354,602,211,391,32,3
138354,914,384,530,39,1
138354,5234,2263,2971,40,1
138354,4405,1726,2679,41,4
138354,2577,1074,1503,42,1
138354,2442,1029,1413,43,1
138354,17,7,10,44,1
138354,2425,1022,1403,45,1
138354,135,45,90,51,1
138354,1828,652,1176,52,3
138354,294,119,175,59,1
138354,2131,903,1228,60,1
138372,703,364,339,1,4
138372,703,364,339,2,1
138372,586,313,273,3,1
138372,276,146,130,4,1
138372,310,167,143,5,1
138372,117,51,66,11,1
138372,310,167,143,20,1
138372,508,267,241,21,4
138372,508,267,241,22,1
138372,508,267,241,23,1
138372,237,127,110,24,1
138372,271,140,131,25,1
138372,271,140,131,40,1
138372,195,97,98,41,4
138372,195,97,98,42,1
138372,78,46,32,43,1
138372,39,19,20,44,1
138372,39,27,12,45,1
138372,117,51,66,51,1
138372,39,27,12,60,1
138479,827,430,397,1,4
138479,827,430,397,2,1
138479,827,430,397,3,1
138479,598,310,288,4,1
138479,229,120,109,5,1
138479,229,120,109,20,1
138479,827,430,397,21,4
138479,827,430,397,22,1
138479,827,430,397,23,1
138479,598,310,288,24,1
138479,229,120,109,25,1
138479,229,120,109,40,1
138488,437,131,306,1,4
138488,437,131,306,2,1
138488,437,131,306,3,1
138488,149,32,117,4,1
138488,288,99,189,5,1
138488,288,99,189,20,1
138488,177,63,114,21,4
138488,177,63,114,22,1
138488,177,63,114,23,1
138488,41,9,32,24,1
138488,136,54,82,25,1
138488,136,54,82,40,1
138488,260,68,192,41,4
138488,260,68,192,42,1
138488,260,68,192,43,1
138488,108,23,85,44,1
138488,152,45,107,45,1
138488,152,45,107,60,1
138497,288,177,111,1,4
138497,288,177,111,2,1
138497,288,177,111,3,1
138497,201,110,91,4,1
138497,87,67,20,5,1
138497,87,67,20,20,1
138497,288,177,111,21,4
138497,288,177,111,22,1
138497,288,177,111,23,1
138497,201,110,91,24,1
138497,87,67,20,25,1
138497,87,67,20,40,1
138558,3394,1552,1842,1,4
138558,3394,1552,1842,2,1
138558,3194,1469,1725,3,1
138558,999,460,539,4,1
138558,2195,1009,1186,5,1
138558,200,83,117,11,1
138558,230,96,134,19,1
138558,1965,913,1052,20,1
138558,2350,1180,1170,21,4
138558,2350,1180,1170,22,1
138558,2330,1171,1159,23,1
138558,944,434,510,24,1
138558,1386,737,649,25,1
138558,20,9,11,31,1
138558,132,78,54,39,1
138558,1254,659,595,40,1
138558,1044,372,672,41,4
138558,1044,372,672,42,1
138558,864,298,566,43,1
138558,55,26,29,44,1
138558,809,272,537,45,1
138558,180,74,106,51,1
138558,98,18,80,59,1
138558,711,254,457,60,1
138600,915,10,905,1,4
138600,915,10,905,2,1
138600,858,0,858,3,1
138600,252,0,252,4,1
138600,606,0,606,5,1
138600,57,10,47,11,1
138600,17,0,17,19,1
138600,589,0,589,20,1
138600,897,8,889,21,4
138600,897,8,889,22,1
138600,853,0,853,23,1
138600,252,0,252,24,1
138600,601,0,601,25,1
138600,44,8,36,31,1
138600,16,0,16,39,1
138600,585,0,585,40,1
138600,18,2,16,41,4
138600,18,2,16,42,1
138600,5,0,5,43,1
138600,5,0,5,45,1
138600,13,2,11,51,1
138600,1,0,1,59,1
138600,4,0,4,60,1
138655,383,305,78,1,4
138655,383,305,78,2,1
138655,379,303,76,3,1
138655,111,91,20,4,1
138655,268,212,56,5,1
138655,4,2,2,11,1
138655,268,212,56,20,1
138655,377,302,75,21,4
138655,377,302,75,22,1
138655,375,301,74,23,1
138655,107,89,18,24,1
138655,268,212,56,25,1
138655,2,1,1,31,1
138655,268,212,56,40,1
138655,6,3,3,41,4
138655,6,3,3,42,1
138655,4,2,2,43,1
138655,4,2,2,44,1
138655,2,1,1,51,1
138664,36,16,20,1,4
138664,36,16,20,2,1
138664,36,16,20,3,1
138664,14,6,8,4,1
138664,22,10,12,5,1
138664,22,10,12,20,1
138664,36,16,20,21,4
138664,36,16,20,22,1
138664,36,16,20,23,1
138664,14,6,8,24,1
138664,22,10,12,25,1
138664,22,10,12,40,1
138682,3894,1551,2343,1,4
138682,3894,1551,2343,2,1
138682,3743,1498,2245,3,1
138682,790,374,416,4,1
138682,2953,1124,1829,5,1
138682,151,53,98,11,1
138682,485,140,345,19,1
138682,2468,984,1484,20,1
138682,2091,882,1209,21,4
138682,2091,882,1209,22,1
138682,2089,880,1209,23,1
138682,416,184,232,24,1
138682,1673,696,977,25,1
138682,2,2,0,31,1
138682,271,81,190,39,1
138682,1402,615,787,40,1
138682,1803,669,1134,41,4
138682,1803,669,1134,42,1
138682,1654,618,1036,43,1
138682,374,190,184,44,1
138682,1280,428,852,45,1
138682,149,51,98,51,1
138682,214,59,155,59,1
138682,1066,369,697,60,1
138691,6195,1891,4304,1,4
138691,6195,1891,4304,2,1
138691,5984,1828,4156,3,1
138691,1134,438,696,4,1
138691,4850,1390,3460,5,1
138691,211,63,148,11,1
138691,911,249,662,19,1
138691,3939,1141,2798,20,1
138691,2953,1080,1873,21,4
138691,2953,1080,1873,22,1
138691,2921,1073,1848,23,1
138691,908,360,548,24,1
138691,2013,713,1300,25,1
138691,32,7,25,31,1
138691,391,133,258,39,1
138691,1622,580,1042,40,1
138691,3242,811,2431,41,4
138691,3242,811,2431,42,1
138691,3063,755,2308,43,1
138691,226,78,148,44,1
138691,2837,677,2160,45,1
138691,179,56,123,51,1
138691,520,116,404,59,1
138691,2317,561,1756,60,1
138716,4260,1382,2878,1,4
138716,3660,1257,2403,2,1
138716,3566,1221,2345,3,1
138716,520,172,348,4,1
138716,3046,1049,1997,5,1
138716,94,36,58,11,1
138716,600,125,475,12,3
138716,325,103,222,19,1
138716,2721,946,1775,20,1
138716,3241,1122,2119,21,4
138716,3019,1077,1942,22,1
138716,3013,1074,1939,23,1
138716,508,167,341,24,1
138716,2505,907,1598,25,1
138716,6,3,3,31,1
138716,222,45,177,32,3
138716,239,90,149,39,1
138716,2266,817,1449,40,1
138716,1019,260,759,41,4
138716,641,180,461,42,1
138716,553,147,406,43,1
138716,12,5,7,44,1
138716,541,142,399,45,1
138716,88,33,55,51,1
138716,378,80,298,52,3
138716,86,13,73,59,1
138716,455,129,326,60,1
138761,316,156,160,1,4
138761,316,156,160,2,1
138761,311,155,156,3,1
138761,184,86,98,4,1
138761,127,69,58,5,1
138761,5,1,4,11,1
138761,21,12,9,19,1
138761,106,57,49,20,1
138761,309,155,154,21,4
138761,309,155,154,22,1
138761,306,155,151,23,1
138761,184,86,98,24,1
138761,122,69,53,25,1
138761,3,0,3,31,1
138761,19,12,7,39,1
138761,103,57,46,40,1
138761,7,1,6,41,4
138761,7,1,6,42,1
138761,5,0,5,43,1
138761,5,0,5,45,1
138761,2,1,1,51,1
138761,2,0,2,59,1
138761,3,0,3,60,1
138789,7101,2292,4809,1,4
138789,6377,2133,4244,2,1
138789,6206,2053,4153,3,1
138789,958,322,636,4,1
138789,5248,1731,3517,5,1
138789,171,80,91,11,1
138789,724,159,565,12,3
138789,620,175,445,19,1
138789,4628,1556,3072,20,1
138789,4987,1625,3362,21,4
138789,4684,1557,3127,22,1
138789,4663,1550,3113,23,1
138789,877,292,585,24,1
138789,3786,1258,2528,25,1
138789,21,7,14,31,1
138789,303,68,235,32,3
138789,440,136,304,39,1
138789,3346,1122,2224,40,1
138789,2114,667,1447,41,4
138789,1693,576,1117,42,1
138789,1543,503,1040,43,1
138789,81,30,51,44,1
138789,1462,473,989,45,1
138789,150,73,77,51,1
138789,421,91,330,52,3
138789,180,39,141,59,1
138789,1282,434,848,60,1
138813,3078,1732,1346,1,4
138813,3078,1732,1346,2,1
138813,2974,1686,1288,3,1
138813,806,464,342,4,1
138813,2168,1222,946,5,1
138813,104,46,58,11,1
138813,386,201,185,19,1
138813,1782,1021,761,20,1
138813,2564,1460,1104,21,4
138813,2564,1460,1104,22,1
138813,2531,1447,1084,23,1
138813,719,408,311,24,1
138813,1812,1039,773,25,1
138813,33,13,20,31,1
138813,311,166,145,39,1
138813,1501,873,628,40,1
138813,514,272,242,41,4
138813,514,272,242,42,1
138813,443,239,204,43,1
138813,87,56,31,44,1
138813,356,183,173,45,1
138813,71,33,38,51,1
138813,75,35,40,59,1
138813,281,148,133,60,1
138822,528,51,477,1,4
138822,528,51,477,2,1
138822,528,51,477,3,1
138822,55,6,49,4,1
138822,473,45,428,5,1
138822,473,45,428,20,1
138822,528,51,477,21,4
138822,528,51,477,22,1
138822,528,51,477,23,1
138822,55,6,49,24,1
138822,473,45,428,25,1
138822,473,45,428,40,1
138840,4859,1958,2901,1,4
138840,4859,1958,2901,2,1
138840,4568,1845,2723,3,1
138840,975,461,514,4,1
138840,3593,1384,2209,5,1
138840,291,113,178,11,1
138840,842,307,535,19,1
138840,2751,1077,1674,20,1
138840,1763,925,838,21,4
138840,1763,925,838,22,1
138840,1735,905,830,23,1
138840,430,242,188,24,1
138840,1305,663,642,25,1
138840,28,20,8,31,1
138840,349,165,184,39,1
138840,956,498,458,40,1
138840,3096,1033,2063,41,4
138840,3096,1033,2063,42,1
138840,2833,940,1893,43,1
138840,545,219,326,44,1
138840,2288,721,1567,45,1
138840,263,93,170,51,1
138840,493,142,351,59,1
138840,1795,579,1216,60,1
138868,1439,638,801,1,4
138868,1439,638,801,2,1
138868,1354,612,742,3,1
138868,192,134,58,4,1
138868,1162,478,684,5,1
138868,85,26,59,11,1
138868,141,76,65,19,1
138868,1021,402,619,20,1
138868,1291,585,706,21,4
138868,1291,585,706,22,1
138868,1281,582,699,23,1
138868,191,133,58,24,1
138868,1090,449,641,25,1
138868,10,3,7,31,1
138868,140,75,65,39,1
138868,950,374,576,40,1
138868,148,53,95,41,4
138868,148,53,95,42,1
138868,73,30,43,43,1
138868,1,1,0,44,1
138868,72,29,43,45,1
138868,75,23,52,51,1
138868,1,1,0,59,1
138868,71,28,43,60,1
138901,3016,1109,1907,1,4
138901,3016,1109,1907,2,1
138901,2950,1073,1877,3,1
138901,510,207,303,4,1
138901,2440,866,1574,5,1
138901,66,36,30,11,1
138901,602,221,381,19,1
138901,1838,645,1193,20,1
138901,1635,599,1036,21,4
138901,1635,599,1036,22,1
138901,1629,595,1034,23,1
138901,265,99,166,24,1
138901,1364,496,868,25,1
138901,6,4,2,31,1
138901,351,123,228,39,1
138901,1013,373,640,40,1
138901,1381,510,871,41,4
138901,1381,510,871,42,1
138901,1321,478,843,43,1
138901,245,108,137,44,1
138901,1076,370,706,45,1
138901,60,32,28,51,1
138901,251,98,153,59,1
138901,825,272,553,60,1
138929,579,270,309,1,4
138929,579,270,309,12,3
138929,359,180,179,21,4
138929,359,180,179,32,3
138929,220,90,130,41,4
138929,220,90,130,52,3
138938,62,19,43,1,4
138938,62,19,43,2,1
138938,62,19,43,3,1
138938,34,12,22,4,1
138938,28,7,21,5,1
138938,28,7,21,20,1
138938,44,16,28,21,4
138938,44,16,28,22,1
138938,44,16,28,23,1
138938,34,12,22,24,1
138938,10,4,6,25,1
138938,10,4,6,40,1
138938,18,3,15,41,4
138938,18,3,15,42,1
138938,18,3,15,43,1
138938,18,3,15,45,1
138938,18,3,15,60,1
138947,3458,878,2580,1,4
138947,2629,651,1978,2,1
138947,2629,651,1978,3,1
138947,781,199,582,4,1
138947,1848,452,1396,5,1
138947,829,227,602,12,3
138947,112,30,82,19,1
138947,1736,422,1314,20,1
138947,3044,749,2295,21,4
138947,2514,611,1903,22,1
138947,2514,611,1903,23,1
138947,767,197,570,24,1
138947,1747,414,1333,25,1
138947,530,138,392,32,3
138947,108,30,78,39,1
138947,1639,384,1255,40,1
138947,414,129,285,41,4
138947,115,40,75,42,1
138947,115,40,75,43,1
138947,14,2,12,44,1
138947,101,38,63,45,1
138947,299,89,210,52,3
138947,4,0,4,59,1
138947,97,38,59,60,1
138956,4379,1897,2482,1,4
138956,4379,1897,2482,2,1
138956,4294,1874,2420,3,1
138956,823,434,389,4,1
138956,3471,1440,2031,5,1
138956,85,23,62,11,1
138956,487,218,269,19,1
138956,2984,1222,1762,20,1
138956,1762,858,904,21,4
138956,1762,858,904,22,1
138956,1749,849,900,23,1
138956,386,235,151,24,1
138956,1363,614,749,25,1
138956,13,9,4,31,1
138956,225,129,96,39,1
138956,1138,485,653,40,1
138956,2617,1039,1578,41,4
138956,2617,1039,1578,42,1
138956,2545,1025,1520,43,1
138956,437,199,238,44,1
138956,2108,826,1282,45,1
138956,72,14,58,51,1
138956,262,89,173,59,1
138956,1846,737,1109,60,1
139010,2695,760,1935,1,4
139010,2695,760,1935,2,1
139010,2533,709,1824,3,1
139010,522,174,348,4,1
139010,2011,535,1476,5,1
139010,162,51,111,11,1
139010,188,39,149,19,1
139010,1823,496,1327,20,1
139010,1139,322,817,21,4
139010,1139,322,817,22,1
139010,1131,319,812,23,1
139010,234,73,161,24,1
139010,897,246,651,25,1
139010,8,3,5,31,1
139010,73,20,53,39,1
139010,824,226,598,40,1
139010,1556,438,1118,41,4
139010,1556,438,1118,42,1
139010,1402,390,1012,43,1
139010,288,101,187,44,1
139010,1114,289,825,45,1
139010,154,48,106,51,1
139010,115,19,96,59,1
139010,999,270,729,60,1
139074,751,138,613,1,4
139074,751,138,613,2,1
139074,744,137,607,3,1
139074,113,25,88,4,1
139074,631,112,519,5,1
139074,7,1,6,11,1
139074,222,32,190,19,1
139074,409,80,329,20,1
139074,397,90,307,21,4
139074,397,90,307,22,1
139074,397,90,307,23,1
139074,75,21,54,24,1
139074,322,69,253,25,1
139074,79,17,62,39,1
139074,243,52,191,40,1
139074,354,48,306,41,4
139074,354,48,306,42,1
139074,347,47,300,43,1
139074,38,4,34,44,1
139074,309,43,266,45,1
139074,7,1,6,51,1
139074,143,15,128,59,1
139074,166,28,138,60,1
139092,53,7,46,1,4
139092,53,7,46,2,1
139092,53,7,46,3,1
139092,5,2,3,4,1
139092,48,5,43,5,1
139092,48,5,43,20,1
139092,53,7,46,21,4
139092,53,7,46,22,1
139092,53,7,46,23,1
139092,5,2,3,24,1
139092,48,5,43,25,1
139092,48,5,43,40,1
139144,2223,831,1392,1,4
139144,2141,809,1332,2,1
139144,2122,802,1320,3,1
139144,672,307,365,4,1
139144,1450,495,955,5,1
139144,19,7,12,11,1
139144,82,22,60,12,3
139144,40,18,22,19,1
139144,1410,477,933,20,1
139144,2122,801,1321,21,4
139144,2107,798,1309,22,1
139144,2102,797,1305,23,1
139144,672,307,365,24,1
139144,1430,490,940,25,1
139144,5,1,4,31,1
139144,15,3,12,32,3
139144,38,18,20,39,1
139144,1392,472,920,40,1
139144,101,30,71,41,4
139144,34,11,23,42,1
139144,20,5,15,43,1
139144,20,5,15,45,1
139144,14,6,8,51,1
139144,67,19,48,52,3
139144,2,0,2,59,1
139144,18,5,13,60,1
139153,788,324,464,1,4
139153,554,222,332,2,1
139153,554,222,332,3,1
139153,93,39,54,4,1
139153,461,183,278,5,1
139153,234,102,132,12,3
139153,14,3,11,19,1
139153,447,180,267,20,1
139153,347,161,186,21,4
139153,238,112,126,22,1
139153,238,112,126,23,1
139153,55,24,31,24,1
139153,183,88,95,25,1
139153,109,49,60,32,3
139153,5,1,4,39,1
139153,178,87,91,40,1
139153,441,163,278,41,4
139153,316,110,206,42,1
139153,316,110,206,43,1
139153,38,15,23,44,1
139153,278,95,183,45,1
139153,125,53,72,52,3
139153,9,2,7,59,1
139153,269,93,176,60,1
139199,2854,428,2426,1,4
139199,1700,191,1509,2,1
139199,1683,185,1498,3,1
139199,204,1,203,4,1
139199,1479,184,1295,5,1
139199,17,6,11,11,1
139199,1154,237,917,12,3
139199,323,53,270,19,1
139199,1156,131,1025,20,1
139199,1528,172,1356,21,4
139199,1074,104,970,22,1
139199,1073,104,969,23,1
139199,201,1,200,24,1
139199,872,103,769,25,1
139199,1,0,1,31,1
139199,454,68,386,32,3
139199,190,36,154,39,1
139199,682,67,615,40,1
139199,1326,256,1070,41,4
139199,626,87,539,42,1
139199,610,81,529,43,1
139199,3,0,3,44,1
139199,607,81,526,45,1
139199,16,6,10,51,1
139199,700,169,531,52,3
139199,133,17,116,59,1
139199,474,64,410,60,1
139205,693,376,317,1,4
139205,693,376,317,2,1
139205,543,300,243,3,1
139205,148,94,54,4,1
139205,395,206,189,5,1
139205,150,76,74,11,1
139205,47,33,14,19,1
139205,348,173,175,20,1
139205,503,284,219,21,4
139205,503,284,219,22,1
139205,498,283,215,23,1
139205,147,94,53,24,1
139205,351,189,162,25,1
139205,5,1,4,31,1
139205,45,33,12,39,1
139205,306,156,150,40,1
139205,190,92,98,41,4
139205,190,92,98,42,1
139205,45,17,28,43,1
139205,1,0,1,44,1
139205,44,17,27,45,1
139205,145,75,70,51,1
139205,2,0,2,59,1
139205,42,17,25,60,1
139214,233,16,217,1,4
139214,233,16,217,2,1
139214,233,16,217,3,1
139214,17,1,16,4,1
139214,216,15,201,5,1
139214,2,0,2,19,1
139214,214,15,199,20,1
139214,66,5,61,21,4
139214,66,5,61,22,1
139214,66,5,61,23,1
139214,6,0,6,24,1
139214,60,5,55,25,1
139214,60,5,55,40,1
139214,167,11,156,41,4
139214,167,11,156,42,1
139214,167,11,156,43,1
139214,11,1,10,44,1
139214,156,10,146,45,1
139214,2,0,2,59,1
139214,154,10,144,60,1
139250,2987,950,2037,1,4
139250,2987,950,2037,2,1
139250,2855,903,1952,3,1
139250,597,229,368,4,1
139250,2258,674,1584,5,1
139250,132,47,85,11,1
139250,233,76,157,19,1
139250,2025,598,1427,20,1
139250,1838,632,1206,21,4
139250,1838,632,1206,22,1
139250,1824,627,1197,23,1
139250,528,196,332,24,1
139250,1296,431,865,25,1
139250,14,5,9,31,1
139250,151,52,99,39,1
139250,1145,379,766,40,1
139250,1149,318,831,41,4
139250,1149,318,831,42,1
139250,1031,276,755,43,1
139250,69,33,36,44,1
139250,962,243,719,45,1
139250,118,42,76,51,1
139250,82,24,58,59,1
139250,880,219,661,60,1
139278,6915,2435,4480,1,4
139278,6915,2435,4480,2,1
139278,6283,2197,4086,3,1
139278,1602,774,828,4,1
139278,4681,1423,3258,5,1
139278,632,238,394,11,1
139278,590,213,377,19,1
139278,4091,1210,2881,20,1
139278,2223,834,1389,21,4
139278,2223,834,1389,22,1
139278,2005,779,1226,23,1
139278,662,325,337,24,1
139278,1343,454,889,25,1
139278,218,55,163,31,1
139278,199,89,110,39,1
139278,1144,365,779,40,1
139278,4692,1601,3091,41,4
139278,4692,1601,3091,42,1
139278,4278,1418,2860,43,1
139278,940,449,491,44,1
139278,3338,969,2369,45,1
139278,414,183,231,51,1
139278,391,124,267,59,1
139278,2947,845,2102,60,1
139287,103,69,34,1,4
139287,103,69,34,2,1
139287,103,69,34,3,1
139287,34,22,12,4,1
139287,69,47,22,5,1
139287,69,47,22,20,1
139287,59,41,18,21,4
139287,59,41,18,22,1
139287,59,41,18,23,1
139287,27,19,8,24,1
139287,32,22,10,25,1
139287,32,22,10,40,1
139287,44,28,16,41,4
139287,44,28,16,42,1
139287,44,28,16,43,1
139287,7,3,4,44,1
139287,37,25,12,45,1
139287,37,25,12,60,1
139311,7261,2214,5047,1,4
139311,6893,2085,4808,2,1
139311,6445,1919,4526,3,1
139311,578,245,333,4,1
139311,5867,1674,4193,5,1
139311,448,166,282,11,1
139311,368,129,239,12,3
139311,1017,266,751,19,1
139311,4850,1408,3442,20,1
139311,4092,1279,2813,21,4
139311,3939,1225,2714,22,1
139311,3839,1190,2649,23,1
139311,476,196,280,24,1
139311,3363,994,2369,25,1
139311,100,35,65,31,1
139311,153,54,99,32,3
139311,596,170,426,39,1
139311,2767,824,1943,40,1
139311,3169,935,2234,41,4
139311,2954,860,2094,42,1
139311,2606,729,1877,43,1
139311,102,49,53,44,1
139311,2504,680,1824,45,1
139311,348,131,217,51,1
139311,215,75,140,52,3
139311,421,96,325,59,1
139311,2083,584,1499,60,1
139348,233,113,120,1,4
139348,233,113,120,12,3
139348,149,69,80,21,4
139348,149,69,80,32,3
139348,84,44,40,41,4
139348,84,44,40,52,3
139357,3739,1354,2385,1,4
139357,3739,1354,2385,2,1
139357,3556,1269,2287,3,1
139357,676,314,362,4,1
139357,2880,955,1925,5,1
139357,183,85,98,11,1
139357,453,158,295,19,1
139357,2427,797,1630,20,1
139357,1426,590,836,21,4
139357,1426,590,836,22,1
139357,1384,574,810,23,1
139357,326,166,160,24,1
139357,1058,408,650,25,1
139357,42,16,26,31,1
139357,189,79,110,39,1
139357,869,329,540,40,1
139357,2313,764,1549,41,4
139357,2313,764,1549,42,1
139357,2172,695,1477,43,1
139357,350,148,202,44,1
139357,1822,547,1275,45,1
139357,141,69,72,51,1
139357,264,79,185,59,1
139357,1558,468,1090,60,1
139366,8156,3346,4810,1,4
139366,7013,2846,4167,2,1
139366,6849,2781,4068,3,1
139366,1117,460,657,4,1
139366,5732,2321,3411,5,1
139366,164,65,99,11,1
139366,1143,500,643,12,3
139366,697,282,415,19,1
139366,5035,2039,2996,20,1
139366,5382,2124,3258,21,4
139366,4979,1940,3039,22,1
139366,4944,1927,3017,23,1
139366,1026,405,621,24,1
139366,3918,1522,2396,25,1
139366,35,13,22,31,1
139366,403,184,219,32,3
139366,428,178,250,39,1
139366,3490,1344,2146,40,1
139366,2774,1222,1552,41,4
139366,2034,906,1128,42,1
139366,1905,854,1051,43,1
139366,91,55,36,44,1
139366,1814,799,1015,45,1
139366,129,52,77,51,1
139366,740,316,424,52,3
139366,269,104,165,59,1
139366,1545,695,850,60,1
139384,6051,2047,4004,1,4
139384,6051,2047,4004,2,1
139384,5220,1745,3475,3,1
139384,1154,515,639,4,1
139384,4066,1230,2836,5,1
139384,831,302,529,11,1
139384,1073,311,762,19,1
139384,2993,919,2074,20,1
139384,2135,820,1315,21,4
139384,2135,820,1315,22,1
139384,2080,797,1283,23,1
139384,549,279,270,24,1
139384,1531,518,1013,25,1
139384,55,23,32,31,1
139384,437,150,287,39,1
139384,1094,368,726,40,1
139384,3916,1227,2689,41,4
139384,3916,1227,2689,42,1
139384,3140,948,2192,43,1
139384,605,236,369,44,1
139384,2535,712,1823,45,1
139384,776,279,497,51,1
139384,636,161,475,59,1
139384,1899,551,1348,60,1
139393,1173,500,673,1,4
139393,1104,483,621,2,1
139393,1063,462,601,3,1
139393,295,129,166,4,1
139393,768,333,435,5,1
139393,41,21,20,11,1
139393,69,17,52,12,3
139393,26,13,13,19,1
139393,742,320,422,20,1
139393,1102,461,641,21,4
139393,1050,451,599,22,1
139393,1050,451,599,23,1
139393,295,129,166,24,1
139393,755,322,433,25,1
139393,52,10,42,32,3
139393,26,13,13,39,1
139393,729,309,420,40,1
139393,71,39,32,41,4
139393,54,32,22,42,1
139393,13,11,2,43,1
139393,13,11,2,45,1
139393,41,21,20,51,1
139393,17,7,10,52,3
139393,13,11,2,60,1
139463,5015,1961,3054,1,4
139463,5015,1961,3054,2,1
139463,4852,1886,2966,3,1
139463,965,425,540,4,1
139463,3887,1461,2426,5,1
139463,163,75,88,11,1
139463,318,130,188,19,1
139463,3569,1331,2238,20,1
139463,3044,1282,1762,21,4
139463,3044,1282,1762,22,1
139463,3010,1269,1741,23,1
139463,819,363,456,24,1
139463,2191,906,1285,25,1
139463,34,13,21,31,1
139463,211,90,121,39,1
139463,1980,816,1164,40,1
139463,1971,679,1292,41,4
139463,1971,679,1292,42,1
139463,1842,617,1225,43,1
139463,146,62,84,44,1
139463,1696,555,1141,45,1
139463,129,62,67,51,1
139463,107,40,67,59,1
139463,1589,515,1074,60,1
139506,68,29,39,1,4
139506,68,29,39,2,1
139506,68,29,39,3,1
139506,20,7,13,4,1
139506,48,22,26,5,1
139506,48,22,26,20,1
139506,68,29,39,21,4
139506,68,29,39,22,1
139506,68,29,39,23,1
139506,20,7,13,24,1
139506,48,22,26,25,1
139506,48,22,26,40,1
139579,1510,465,1045,1,4
139579,777,272,505,2,1
139579,775,272,503,3,1
139579,63,23,40,4,1
139579,712,249,463,5,1
139579,2,0,2,11,1
139579,733,193,540,12,3
139579,166,51,115,19,1
139579,546,198,348,20,1
139579,928,316,612,21,4
139579,379,158,221,22,1
139579,379,158,221,23,1
139579,41,18,23,24,1
139579,338,140,198,25,1
139579,549,158,391,32,3
139579,70,27,43,39,1
139579,268,113,155,40,1
139579,582,149,433,41,4
139579,398,114,284,42,1
139579,396,114,282,43,1
139579,22,5,17,44,1
139579,374,109,265,45,1
139579,2,0,2,51,1
139579,184,35,149,52,3
139579,96,24,72,59,1
139579,278,85,193,60,1
139621,2857,1225,1632,1,4
139621,2857,1225,1632,2,1
139621,2803,1204,1599,3,1
139621,1040,458,582,4,1
139621,1763,746,1017,5,1
139621,54,21,33,11,1
139621,249,121,128,19,1
139621,1514,625,889,20,1
139621,2194,952,1242,21,4
139621,2194,952,1242,22,1
139621,2189,951,1238,23,1
139621,929,404,525,24,1
139621,1260,547,713,25,1
139621,5,1,4,31,1
139621,186,87,99,39,1
139621,1074,460,614,40,1
139621,663,273,390,41,4
139621,663,273,390,42,1
139621,614,253,361,43,1
139621,111,54,57,44,1
139621,503,199,304,45,1
139621,49,20,29,51,1
139621,63,34,29,59,1
139621,440,165,275,60,1
139630,806,396,410,1,4
139630,806,396,410,2,1
139630,709,361,348,3,1
139630,167,88,79,4,1
139630,542,273,269,5,1
139630,97,35,62,11,1
139630,55,34,21,19,1
139630,487,239,248,20,1
139630,702,358,344,21,4
139630,702,358,344,22,1
139630,689,354,335,23,1
139630,167,88,79,24,1
139630,522,266,256,25,1
139630,13,4,9,31,1
139630,51,32,19,39,1
139630,471,234,237,40,1
139630,104,38,66,41,4
139630,104,38,66,42,1
139630,20,7,13,43,1
139630,20,7,13,45,1
139630,84,31,53,51,1
139630,4,2,2,59,1
139630,16,5,11,60,1
139658,14513,6328,8185,1,4
139658,7836,3393,4443,2,1
139658,7705,3337,4368,3,1
139658,1853,799,1054,4,1
139658,5852,2538,3314,5,1
139658,131,56,75,11,1
139658,6677,2935,3742,12,3
139658,245,71,174,19,1
139658,5607,2467,3140,20,1
139658,13181,5705,7476,21,4
139658,7676,3321,4355,22,1
139658,7607,3289,4318,23,1
139658,1853,799,1054,24,1
139658,5754,2490,3264,25,1
139658,69,32,37,31,1
139658,5505,2384,3121,32,3
139658,243,70,173,39,1
139658,5511,2420,3091,40,1
139658,1332,623,709,41,4
139658,160,72,88,42,1
139658,98,48,50,43,1
139658,98,48,50,45,1
139658,62,24,38,51,1
139658,1172,551,621,52,3
139658,2,1,1,59,1
139658,96,47,49,60,1
139700,5492,2101,3391,1,4
139700,5492,2101,3391,2,1
139700,5324,2043,3281,3,1
139700,1307,563,744,4,1
139700,4017,1480,2537,5,1
139700,168,58,110,11,1
139700,570,224,346,19,1
139700,3447,1256,2191,20,1
139700,2843,1237,1606,21,4
139700,2843,1237,1606,22,1
139700,2812,1229,1583,23,1
139700,1018,449,569,24,1
139700,1794,780,1014,25,1
139700,31,8,23,31,1
139700,294,136,158,39,1
139700,1500,644,856,40,1
139700,2649,864,1785,41,4
139700,2649,864,1785,42,1
139700,2512,814,1698,43,1
139700,289,114,175,44,1
139700,2223,700,1523,45,1
139700,137,50,87,51,1
139700,276,88,188,59,1
139700,1947,612,1335,60,1
139719,3180,1286,1894,1,4
139719,2858,1228,1630,2,1
139719,2805,1210,1595,3,1
139719,538,255,283,4,1
139719,2267,955,1312,5,1
139719,53,18,35,11,1
139719,322,58,264,12,3
139719,94,38,56,19,1
139719,2173,917,1256,20,1
139719,2695,1163,1532,21,4
139719,2570,1134,1436,22,1
139719,2561,1128,1433,23,1
139719,524,248,276,24,1
139719,2037,880,1157,25,1
139719,9,6,3,31,1
139719,125,29,96,32,3
139719,77,35,42,39,1
139719,1960,845,1115,40,1
139719,485,123,362,41,4
139719,288,94,194,42,1
139719,244,82,162,43,1
139719,14,7,7,44,1
139719,230,75,155,45,1
139719,44,12,32,51,1
139719,197,29,168,52,3
139719,17,3,14,59,1
139719,213,72,141,60,1
139746,60,16,44,1,4
139746,60,16,44,2,1
139746,60,16,44,3,1
139746,60,16,44,5,1
139746,60,16,44,20,1
139746,60,16,44,21,4
139746,60,16,44,22,1
139746,60,16,44,23,1
139746,60,16,44,25,1
139746,60,16,44,40,1
139755,21471,14846,6625,1,4
139755,14558,9725,4833,2,1
139755,13975,9343,4632,3,1
139755,2673,1677,996,4,1
139755,11302,7666,3636,5,1
139755,583,382,201,11,1
139755,6913,5121,1792,12,3
139755,501,393,108,19,1
139755,10801,7273,3528,20,1
139755,18743,12840,5903,21,4
139755,13291,8837,4454,22,1
139755,13193,8770,4423,23,1
139755,2669,1673,996,24,1
139755,10524,7097,3427,25,1
139755,98,67,31,31,1
139755,5452,4003,1449,32,3
139755,478,376,102,39,1
139755,10046,6721,3325,40,1
139755,2728,2006,722,41,4
139755,1267,888,379,42,1
139755,782,573,209,43,1
139755,4,4,0,44,1
139755,778,569,209,45,1
139755,485,315,170,51,1
139755,1461,1118,343,52,3
139755,23,17,6,59,1
139755,755,552,203,60,1
139764,2806,1003,1803,1,4
139764,2667,962,1705,2,1
139764,2598,936,1662,3,1
139764,376,151,225,4,1
139764,2222,785,1437,5,1
139764,69,26,43,11,1
139764,139,41,98,12,3
139764,387,138,249,19,1
139764,1835,647,1188,20,1
139764,1946,711,1235,21,4
139764,1870,694,1176,22,1
139764,1866,693,1173,23,1
139764,351,139,212,24,1
139764,1515,554,961,25,1
139764,4,1,3,31,1
139764,76,17,59,32,3
139764,248,92,156,39,1
139764,1267,462,805,40,1
139764,860,292,568,41,4
139764,797,268,529,42,1
139764,732,243,489,43,1
139764,25,12,13,44,1
139764,707,231,476,45,1
139764,65,25,40,51,1
139764,63,24,39,52,3
139764,139,46,93,59,1
139764,568,185,383,60,1
139861,6551,2573,3978,1,4
139861,5729,2294,3435,2,1
139861,5636,2256,3380,3,1
139861,1395,542,853,4,1
139861,4241,1714,2527,5,1
139861,93,38,55,11,1
139861,822,279,543,12,3
139861,355,150,205,19,1
139861,3886,1564,2322,20,1
139861,5600,2220,3380,21,4
139861,5264,2091,3173,22,1
139861,5229,2071,3158,23,1
139861,1395,542,853,24,1
139861,3834,1529,2305,25,1
139861,35,20,15,31,1
139861,336,129,207,32,3
139861,302,146,156,39,1
139861,3532,1383,2149,40,1
139861,951,353,598,41,4
139861,465,203,262,42,1
139861,407,185,222,43,1
139861,407,185,222,45,1
139861,58,18,40,51,1
139861,486,150,336,52,3
139861,53,4,49,59,1
139861,354,181,173,60,1
139904,1651,794,857,1,4
139904,1651,794,857,2,1
139904,1549,761,788,3,1
139904,1067,567,500,4,1
139904,482,194,288,5,1
139904,102,33,69,11,1
139904,451,182,269,19,1
139904,31,12,19,20,1
139904,1336,687,649,21,4
139904,1336,687,649,22,1
139904,1332,685,647,23,1
139904,977,531,446,24,1
139904,355,154,201,25,1
139904,4,2,2,31,1
139904,340,148,192,39,1
139904,15,6,9,40,1
139904,315,107,208,41,4
139904,315,107,208,42,1
139904,217,76,141,43,1
139904,90,36,54,44,1
139904,127,40,87,45,1
139904,98,31,67,51,1
139904,111,34,77,59,1
139904,16,6,10,60,1
139931,20517,9860,10657,1,4
139931,17904,8958,8946,2,1
139931,17103,8581,8522,3,1
139931,3583,1857,1726,4,1
139931,13520,6724,6796,5,1
139931,801,377,424,11,1
139931,2613,902,1711,12,3
139931,1136,536,600,19,1
139931,12384,6188,6196,20,1
139931,16767,8251,8516,21,4
139931,15762,7896,7866,22,1
139931,15718,7885,7833,23,1
139931,3544,1832,1712,24,1
139931,12174,6053,6121,25,1
139931,44,11,33,31,1
139931,1005,355,650,32,3
139931,1014,487,527,39,1
139931,11160,5566,5594,40,1
139931,3750,1609,2141,41,4
139931,2142,1062,1080,42,1
139931,1385,696,689,43,1
139931,39,25,14,44,1
139931,1346,671,675,45,1
139931,757,366,391,51,1
139931,1608,547,1061,52,3
139931,122,49,73,59,1
139931,1224,622,602,60,1
139940,32165,13372,18793,1,4
139940,24868,10357,14511,2,1
139940,24128,10091,14037,3,1
139940,3469,1503,1966,4,1
139940,20659,8588,12071,5,1
139940,740,266,474,11,1
139940,7297,3015,4282,12,3
139940,2941,1170,1771,19,1
139940,17718,7418,10300,20,1
139940,23677,9961,13716,21,4
139940,18410,7675,10735,22,1
139940,18267,7625,10642,23,1
139940,3388,1462,1926,24,1
139940,14879,6163,8716,25,1
139940,143,50,93,31,1
139940,5267,2286,2981,32,3
139940,2133,873,1260,39,1
139940,12746,5290,7456,40,1
139940,8488,3411,5077,41,4
139940,6458,2682,3776,42,1
139940,5861,2466,3395,43,1
139940,81,41,40,44,1
139940,5780,2425,3355,45,1
139940,597,216,381,51,1
139940,2030,729,1301,52,3
139940,808,297,511,59,1
139940,4972,2128,2844,60,1
139959,34536,14773,19763,1,4
139959,26278,11320,14958,2,1
139959,26120,11251,14869,3,1
139959,5237,2033,3204,4,1
139959,20883,9218,11665,5,1
139959,158,69,89,11,1
139959,8258,3453,4805,12,3
139959,1292,628,664,19,1
139959,19591,8590,11001,20,1
139959,31364,13347,18017,21,4
139959,24746,10520,14226,22,1
139959,24654,10486,14168,23,1
139959,5219,2026,3193,24,1
139959,19435,8460,10975,25,1
139959,92,34,58,31,1
139959,6618,2827,3791,32,3
139959,1217,596,621,39,1
139959,18218,7864,10354,40,1
139959,3172,1426,1746,41,4
139959,1532,800,732,42,1
139959,1466,765,701,43,1
139959,18,7,11,44,1
139959,1448,758,690,45,1
139959,66,35,31,51,1
139959,1640,626,1014,52,3
139959,75,32,43,59,1
139959,1373,726,647,60,1
139968,4187,1387,2800,1,4
139968,4187,1387,2800,2,1
139968,4031,1327,2704,3,1
139968,1142,469,673,4,1
139968,2889,858,2031,5,1
139968,156,60,96,11,1
139968,276,87,189,19,1
139968,2613,771,1842,20,1
139968,2758,983,1775,21,4
139968,2758,983,1775,22,1
139968,2727,970,1757,23,1
139968,1072,427,645,24,1
139968,1655,543,1112,25,1
139968,31,13,18,31,1
139968,168,64,104,39,1
139968,1487,479,1008,40,1
139968,1429,404,1025,41,4
139968,1429,404,1025,42,1
139968,1304,357,947,43,1
139968,70,42,28,44,1
139968,1234,315,919,45,1
139968,125,47,78,51,1
139968,108,23,85,59,1
139968,1126,292,834,60,1
139986,5177,1793,3384,1,4
139986,5177,1793,3384,2,1
139986,4919,1686,3233,3,1
139986,1006,456,550,4,1
139986,3913,1230,2683,5,1
139986,258,107,151,11,1
139986,1162,372,790,19,1
139986,2751,858,1893,20,1
139986,2142,820,1322,21,4
139986,2142,820,1322,22,1
139986,2123,812,1311,23,1
139986,511,249,262,24,1
139986,1612,563,1049,25,1
139986,19,8,11,31,1
139986,509,191,318,39,1
139986,1103,372,731,40,1
139986,3035,973,2062,41,4
139986,3035,973,2062,42,1
139986,2796,874,1922,43,1
139986,495,207,288,44,1
139986,2301,667,1634,45,1
139986,239,99,140,51,1
139986,653,181,472,59,1
139986,1648,486,1162,60,1
139995,174,84,90,1,4
139995,174,84,90,2,1
139995,174,84,90,3,1
139995,93,45,48,4,1
139995,81,39,42,5,1
139995,81,39,42,20,1
139995,174,84,90,21,4
139995,174,84,90,22,1
139995,174,84,90,23,1
139995,93,45,48,24,1
139995,81,39,42,25,1
139995,81,39,42,40,1
140003,368,59,309,1,4
140003,368,59,309,2,1
140003,368,59,309,3,1
140003,105,15,90,4,1
140003,263,44,219,5,1
140003,263,44,219,20,1
140003,168,21,147,21,4
140003,168,21,147,22,1
140003,168,21,147,23,1
140003,51,6,45,24,1
140003,117,15,102,25,1
140003,117,15,102,40,1
140003,200,38,162,41,4
140003,200,38,162,42,1
140003,200,38,162,43,1
140003,54,9,45,44,1
140003,146,29,117,45,1
140003,146,29,117,60,1
140012,7180,2823,4357,1,4
140012,7180,2823,4357,2,1
140012,6918,2718,4200,3,1
140012,1021,510,511,4,1
140012,5897,2208,3689,5,1
140012,262,105,157,11,1
140012,1306,463,843,19,1
140012,4591,1745,2846,20,1
140012,2282,1026,1256,21,4
140012,2282,1026,1256,22,1
140012,2258,1019,1239,23,1
140012,454,254,200,24,1
140012,1804,765,1039,25,1
140012,24,7,17,31,1
140012,439,193,246,39,1
140012,1365,572,793,40,1
140012,4898,1797,3101,41,4
140012,4898,1797,3101,42,1
140012,4660,1699,2961,43,1
140012,567,256,311,44,1
140012,4093,1443,2650,45,1
140012,238,98,140,51,1
140012,867,270,597,59,1
140012,3226,1173,2053,60,1
140146,562,294,268,1,4
140146,562,294,268,12,3
140146,190,131,59,21,4
140146,190,131,59,32,3
140146,372,163,209,41,4
140146,372,163,209,52,3
140164,24629,10204,14425,1,4
140164,22621,9450,13171,2,1
140164,22211,9292,12919,3,1
140164,3229,1317,1912,4,1
140164,18982,7975,11007,5,1
140164,410,158,252,11,1
140164,2008,754,1254,12,3
140164,2597,1135,1462,19,1
140164,16385,6840,9545,20,1
140164,17690,7263,10427,21,4
140164,16869,6995,9874,22,1
140164,16689,6921,9768,23,1
140164,3148,1280,1868,24,1
140164,13541,5641,7900,25,1
140164,180,74,106,31,1
140164,821,268,553,32,3
140164,1931,850,1081,39,1
140164,11610,4791,6819,40,1
140164,6939,2941,3998,41,4
140164,5752,2455,3297,42,1
140164,5522,2371,3151,43,1
140164,81,37,44,44,1
140164,5441,2334,3107,45,1
140164,230,84,146,51,1
140164,1187,486,701,52,3
140164,666,285,381,59,1
140164,4775,2049,2726,60,1
140234,940,411,529,1,4
140234,856,394,462,2,1
140234,854,394,460,3,1
140234,271,168,103,4,1
140234,583,226,357,5,1
140234,2,0,2,11,1
140234,84,17,67,12,3
140234,75,30,45,19,1
140234,508,196,312,20,1
140234,858,392,466,21,4
140234,786,380,406,22,1
140234,786,380,406,23,1
140234,267,167,100,24,1
140234,519,213,306,25,1
140234,72,12,60,32,3
140234,64,30,34,39,1
140234,455,183,272,40,1
140234,82,19,63,41,4
140234,70,14,56,42,1
140234,68,14,54,43,1
140234,4,1,3,44,1
140234,64,13,51,45,1
140234,2,0,2,51,1
140234,12,5,7,52,3
140234,11,0,11,59,1
140234,53,13,40,60,1
140243,3579,1349,2230,1,4
140243,3579,1349,2230,2,1
140243,3227,1209,2018,3,1
140243,898,414,484,4,1
140243,2329,795,1534,5,1
140243,352,140,212,11,1
140243,290,82,208,19,1
140243,2039,713,1326,20,1
140243,1042,405,637,21,4
140243,1042,405,637,22,1
140243,1032,398,634,23,1
140243,378,181,197,24,1
140243,654,217,437,25,1
140243,10,7,3,31,1
140243,109,36,73,39,1
140243,545,181,364,40,1
140243,2537,944,1593,41,4
140243,2537,944,1593,42,1
140243,2195,811,1384,43,1
140243,520,233,287,44,1
140243,1675,578,1097,45,1
140243,342,133,209,51,1
140243,181,46,135,59,1
140243,1494,532,962,60,1
140252,2730,1460,1270,1,4
140252,765,390,375,2,1
140252,765,390,375,3,1
140252,75,50,25,4,1
140252,690,340,350,5,1
140252,1965,1070,895,12,3
140252,85,52,33,19,1
140252,605,288,317,20,1
140252,2342,1285,1057,21,4
140252,556,312,244,22,1
140252,556,312,244,23,1
140252,73,49,24,24,1
140252,483,263,220,25,1
140252,1786,973,813,32,3
140252,65,41,24,39,1
140252,418,222,196,40,1
140252,388,175,213,41,4
140252,209,78,131,42,1
140252,209,78,131,43,1
140252,2,1,1,44,1
140252,207,77,130,45,1
140252,179,97,82,52,3
140252,20,11,9,59,1
140252,187,66,121,60,1
140331,10470,4556,5914,1,4
140331,10470,4556,5914,2,1
140331,9935,4328,5607,3,1
140331,2176,1040,1136,4,1
140331,7759,3288,4471,5,1
140331,535,228,307,11,1
140331,1659,688,971,19,1
140331,6100,2600,3500,20,1
140331,3434,1641,1793,21,4
140331,3434,1641,1793,22,1
140331,3323,1597,1726,23,1
140331,1032,523,509,24,1
140331,2291,1074,1217,25,1
140331,111,44,67,31,1
140331,583,291,292,39,1
140331,1708,783,925,40,1
140331,7036,2915,4121,41,4
140331,7036,2915,4121,42,1
140331,6612,2731,3881,43,1
140331,1144,517,627,44,1
140331,5468,2214,3254,45,1
140331,424,184,240,51,1
140331,1076,397,679,59,1
140331,4392,1817,2575,60,1
140340,459,193,266,1,4
140340,393,165,228,2,1
140340,391,164,227,3,1
140340,39,21,18,4,1
140340,352,143,209,5,1
140340,2,1,1,11,1
140340,66,28,38,12,3
140340,15,6,9,19,1
140340,337,137,200,20,1
140340,324,138,186,21,4
140340,279,118,161,22,1
140340,279,118,161,23,1
140340,39,21,18,24,1
140340,240,97,143,25,1
140340,45,20,25,32,3
140340,14,6,8,39,1
140340,226,91,135,40,1
140340,135,55,80,41,4
140340,114,47,67,42,1
140340,112,46,66,43,1
140340,112,46,66,45,1
140340,2,1,1,51,1
140340,21,8,13,52,3
140340,1,0,1,59,1
140340,111,46,65,60,1
140447,8351,3038,5313,1,4
140447,4419,1628,2791,2,1
140447,4304,1584,2720,3,1
140447,767,353,414,4,1
140447,3537,1231,2306,5,1
140447,115,44,71,11,1
140447,3932,1410,2522,12,3
140447,461,106,355,19,1
140447,3076,1125,1951,20,1
140447,6435,2544,3891,21,4
140447,3659,1459,2200,22,1
140447,3606,1437,2169,23,1
140447,727,342,385,24,1
140447,2879,1095,1784,25,1
140447,53,22,31,31,1
140447,2776,1085,1691,32,3
140447,339,81,258,39,1
140447,2540,1014,1526,40,1
140447,1916,494,1422,41,4
140447,760,169,591,42,1
140447,698,147,551,43,1
140447,40,11,29,44,1
140447,658,136,522,45,1
140447,62,22,40,51,1
140447,1156,325,831,52,3
140447,122,25,97,59,1
140447,536,111,425,60,1
140553,2170,2166,4,1,4
140553,2170,2166,4,2,1
140553,2161,2161,0,3,1
140553,486,486,0,4,1
140553,1675,1675,0,5,1
140553,9,5,4,11,1
140553,66,66,0,19,1
140553,1609,1609,0,20,1
140553,2006,2006,0,21,4
140553,2006,2006,0,22,1
140553,2002,2002,0,23,1
140553,483,483,0,24,1
140553,1519,1519,0,25,1
140553,4,4,0,31,1
140553,62,62,0,39,1
140553,1457,1457,0,40,1
140553,164,160,4,41,4
140553,164,160,4,42,1
140553,159,159,0,43,1
140553,3,3,0,44,1
140553,156,156,0,45,1
140553,5,1,4,51,1
140553,4,4,0,59,1
140553,152,152,0,60,1
140562,372,127,245,1,4
140562,372,127,245,12,3
140562,366,125,241,21,4
140562,366,125,241,32,3
140562,6,2,4,41,4
140562,6,2,4,52,3
140599,2058,775,1283,1,4
140599,2058,775,1283,2,1
140599,1453,481,972,3,1
140599,345,146,199,4,1
140599,1108,335,773,5,1
140599,605,294,311,11,1
140599,2,0,2,19,1
140599,1106,335,771,20,1
140599,789,271,518,21,4
140599,789,271,518,22,1
140599,782,266,516,23,1
140599,212,91,121,24,1
140599,570,175,395,25,1
140599,7,5,2,31,1
140599,1,0,1,39,1
140599,569,175,394,40,1
140599,1269,504,765,41,4
140599,1269,504,765,42,1
140599,671,215,456,43,1
140599,133,55,78,44,1
140599,538,160,378,45,1
140599,598,289,309,51,1
140599,1,0,1,59,1
140599,537,160,377,60,1
140678,2441,1021,1420,1,4
140678,2441,1021,1420,2,1
140678,2300,981,1319,3,1
140678,675,325,350,4,1
140678,1625,656,969,5,1
140678,141,40,101,11,1
140678,235,110,125,19,1
140678,1390,546,844,20,1
140678,1027,490,537,21,4
140678,1027,490,537,22,1
140678,1021,488,533,23,1
140678,395,211,184,24,1
140678,626,277,349,25,1
140678,6,2,4,31,1
140678,123,61,62,39,1
140678,503,216,287,40,1
140678,1414,531,883,41,4
140678,1414,531,883,42,1
140678,1279,493,786,43,1
140678,280,114,166,44,1
140678,999,379,620,45,1
140678,135,38,97,51,1
140678,112,49,63,59,1
140678,887,330,557,60,1
140696,1100,466,634,1,4
140696,1091,466,625,2,1
140696,1020,441,579,3,1
140696,284,130,154,4,1
140696,736,311,425,5,1
140696,71,25,46,11,1
140696,9,0,9,12,3
140696,41,21,20,19,1
140696,695,290,405,20,1
140696,996,434,562,21,4
140696,992,434,558,22,1
140696,964,423,541,23,1
140696,283,129,154,24,1
140696,681,294,387,25,1
140696,28,11,17,31,1
140696,4,0,4,32,3
140696,38,20,18,39,1
140696,643,274,369,40,1
140696,104,32,72,41,4
140696,99,32,67,42,1
140696,56,18,38,43,1
140696,1,1,0,44,1
140696,55,17,38,45,1
140696,43,14,29,51,1
140696,5,0,5,52,3
140696,3,1,2,59,1
140696,52,16,36,60,1
140720,924,472,452,1,4
140720,924,472,452,2,1
140720,921,470,451,3,1
140720,268,185,83,4,1
140720,653,285,368,5,1
140720,3,2,1,11,1
140720,88,62,26,19,1
140720,565,223,342,20,1
140720,838,428,410,21,4
140720,838,428,410,22,1
140720,836,427,409,23,1
140720,252,174,78,24,1
140720,584,253,331,25,1
140720,2,1,1,31,1
140720,80,58,22,39,1
140720,504,195,309,40,1
140720,86,44,42,41,4
140720,86,44,42,42,1
140720,85,43,42,43,1
140720,16,11,5,44,1
140720,69,32,37,45,1
140720,1,1,0,51,1
140720,8,4,4,59,1
140720,61,28,33,60,1
140818,2368,667,1701,1,4
140818,1281,425,856,2,1
140818,1281,425,856,3,1
140818,255,101,154,4,1
140818,1026,324,702,5,1
140818,1087,242,845,12,3
140818,99,32,67,19,1
140818,927,292,635,20,1
140818,1501,481,1020,21,4
140818,1131,380,751,22,1
140818,1131,380,751,23,1
140818,253,100,153,24,1
140818,878,280,598,25,1
140818,370,101,269,32,3
140818,89,31,58,39,1
140818,789,249,540,40,1
140818,867,186,681,41,4
140818,150,45,105,42,1
140818,150,45,105,43,1
140818,2,1,1,44,1
140818,148,44,104,45,1
140818,717,141,576,52,3
140818,10,1,9,59,1
140818,138,43,95,60,1
140827,116,46,70,1,4
140827,116,46,70,2,1
140827,116,46,70,3,1
140827,8,5,3,4,1
140827,108,41,67,5,1
140827,108,41,67,20,1
140827,116,46,70,21,4
140827,116,46,70,22,1
140827,116,46,70,23,1
140827,8,5,3,24,1
140827,108,41,67,25,1
140827,108,41,67,40,1
140872,1309,647,662,1,4
140872,1217,610,607,2,1
140872,1191,604,587,3,1
140872,346,192,154,4,1
140872,845,412,433,5,1
140872,26,6,20,11,1
140872,92,37,55,12,3
140872,35,19,16,19,1
140872,810,393,417,20,1
140872,1225,611,614,21,4
140872,1141,580,561,22,1
140872,1136,579,557,23,1
140872,344,192,152,24,1
140872,792,387,405,25,1
140872,5,1,4,31,1
140872,84,31,53,32,3
140872,29,17,12,39,1
140872,763,370,393,40,1
140872,84,36,48,41,4
140872,76,30,46,42,1
140872,55,25,30,43,1
140872,2,0,2,44,1
140872,53,25,28,45,1
140872,21,5,16,51,1
140872,8,6,2,52,3
140872,6,2,4,59,1
140872,47,23,24,60,1
140942,4784,1827,2957,1,4
140942,4784,1827,2957,2,1
140942,4523,1715,2808,3,1
140942,900,426,474,4,1
140942,3623,1289,2334,5,1
140942,261,112,149,11,1
140942,777,299,478,19,1
140942,2846,990,1856,20,1
140942,1749,828,921,21,4
140942,1749,828,921,22,1
140942,1711,815,896,23,1
140942,362,194,168,24,1
140942,1349,621,728,25,1
140942,38,13,25,31,1
140942,369,173,196,39,1
140942,980,448,532,40,1
140942,3035,999,2036,41,4
140942,3035,999,2036,42,1
140942,2812,900,1912,43,1
140942,538,232,306,44,1
140942,2274,668,1606,45,1
140942,223,99,124,51,1
140942,408,126,282,59,1
140942,1866,542,1324,60,1
140951,11093,4064,7029,1,4
140951,8825,3163,5662,2,1
140951,8750,3139,5611,3,1
140951,1691,535,1156,4,1
140951,7059,2604,4455,5,1
140951,75,24,51,11,1
140951,2268,901,1367,12,3
140951,643,247,396,19,1
140951,6416,2357,4059,20,1
140951,8950,3230,5720,21,4
140951,7347,2603,4744,22,1
140951,7332,2596,4736,23,1
140951,1598,505,1093,24,1
140951,5734,2091,3643,25,1
140951,15,7,8,31,1
140951,1603,627,976,32,3
140951,581,221,360,39,1
140951,5153,1870,3283,40,1
140951,2143,834,1309,41,4
140951,1478,560,918,42,1
140951,1418,543,875,43,1
140951,93,30,63,44,1
140951,1325,513,812,45,1
140951,60,17,43,51,1
140951,665,274,391,52,3
140951,62,26,36,59,1
140951,1263,487,776,60,1
140960,4772,2117,2655,1,4
140960,4602,2072,2530,2,1
140960,4462,2019,2443,3,1
140960,1299,547,752,4,1
140960,3163,1472,1691,5,1
140960,140,53,87,11,1
140960,170,45,125,12,3
140960,160,87,73,19,1
140960,3003,1385,1618,20,1
140960,4221,1864,2357,21,4
140960,4098,1837,2261,22,1
140960,4066,1829,2237,23,1
140960,1264,533,731,24,1
140960,2802,1296,1506,25,1
140960,32,8,24,31,1
140960,123,27,96,32,3
140960,143,80,63,39,1
140960,2659,1216,1443,40,1
140960,551,253,298,41,4
140960,504,235,269,42,1
140960,396,190,206,43,1
140960,35,14,21,44,1
140960,361,176,185,45,1
140960,108,45,63,51,1
140960,47,18,29,52,3
140960,17,7,10,59,1
140960,344,169,175,60,1
140988,1629,676,953,1,4
140988,1544,657,887,2,1
140988,1518,644,874,3,1
140988,309,167,142,4,1
140988,1209,477,732,5,1
140988,26,13,13,11,1
140988,85,19,66,12,3
140988,116,63,53,19,1
140988,1093,414,679,20,1
140988,1428,604,824,21,4
140988,1384,595,789,22,1
140988,1382,595,787,23,1
140988,307,165,142,24,1
140988,1075,430,645,25,1
140988,2,0,2,31,1
140988,44,9,35,32,3
140988,108,60,48,39,1
140988,967,370,597,40,1
140988,201,72,129,41,4
140988,160,62,98,42,1
140988,136,49,87,43,1
140988,2,2,0,44,1
140988,134,47,87,45,1
140988,24,13,11,51,1
140988,41,10,31,52,3
140988,8,3,5,59,1
140988,126,44,82,60,1
141006,1828,910,918,1,4
141006,1828,910,918,2,1
141006,1644,835,809,3,1
141006,524,310,214,4,1
141006,1120,525,595,5,1
141006,184,75,109,11,1
141006,26,14,12,19,1
141006,1094,511,583,20,1
141006,976,514,462,21,4
141006,976,514,462,22,1
141006,952,507,445,23,1
141006,376,229,147,24,1
141006,576,278,298,25,1
141006,24,7,17,31,1
141006,16,8,8,39,1
141006,560,270,290,40,1
141006,852,396,456,41,4
141006,852,396,456,42,1
141006,692,328,364,43,1
141006,148,81,67,44,1
141006,544,247,297,45,1
141006,160,68,92,51,1
141006,10,6,4,59,1
141006,534,241,293,60,1
141015,135,69,66,1,4
141015,135,69,66,2,1
141015,135,69,66,3,1
141015,7,2,5,4,1
141015,128,67,61,5,1
141015,128,67,61,20,1
141015,111,57,54,21,4
141015,111,57,54,22,1
141015,111,57,54,23,1
141015,7,2,5,24,1
141015,104,55,49,25,1
141015,104,55,49,40,1
141015,24,12,12,41,4
141015,24,12,12,42,1
141015,24,12,12,43,1
141015,24,12,12,45,1
141015,24,12,12,60,1
141060,2129,0,2129,1,4
141060,2129,0,2129,2,1
141060,2129,0,2129,3,1
141060,559,0,559,4,1
141060,1570,0,1570,5,1
141060,55,0,55,19,1
141060,1515,0,1515,20,1
141060,2061,0,2061,21,4
141060,2061,0,2061,22,1
141060,2061,0,2061,23,1
141060,557,0,557,24,1
141060,1504,0,1504,25,1
141060,51,0,51,39,1
141060,1453,0,1453,40,1
141060,68,0,68,41,4
141060,68,0,68,42,1
141060,68,0,68,43,1
141060,2,0,2,44,1
141060,66,0,66,45,1
141060,4,0,4,59,1
141060,62,0,62,60,1
141097,6549,5144,1405,1,4
141097,5732,4649,1083,2,1
141097,5636,4601,1035,3,1
141097,805,687,118,4,1
141097,4831,3914,917,5,1
141097,96,48,48,11,1
141097,817,495,322,12,3
141097,794,590,204,19,1
141097,4037,3324,713,20,1
141097,4362,3502,860,21,4
141097,4142,3371,771,22,1
141097,4084,3343,741,23,1
141097,761,653,108,24,1
141097,3323,2690,633,25,1
141097,58,28,30,31,1
141097,220,131,89,32,3
141097,570,425,145,39,1
141097,2753,2265,488,40,1
141097,2187,1642,545,41,4
141097,1590,1278,312,42,1
141097,1552,1258,294,43,1
141097,44,34,10,44,1
141097,1508,1224,284,45,1
141097,38,20,18,51,1
141097,597,364,233,52,3
141097,224,165,59,59,1
141097,1284,1059,225,60,1
141158,1546,506,1040,1,4
141158,1546,506,1040,2,1
141158,1255,407,848,3,1
141158,226,94,132,4,1
141158,1029,313,716,5,1
141158,291,99,192,11,1
141158,450,128,322,19,1
141158,579,185,394,20,1
141158,443,152,291,21,4
141158,443,152,291,22,1
141158,421,146,275,23,1
141158,78,37,41,24,1
141158,343,109,234,25,1
141158,22,6,16,31,1
141158,148,50,98,39,1
141158,195,59,136,40,1
141158,1103,354,749,41,4
141158,1103,354,749,42,1
141158,834,261,573,43,1
141158,148,57,91,44,1
141158,686,204,482,45,1
141158,269,93,176,51,1
141158,302,78,224,59,1
141158,384,126,258,60,1
141167,1090,457,633,1,4
141167,886,409,477,2,1
141167,815,382,433,3,1
141167,79,51,28,4,1
141167,736,331,405,5,1
141167,71,27,44,11,1
141167,204,48,156,12,3
141167,165,69,96,19,1
141167,571,262,309,20,1
141167,588,267,321,21,4
141167,506,244,262,22,1
141167,486,237,249,23,1
141167,70,43,27,24,1
141167,416,194,222,25,1
141167,20,7,13,31,1
141167,82,23,59,32,3
141167,103,46,57,39,1
141167,313,148,165,40,1
141167,502,190,312,41,4
141167,380,165,215,42,1
141167,329,145,184,43,1
141167,9,8,1,44,1
141167,320,137,183,45,1
141167,51,20,31,51,1
141167,122,25,97,52,3
141167,62,23,39,59,1
141167,258,114,144,60,1
141185,870,410,460,1,4
141185,870,410,460,2,1
141185,817,393,424,3,1
141185,168,71,97,4,1
141185,649,322,327,5,1
141185,53,17,36,11,1
141185,60,31,29,19,1
141185,589,291,298,20,1
141185,777,369,408,21,4
141185,777,369,408,22,1
141185,771,367,404,23,1
141185,163,68,95,24,1
141185,608,299,309,25,1
141185,6,2,4,31,1
141185,57,29,28,39,1
141185,551,270,281,40,1
141185,93,41,52,41,4
141185,93,41,52,42,1
141185,46,26,20,43,1
141185,5,3,2,44,1
141185,41,23,18,45,1
141185,47,15,32,51,1
141185,3,2,1,59,1
141185,38,21,17,60,1
141237,1606,698,908,1,4
141237,1606,698,908,2,1
141237,697,334,363,3,1
141237,199,96,103,4,1
141237,498,238,260,5,1
141237,909,364,545,11,1
141237,47,23,24,19,1
141237,451,215,236,20,1
141237,691,327,364,21,4
141237,691,327,364,22,1
141237,659,316,343,23,1
141237,197,95,102,24,1
141237,462,221,241,25,1
141237,32,11,21,31,1
141237,43,23,20,39,1
141237,419,198,221,40,1
141237,915,371,544,41,4
141237,915,371,544,42,1
141237,38,18,20,43,1
141237,2,1,1,44,1
141237,36,17,19,45,1
141237,877,353,524,51,1
141237,4,0,4,59,1
141237,32,17,15,60,1
141255,3966,1374,2592,1,4
141255,3966,1374,2592,2,1
141255,3378,1186,2192,3,1
141255,686,316,370,4,1
141255,2692,870,1822,5,1
141255,588,188,400,11,1
141255,428,149,279,19,1
141255,2264,721,1543,20,1
141255,1386,528,858,21,4
141255,1386,528,858,22,1
141255,1364,522,842,23,1
141255,303,140,163,24,1
141255,1061,382,679,25,1
141255,22,6,16,31,1
141255,174,66,108,39,1
141255,887,316,571,40,1
141255,2580,846,1734,41,4
141255,2580,846,1734,42,1
141255,2014,664,1350,43,1
141255,383,176,207,44,1
141255,1631,488,1143,45,1
141255,566,182,384,51,1
141255,254,83,171,59,1
141255,1377,405,972,60,1
141264,11885,4598,7287,1,4
141264,9718,3953,5765,2,1
141264,9634,3918,5716,3,1
141264,1722,717,1005,4,1
141264,7912,3201,4711,5,1
141264,84,35,49,11,1
141264,2167,645,1522,12,3
141264,792,328,464,19,1
141264,7120,2873,4247,20,1
141264,8964,3514,5450,21,4
141264,8277,3322,4955,22,1
141264,8250,3310,4940,23,1
141264,1688,705,983,24,1
141264,6562,2605,3957,25,1
141264,27,12,15,31,1
141264,687,192,495,32,3
141264,643,275,368,39,1
141264,5919,2330,3589,40,1
141264,2921,1084,1837,41,4
141264,1441,631,810,42,1
141264,1384,608,776,43,1
141264,34,12,22,44,1
141264,1350,596,754,45,1
141264,57,23,34,51,1
141264,1480,453,1027,52,3
141264,149,53,96,59,1
141264,1201,543,658,60,1
141325,700,32,668,1,4
141325,651,26,625,2,1
141325,530,0,530,3,1
141325,119,0,119,4,1
141325,411,0,411,5,1
141325,121,26,95,11,1
141325,49,6,43,12,3
141325,46,0,46,19,1
141325,365,0,365,20,1
141325,517,6,511,21,4
141325,468,0,468,22,1
141325,453,0,453,23,1
141325,119,0,119,24,1
141325,334,0,334,25,1
141325,15,0,15,31,1
141325,49,6,43,32,3
141325,39,0,39,39,1
141325,295,0,295,40,1
141325,183,26,157,41,4
141325,183,26,157,42,1
141325,77,0,77,43,1
141325,77,0,77,45,1
141325,106,26,80,51,1
141325,7,0,7,59,1
141325,70,0,70,60,1
141334,11929,4254,7675,1,4
141334,9959,3702,6257,2,1
141334,9777,3616,6161,3,1
141334,2237,788,1449,4,1
141334,7540,2828,4712,5,1
141334,182,86,96,11,1
141334,1970,552,1418,12,3
141334,769,282,487,19,1
141334,6771,2546,4225,20,1
141334,9067,3294,5773,21,4
141334,8369,3090,5279,22,1
141334,8292,3053,5239,23,1
141334,2198,769,1429,24,1
141334,6094,2284,3810,25,1
141334,77,37,40,31,1
141334,698,204,494,32,3
141334,567,228,339,39,1
141334,5527,2056,3471,40,1
141334,2862,960,1902,41,4
141334,1590,612,978,42,1
141334,1485,563,922,43,1
141334,39,19,20,44,1
141334,1446,544,902,45,1
141334,105,49,56,51,1
141334,1272,348,924,52,3
141334,202,54,148,59,1
141334,1244,490,754,60,1
141361,1117,469,648,1,4
141361,1117,469,648,2,1
141361,1083,460,623,3,1
141361,420,162,258,4,1
141361,663,298,365,5,1
141361,34,9,25,11,1
141361,37,20,17,19,1
141361,626,278,348,20,1
141361,1091,458,633,21,4
141361,1091,458,633,22,1
141361,1067,450,617,23,1
141361,419,161,258,24,1
141361,648,289,359,25,1
141361,24,8,16,31,1
141361,37,20,17,39,1
141361,611,269,342,40,1
141361,26,11,15,41,4
141361,26,11,15,42,1
141361,16,10,6,43,1
141361,1,1,0,44,1
141361,15,9,6,45,1
141361,10,1,9,51,1
141361,15,9,6,60,1
141468,1678,649,1029,1,4
141468,1678,649,1029,2,1
141468,1678,649,1029,3,1
141468,281,114,167,4,1
141468,1397,535,862,5,1
141468,129,51,78,19,1
141468,1268,484,784,20,1
141468,1217,474,743,21,4
141468,1217,474,743,22,1
141468,1217,474,743,23,1
141468,195,80,115,24,1
141468,1022,394,628,25,1
141468,76,30,46,39,1
141468,946,364,582,40,1
141468,461,175,286,41,4
141468,461,175,286,42,1
141468,461,175,286,43,1
141468,86,34,52,44,1
141468,375,141,234,45,1
141468,53,21,32,59,1
141468,322,120,202,60,1
141486,2752,925,1827,1,4
141486,2036,702,1334,2,1
141486,1864,654,1210,3,1
141486,280,93,187,4,1
141486,1584,561,1023,5,1
141486,172,48,124,11,1
141486,716,223,493,12,3
141486,157,50,107,19,1
141486,1427,511,916,20,1
141486,2124,682,1442,21,4
141486,1644,541,1103,22,1
141486,1566,518,1048,23,1
141486,263,82,181,24,1
141486,1303,436,867,25,1
141486,78,23,55,31,1
141486,480,141,339,32,3
141486,135,44,91,39,1
141486,1168,392,776,40,1
141486,628,243,385,41,4
141486,392,161,231,42,1
141486,298,136,162,43,1
141486,17,11,6,44,1
141486,281,125,156,45,1
141486,94,25,69,51,1
141486,236,82,154,52,3
141486,22,6,16,59,1
141486,259,119,140,60,1
141565,4043,1628,2415,1,4
141565,3457,1394,2063,2,1
141565,3335,1346,1989,3,1
141565,496,176,320,4,1
141565,2839,1170,1669,5,1
141565,122,48,74,11,1
141565,586,234,352,12,3
141565,636,253,383,19,1
141565,2203,917,1286,20,1
141565,3220,1316,1904,21,4
141565,2766,1125,1641,22,1
141565,2756,1119,1637,23,1
141565,489,173,316,24,1
141565,2267,946,1321,25,1
141565,10,6,4,31,1
141565,454,191,263,32,3
141565,502,208,294,39,1
141565,1765,738,1027,40,1
141565,823,312,511,41,4
141565,691,269,422,42,1
141565,579,227,352,43,1
141565,7,3,4,44,1
141565,572,224,348,45,1
141565,112,42,70,51,1
141565,132,43,89,52,3
141565,134,45,89,59,1
141565,438,179,259,60,1
141574,20006,8849,11157,1,4
141574,14499,6557,7942,2,1
141574,14097,6438,7659,3,1
141574,2005,847,1158,4,1
141574,12092,5591,6501,5,1
141574,402,119,283,11,1
141574,5507,2292,3215,12,3
141574,1823,799,1024,19,1
141574,10269,4792,5477,20,1
141574,14803,6540,8263,21,4
141574,12064,5409,6655,22,1
141574,11822,5337,6485,23,1
141574,1957,823,1134,24,1
141574,9865,4514,5351,25,1
141574,242,72,170,31,1
141574,2739,1131,1608,32,3
141574,1345,580,765,39,1
141574,8520,3934,4586,40,1
141574,5203,2309,2894,41,4
141574,2435,1148,1287,42,1
141574,2275,1101,1174,43,1
141574,48,24,24,44,1
141574,2227,1077,1150,45,1
141574,160,47,113,51,1
141574,2768,1161,1607,52,3
141574,478,219,259,59,1
141574,1749,858,891,60,1
141608,85,40,45,1,4
141608,85,40,45,2,1
141608,85,40,45,3,1
141608,9,5,4,4,1
141608,76,35,41,5,1
141608,76,35,41,20,1
141608,85,40,45,21,4
141608,85,40,45,22,1
141608,85,40,45,23,1
141608,9,5,4,24,1
141608,76,35,41,25,1
141608,76,35,41,40,1
141644,6736,2998,3738,1,4
141644,5582,2481,3101,2,1
141644,5386,2370,3016,3,1
141644,576,199,377,4,1
141644,4810,2171,2639,5,1
141644,196,111,85,11,1
141644,1154,517,637,12,3
141644,855,414,441,19,1
141644,3955,1757,2198,20,1
141644,4359,1737,2622,21,4
141644,3719,1471,2248,22,1
141644,3691,1452,2239,23,1
141644,516,162,354,24,1
141644,3175,1290,1885,25,1
141644,28,19,9,31,1
141644,640,266,374,32,3
141644,616,260,356,39,1
141644,2559,1030,1529,40,1
141644,2377,1261,1116,41,4
141644,1863,1010,853,42,1
141644,1695,918,777,43,1
141644,60,37,23,44,1
141644,1635,881,754,45,1
141644,168,92,76,51,1
141644,514,251,263,52,3
141644,239,154,85,59,1
141644,1396,727,669,60,1
141680,4368,2583,1785,1,4
141680,4368,2583,1785,2,1
141680,3434,2187,1247,3,1
141680,670,451,219,4,1
141680,2764,1736,1028,5,1
141680,934,396,538,11,1
141680,445,242,203,19,1
141680,2319,1494,825,20,1
141680,1632,1043,589,21,4
141680,1632,1043,589,22,1
141680,1582,1015,567,23,1
141680,432,294,138,24,1
141680,1150,721,429,25,1
141680,50,28,22,31,1
141680,204,122,82,39,1
141680,946,599,347,40,1
141680,2736,1540,1196,41,4
141680,2736,1540,1196,42,1
141680,1852,1172,680,43,1
141680,238,157,81,44,1
141680,1614,1015,599,45,1
141680,884,368,516,51,1
141680,241,120,121,59,1
141680,1373,895,478,60,1
141796,8376,3616,4760,1,4
141796,8376,3616,4760,2,1
141796,6025,2639,3386,3,1
141796,1267,548,719,4,1
141796,4758,2091,2667,5,1
141796,2351,977,1374,11,1
141796,801,323,478,19,1
141796,3957,1768,2189,20,1
141796,3176,1397,1779,21,4
141796,3176,1397,1779,22,1
141796,2996,1303,1693,23,1
141796,815,352,463,24,1
141796,2181,951,1230,25,1
141796,180,94,86,31,1
141796,365,158,207,39,1
141796,1816,793,1023,40,1
141796,5200,2219,2981,41,4
141796,5200,2219,2981,42,1
141796,3029,1336,1693,43,1
141796,452,196,256,44,1
141796,2577,1140,1437,45,1
141796,2171,883,1288,51,1
141796,436,165,271,59,1
141796,2141,975,1166,60,1
141802,1530,615,915,1,4
141802,1530,615,915,2,1
141802,1251,494,757,3,1
141802,328,139,189,4,1
141802,923,355,568,5,1
141802,279,121,158,11,1
141802,94,38,56,19,1
141802,829,317,512,20,1
141802,574,240,334,21,4
141802,574,240,334,22,1
141802,558,232,326,23,1
141802,211,87,124,24,1
141802,347,145,202,25,1
141802,16,8,8,31,1
141802,30,13,17,39,1
141802,317,132,185,40,1
141802,956,375,581,41,4
141802,956,375,581,42,1
141802,693,262,431,43,1
141802,117,52,65,44,1
141802,576,210,366,45,1
141802,263,113,150,51,1
141802,64,25,39,59,1
141802,512,185,327,60,1
141811,7976,3289,4687,1,4
141811,7976,3289,4687,2,1
141811,5932,2545,3387,3,1
141811,1301,614,687,4,1
141811,4631,1931,2700,5,1
141811,2044,744,1300,11,1
141811,683,270,413,19,1
141811,3948,1661,2287,20,1
141811,3141,1428,1713,21,4
141811,3141,1428,1713,22,1
141811,3020,1365,1655,23,1
141811,837,403,434,24,1
141811,2183,962,1221,25,1
141811,121,63,58,31,1
141811,303,139,164,39,1
141811,1880,823,1057,40,1
141811,4835,1861,2974,41,4
141811,4835,1861,2974,42,1
141811,2912,1180,1732,43,1
141811,464,211,253,44,1
141811,2448,969,1479,45,1
141811,1923,681,1242,51,1
141811,380,131,249,59,1
141811,2068,838,1230,60,1
141839,4076,1449,2627,1,4
141839,4076,1449,2627,2,1
141839,3553,1282,2271,3,1
141839,770,328,442,4,1
141839,2783,954,1829,5,1
141839,523,167,356,11,1
141839,268,93,175,19,1
141839,2515,861,1654,20,1
141839,1460,558,902,21,4
141839,1460,558,902,22,1
141839,1428,546,882,23,1
141839,431,181,250,24,1
141839,997,365,632,25,1
141839,32,12,20,31,1
141839,82,31,51,39,1
141839,915,334,581,40,1
141839,2616,891,1725,41,4
141839,2616,891,1725,42,1
141839,2125,736,1389,43,1
141839,339,147,192,44,1
141839,1786,589,1197,45,1
141839,491,155,336,51,1
141839,186,62,124,59,1
141839,1600,527,1073,60,1
141848,81,6,75,1,4
141848,81,6,75,2,1
141848,81,6,75,3,1
141848,31,3,28,4,1
141848,50,3,47,5,1
141848,50,3,47,20,1
141848,78,6,72,21,4
141848,78,6,72,22,1
141848,78,6,72,23,1
141848,30,3,27,24,1
141848,48,3,45,25,1
141848,48,3,45,40,1
141848,3,0,3,41,4
141848,3,0,3,42,1
141848,3,0,3,43,1
141848,1,0,1,44,1
141848,2,0,2,45,1
141848,2,0,2,60,1
141936,64,23,41,1,4
141936,64,23,41,12,3
141936,64,23,41,21,4
141936,64,23,41,32,3
141945,188,62,126,1,4
141945,188,62,126,2,1
141945,188,62,126,3,1
141945,56,23,33,4,1
141945,132,39,93,5,1
141945,132,39,93,20,1
141945,188,62,126,21,4
141945,188,62,126,22,1
141945,188,62,126,23,1
141945,56,23,33,24,1
141945,132,39,93,25,1
141945,132,39,93,40,1
141981,2361,792,1569,1,4
141981,2361,792,1569,2,1
141981,2192,740,1452,3,1
141981,291,115,176,4,1
141981,1901,625,1276,5,1
141981,169,52,117,11,1
141981,539,169,370,19,1
141981,1362,456,906,20,1
141981,1043,349,694,21,4
141981,1043,349,694,22,1
141981,1035,344,691,23,1
141981,214,79,135,24,1
141981,821,265,556,25,1
141981,8,5,3,31,1
141981,221,60,161,39,1
141981,600,205,395,40,1
141981,1318,443,875,41,4
141981,1318,443,875,42,1
141981,1157,396,761,43,1
141981,77,36,41,44,1
141981,1080,360,720,45,1
141981,161,47,114,51,1
141981,318,109,209,59,1
141981,762,251,511,60,1
141990,2799,1045,1754,1,4
141990,2799,1045,1754,2,1
141990,1911,712,1199,3,1
141990,422,171,251,4,1
141990,1489,541,948,5,1
141990,888,333,555,11,1
141990,290,91,199,19,1
141990,1199,450,749,20,1
141990,959,380,579,21,4
141990,959,380,579,22,1
141990,893,351,542,23,1
141990,283,108,175,24,1
141990,610,243,367,25,1
141990,66,29,37,31,1
141990,114,43,71,39,1
141990,496,200,296,40,1
141990,1840,665,1175,41,4
141990,1840,665,1175,42,1
141990,1018,361,657,43,1
141990,139,63,76,44,1
141990,879,298,581,45,1
141990,822,304,518,51,1
141990,176,48,128,59,1
141990,703,250,453,60,1
142054,552,91,461,1,4
142054,552,91,461,2,1
142054,552,91,461,3,1
142054,49,10,39,4,1
142054,503,81,422,5,1
142054,116,23,93,19,1
142054,387,58,329,20,1
142054,496,78,418,21,4
142054,496,78,418,22,1
142054,496,78,418,23,1
142054,49,10,39,24,1
142054,447,68,379,25,1
142054,92,15,77,39,1
142054,355,53,302,40,1
142054,56,13,43,41,4
142054,56,13,43,42,1
142054,56,13,43,43,1
142054,56,13,43,45,1
142054,24,8,16,59,1
142054,32,5,27,60,1
142090,186,102,84,1,4
142090,186,102,84,2,1
142090,183,101,82,3,1
142090,47,33,14,4,1
142090,136,68,68,5,1
142090,3,1,2,11,1
142090,10,7,3,19,1
142090,126,61,65,20,1
142090,167,92,75,21,4
142090,167,92,75,22,1
142090,167,92,75,23,1
142090,47,33,14,24,1
142090,120,59,61,25,1
142090,10,7,3,39,1
142090,110,52,58,40,1
142090,19,10,9,41,4
142090,19,10,9,42,1
142090,16,9,7,43,1
142090,16,9,7,45,1
142090,3,1,2,51,1
142090,16,9,7,60,1
142115,21981,9973,12008,1,4
142115,19026,8846,10180,2,1
142115,16557,7841,8716,3,1
142115,2194,1000,1194,4,1
142115,14363,6841,7522,5,1
142115,2469,1005,1464,11,1
142115,2955,1127,1828,12,3
142115,1400,631,769,19,1
142115,12963,6210,6753,20,1
142115,13264,6412,6852,21,4
142115,12452,6030,6422,22,1
142115,12427,6023,6404,23,1
142115,2079,950,1129,24,1
142115,10348,5073,5275,25,1
142115,25,7,18,31,1
142115,812,382,430,32,3
142115,974,456,518,39,1
142115,9374,4617,4757,40,1
142115,8717,3561,5156,41,4
142115,6574,2816,3758,42,1
142115,4130,1818,2312,43,1
142115,115,50,65,44,1
142115,4015,1768,2247,45,1
142115,2444,998,1446,51,1
142115,2143,745,1398,52,3
142115,426,175,251,59,1
142115,3589,1593,1996,60,1
142179,725,270,455,1,4
142179,725,270,455,2,1
142179,575,209,366,3,1
142179,82,50,32,4,1
142179,493,159,334,5,1
142179,150,61,89,11,1
142179,54,17,37,19,1
142179,439,142,297,20,1
142179,294,146,148,21,4
142179,294,146,148,22,1
142179,289,143,146,23,1
142179,53,34,19,24,1
142179,236,109,127,25,1
142179,5,3,2,31,1
142179,29,11,18,39,1
142179,207,98,109,40,1
142179,431,124,307,41,4
142179,431,124,307,42,1
142179,286,66,220,43,1
142179,29,16,13,44,1
142179,257,50,207,45,1
142179,145,58,87,51,1
142179,25,6,19,59,1
142179,232,44,188,60,1
142276,13326,6194,7132,1,4
142276,11418,5315,6103,2,1
142276,9337,4475,4862,3,1
142276,1551,771,780,4,1
142276,7786,3704,4082,5,1
142276,2081,840,1241,11,1
142276,1908,879,1029,12,3
142276,458,192,266,19,1
142276,7328,3512,3816,20,1
142276,8231,4032,4199,21,4
142276,7016,3462,3554,22,1
142276,6969,3444,3525,23,1
142276,1334,661,673,24,1
142276,5635,2783,2852,25,1
142276,47,18,29,31,1
142276,1215,570,645,32,3
142276,335,152,183,39,1
142276,5300,2631,2669,40,1
142276,5095,2162,2933,41,4
142276,4402,1853,2549,42,1
142276,2368,1031,1337,43,1
142276,217,110,107,44,1
142276,2151,921,1230,45,1
142276,2034,822,1212,51,1
142276,693,309,384,52,3
142276,123,40,83,59,1
142276,2028,881,1147,60,1
142285,12024,6402,5622,1,4
142285,9540,5012,4528,2,1
142285,8539,4586,3953,3,1
142285,1630,837,793,4,1
142285,6909,3749,3160,5,1
142285,1001,426,575,11,1
142285,2484,1390,1094,12,3
142285,671,363,308,19,1
142285,6238,3386,2852,20,1
142285,9387,5086,4301,21,4
142285,8011,4295,3716,22,1
142285,7976,4278,3698,23,1
142285,1590,809,781,24,1
142285,6386,3469,2917,25,1
142285,35,17,18,31,1
142285,1376,791,585,32,3
142285,575,319,256,39,1
142285,5811,3150,2661,40,1
142285,2637,1316,1321,41,4
142285,1529,717,812,42,1
142285,563,308,255,43,1
142285,40,28,12,44,1
142285,523,280,243,45,1
142285,966,409,557,51,1
142285,1108,599,509,52,3
142285,96,44,52,59,1
142285,427,236,191,60,1
142294,1122,495,627,1,4
142294,1095,490,605,2,1
142294,1086,487,599,3,1
142294,292,143,149,4,1
142294,794,344,450,5,1
142294,9,3,6,11,1
142294,27,5,22,12,3
142294,64,36,28,19,1
142294,730,308,422,20,1
142294,1070,476,594,21,4
142294,1055,473,582,22,1
142294,1054,472,582,23,1
142294,291,143,148,24,1
142294,763,329,434,25,1
142294,1,1,0,31,1
142294,15,3,12,32,3
142294,64,36,28,39,1
142294,699,293,406,40,1
142294,52,19,33,41,4
142294,40,17,23,42,1
142294,32,15,17,43,1
142294,1,0,1,44,1
142294,31,15,16,45,1
142294,8,2,6,51,1
142294,12,2,10,52,3
142294,31,15,16,60,1
142328,4304,1685,2619,1,4
142328,4304,1685,2619,2,1
142328,3161,1213,1948,3,1
142328,475,195,280,4,1
142328,2686,1018,1668,5,1
142328,1143,472,671,11,1
142328,366,135,231,19,1
142328,2320,883,1437,20,1
142328,2443,991,1452,21,4
142328,2443,991,1452,22,1
142328,2420,984,1436,23,1
142328,446,186,260,24,1
142328,1974,798,1176,25,1
142328,23,7,16,31,1
142328,225,100,125,39,1
142328,1749,698,1051,40,1
142328,1861,694,1167,41,4
142328,1861,694,1167,42,1
142328,741,229,512,43,1
142328,29,9,20,44,1
142328,712,220,492,45,1
142328,1120,465,655,51,1
142328,141,35,106,59,1
142328,571,185,386,60,1
142337,251,147,104,1,4
142337,251,147,104,2,1
142337,251,147,104,3,1
142337,31,20,11,4,1
142337,220,127,93,5,1
142337,15,4,11,19,1
142337,205,123,82,20,1
142337,174,108,66,21,4
142337,174,108,66,22,1
142337,174,108,66,23,1
142337,31,20,11,24,1
142337,143,88,55,25,1
142337,10,3,7,39,1
142337,133,85,48,40,1
142337,77,39,38,41,4
142337,77,39,38,42,1
142337,77,39,38,43,1
142337,77,39,38,45,1
142337,5,1,4,59,1
142337,72,38,34,60,1
142407,57,0,57,1,4
142407,57,0,57,2,1
142407,57,0,57,3,1
142407,47,0,47,4,1
142407,10,0,10,5,1
142407,10,0,10,20,1
142407,34,0,34,21,4
142407,34,0,34,22,1
142407,34,0,34,23,1
142407,31,0,31,24,1
142407,3,0,3,25,1
142407,3,0,3,40,1
142407,23,0,23,41,4
142407,23,0,23,42,1
142407,23,0,23,43,1
142407,16,0,16,44,1
142407,7,0,7,45,1
142407,7,0,7,60,1
142416,25,2,23,1,4
142416,25,2,23,2,1
142416,25,2,23,3,1
142416,16,1,15,4,1
142416,9,1,8,5,1
142416,9,1,8,20,1
142416,25,2,23,21,4
142416,25,2,23,22,1
142416,25,2,23,23,1
142416,16,1,15,24,1
142416,9,1,8,25,1
142416,9,1,8,40,1
142443,6029,2402,3627,1,4
142443,6029,2402,3627,2,1
142443,5095,2066,3029,3,1
142443,1049,490,559,4,1
142443,4046,1576,2470,5,1
142443,934,336,598,11,1
142443,253,112,141,19,1
142443,3793,1464,2329,20,1
142443,3068,1406,1662,21,4
142443,3068,1406,1662,22,1
142443,2915,1353,1562,23,1
142443,754,377,377,24,1
142443,2161,976,1185,25,1
142443,153,53,100,31,1
142443,155,77,78,39,1
142443,2006,899,1107,40,1
142443,2961,996,1965,41,4
142443,2961,996,1965,42,1
142443,2180,713,1467,43,1
142443,295,113,182,44,1
142443,1885,600,1285,45,1
142443,781,283,498,51,1
142443,98,35,63,59,1
142443,1787,565,1222,60,1
142461,2246,949,1297,1,4
142461,1488,648,840,2,1
142461,1251,496,755,3,1
142461,252,98,154,4,1
142461,999,398,601,5,1
142461,237,152,85,11,1
142461,758,301,457,12,3
142461,89,37,52,19,1
142461,910,361,549,20,1
142461,1692,691,1001,21,4
142461,1136,454,682,22,1
142461,1125,448,677,23,1
142461,249,96,153,24,1
142461,876,352,524,25,1
142461,11,6,5,31,1
142461,556,237,319,32,3
142461,70,33,37,39,1
142461,806,319,487,40,1
142461,554,258,296,41,4
142461,352,194,158,42,1
142461,126,48,78,43,1
142461,3,2,1,44,1
142461,123,46,77,45,1
142461,226,146,80,51,1
142461,202,64,138,52,3
142461,19,4,15,59,1
142461,104,42,62,60,1
142489,36,1,35,1,4
142489,36,1,35,2,1
142489,36,1,35,3,1
142489,21,1,20,4,1
142489,15,0,15,5,1
142489,15,0,15,20,1
142489,36,1,35,21,4
142489,36,1,35,22,1
142489,36,1,35,23,1
142489,21,1,20,24,1
142489,15,0,15,25,1
142489,15,0,15,40,1
142522,27692,11780,15912,1,4
142522,27692,11780,15912,2,1
142522,20208,8594,11614,3,1
142522,2423,754,1669,4,1
142522,17785,7840,9945,5,1
142522,7484,3186,4298,11,1
142522,1859,601,1258,19,1
142522,15926,7239,8687,20,1
142522,14376,6357,8019,21,4
142522,14376,6357,8019,22,1
142522,14369,6353,8016,23,1
142522,2234,686,1548,24,1
142522,12135,5667,6468,25,1
142522,7,4,3,31,1
142522,1685,537,1148,39,1
142522,10450,5130,5320,40,1
142522,13316,5423,7893,41,4
142522,13316,5423,7893,42,1
142522,5839,2241,3598,43,1
142522,189,68,121,44,1
142522,5650,2173,3477,45,1
142522,7477,3182,4295,51,1
142522,174,64,110,59,1
142522,5476,2109,3367,60,1
142559,8330,2982,5348,1,4
142559,8330,2982,5348,2,1
142559,5023,1920,3103,3,1
142559,1145,510,635,4,1
142559,3878,1410,2468,5,1
142559,3307,1062,2245,11,1
142559,308,111,197,19,1
142559,3570,1299,2271,20,1
142559,2730,1118,1612,21,4
142559,2730,1118,1612,22,1
142559,2613,1081,1532,23,1
142559,783,374,409,24,1
142559,1830,707,1123,25,1
142559,117,37,80,31,1
142559,176,61,115,39,1
142559,1654,646,1008,40,1
142559,5600,1864,3736,41,4
142559,5600,1864,3736,42,1
142559,2410,839,1571,43,1
142559,362,136,226,44,1
142559,2048,703,1345,45,1
142559,3190,1025,2165,51,1
142559,132,50,82,59,1
142559,1916,653,1263,60,1
142832,981,209,772,1,4
142832,981,209,772,12,3
142832,772,160,612,21,4
142832,772,160,612,32,3
142832,209,49,160,41,4
142832,209,49,160,52,3
142869,45,4,41,1,4
142869,45,4,41,2,1
142869,45,4,41,3,1
142869,29,4,25,4,1
142869,16,0,16,5,1
142869,16,0,16,20,1
142869,25,1,24,21,4
142869,25,1,24,22,1
142869,25,1,24,23,1
142869,15,1,14,24,1
142869,10,0,10,25,1
142869,10,0,10,40,1
142869,20,3,17,41,4
142869,20,3,17,42,1
142869,20,3,17,43,1
142869,14,3,11,44,1
142869,6,0,6,45,1
142869,6,0,6,60,1
142878,40,2,38,1,4
142878,40,2,38,2,1
142878,40,2,38,3,1
142878,38,1,37,4,1
142878,2,1,1,5,1
142878,2,1,1,20,1
142878,40,2,38,21,4
142878,40,2,38,22,1
142878,40,2,38,23,1
142878,38,1,37,24,1
142878,2,1,1,25,1
142878,2,1,1,40,1
142887,406,190,216,1,4
142887,406,190,216,2,1
142887,406,190,216,3,1
142887,100,50,50,4,1
142887,306,140,166,5,1
142887,12,5,7,19,1
142887,294,135,159,20,1
142887,299,136,163,21,4
142887,299,136,163,22,1
142887,299,136,163,23,1
142887,75,35,40,24,1
142887,224,101,123,25,1
142887,11,4,7,39,1
142887,213,97,116,40,1
142887,107,54,53,41,4
142887,107,54,53,42,1
142887,107,54,53,43,1
142887,25,15,10,44,1
142887,82,39,43,45,1
142887,1,1,0,59,1
142887,81,38,43,60,1
143048,3402,1031,2371,1,4
143048,2714,802,1912,2,1
143048,2641,781,1860,3,1
143048,577,170,407,4,1
143048,2064,611,1453,5,1
143048,73,21,52,11,1
143048,688,229,459,12,3
143048,270,93,177,19,1
143048,1794,518,1276,20,1
143048,3107,942,2165,21,4
143048,2469,728,1741,22,1
143048,2469,728,1741,23,1
143048,575,170,405,24,1
143048,1894,558,1336,25,1
143048,638,214,424,32,3
143048,255,83,172,39,1
143048,1639,475,1164,40,1
143048,295,89,206,41,4
143048,245,74,171,42,1
143048,172,53,119,43,1
143048,2,0,2,44,1
143048,170,53,117,45,1
143048,73,21,52,51,1
143048,50,15,35,52,3
143048,15,10,5,59,1
143048,155,43,112,60,1
143084,2524,1089,1435,1,4
143084,2524,1089,1435,2,1
143084,2504,1081,1423,3,1
143084,627,291,336,4,1
143084,1877,790,1087,5,1
143084,20,8,12,11,1
143084,49,21,28,19,1
143084,1828,769,1059,20,1
143084,2509,1079,1430,21,4
143084,2509,1079,1430,22,1
143084,2494,1075,1419,23,1
143084,627,291,336,24,1
143084,1867,784,1083,25,1
143084,15,4,11,31,1
143084,48,20,28,39,1
143084,1819,764,1055,40,1
143084,15,10,5,41,4
143084,15,10,5,42,1
143084,10,6,4,43,1
143084,10,6,4,45,1
143084,5,4,1,51,1
143084,1,1,0,59,1
143084,9,5,4,60,1
143118,4946,1608,3338,1,4
143118,3246,1195,2051,2,1
143118,3236,1190,2046,3,1
143118,701,302,399,4,1
143118,2535,888,1647,5,1
143118,10,5,5,11,1
143118,1700,413,1287,12,3
143118,455,143,312,19,1
143118,2080,745,1335,20,1
143118,3342,1176,2166,21,4
143118,2852,1081,1771,22,1
143118,2851,1080,1771,23,1
143118,701,302,399,24,1
143118,2150,778,1372,25,1
143118,1,1,0,31,1
143118,490,95,395,32,3
143118,378,123,255,39,1
143118,1772,655,1117,40,1
143118,1604,432,1172,41,4
143118,394,114,280,42,1
143118,385,110,275,43,1
143118,385,110,275,45,1
143118,9,4,5,51,1
143118,1210,318,892,52,3
143118,77,20,57,59,1
143118,308,90,218,60,1
143181,33,2,31,1,4
143181,33,2,31,2,1
143181,33,2,31,3,1
143181,13,1,12,4,1
143181,20,1,19,5,1
143181,20,1,19,20,1
143181,33,2,31,21,4
143181,33,2,31,22,1
143181,33,2,31,23,1
143181,13,1,12,24,1
143181,20,1,19,25,1
143181,20,1,19,40,1
143215,11332,5039,6293,1,4
143215,11332,5039,6293,2,1
143215,9862,4365,5497,3,1
143215,1550,809,741,4,1
143215,8312,3556,4756,5,1
143215,1470,674,796,11,1
143215,490,232,258,19,1
143215,7822,3324,4498,20,1
143215,4879,2347,2532,21,4
143215,4879,2347,2532,22,1
143215,4741,2274,2467,23,1
143215,1098,585,513,24,1
143215,3643,1689,1954,25,1
143215,138,73,65,31,1
143215,302,147,155,39,1
143215,3341,1542,1799,40,1
143215,6453,2692,3761,41,4
143215,6453,2692,3761,42,1
143215,5121,2091,3030,43,1
143215,452,224,228,44,1
143215,4669,1867,2802,45,1
143215,1332,601,731,51,1
143215,188,85,103,59,1
143215,4481,1782,2699,60,1
143233,60,28,32,1,4
143233,60,28,32,12,3
143233,29,13,16,21,4
143233,29,13,16,32,3
143233,31,15,16,41,4
143233,31,15,16,52,3
143279,6574,2666,3908,1,4
143279,6574,2666,3908,2,1
143279,4736,1930,2806,3,1
143279,569,284,285,4,1
143279,4167,1646,2521,5,1
143279,1838,736,1102,11,1
143279,285,116,169,19,1
143279,3882,1530,2352,20,1
143279,2581,1104,1477,21,4
143279,2581,1104,1477,22,1
143279,2422,1039,1383,23,1
143279,438,227,211,24,1
143279,1984,812,1172,25,1
143279,159,65,94,31,1
143279,187,80,107,39,1
143279,1797,732,1065,40,1
143279,3993,1562,2431,41,4
143279,3993,1562,2431,42,1
143279,2314,891,1423,43,1
143279,131,57,74,44,1
143279,2183,834,1349,45,1
143279,1679,671,1008,51,1
143279,98,36,62,59,1
143279,2085,798,1287,60,1
143288,543,229,314,1,4
143288,543,229,314,2,1
143288,539,228,311,3,1
143288,116,53,63,4,1
143288,423,175,248,5,1
143288,4,1,3,11,1
143288,46,21,25,19,1
143288,377,154,223,20,1
143288,523,222,301,21,4
143288,523,222,301,22,1
143288,522,222,300,23,1
143288,115,53,62,24,1
143288,407,169,238,25,1
143288,1,0,1,31,1
143288,45,20,25,39,1
143288,362,149,213,40,1
143288,20,7,13,41,4
143288,20,7,13,42,1
143288,17,6,11,43,1
143288,1,0,1,44,1
143288,16,6,10,45,1
143288,3,1,2,51,1
143288,1,1,0,59,1
143288,15,5,10,60,1
143297,256,30,226,1,4
143297,243,30,213,2,1
143297,243,30,213,3,1
143297,243,30,213,5,1
143297,13,0,13,12,3
143297,26,3,23,19,1
143297,217,27,190,20,1
143297,178,22,156,21,4
143297,178,22,156,22,1
143297,178,22,156,23,1
143297,178,22,156,25,1
143297,26,3,23,39,1
143297,152,19,133,40,1
143297,78,8,70,41,4
143297,65,8,57,42,1
143297,65,8,57,43,1
143297,65,8,57,45,1
143297,13,0,13,52,3
143297,65,8,57,60,1
143303,20,2,18,1,4
143303,20,2,18,2,1
143303,20,2,18,3,1
143303,20,2,18,5,1
143303,20,2,18,20,1
143303,20,2,18,21,4
143303,20,2,18,22,1
143303,20,2,18,23,1
143303,20,2,18,25,1
143303,20,2,18,40,1
143358,5430,2621,2809,1,4
143358,4825,2309,2516,2,1
143358,4823,2308,2515,3,1
143358,1085,510,575,4,1
143358,3738,1798,1940,5,1
143358,2,1,1,11,1
143358,605,312,293,12,3
143358,266,154,112,19,1
143358,3472,1644,1828,20,1
143358,4912,2352,2560,21,4
143358,4618,2196,2422,22,1
143358,4618,2196,2422,23,1
143358,1082,508,574,24,1
143358,3536,1688,1848,25,1
143358,294,156,138,32,3
143358,246,143,103,39,1
143358,3290,1545,1745,40,1
143358,518,269,249,41,4
143358,207,113,94,42,1
143358,205,112,93,43,1
143358,3,2,1,44,1
143358,202,110,92,45,1
143358,2,1,1,51,1
143358,311,156,155,52,3
143358,20,11,9,59,1
143358,182,99,83,60,1
143376,395,18,377,1,4
143376,395,18,377,2,1
143376,395,18,377,3,1
143376,298,10,288,4,1
143376,97,8,89,5,1
143376,97,8,89,20,1
143376,304,17,287,21,4
143376,304,17,287,22,1
143376,304,17,287,23,1
143376,219,10,209,24,1
143376,85,7,78,25,1
143376,85,7,78,40,1
143376,91,1,90,41,4
143376,91,1,90,42,1
143376,91,1,90,43,1
143376,79,0,79,44,1
143376,12,1,11,45,1
143376,12,1,11,60,1
143464,105,1,104,1,4
143464,105,1,104,2,1
143464,105,1,104,3,1
143464,12,1,11,4,1
143464,93,0,93,5,1
143464,93,0,93,20,1
143464,57,0,57,21,4
143464,57,0,57,22,1
143464,57,0,57,23,1
143464,4,0,4,24,1
143464,53,0,53,25,1
143464,53,0,53,40,1
143464,48,1,47,41,4
143464,48,1,47,42,1
143464,48,1,47,43,1
143464,8,1,7,44,1
143464,40,0,40,45,1
143464,40,0,40,60,1
143473,83,4,79,1,4
143473,83,4,79,2,1
143473,83,4,79,3,1
143473,50,3,47,4,1
143473,33,1,32,5,1
143473,33,1,32,20,1
143473,14,0,14,21,4
143473,14,0,14,22,1
143473,14,0,14,23,1
143473,5,0,5,24,1
143473,9,0,9,25,1
143473,9,0,9,40,1
143473,69,4,65,41,4
143473,69,4,65,42,1
143473,69,4,65,43,1
143473,45,3,42,44,1
143473,24,1,23,45,1
143473,24,1,23,60,1
143482,84,2,82,1,4
143482,84,2,82,2,1
143482,84,2,82,3,1
143482,26,1,25,4,1
143482,58,1,57,5,1
143482,58,1,57,20,1
143482,22,0,22,21,4
143482,22,0,22,22,1
143482,22,0,22,23,1
143482,3,0,3,24,1
143482,19,0,19,25,1
143482,19,0,19,40,1
143482,62,2,60,41,4
143482,62,2,60,42,1
143482,62,2,60,43,1
143482,23,1,22,44,1
143482,39,1,38,45,1
143482,39,1,38,60,1
143491,125,1,124,1,4
143491,125,1,124,2,1
143491,125,1,124,3,1
143491,70,0,70,4,1
143491,55,1,54,5,1
143491,55,1,54,20,1
143491,9,0,9,21,4
143491,9,0,9,22,1
143491,9,0,9,23,1
143491,1,0,1,24,1
143491,8,0,8,25,1
143491,8,0,8,40,1
143491,116,1,115,41,4
143491,116,1,115,42,1
143491,116,1,115,43,1
143491,69,0,69,44,1
143491,47,1,46,45,1
143491,47,1,46,60,1
143516,79,7,72,1,4
143516,79,7,72,2,1
143516,79,7,72,3,1
143516,34,2,32,4,1
143516,45,5,40,5,1
143516,45,5,40,20,1
143516,13,1,12,21,4
143516,13,1,12,22,1
143516,13,1,12,23,1
143516,4,0,4,24,1
143516,9,1,8,25,1
143516,9,1,8,40,1
143516,66,6,60,41,4
143516,66,6,60,42,1
143516,66,6,60,43,1
143516,30,2,28,44,1
143516,36,4,32,45,1
143516,36,4,32,60,1
143534,32,1,31,1,4
143534,32,1,31,2,1
143534,32,1,31,3,1
143534,1,0,1,4,1
143534,31,1,30,5,1
143534,31,1,30,20,1
143534,32,1,31,21,4
143534,32,1,31,22,1
143534,32,1,31,23,1
143534,1,0,1,24,1
143534,31,1,30,25,1
143534,31,1,30,40,1
143543,81,8,73,1,4
143543,81,8,73,2,1
143543,81,8,73,3,1
143543,32,3,29,4,1
143543,49,5,44,5,1
143543,49,5,44,20,1
143543,47,8,39,21,4
143543,47,8,39,22,1
143543,47,8,39,23,1
143543,18,3,15,24,1
143543,29,5,24,25,1
143543,29,5,24,40,1
143543,34,0,34,41,4
143543,34,0,34,42,1
143543,34,0,34,43,1
143543,14,0,14,44,1
143543,20,0,20,45,1
143543,20,0,20,60,1
143552,86,0,86,1,4
143552,86,0,86,2,1
143552,86,0,86,3,1
143552,4,0,4,4,1
143552,82,0,82,5,1
143552,82,0,82,20,1
143552,59,0,59,21,4
143552,59,0,59,22,1
143552,59,0,59,23,1
143552,4,0,4,24,1
143552,55,0,55,25,1
143552,55,0,55,40,1
143552,27,0,27,41,4
143552,27,0,27,42,1
143552,27,0,27,43,1
143552,27,0,27,45,1
143552,27,0,27,60,1
143613,2328,843,1485,1,4
143613,2328,843,1485,2,1
143613,1724,576,1148,3,1
143613,429,196,233,4,1
143613,1295,380,915,5,1
143613,604,267,337,11,1
143613,310,89,221,19,1
143613,985,291,694,20,1
143613,1026,406,620,21,4
143613,1026,406,620,22,1
143613,994,395,599,23,1
143613,301,153,148,24,1
143613,693,242,451,25,1
143613,32,11,21,31,1
143613,203,59,144,39,1
143613,490,183,307,40,1
143613,1302,437,865,41,4
143613,1302,437,865,42,1
143613,730,181,549,43,1
143613,128,43,85,44,1
143613,602,138,464,45,1
143613,572,256,316,51,1
143613,107,30,77,59,1
143613,495,108,387,60,1
143659,437,246,191,1,4
143659,437,246,191,12,3
143659,136,99,37,21,4
143659,136,99,37,32,3
143659,301,147,154,41,4
143659,301,147,154,52,3
143695,23,1,22,1,4
143695,23,1,22,2,1
143695,23,1,22,3,1
143695,7,0,7,4,1
143695,16,1,15,5,1
143695,16,1,15,20,1
143695,23,1,22,21,4
143695,23,1,22,22,1
143695,23,1,22,23,1
143695,7,0,7,24,1
143695,16,1,15,25,1
143695,16,1,15,40,1
143853,2730,1191,1539,1,4
143853,2730,1191,1539,12,3
143853,2668,1166,1502,21,4
143853,2668,1166,1502,32,3
143853,62,25,37,41,4
143853,62,25,37,52,3
143978,1636,321,1315,1,4
143978,1636,321,1315,12,3
143978,1034,192,842,21,4
143978,1034,192,842,32,3
143978,602,129,473,41,4
143978,602,129,473,52,3
144005,5701,1672,4029,1,4
144005,4340,1239,3101,2,1
144005,4321,1230,3091,3,1
144005,276,94,182,4,1
144005,4045,1136,2909,5,1
144005,19,9,10,11,1
144005,1361,433,928,12,3
144005,535,154,381,19,1
144005,3510,982,2528,20,1
144005,3590,1116,2474,21,4
144005,2852,864,1988,22,1
144005,2848,862,1986,23,1
144005,225,74,151,24,1
144005,2623,788,1835,25,1
144005,4,2,2,31,1
144005,738,252,486,32,3
144005,401,126,275,39,1
144005,2222,662,1560,40,1
144005,2111,556,1555,41,4
144005,1488,375,1113,42,1
144005,1473,368,1105,43,1
144005,51,20,31,44,1
144005,1422,348,1074,45,1
144005,15,7,8,51,1
144005,623,181,442,52,3
144005,134,28,106,59,1
144005,1288,320,968,60,1
144014,251,135,116,1,4
144014,251,135,116,12,3
144014,141,84,57,21,4
144014,141,84,57,32,3
144014,110,51,59,41,4
144014,110,51,59,52,3
144050,15048,8722,6326,1,4
144050,5703,3023,2680,2,1
144050,5697,3022,2675,3,1
144050,1426,781,645,4,1
144050,4271,2241,2030,5,1
144050,6,1,5,11,1
144050,9345,5699,3646,12,3
144050,18,11,7,19,1
144050,4253,2230,2023,20,1
144050,12848,7140,5708,21,4
144050,5630,2982,2648,22,1
144050,5624,2981,2643,23,1
144050,1426,781,645,24,1
144050,4198,2200,1998,25,1
144050,6,1,5,31,1
144050,7218,4158,3060,32,3
144050,18,11,7,39,1
144050,4180,2189,1991,40,1
144050,2200,1582,618,41,4
144050,73,41,32,42,1
144050,73,41,32,43,1
144050,73,41,32,45,1
144050,2127,1541,586,52,3
144050,73,41,32,60,1
144157,5860,2159,3701,1,4
144157,5860,2159,3701,2,1
144157,4509,1689,2820,3,1
144157,662,314,348,4,1
144157,3847,1375,2472,5,1
144157,1351,470,881,11,1
144157,419,163,256,19,1
144157,3428,1212,2216,20,1
144157,3287,1278,2009,21,4
144157,3287,1278,2009,22,1
144157,3136,1219,1917,23,1
144157,504,237,267,24,1
144157,2632,982,1650,25,1
144157,151,59,92,31,1
144157,319,117,202,39,1
144157,2313,865,1448,40,1
144157,2573,881,1692,41,4
144157,2573,881,1692,42,1
144157,1373,470,903,43,1
144157,158,77,81,44,1
144157,1215,393,822,45,1
144157,1200,411,789,51,1
144157,100,46,54,59,1
144157,1115,347,768,60,1
144166,6842,2187,4655,1,4
144166,6842,2187,4655,2,1
144166,5222,1531,3691,3,1
144166,774,253,521,4,1
144166,4448,1278,3170,5,1
144166,1620,656,964,11,1
144166,651,255,396,19,1
144166,3797,1023,2774,20,1
144166,3047,934,2113,21,4
144166,3047,934,2113,22,1
144166,3029,924,2105,23,1
144166,556,181,375,24,1
144166,2473,743,1730,25,1
144166,18,10,8,31,1
144166,380,158,222,39,1
144166,2093,585,1508,40,1
144166,3795,1253,2542,41,4
144166,3795,1253,2542,42,1
144166,2193,607,1586,43,1
144166,218,72,146,44,1
144166,1975,535,1440,45,1
144166,1602,646,956,51,1
144166,271,97,174,59,1
144166,1704,438,1266,60,1
144175,5298,2274,3024,1,4
144175,5298,2274,3024,2,1
144175,3671,1612,2059,3,1
144175,469,203,266,4,1
144175,3202,1409,1793,5,1
144175,1627,662,965,11,1
144175,334,137,197,19,1
144175,2868,1272,1596,20,1
144175,1940,683,1257,21,4
144175,1940,683,1257,22,1
144175,1816,646,1170,23,1
144175,319,133,186,24,1
144175,1497,513,984,25,1
144175,124,37,87,31,1
144175,214,84,130,39,1
144175,1283,429,854,40,1
144175,3358,1591,1767,41,4
144175,3358,1591,1767,42,1
144175,1855,966,889,43,1
144175,150,70,80,44,1
144175,1705,896,809,45,1
144175,1503,625,878,51,1
144175,120,53,67,59,1
144175,1585,843,742,60,1
144184,11800,4988,6812,1,4
144184,11800,4988,6812,2,1
144184,6221,2576,3645,3,1
144184,642,276,366,4,1
144184,5579,2300,3279,5,1
144184,5579,2412,3167,11,1
144184,698,312,386,19,1
144184,4881,1988,2893,20,1
144184,3070,1358,1712,21,4
144184,3070,1358,1712,22,1
144184,2775,1219,1556,23,1
144184,447,199,248,24,1
144184,2328,1020,1308,25,1
144184,295,139,156,31,1
144184,329,157,172,39,1
144184,1999,863,1136,40,1
144184,8730,3630,5100,41,4
144184,8730,3630,5100,42,1
144184,3446,1357,2089,43,1
144184,195,77,118,44,1
144184,3251,1280,1971,45,1
144184,5284,2273,3011,51,1
144184,369,155,214,59,1
144184,2882,1125,1757,60,1
144193,9384,3685,5699,1,4
144193,9384,3685,5699,2,1
144193,4791,1939,2852,3,1
144193,766,380,386,4,1
144193,4025,1559,2466,5,1
144193,4593,1746,2847,11,1
144193,507,276,231,19,1
144193,3518,1283,2235,20,1
144193,3760,1524,2236,21,4
144193,3760,1524,2236,22,1
144193,2478,1084,1394,23,1
144193,487,230,257,24,1
144193,1991,854,1137,25,1
144193,1282,440,842,31,1
144193,355,208,147,39,1
144193,1636,646,990,40,1
144193,5624,2161,3463,41,4
144193,5624,2161,3463,42,1
144193,2313,855,1458,43,1
144193,279,150,129,44,1
144193,2034,705,1329,45,1
144193,3311,1306,2005,51,1
144193,152,68,84,59,1
144193,1882,637,1245,60,1
144209,9036,3802,5234,1,4
144209,9036,3802,5234,2,1
144209,8752,3692,5060,3,1
144209,1574,701,873,4,1
144209,7178,2991,4187,5,1
144209,284,110,174,11,1
144209,1225,535,690,19,1
144209,5953,2456,3497,20,1
144209,6059,2608,3451,21,4
144209,6059,2608,3451,22,1
144209,5987,2583,3404,23,1
144209,1307,580,727,24,1
144209,4680,2003,2677,25,1
144209,72,25,47,31,1
144209,776,354,422,39,1
144209,3904,1649,2255,40,1
144209,2977,1194,1783,41,4
144209,2977,1194,1783,42,1
144209,2765,1109,1656,43,1
144209,267,121,146,44,1
144209,2498,988,1510,45,1
144209,212,85,127,51,1
144209,449,181,268,59,1
144209,2049,807,1242,60,1
144218,12640,5179,7461,1,4
144218,12640,5179,7461,2,1
144218,9444,3971,5473,3,1
144218,1484,712,772,4,1
144218,7960,3259,4701,5,1
144218,3196,1208,1988,11,1
144218,733,316,417,19,1
144218,7227,2943,4284,20,1
144218,4387,1997,2390,21,4
144218,4387,1997,2390,22,1
144218,4244,1941,2303,23,1
144218,933,453,480,24,1
144218,3311,1488,1823,25,1
144218,143,56,87,31,1
144218,393,178,215,39,1
144218,2918,1310,1608,40,1
144218,8253,3182,5071,41,4
144218,8253,3182,5071,42,1
144218,5200,2030,3170,43,1
144218,551,259,292,44,1
144218,4649,1771,2878,45,1
144218,3053,1152,1901,51,1
144218,340,138,202,59,1
144218,4309,1633,2676,60,1
144281,10142,4492,5650,1,4
144281,9671,4330,5341,2,1
144281,9577,4292,5285,3,1
144281,2161,906,1255,4,1
144281,7416,3386,4030,5,1
144281,94,38,56,11,1
144281,471,162,309,12,3
144281,682,310,372,19,1
144281,6734,3076,3658,20,1
144281,9066,4019,5047,21,4
144281,8720,3898,4822,22,1
144281,8689,3890,4799,23,1
144281,2125,888,1237,24,1
144281,6564,3002,3562,25,1
144281,31,8,23,31,1
144281,346,121,225,32,3
144281,622,282,340,39,1
144281,5942,2720,3222,40,1
144281,1076,473,603,41,4
144281,951,432,519,42,1
144281,888,402,486,43,1
144281,36,18,18,44,1
144281,852,384,468,45,1
144281,63,30,33,51,1
144281,125,41,84,52,3
144281,60,28,32,59,1
144281,792,356,436,60,1
144351,5286,1644,3642,1,4
144351,1604,634,970,2,1
144351,1563,618,945,3,1
144351,376,182,194,4,1
144351,1187,436,751,5,1
144351,41,16,25,11,1
144351,3682,1010,2672,12,3
144351,207,78,129,19,1
144351,980,358,622,20,1
144351,1684,647,1037,21,4
144351,1489,580,909,22,1
144351,1487,579,908,23,1
144351,376,182,194,24,1
144351,1111,397,714,25,1
144351,2,1,1,31,1
144351,195,67,128,32,3
144351,198,74,124,39,1
144351,913,323,590,40,1
144351,3602,997,2605,41,4
144351,115,54,61,42,1
144351,76,39,37,43,1
144351,76,39,37,45,1
144351,39,15,24,51,1
144351,3487,943,2544,52,3
144351,9,4,5,59,1
144351,67,35,32,60,1
144467,958,472,486,1,4
144467,958,472,486,2,1
144467,958,472,486,3,1
144467,140,60,80,4,1
144467,818,412,406,5,1
144467,81,34,47,19,1
144467,737,378,359,20,1
144467,958,472,486,21,4
144467,958,472,486,22,1
144467,958,472,486,23,1
144467,140,60,80,24,1
144467,818,412,406,25,1
144467,81,34,47,39,1
144467,737,378,359,40,1
144485,590,404,186,1,4
144485,590,404,186,2,1
144485,590,404,186,3,1
144485,199,129,70,4,1
144485,391,275,116,5,1
144485,391,275,116,20,1
144485,590,404,186,21,4
144485,590,404,186,22,1
144485,590,404,186,23,1
144485,199,129,70,24,1
144485,391,275,116,25,1
144485,391,275,116,40,1
144564,4035,1802,2233,1,4
144564,4035,1802,2233,2,1
144564,2339,1091,1248,3,1
144564,698,329,369,4,1
144564,1641,762,879,5,1
144564,1696,711,985,11,1
144564,108,46,62,19,1
144564,1533,716,817,20,1
144564,1175,557,618,21,4
144564,1175,557,618,22,1
144564,1146,542,604,23,1
144564,426,209,217,24,1
144564,720,333,387,25,1
144564,29,15,14,31,1
144564,48,28,20,39,1
144564,672,305,367,40,1
144564,2860,1245,1615,41,4
144564,2860,1245,1615,42,1
144564,1193,549,644,43,1
144564,272,120,152,44,1
144564,921,429,492,45,1
144564,1667,696,971,51,1
144564,60,18,42,59,1
144564,861,411,450,60,1
144573,58,5,53,1,4
144573,58,5,53,2,1
144573,58,5,53,3,1
144573,21,4,17,4,1
144573,37,1,36,5,1
144573,37,1,36,20,1
144573,58,5,53,21,4
144573,58,5,53,22,1
144573,58,5,53,23,1
144573,21,4,17,24,1
144573,37,1,36,25,1
144573,37,1,36,40,1
144740,24414,11397,13017,1,4
144740,16420,7616,8804,2,1
144740,16120,7454,8666,3,1
144740,2425,1014,1411,4,1
144740,13695,6440,7255,5,1
144740,300,162,138,11,1
144740,7994,3781,4213,12,3
144740,1698,862,836,19,1
144740,11997,5578,6419,20,1
144740,18706,8671,10035,21,4
144740,13594,6364,7230,22,1
144740,13556,6345,7211,23,1
144740,2422,1014,1408,24,1
144740,11134,5331,5803,25,1
144740,38,19,19,31,1
144740,5112,2307,2805,32,3
144740,1412,748,664,39,1
144740,9722,4583,5139,40,1
144740,5708,2726,2982,41,4
144740,2826,1252,1574,42,1
144740,2564,1109,1455,43,1
144740,3,0,3,44,1
144740,2561,1109,1452,45,1
144740,262,143,119,51,1
144740,2882,1474,1408,52,3
144740,286,114,172,59,1
144740,2275,995,1280,60,1
144795,147,5,142,1,4
144795,147,5,142,2,1
144795,147,5,142,3,1
144795,73,4,69,4,1
144795,74,1,73,5,1
144795,74,1,73,20,1
144795,136,5,131,21,4
144795,136,5,131,22,1
144795,136,5,131,23,1
144795,71,4,67,24,1
144795,65,1,64,25,1
144795,65,1,64,40,1
144795,11,0,11,41,4
144795,11,0,11,42,1
144795,11,0,11,43,1
144795,2,0,2,44,1
144795,9,0,9,45,1
144795,9,0,9,60,1
144865,28627,13325,15302,1,4
144865,28627,13325,15302,2,1
144865,21214,10166,11048,3,1
144865,3813,2049,1764,4,1
144865,17401,8117,9284,5,1
144865,7413,3159,4254,11,1
144865,1314,606,708,19,1
144865,16087,7511,8576,20,1
144865,9908,5204,4704,21,4
144865,9908,5204,4704,22,1
144865,8985,4660,4325,23,1
144865,2521,1388,1133,24,1
144865,6464,3272,3192,25,1
144865,923,544,379,31,1
144865,580,314,266,39,1
144865,5884,2958,2926,40,1
144865,18719,8121,10598,41,4
144865,18719,8121,10598,42,1
144865,12229,5506,6723,43,1
144865,1292,661,631,44,1
144865,10937,4845,6092,45,1
144865,6490,2615,3875,51,1
144865,734,292,442,59,1
144865,10203,4553,5650,60,1
144883,684,288,396,1,4
144883,684,288,396,2,1
144883,679,285,394,3,1
144883,185,83,102,4,1
144883,494,202,292,5,1
144883,5,3,2,11,1
144883,61,23,38,19,1
144883,433,179,254,20,1
144883,669,278,391,21,4
144883,669,278,391,22,1
144883,669,278,391,23,1
144883,178,78,100,24,1
144883,491,200,291,25,1
144883,61,23,38,39,1
144883,430,177,253,40,1
144883,15,10,5,41,4
144883,15,10,5,42,1
144883,10,7,3,43,1
144883,7,5,2,44,1
144883,3,2,1,45,1
144883,5,3,2,51,1
144883,3,2,1,60,1
144892,9775,3927,5848,1,4
144892,8347,3368,4979,2,1
144892,8255,3351,4904,3,1
144892,1333,512,821,4,1
144892,6922,2839,4083,5,1
144892,92,17,75,11,1
144892,1428,559,869,12,3
144892,884,377,507,19,1
144892,6038,2462,3576,20,1
144892,8013,3284,4729,21,4
144892,7327,3002,4325,22,1
144892,7316,2998,4318,23,1
144892,1329,508,821,24,1
144892,5987,2490,3497,25,1
144892,11,4,7,31,1
144892,686,282,404,32,3
144892,741,324,417,39,1
144892,5246,2166,3080,40,1
144892,1762,643,1119,41,4
144892,1020,366,654,42,1
144892,939,353,586,43,1
144892,4,4,0,44,1
144892,935,349,586,45,1
144892,81,13,68,51,1
144892,742,277,465,52,3
144892,143,53,90,59,1
144892,792,296,496,60,1
144944,11285,5127,6158,1,4
144944,11285,5127,6158,2,1
144944,8599,4004,4595,3,1
144944,1357,747,610,4,1
144944,7242,3257,3985,5,1
144944,2686,1123,1563,11,1
144944,468,240,228,19,1
144944,6774,3017,3757,20,1
144944,3780,1857,1923,21,4
144944,3780,1857,1923,22,1
144944,3554,1735,1819,23,1
144944,975,527,448,24,1
144944,2579,1208,1371,25,1
144944,226,122,104,31,1
144944,219,123,96,39,1
144944,2360,1085,1275,40,1
144944,7505,3270,4235,41,4
144944,7505,3270,4235,42,1
144944,5045,2269,2776,43,1
144944,382,220,162,44,1
144944,4663,2049,2614,45,1
144944,2460,1001,1459,51,1
144944,249,117,132,59,1
144944,4414,1932,2482,60,1
144962,3210,1263,1947,1,4
144962,2900,1160,1740,2,1
144962,2819,1124,1695,3,1
144962,506,230,276,4,1
144962,2313,894,1419,5,1
144962,81,36,45,11,1
144962,310,103,207,12,3
144962,299,107,192,19,1
144962,2014,787,1227,20,1
144962,2782,1093,1689,21,4
144962,2736,1083,1653,22,1
144962,2719,1074,1645,23,1
144962,506,230,276,24,1
144962,2213,844,1369,25,1
144962,17,9,8,31,1
144962,46,10,36,32,3
144962,296,107,189,39,1
144962,1917,737,1180,40,1
144962,428,170,258,41,4
144962,164,77,87,42,1
144962,100,50,50,43,1
144962,100,50,50,45,1
144962,64,27,37,51,1
144962,264,93,171,52,3
144962,3,0,3,59,1
144962,97,50,47,60,1
144971,692,286,406,1,4
144971,692,286,406,2,1
144971,667,274,393,3,1
144971,138,57,81,4,1
144971,529,217,312,5,1
144971,25,12,13,11,1
144971,74,33,41,19,1
144971,455,184,271,20,1
144971,644,263,381,21,4
144971,644,263,381,22,1
144971,640,261,379,23,1
144971,138,57,81,24,1
144971,502,204,298,25,1
144971,4,2,2,31,1
144971,74,33,41,39,1
144971,428,171,257,40,1
144971,48,23,25,41,4
144971,48,23,25,42,1
144971,27,13,14,43,1
144971,27,13,14,45,1
144971,21,10,11,51,1
144971,27,13,14,60,1
145099,53,2,51,1,4
145099,53,2,51,2,1
145099,53,2,51,3,1
145099,51,2,49,4,1
145099,2,0,2,5,1
145099,2,0,2,20,1
145099,53,2,51,21,4
145099,53,2,51,22,1
145099,53,2,51,23,1
145099,51,2,49,24,1
145099,2,0,2,25,1
145099,2,0,2,40,1
145239,387,64,323,1,4
145239,387,64,323,2,1
145239,375,63,312,3,1
145239,65,11,54,4,1
145239,310,52,258,5,1
145239,12,1,11,11,1
145239,151,28,123,19,1
145239,159,24,135,20,1
145239,387,64,323,21,4
145239,387,64,323,22,1
145239,375,63,312,23,1
145239,65,11,54,24,1
145239,310,52,258,25,1
145239,12,1,11,31,1
145239,151,28,123,39,1
145239,159,24,135,40,1
145275,399,188,211,1,4
145275,399,188,211,12,3
145275,229,122,107,21,4
145275,229,122,107,32,3
145275,170,66,104,41,4
145275,170,66,104,52,3
145309,44,16,28,1,4
145309,44,16,28,2,1
145309,44,16,28,3,1
145309,21,7,14,4,1
145309,23,9,14,5,1
145309,23,9,14,20,1
145309,44,16,28,21,4
145309,44,16,28,22,1
145309,44,16,28,23,1
145309,21,7,14,24,1
145309,23,9,14,25,1
145309,23,9,14,40,1
145336,5568,1629,3939,1,4
145336,3218,1028,2190,2,1
145336,3179,1014,2165,3,1
145336,3179,1014,2165,5,1
145336,39,14,25,11,1
145336,2350,601,1749,12,3
145336,792,268,524,19,1
145336,2387,746,1641,20,1
145336,2009,631,1378,21,4
145336,1315,444,871,22,1
145336,1313,443,870,23,1
145336,1313,443,870,25,1
145336,2,1,1,31,1
145336,694,187,507,32,3
145336,404,145,259,39,1
145336,909,298,611,40,1
145336,3559,998,2561,41,4
145336,1903,584,1319,42,1
145336,1866,571,1295,43,1
145336,1866,571,1295,45,1
145336,37,13,24,51,1
145336,1656,414,1242,52,3
145336,388,123,265,59,1
145336,1478,448,1030,60,1
145354,82,4,78,1,4
145354,82,4,78,2,1
145354,82,4,78,3,1
145354,82,4,78,5,1
145354,82,4,78,20,1
145354,25,3,22,21,4
145354,25,3,22,22,1
145354,25,3,22,23,1
145354,25,3,22,25,1
145354,25,3,22,40,1
145354,57,1,56,41,4
145354,57,1,56,42,1
145354,57,1,56,43,1
145354,57,1,56,45,1
145354,57,1,56,60,1
145372,1368,648,720,1,4
145372,1129,582,547,2,1
145372,1101,566,535,3,1
145372,277,150,127,4,1
145372,824,416,408,5,1
145372,28,16,12,11,1
145372,239,66,173,12,3
145372,102,47,55,19,1
145372,722,369,353,20,1
145372,1129,576,553,21,4
145372,1090,570,520,22,1
145372,1076,558,518,23,1
145372,277,150,127,24,1
145372,799,408,391,25,1
145372,14,12,2,31,1
145372,39,6,33,32,3
145372,97,46,51,39,1
145372,702,362,340,40,1
145372,239,72,167,41,4
145372,39,12,27,42,1
145372,25,8,17,43,1
145372,25,8,17,45,1
145372,14,4,10,51,1
145372,200,60,140,52,3
145372,5,1,4,59,1
145372,20,7,13,60,1
145406,218,4,214,1,4
145406,218,4,214,2,1
145406,218,4,214,3,1
145406,33,1,32,4,1
145406,185,3,182,5,1
145406,185,3,182,20,1
145406,76,3,73,21,4
145406,76,3,73,22,1
145406,76,3,73,23,1
145406,13,1,12,24,1
145406,63,2,61,25,1
145406,63,2,61,40,1
145406,142,1,141,41,4
145406,142,1,141,42,1
145406,142,1,141,43,1
145406,20,0,20,44,1
145406,122,1,121,45,1
145406,122,1,121,60,1
145424,81,1,80,1,4
145424,81,1,80,2,1
145424,81,1,80,3,1
145424,4,0,4,4,1
145424,77,1,76,5,1
145424,77,1,76,20,1
145424,28,0,28,21,4
145424,28,0,28,22,1
145424,28,0,28,23,1
145424,2,0,2,24,1
145424,26,0,26,25,1
145424,26,0,26,40,1
145424,53,1,52,41,4
145424,53,1,52,42,1
145424,53,1,52,43,1
145424,2,0,2,44,1
145424,51,1,50,45,1
145424,51,1,50,60,1
145433,92,6,86,1,4
145433,92,6,86,2,1
145433,92,6,86,3,1
145433,21,3,18,4,1
145433,71,3,68,5,1
145433,71,3,68,20,1
145433,40,2,38,21,4
145433,40,2,38,22,1
145433,40,2,38,23,1
145433,8,0,8,24,1
145433,32,2,30,25,1
145433,32,2,30,40,1
145433,52,4,48,41,4
145433,52,4,48,42,1
145433,52,4,48,43,1
145433,13,3,10,44,1
145433,39,1,38,45,1
145433,39,1,38,60,1
145460,600,137,463,1,4
145460,381,99,282,2,1
145460,381,99,282,3,1
145460,27,4,23,4,1
145460,354,95,259,5,1
145460,219,38,181,12,3
145460,29,9,20,19,1
145460,325,86,239,20,1
145460,213,56,157,21,4
145460,167,44,123,22,1
145460,167,44,123,23,1
145460,19,3,16,24,1
145460,148,41,107,25,1
145460,46,12,34,32,3
145460,14,4,10,39,1
145460,134,37,97,40,1
145460,387,81,306,41,4
145460,214,55,159,42,1
145460,214,55,159,43,1
145460,8,1,7,44,1
145460,206,54,152,45,1
145460,173,26,147,52,3
145460,15,5,10,59,1
145460,191,49,142,60,1
145497,522,62,460,1,4
145497,521,61,460,2,1
145497,458,59,399,3,1
145497,340,29,311,4,1
145497,118,30,88,5,1
145497,63,2,61,11,1
145497,1,1,0,12,3
145497,11,3,8,19,1
145497,107,27,80,20,1
145497,436,54,382,21,4
145497,435,53,382,22,1
145497,435,53,382,23,1
145497,340,29,311,24,1
145497,95,24,71,25,1
145497,1,1,0,32,3
145497,11,3,8,39,1
145497,84,21,63,40,1
145497,86,8,78,41,4
145497,86,8,78,42,1
145497,23,6,17,43,1
145497,23,6,17,45,1
145497,63,2,61,51,1
145497,23,6,17,60,1
145521,2031,792,1239,1,4
145521,2031,792,1239,2,1
145521,1698,644,1054,3,1
145521,423,195,228,4,1
145521,1275,449,826,5,1
145521,333,148,185,11,1
145521,73,28,45,19,1
145521,1202,421,781,20,1
145521,1050,442,608,21,4
145521,1050,442,608,22,1
145521,1010,425,585,23,1
145521,335,160,175,24,1
145521,675,265,410,25,1
145521,40,17,23,31,1
145521,40,18,22,39,1
145521,635,247,388,40,1
145521,981,350,631,41,4
145521,981,350,631,42,1
145521,688,219,469,43,1
145521,88,35,53,44,1
145521,600,184,416,45,1
145521,293,131,162,51,1
145521,33,10,23,59,1
145521,567,174,393,60,1
145558,2157,973,1184,1,4
145558,2157,973,1184,12,3
145558,1993,918,1075,21,4
145558,1993,918,1075,32,3
145558,164,55,109,41,4
145558,164,55,109,52,3
145600,28038,12860,15178,1,4
145600,16671,8274,8397,2,1
145600,16601,8240,8361,3,1
145600,3104,1544,1560,4,1
145600,13497,6696,6801,5,1
145600,70,34,36,11,1
145600,11367,4586,6781,12,3
145600,1640,815,825,19,1
145600,11857,5881,5976,20,1
145600,23239,11001,12238,21,4
145600,15402,7592,7810,22,1
145600,15357,7569,7788,23,1
145600,3079,1528,1551,24,1
145600,12278,6041,6237,25,1
145600,45,23,22,31,1
145600,7837,3409,4428,32,3
145600,1468,738,730,39,1
145600,10810,5303,5507,40,1
145600,4799,1859,2940,41,4
145600,1269,682,587,42,1
145600,1244,671,573,43,1
145600,25,16,9,44,1
145600,1219,655,564,45,1
145600,25,11,14,51,1
145600,3530,1177,2353,52,3
145600,172,77,95,59,1
145600,1047,578,469,60,1
145619,6318,2237,4081,1,4
145619,3828,1509,2319,2,1
145619,3739,1480,2259,3,1
145619,635,284,351,4,1
145619,3104,1196,1908,5,1
145619,89,29,60,11,1
145619,2490,728,1762,12,3
145619,573,224,349,19,1
145619,2531,972,1559,20,1
145619,3588,1445,2143,21,4
145619,3056,1252,1804,22,1
145619,3037,1247,1790,23,1
145619,623,280,343,24,1
145619,2414,967,1447,25,1
145619,19,5,14,31,1
145619,532,193,339,32,3
145619,439,186,253,39,1
145619,1975,781,1194,40,1
145619,2730,792,1938,41,4
145619,772,257,515,42,1
145619,702,233,469,43,1
145619,12,4,8,44,1
145619,690,229,461,45,1
145619,70,24,46,51,1
145619,1958,535,1423,52,3
145619,134,38,96,59,1
145619,556,191,365,60,1
145628,636,192,444,1,4
145628,636,192,444,12,3
145628,636,192,444,21,4
145628,636,192,444,32,3
145637,44942,24798,20144,1,4
145637,32695,18455,14240,2,1
145637,31663,17793,13870,3,1
145637,7329,4123,3206,4,1
145637,24334,13670,10664,5,1
145637,1032,662,370,11,1
145637,12247,6343,5904,12,3
145637,1343,738,605,19,1
145637,22991,12932,10059,20,1
145637,41118,22787,18331,21,4
145637,31516,17685,13831,22,1
145637,31129,17447,13682,23,1
145637,7321,4116,3205,24,1
145637,23808,13331,10477,25,1
145637,387,238,149,31,1
145637,9602,5102,4500,32,3
145637,1327,731,596,39,1
145637,22481,12600,9881,40,1
145637,3824,2011,1813,41,4
145637,1179,770,409,42,1
145637,534,346,188,43,1
145637,8,7,1,44,1
145637,526,339,187,45,1
145637,645,424,221,51,1
145637,2645,1241,1404,52,3
145637,16,7,9,59,1
145637,510,332,178,60,1
145646,2009,886,1123,1,4
145646,2009,886,1123,2,1
145646,2000,885,1115,3,1
145646,527,255,272,4,1
145646,1473,630,843,5,1
145646,9,1,8,11,1
145646,35,14,21,19,1
145646,1438,616,822,20,1
145646,2001,882,1119,21,4
145646,2001,882,1119,22,1
145646,1994,881,1113,23,1
145646,527,255,272,24,1
145646,1467,626,841,25,1
145646,7,1,6,31,1
145646,35,14,21,39,1
145646,1432,612,820,40,1
145646,8,4,4,41,4
145646,8,4,4,42,1
145646,6,4,2,43,1
145646,6,4,2,45,1
145646,2,0,2,51,1
145646,6,4,2,60,1
145682,10770,4809,5961,1,4
145682,10770,4809,5961,2,1
145682,7882,3529,4353,3,1
145682,1588,843,745,4,1
145682,6294,2686,3608,5,1
145682,2888,1280,1608,11,1
145682,169,66,103,19,1
145682,6125,2620,3505,20,1
145682,3967,2037,1930,21,4
145682,3967,2037,1930,22,1
145682,3496,1807,1689,23,1
145682,1125,616,509,24,1
145682,2371,1191,1180,25,1
145682,471,230,241,31,1
145682,94,47,47,39,1
145682,2277,1144,1133,40,1
145682,6803,2772,4031,41,4
145682,6803,2772,4031,42,1
145682,4386,1722,2664,43,1
145682,463,227,236,44,1
145682,3923,1495,2428,45,1
145682,2417,1050,1367,51,1
145682,75,19,56,59,1
145682,3848,1476,2372,60,1
145691,1028,504,524,1,4
145691,1010,504,506,2,1
145691,981,490,491,3,1
145691,270,140,130,4,1
145691,711,350,361,5,1
145691,29,14,15,11,1
145691,18,0,18,12,3
145691,32,13,19,19,1
145691,679,337,342,20,1
145691,981,488,493,21,4
145691,981,488,493,22,1
145691,974,484,490,23,1
145691,270,140,130,24,1
145691,704,344,360,25,1
145691,7,4,3,31,1
145691,32,13,19,39,1
145691,672,331,341,40,1
145691,47,16,31,41,4
145691,29,16,13,42,1
145691,7,6,1,43,1
145691,7,6,1,45,1
145691,22,10,12,51,1
145691,18,0,18,52,3
145691,7,6,1,60,1
145707,1470,520,950,1,4
145707,1470,520,950,2,1
145707,899,321,578,3,1
145707,238,113,125,4,1
145707,661,208,453,5,1
145707,571,199,372,11,1
145707,8,2,6,19,1
145707,653,206,447,20,1
145707,680,285,395,21,4
145707,680,285,395,22,1
145707,653,271,382,23,1
145707,220,109,111,24,1
145707,433,162,271,25,1
145707,27,14,13,31,1
145707,7,2,5,39,1
145707,426,160,266,40,1
145707,790,235,555,41,4
145707,790,235,555,42,1
145707,246,50,196,43,1
145707,18,4,14,44,1
145707,228,46,182,45,1
145707,544,185,359,51,1
145707,1,0,1,59,1
145707,227,46,181,60,1
145725,7850,5023,2827,1,4
145725,2926,2059,867,2,1
145725,2855,2014,841,3,1
145725,464,355,109,4,1
145725,2391,1659,732,5,1
145725,71,45,26,11,1
145725,4924,2964,1960,12,3
145725,309,244,65,19,1
145725,2082,1415,667,20,1
145725,6539,4161,2378,21,4
145725,2712,1894,818,22,1
145725,2709,1892,817,23,1
145725,464,355,109,24,1
145725,2245,1537,708,25,1
145725,3,2,1,31,1
145725,3827,2267,1560,32,3
145725,276,213,63,39,1
145725,1969,1324,645,40,1
145725,1311,862,449,41,4
145725,214,165,49,42,1
145725,146,122,24,43,1
145725,146,122,24,45,1
145725,68,43,25,51,1
145725,1097,697,400,52,3
145725,33,31,2,59,1
145725,113,91,22,60,1
145770,1017,289,728,1,4
145770,296,89,207,2,1
145770,293,89,204,3,1
145770,69,22,47,4,1
145770,224,67,157,5,1
145770,3,0,3,11,1
145770,721,200,521,12,3
145770,15,4,11,19,1
145770,209,63,146,20,1
145770,220,64,156,21,4
145770,73,21,52,22,1
145770,73,21,52,23,1
145770,8,3,5,24,1
145770,65,18,47,25,1
145770,147,43,104,32,3
145770,5,2,3,39,1
145770,60,16,44,40,1
145770,797,225,572,41,4
145770,223,68,155,42,1
145770,220,68,152,43,1
145770,61,19,42,44,1
145770,159,49,110,45,1
145770,3,0,3,51,1
145770,574,157,417,52,3
145770,10,2,8,59,1
145770,149,47,102,60,1
145813,20272,8878,11394,1,4
145813,17749,7986,9763,2,1
145813,17667,7952,9715,3,1
145813,2981,1215,1766,4,1
145813,14686,6737,7949,5,1
145813,82,34,48,11,1
145813,2523,892,1631,12,3
145813,1856,972,884,19,1
145813,12830,5765,7065,20,1
145813,17864,7918,9946,21,4
145813,16683,7447,9236,22,1
145813,16632,7428,9204,23,1
145813,2978,1213,1765,24,1
145813,13654,6215,7439,25,1
145813,51,19,32,31,1
145813,1181,471,710,32,3
145813,1718,914,804,39,1
145813,11936,5301,6635,40,1
145813,2408,960,1448,41,4
145813,1066,539,527,42,1
145813,1035,524,511,43,1
145813,3,2,1,44,1
145813,1032,522,510,45,1
145813,31,15,16,51,1
145813,1342,421,921,52,3
145813,138,58,80,59,1
145813,894,464,430,60,1
145831,3705,1500,2205,1,4
145831,3705,1500,2205,2,1
145831,2981,1205,1776,3,1
145831,320,172,148,4,1
145831,2661,1033,1628,5,1
145831,724,295,429,11,1
145831,73,30,43,19,1
145831,2588,1003,1585,20,1
145831,1499,687,812,21,4
145831,1499,687,812,22,1
145831,1438,658,780,23,1
145831,194,113,81,24,1
145831,1244,545,699,25,1
145831,61,29,32,31,1
145831,37,19,18,39,1
145831,1207,526,681,40,1
145831,2206,813,1393,41,4
145831,2206,813,1393,42,1
145831,1543,547,996,43,1
145831,126,59,67,44,1
145831,1417,488,929,45,1
145831,663,266,397,51,1
145831,36,11,25,59,1
145831,1381,477,904,60,1
145886,129,27,102,1,4
145886,129,27,102,12,3
145886,116,27,89,21,4
145886,116,27,89,32,3
145886,13,0,13,41,4
145886,13,0,13,52,3
146010,346,150,196,1,4
146010,346,150,196,2,1
146010,345,149,196,3,1
146010,29,14,15,4,1
146010,316,135,181,5,1
146010,1,1,0,11,1
146010,30,11,19,19,1
146010,286,124,162,20,1
146010,250,109,141,21,4
146010,250,109,141,22,1
146010,250,109,141,23,1
146010,12,6,6,24,1
146010,238,103,135,25,1
146010,11,5,6,39,1
146010,227,98,129,40,1
146010,96,41,55,41,4
146010,96,41,55,42,1
146010,95,40,55,43,1
146010,17,8,9,44,1
146010,78,32,46,45,1
146010,1,1,0,51,1
146010,19,6,13,59,1
146010,59,26,33,60,1
146205,7150,2923,4227,1,4
146205,7150,2923,4227,2,1
146205,3857,1740,2117,3,1
146205,736,347,389,4,1
146205,3121,1393,1728,5,1
146205,3293,1183,2110,11,1
146205,1169,491,678,19,1
146205,1952,902,1050,20,1
146205,2091,1007,1084,21,4
146205,2091,1007,1084,22,1
146205,2061,993,1068,23,1
146205,581,264,317,24,1
146205,1480,729,751,25,1
146205,30,14,16,31,1
146205,571,268,303,39,1
146205,909,461,448,40,1
146205,5059,1916,3143,41,4
146205,5059,1916,3143,42,1
146205,1796,747,1049,43,1
146205,155,83,72,44,1
146205,1641,664,977,45,1
146205,3263,1169,2094,51,1
146205,598,223,375,59,1
146205,1043,441,602,60,1
146241,1466,743,723,1,4
146241,1466,743,723,12,3
146241,1046,533,513,21,4
146241,1046,533,513,32,3
146241,420,210,210,41,4
146241,420,210,210,52,3
146278,1923,779,1144,1,4
146278,1923,779,1144,2,1
146278,1638,654,984,3,1
146278,538,249,289,4,1
146278,1100,405,695,5,1
146278,285,125,160,11,1
146278,175,76,99,19,1
146278,925,329,596,20,1
146278,956,458,498,21,4
146278,956,458,498,22,1
146278,949,454,495,23,1
146278,419,208,211,24,1
146278,530,246,284,25,1
146278,7,4,3,31,1
146278,98,56,42,39,1
146278,432,190,242,40,1
146278,967,321,646,41,4
146278,967,321,646,42,1
146278,689,200,489,43,1
146278,119,41,78,44,1
146278,570,159,411,45,1
146278,278,121,157,51,1
146278,77,20,57,59,1
146278,493,139,354,60,1
146296,16869,7791,9078,1,4
146296,16869,7791,9078,2,1
146296,13014,6057,6957,3,1
146296,1699,880,819,4,1
146296,11315,5177,6138,5,1
146296,3855,1734,2121,11,1
146296,411,142,269,19,1
146296,10904,5035,5869,20,1
146296,5849,2880,2969,21,4
146296,5849,2880,2969,22,1
146296,5743,2842,2901,23,1
146296,987,536,451,24,1
146296,4756,2306,2450,25,1
146296,106,38,68,31,1
146296,201,77,124,39,1
146296,4555,2229,2326,40,1
146296,11020,4911,6109,41,4
146296,11020,4911,6109,42,1
146296,7271,3215,4056,43,1
146296,712,344,368,44,1
146296,6559,2871,3688,45,1
146296,3749,1696,2053,51,1
146296,210,65,145,59,1
146296,6349,2806,3543,60,1
146339,1170,511,659,1,4
146339,1066,471,595,2,1
146339,1020,454,566,3,1
146339,201,93,108,4,1
146339,819,361,458,5,1
146339,46,17,29,11,1
146339,104,40,64,12,3
146339,173,66,107,19,1
146339,646,295,351,20,1
146339,856,405,451,21,4
146339,783,379,404,22,1
146339,776,374,402,23,1
146339,189,89,100,24,1
146339,587,285,302,25,1
146339,7,5,2,31,1
146339,73,26,47,32,3
146339,83,38,45,39,1
146339,504,247,257,40,1
146339,314,106,208,41,4
146339,283,92,191,42,1
146339,244,80,164,43,1
146339,12,4,8,44,1
146339,232,76,156,45,1
146339,39,12,27,51,1
146339,31,14,17,52,3
146339,90,28,62,59,1
146339,142,48,94,60,1
146348,3825,1459,2366,1,4
146348,3825,1459,2366,2,1
146348,3115,1180,1935,3,1
146348,383,178,205,4,1
146348,2732,1002,1730,5,1
146348,710,279,431,11,1
146348,128,56,72,19,1
146348,2604,946,1658,20,1
146348,1599,709,890,21,4
146348,1599,709,890,22,1
146348,1503,648,855,23,1
146348,282,137,145,24,1
146348,1221,511,710,25,1
146348,96,61,35,31,1
146348,72,32,40,39,1
146348,1149,479,670,40,1
146348,2226,750,1476,41,4
146348,2226,750,1476,42,1
146348,1612,532,1080,43,1
146348,101,41,60,44,1
146348,1511,491,1020,45,1
146348,614,218,396,51,1
146348,56,24,32,59,1
146348,1455,467,988,60,1
146366,5258,2131,3127,1,4
146366,5258,2131,3127,2,1
146366,3091,1150,1941,3,1
146366,353,186,167,4,1
146366,2738,964,1774,5,1
146366,2167,981,1186,11,1
146366,113,38,75,19,1
146366,2625,926,1699,20,1
146366,1952,823,1129,21,4
146366,1952,823,1129,22,1
146366,1841,764,1077,23,1
146366,229,145,84,24,1
146366,1612,619,993,25,1
146366,111,59,52,31,1
146366,81,30,51,39,1
146366,1531,589,942,40,1
146366,3306,1308,1998,41,4
146366,3306,1308,1998,42,1
146366,1250,386,864,43,1
146366,124,41,83,44,1
146366,1126,345,781,45,1
146366,2056,922,1134,51,1
146366,32,8,24,59,1
146366,1094,337,757,60,1
146393,1659,389,1270,1,4
146393,1659,389,1270,2,1
146393,1579,385,1194,3,1
146393,98,36,62,4,1
146393,1481,349,1132,5,1
146393,80,4,76,11,1
146393,229,62,167,19,1
146393,1252,287,965,20,1
146393,938,310,628,21,4
146393,938,310,628,22,1
146393,926,309,617,23,1
146393,86,30,56,24,1
146393,840,279,561,25,1
146393,12,1,11,31,1
146393,172,55,117,39,1
146393,668,224,444,40,1
146393,721,79,642,41,4
146393,721,79,642,42,1
146393,653,76,577,43,1
146393,12,6,6,44,1
146393,641,70,571,45,1
146393,68,3,65,51,1
146393,57,7,50,59,1
146393,584,63,521,60,1
146418,4717,2168,2549,1,4
146418,4717,2168,2549,2,1
146418,3627,1650,1977,3,1
146418,603,316,287,4,1
146418,3024,1334,1690,5,1
146418,1090,518,572,11,1
146418,335,173,162,19,1
146418,2689,1161,1528,20,1
146418,2348,1124,1224,21,4
146418,2348,1124,1224,22,1
146418,2312,1098,1214,23,1
146418,472,249,223,24,1
146418,1840,849,991,25,1
146418,36,26,10,31,1
146418,255,133,122,39,1
146418,1585,716,869,40,1
146418,2369,1044,1325,41,4
146418,2369,1044,1325,42,1
146418,1315,552,763,43,1
146418,131,67,64,44,1
146418,1184,485,699,45,1
146418,1054,492,562,51,1
146418,80,40,40,59,1
146418,1104,445,659,60,1
146427,1424,614,810,1,4
146427,1424,614,810,2,1
146427,1402,603,799,3,1
146427,380,149,231,4,1
146427,1022,454,568,5,1
146427,22,11,11,11,1
146427,22,13,9,19,1
146427,1000,441,559,20,1
146427,1400,600,800,21,4
146427,1400,600,800,22,1
146427,1396,599,797,23,1
146427,380,149,231,24,1
146427,1016,450,566,25,1
146427,4,1,3,31,1
146427,22,13,9,39,1
146427,994,437,557,40,1
146427,24,14,10,41,4
146427,24,14,10,42,1
146427,6,4,2,43,1
146427,6,4,2,45,1
146427,18,10,8,51,1
146427,6,4,2,60,1
146454,33,0,33,1,4
146454,33,0,33,2,1
146454,33,0,33,3,1
146454,11,0,11,4,1
146454,22,0,22,5,1
146454,22,0,22,20,1
146454,33,0,33,21,4
146454,33,0,33,22,1
146454,33,0,33,23,1
146454,11,0,11,24,1
146454,22,0,22,25,1
146454,22,0,22,40,1
146472,17685,7934,9751,1,4
146472,17685,7934,9751,2,1
146472,11978,5657,6321,3,1
146472,2049,1103,946,4,1
146472,9929,4554,5375,5,1
146472,5707,2277,3430,11,1
146472,606,271,335,19,1
146472,9323,4283,5040,20,1
146472,4764,2421,2343,21,4
146472,4764,2421,2343,22,1
146472,4060,2105,1955,23,1
146472,1177,618,559,24,1
146472,2883,1487,1396,25,1
146472,704,316,388,31,1
146472,290,146,144,39,1
146472,2593,1341,1252,40,1
146472,12921,5513,7408,41,4
146472,12921,5513,7408,42,1
146472,7918,3552,4366,43,1
146472,872,485,387,44,1
146472,7046,3067,3979,45,1
146472,5003,1961,3042,51,1
146472,316,125,191,59,1
146472,6730,2942,3788,60,1
146481,1618,681,937,1,4
146481,1590,671,919,2,1
146481,1577,665,912,3,1
146481,399,182,217,4,1
146481,1178,483,695,5,1
146481,13,6,7,11,1
146481,28,10,18,12,3
146481,87,35,52,19,1
146481,1091,448,643,20,1
146481,1582,666,916,21,4
146481,1571,661,910,22,1
146481,1567,658,909,23,1
146481,399,182,217,24,1
146481,1168,476,692,25,1
146481,4,3,1,31,1
146481,11,5,6,32,3
146481,87,35,52,39,1
146481,1081,441,640,40,1
146481,36,15,21,41,4
146481,19,10,9,42,1
146481,10,7,3,43,1
146481,10,7,3,45,1
146481,9,3,6,51,1
146481,17,5,12,52,3
146481,10,7,3,60,1
146490,530,311,219,1,4
146490,530,311,219,12,3
146490,530,311,219,41,4
146490,530,311,219,52,3
146506,6351,3021,3330,1,4
146506,6351,3021,3330,2,1
146506,4118,1719,2399,3,1
146506,1101,525,576,4,1
146506,3017,1194,1823,5,1
146506,2233,1302,931,11,1
146506,176,72,104,19,1
146506,2841,1122,1719,20,1
146506,2809,1274,1535,21,4
146506,2809,1274,1535,22,1
146506,2734,1239,1495,23,1
146506,909,447,462,24,1
146506,1825,792,1033,25,1
146506,75,35,40,31,1
146506,120,58,62,39,1
146506,1705,734,971,40,1
146506,3542,1747,1795,41,4
146506,3542,1747,1795,42,1
146506,1384,480,904,43,1
146506,192,78,114,44,1
146506,1192,402,790,45,1
146506,2158,1267,891,51,1
146506,56,14,42,59,1
146506,1136,388,748,60,1
146533,316,45,271,1,4
146533,316,45,271,2,1
146533,284,38,246,3,1
146533,284,38,246,5,1
146533,32,7,25,11,1
146533,85,12,73,19,1
146533,199,26,173,20,1
146533,254,34,220,21,4
146533,254,34,220,22,1
146533,254,34,220,23,1
146533,254,34,220,25,1
146533,85,12,73,39,1
146533,169,22,147,40,1
146533,62,11,51,41,4
146533,62,11,51,42,1
146533,30,4,26,43,1
146533,30,4,26,45,1
146533,32,7,25,51,1
146533,30,4,26,60,1
146603,8520,3788,4732,1,4
146603,8520,3788,4732,2,1
146603,4678,1918,2760,3,1
146603,735,385,350,4,1
146603,3943,1533,2410,5,1
146603,3842,1870,1972,11,1
146603,128,55,73,19,1
146603,3815,1478,2337,20,1
146603,2421,1119,1302,21,4
146603,2421,1119,1302,22,1
146603,2177,1009,1168,23,1
146603,567,296,271,24,1
146603,1610,713,897,25,1
146603,244,110,134,31,1
146603,72,38,34,39,1
146603,1538,675,863,40,1
146603,6099,2669,3430,41,4
146603,6099,2669,3430,42,1
146603,2501,909,1592,43,1
146603,168,89,79,44,1
146603,2333,820,1513,45,1
146603,3598,1760,1838,51,1
146603,56,17,39,59,1
146603,2277,803,1474,60,1
146612,6525,2647,3878,1,4
146612,4613,2032,2581,2,1
146612,4489,1939,2550,3,1
146612,694,313,381,4,1
146612,3795,1626,2169,5,1
146612,124,93,31,11,1
146612,1912,615,1297,12,3
146612,633,269,364,19,1
146612,3162,1357,1805,20,1
146612,4123,1811,2312,21,4
146612,3723,1672,2051,22,1
146612,3715,1666,2049,23,1
146612,694,313,381,24,1
146612,3021,1353,1668,25,1
146612,8,6,2,31,1
146612,400,139,261,32,3
146612,456,208,248,39,1
146612,2565,1145,1420,40,1
146612,2402,836,1566,41,4
146612,890,360,530,42,1
146612,774,273,501,43,1
146612,774,273,501,45,1
146612,116,87,29,51,1
146612,1512,476,1036,52,3
146612,177,61,116,59,1
146612,597,212,385,60,1
146621,55,0,55,1,4
146621,55,0,55,2,1
146621,55,0,55,3,1
146621,15,0,15,4,1
146621,40,0,40,5,1
146621,6,0,6,19,1
146621,34,0,34,20,1
146621,45,0,45,21,4
146621,45,0,45,22,1
146621,45,0,45,23,1
146621,7,0,7,24,1
146621,38,0,38,25,1
146621,6,0,6,39,1
146621,32,0,32,40,1
146621,10,0,10,41,4
146621,10,0,10,42,1
146621,10,0,10,43,1
146621,8,0,8,44,1
146621,2,0,2,45,1
146621,2,0,2,60,1
146667,997,557,440,1,4
146667,623,295,328,2,1
146667,613,291,322,3,1
146667,79,42,37,4,1
146667,534,249,285,5,1
146667,10,4,6,11,1
146667,374,262,112,12,3
146667,67,35,32,19,1
146667,467,214,253,20,1
146667,734,403,331,21,4
146667,511,252,259,22,1
146667,503,249,254,23,1
146667,79,42,37,24,1
146667,424,207,217,25,1
146667,8,3,5,31,1
146667,223,151,72,32,3
146667,57,30,27,39,1
146667,367,177,190,40,1
146667,263,154,109,41,4
146667,112,43,69,42,1
146667,110,42,68,43,1
146667,110,42,68,45,1
146667,2,1,1,51,1
146667,151,111,40,52,3
146667,10,5,5,59,1
146667,100,37,63,60,1
146676,1240,538,702,1,4
146676,1240,538,702,2,1
146676,1163,511,652,3,1
146676,396,197,199,4,1
146676,767,314,453,5,1
146676,77,27,50,11,1
146676,99,51,48,19,1
146676,668,263,405,20,1
146676,798,423,375,21,4
146676,798,423,375,22,1
146676,797,423,374,23,1
146676,375,195,180,24,1
146676,422,228,194,25,1
146676,1,0,1,31,1
146676,64,44,20,39,1
146676,358,184,174,40,1
146676,442,115,327,41,4
146676,442,115,327,42,1
146676,366,88,278,43,1
146676,21,2,19,44,1
146676,345,86,259,45,1
146676,76,27,49,51,1
146676,35,7,28,59,1
146676,310,79,231,60,1
146685,7020,2955,4065,1,4
146685,7020,2955,4065,2,1
146685,5751,2413,3338,3,1
146685,1418,684,734,4,1
146685,4333,1729,2604,5,1
146685,1269,542,727,11,1
146685,233,106,127,19,1
146685,4100,1623,2477,20,1
146685,2985,1422,1563,21,4
146685,2985,1422,1563,22,1
146685,2751,1298,1453,23,1
146685,1024,505,519,24,1
146685,1727,793,934,25,1
146685,234,124,110,31,1
146685,140,69,71,39,1
146685,1587,724,863,40,1
146685,4035,1533,2502,41,4
146685,4035,1533,2502,42,1
146685,3000,1115,1885,43,1
146685,394,179,215,44,1
146685,2606,936,1670,45,1
146685,1035,418,617,51,1
146685,93,37,56,59,1
146685,2513,899,1614,60,1
146700,617,473,144,1,4
146700,617,473,144,2,1
146700,617,473,144,3,1
146700,184,132,52,4,1
146700,433,341,92,5,1
146700,59,56,3,19,1
146700,374,285,89,20,1
146700,617,473,144,21,4
146700,617,473,144,22,1
146700,617,473,144,23,1
146700,184,132,52,24,1
146700,433,341,92,25,1
146700,59,56,3,39,1
146700,374,285,89,40,1
146719,15957,5771,10186,1,4
146719,10168,3688,6480,2,1
146719,9931,3595,6336,3,1
146719,2512,861,1651,4,1
146719,7419,2734,4685,5,1
146719,237,93,144,11,1
146719,5789,2083,3706,12,3
146719,597,226,371,19,1
146719,6822,2508,4314,20,1
146719,13463,4995,8468,21,4
146719,9339,3345,5994,22,1
146719,9181,3293,5888,23,1
146719,2497,847,1650,24,1
146719,6684,2446,4238,25,1
146719,158,52,106,31,1
146719,4124,1650,2474,32,3
146719,491,191,300,39,1
146719,6193,2255,3938,40,1
146719,2494,776,1718,41,4
146719,829,343,486,42,1
146719,750,302,448,43,1
146719,15,14,1,44,1
146719,735,288,447,45,1
146719,79,41,38,51,1
146719,1665,433,1232,52,3
146719,106,35,71,59,1
146719,629,253,376,60,1
146728,261,137,124,1,4
146728,261,137,124,12,3
146728,165,85,80,21,4
146728,165,85,80,32,3
146728,96,52,44,41,4
146728,96,52,44,52,3
146755,234,25,209,1,4
146755,234,25,209,2,1
146755,191,16,175,3,1
146755,191,16,175,5,1
146755,43,9,34,11,1
146755,95,9,86,19,1
146755,96,7,89,20,1
146755,114,10,104,21,4
146755,114,10,104,22,1
146755,114,10,104,23,1
146755,114,10,104,25,1
146755,50,6,44,39,1
146755,64,4,60,40,1
146755,120,15,105,41,4
146755,120,15,105,42,1
146755,77,6,71,43,1
146755,77,6,71,45,1
146755,43,9,34,51,1
146755,45,3,42,59,1
146755,32,3,29,60,1
146791,209,104,105,1,4
146791,209,104,105,2,1
146791,209,104,105,3,1
146791,98,48,50,4,1
146791,111,56,55,5,1
146791,111,56,55,20,1
146791,209,104,105,21,4
146791,209,104,105,22,1
146791,209,104,105,23,1
146791,98,48,50,24,1
146791,111,56,55,25,1
146791,111,56,55,40,1
146807,62,6,56,1,4
146807,62,6,56,2,1
146807,62,6,56,3,1
146807,5,1,4,4,1
146807,57,5,52,5,1
146807,57,5,52,20,1
146807,39,2,37,21,4
146807,39,2,37,22,1
146807,39,2,37,23,1
146807,4,0,4,24,1
146807,35,2,33,25,1
146807,35,2,33,40,1
146807,23,4,19,41,4
146807,23,4,19,42,1
146807,23,4,19,43,1
146807,1,1,0,44,1
146807,22,3,19,45,1
146807,22,3,19,60,1
146816,215,41,174,1,4
146816,215,41,174,2,1
146816,209,39,170,3,1
146816,29,9,20,4,1
146816,180,30,150,5,1
146816,6,2,4,11,1
146816,41,9,32,19,1
146816,139,21,118,20,1
146816,104,26,78,21,4
146816,104,26,78,22,1
146816,104,26,78,23,1
146816,22,8,14,24,1
146816,82,18,64,25,1
146816,24,8,16,39,1
146816,58,10,48,40,1
146816,111,15,96,41,4
146816,111,15,96,42,1
146816,105,13,92,43,1
146816,7,1,6,44,1
146816,98,12,86,45,1
146816,6,2,4,51,1
146816,17,1,16,59,1
146816,81,11,70,60,1
146825,571,251,320,1,4
146825,571,251,320,2,1
146825,542,236,306,3,1
146825,120,56,64,4,1
146825,422,180,242,5,1
146825,29,15,14,11,1
146825,54,24,30,19,1
146825,368,156,212,20,1
146825,517,233,284,21,4
146825,517,233,284,22,1
146825,516,232,284,23,1
146825,120,56,64,24,1
146825,396,176,220,25,1
146825,1,1,0,31,1
146825,49,24,25,39,1
146825,347,152,195,40,1
146825,54,18,36,41,4
146825,54,18,36,42,1
146825,26,4,22,43,1
146825,26,4,22,45,1
146825,28,14,14,51,1
146825,5,0,5,59,1
146825,21,4,17,60,1
146977,207,106,101,1,4
146977,207,106,101,12,3
146977,51,29,22,21,4
146977,51,29,22,32,3
146977,156,77,79,41,4
146977,156,77,79,52,3
147004,7023,3183,3840,1,4
147004,7023,3183,3840,2,1
147004,4892,2291,2601,3,1
147004,1212,648,564,4,1
147004,3680,1643,2037,5,1
147004,2131,892,1239,11,1
147004,348,136,212,19,1
147004,3332,1507,1825,20,1
147004,2642,1333,1309,21,4
147004,2642,1333,1309,22,1
147004,2239,1139,1100,23,1
147004,748,422,326,24,1
147004,1491,717,774,25,1
147004,403,194,209,31,1
147004,124,53,71,39,1
147004,1367,664,703,40,1
147004,4381,1850,2531,41,4
147004,4381,1850,2531,42,1
147004,2653,1152,1501,43,1
147004,464,226,238,44,1
147004,2189,926,1263,45,1
147004,1728,698,1030,51,1
147004,224,83,141,59,1
147004,1965,843,1122,60,1
147013,3027,1230,1797,1,4
147013,2358,1038,1320,2,1
147013,2312,1016,1296,3,1
147013,387,194,193,4,1
147013,1925,822,1103,5,1
147013,46,22,24,11,1
147013,669,192,477,12,3
147013,340,126,214,19,1
147013,1585,696,889,20,1
147013,1935,894,1041,21,4
147013,1776,841,935,22,1
147013,1773,839,934,23,1
147013,387,194,193,24,1
147013,1386,645,741,25,1
147013,3,2,1,31,1
147013,159,53,106,32,3
147013,224,97,127,39,1
147013,1162,548,614,40,1
147013,1092,336,756,41,4
147013,582,197,385,42,1
147013,539,177,362,43,1
147013,539,177,362,45,1
147013,43,20,23,51,1
147013,510,139,371,52,3
147013,116,29,87,59,1
147013,423,148,275,60,1
147031,84,31,53,1,4
147031,84,31,53,12,3
147031,44,15,29,21,4
147031,44,15,29,32,3
147031,40,16,24,41,4
147031,40,16,24,52,3
147129,508,64,444,1,4
147129,508,64,444,2,1
147129,508,64,444,3,1
147129,14,1,13,4,1
147129,494,63,431,5,1
147129,105,19,86,19,1
147129,389,44,345,20,1
147129,350,46,304,21,4
147129,350,46,304,22,1
147129,350,46,304,23,1
147129,14,1,13,24,1
147129,336,45,291,25,1
147129,69,15,54,39,1
147129,267,30,237,40,1
147129,158,18,140,41,4
147129,158,18,140,42,1
147129,158,18,140,43,1
147129,158,18,140,45,1
147129,36,4,32,59,1
147129,122,14,108,60,1
147165,543,111,432,1,4
147165,543,111,432,2,1
147165,532,105,427,3,1
147165,15,7,8,4,1
147165,517,98,419,5,1
147165,11,6,5,11,1
147165,124,19,105,19,1
147165,393,79,314,20,1
147165,183,47,136,21,4
147165,183,47,136,22,1
147165,182,46,136,23,1
147165,6,4,2,24,1
147165,176,42,134,25,1
147165,1,1,0,31,1
147165,43,9,34,39,1
147165,133,33,100,40,1
147165,360,64,296,41,4
147165,360,64,296,42,1
147165,350,59,291,43,1
147165,9,3,6,44,1
147165,341,56,285,45,1
147165,10,5,5,51,1
147165,81,10,71,59,1
147165,260,46,214,60,1
147244,2261,933,1328,1,4
147244,2153,880,1273,2,1
147244,2122,870,1252,3,1
147244,451,206,245,4,1
147244,1671,664,1007,5,1
147244,31,10,21,11,1
147244,108,53,55,12,3
147244,128,40,88,19,1
147244,1543,624,919,20,1
147244,2126,890,1236,21,4
147244,2044,845,1199,22,1
147244,2028,841,1187,23,1
147244,450,206,244,24,1
147244,1578,635,943,25,1
147244,16,4,12,31,1
147244,82,45,37,32,3
147244,118,37,81,39,1
147244,1460,598,862,40,1
147244,135,43,92,41,4
147244,109,35,74,42,1
147244,94,29,65,43,1
147244,1,0,1,44,1
147244,93,29,64,45,1
147244,15,6,9,51,1
147244,26,8,18,52,3
147244,10,3,7,59,1
147244,83,26,57,60,1
147341,1255,568,687,1,4
147341,1255,568,687,2,1
147341,1247,563,684,3,1
147341,390,179,211,4,1
147341,857,384,473,5,1
147341,8,5,3,11,1
147341,42,18,24,19,1
147341,815,366,449,20,1
147341,1244,564,680,21,4
147341,1244,564,680,22,1
147341,1239,560,679,23,1
147341,390,179,211,24,1
147341,849,381,468,25,1
147341,5,4,1,31,1
147341,41,17,24,39,1
147341,808,364,444,40,1
147341,11,4,7,41,4
147341,11,4,7,42,1
147341,8,3,5,43,1
147341,8,3,5,45,1
147341,3,1,2,51,1
147341,1,1,0,59,1
147341,7,2,5,60,1
147369,3709,2095,1614,1,4
147369,3103,1726,1377,2,1
147369,3019,1682,1337,3,1
147369,468,261,207,4,1
147369,2551,1421,1130,5,1
147369,84,44,40,11,1
147369,606,369,237,12,3
147369,434,241,193,19,1
147369,2117,1180,937,20,1
147369,2601,1413,1188,21,4
147369,2413,1303,1110,22,1
147369,2406,1297,1109,23,1
147369,414,228,186,24,1
147369,1992,1069,923,25,1
147369,7,6,1,31,1
147369,188,110,78,32,3
147369,347,193,154,39,1
147369,1645,876,769,40,1
147369,1108,682,426,41,4
147369,690,423,267,42,1
147369,613,385,228,43,1
147369,54,33,21,44,1
147369,559,352,207,45,1
147369,77,38,39,51,1
147369,418,259,159,52,3
147369,87,48,39,59,1
147369,472,304,168,60,1
147378,16106,7668,8438,1,4
147378,16106,7668,8438,2,1
147378,10987,5251,5736,3,1
147378,2180,1159,1021,4,1
147378,8807,4092,4715,5,1
147378,5119,2417,2702,11,1
147378,373,168,205,19,1
147378,8434,3924,4510,20,1
147378,6764,3398,3366,21,4
147378,6764,3398,3366,22,1
147378,5515,2816,2699,23,1
147378,1651,894,757,24,1
147378,3864,1922,1942,25,1
147378,1249,582,667,31,1
147378,155,70,85,39,1
147378,3709,1852,1857,40,1
147378,9342,4270,5072,41,4
147378,9342,4270,5072,42,1
147378,5472,2435,3037,43,1
147378,529,265,264,44,1
147378,4943,2170,2773,45,1
147378,3870,1835,2035,51,1
147378,218,98,120,59,1
147378,4725,2072,2653,60,1
147396,103,94,9,1,4
147396,103,94,9,2,1
147396,103,94,9,3,1
147396,38,33,5,4,1
147396,65,61,4,5,1
147396,6,6,0,19,1
147396,59,55,4,20,1
147396,103,94,9,21,4
147396,103,94,9,22,1
147396,103,94,9,23,1
147396,38,33,5,24,1
147396,65,61,4,25,1
147396,6,6,0,39,1
147396,59,55,4,40,1
147411,4886,1987,2899,1,4
147411,4886,1987,2899,2,1
147411,2914,1349,1565,3,1
147411,541,293,248,4,1
147411,2373,1056,1317,5,1
147411,1972,638,1334,11,1
147411,55,28,27,19,1
147411,2318,1028,1290,20,1
147411,1553,740,813,21,4
147411,1553,740,813,22,1
147411,1238,622,616,23,1
147411,325,177,148,24,1
147411,913,445,468,25,1
147411,315,118,197,31,1
147411,28,17,11,39,1
147411,885,428,457,40,1
147411,3333,1247,2086,41,4
147411,3333,1247,2086,42,1
147411,1676,727,949,43,1
147411,216,116,100,44,1
147411,1460,611,849,45,1
147411,1657,520,1137,51,1
147411,27,11,16,59,1
147411,1433,600,833,60,1
147439,86,5,81,1,4
147439,86,5,81,2,1
147439,86,5,81,3,1
147439,19,0,19,4,1
147439,67,5,62,5,1
147439,67,5,62,20,1
147439,72,5,67,21,4
147439,72,5,67,22,1
147439,72,5,67,23,1
147439,16,0,16,24,1
147439,56,5,51,25,1
147439,56,5,51,40,1
147439,14,0,14,41,4
147439,14,0,14,42,1
147439,14,0,14,43,1
147439,3,0,3,44,1
147439,11,0,11,45,1
147439,11,0,11,60,1
147536,4814,946,3868,1,4
147536,1427,325,1102,2,1
147536,1393,321,1072,3,1
147536,28,5,23,4,1
147536,1365,316,1049,5,1
147536,34,4,30,11,1
147536,3387,621,2766,12,3
147536,319,64,255,19,1
147536,1046,252,794,20,1
147536,2209,500,1709,21,4
147536,784,162,622,22,1
147536,784,162,622,23,1
147536,27,4,23,24,1
147536,757,158,599,25,1
147536,1425,338,1087,32,3
147536,209,37,172,39,1
147536,548,121,427,40,1
147536,2605,446,2159,41,4
147536,643,163,480,42,1
147536,609,159,450,43,1
147536,1,1,0,44,1
147536,608,158,450,45,1
147536,34,4,30,51,1
147536,1962,283,1679,52,3
147536,110,27,83,59,1
147536,498,131,367,60,1
147590,786,332,454,1,4
147590,121,35,86,2,1
147590,87,27,60,3,1
147590,87,27,60,5,1
147590,34,8,26,11,1
147590,665,297,368,12,3
147590,28,8,20,19,1
147590,59,19,40,20,1
147590,699,301,398,21,4
147590,62,19,43,22,1
147590,54,16,38,23,1
147590,54,16,38,25,1
147590,8,3,5,31,1
147590,637,282,355,32,3
147590,18,5,13,39,1
147590,36,11,25,40,1
147590,87,31,56,41,4
147590,59,16,43,42,1
147590,33,11,22,43,1
147590,33,11,22,45,1
147590,26,5,21,51,1
147590,28,15,13,52,3
147590,10,3,7,59,1
147590,23,8,15,60,1
147642,78,3,75,1,4
147642,78,3,75,2,1
147642,78,3,75,3,1
147642,25,1,24,4,1
147642,53,2,51,5,1
147642,53,2,51,20,1
147642,16,0,16,21,4
147642,16,0,16,22,1
147642,16,0,16,23,1
147642,7,0,7,24,1
147642,9,0,9,25,1
147642,9,0,9,40,1
147642,62,3,59,41,4
147642,62,3,59,42,1
147642,62,3,59,43,1
147642,18,1,17,44,1
147642,44,2,42,45,1
147642,44,2,42,60,1
147660,3048,1384,1664,1,4
147660,2797,1251,1546,2,1
147660,2700,1189,1511,3,1
147660,529,258,271,4,1
147660,2171,931,1240,5,1
147660,97,62,35,11,1
147660,251,133,118,12,3
147660,324,137,187,19,1
147660,1847,794,1053,20,1
147660,2682,1194,1488,21,4
147660,2592,1145,1447,22,1
147660,2575,1134,1441,23,1
147660,529,258,271,24,1
147660,2046,876,1170,25,1
147660,17,11,6,31,1
147660,90,49,41,32,3
147660,308,130,178,39,1
147660,1738,746,992,40,1
147660,366,190,176,41,4
147660,205,106,99,42,1
147660,125,55,70,43,1
147660,125,55,70,45,1
147660,80,51,29,51,1
147660,161,84,77,52,3
147660,16,7,9,59,1
147660,109,48,61,60,1
147679,3136,1119,2017,1,4
147679,2204,811,1393,2,1
147679,2190,802,1388,3,1
147679,373,157,216,4,1
147679,1817,645,1172,5,1
147679,14,9,5,11,1
147679,932,308,624,12,3
147679,275,106,169,19,1
147679,1542,539,1003,20,1
147679,1970,750,1220,21,4
147679,1861,696,1165,22,1
147679,1860,695,1165,23,1
147679,371,157,214,24,1
147679,1489,538,951,25,1
147679,1,1,0,31,1
147679,109,54,55,32,3
147679,210,80,130,39,1
147679,1279,458,821,40,1
147679,1166,369,797,41,4
147679,343,115,228,42,1
147679,330,107,223,43,1
147679,2,0,2,44,1
147679,328,107,221,45,1
147679,13,8,5,51,1
147679,823,254,569,52,3
147679,65,26,39,59,1
147679,263,81,182,60,1
147697,205,132,73,1,4
147697,205,132,73,12,3
147697,119,88,31,21,4
147697,119,88,31,32,3
147697,86,44,42,41,4
147697,86,44,42,52,3
147703,21138,10262,10876,1,4
147703,15814,7926,7888,2,1
147703,15782,7910,7872,3,1
147703,2679,1282,1397,4,1
147703,13103,6628,6475,5,1
147703,32,16,16,11,1
147703,5324,2336,2988,12,3
147703,1881,977,904,19,1
147703,11222,5651,5571,20,1
147703,16053,8036,8017,21,4
147703,13821,6919,6902,22,1
147703,13813,6915,6898,23,1
147703,2630,1261,1369,24,1
147703,11183,5654,5529,25,1
147703,8,4,4,31,1
147703,2232,1117,1115,32,3
147703,1592,852,740,39,1
147703,9591,4802,4789,40,1
147703,5085,2226,2859,41,4
147703,1993,1007,986,42,1
147703,1969,995,974,43,1
147703,49,21,28,44,1
147703,1920,974,946,45,1
147703,24,12,12,51,1
147703,3092,1219,1873,52,3
147703,289,125,164,59,1
147703,1631,849,782,60,1
147749,430,95,335,1,4
147749,430,95,335,2,1
147749,430,95,335,3,1
147749,85,21,64,4,1
147749,345,74,271,5,1
147749,8,2,6,19,1
147749,337,72,265,20,1
147749,235,57,178,21,4
147749,235,57,178,22,1
147749,235,57,178,23,1
147749,69,16,53,24,1
147749,166,41,125,25,1
147749,166,41,125,40,1
147749,195,38,157,41,4
147749,195,38,157,42,1
147749,195,38,157,43,1
147749,16,5,11,44,1
147749,179,33,146,45,1
147749,8,2,6,59,1
147749,171,31,140,60,1
147767,21592,11489,10103,1,4
147767,9283,4518,4765,2,1
147767,8855,4341,4514,3,1
147767,2040,989,1051,4,1
147767,6815,3352,3463,5,1
147767,428,177,251,11,1
147767,12309,6971,5338,12,3
147767,77,44,33,19,1
147767,6738,3308,3430,20,1
147767,17190,8893,8297,21,4
147767,8489,4166,4323,22,1
147767,8458,4146,4312,23,1
147767,2040,989,1051,24,1
147767,6418,3157,3261,25,1
147767,31,20,11,31,1
147767,8701,4727,3974,32,3
147767,77,44,33,39,1
147767,6341,3113,3228,40,1
147767,4402,2596,1806,41,4
147767,794,352,442,42,1
147767,397,195,202,43,1
147767,397,195,202,45,1
147767,397,157,240,51,1
147767,3608,2244,1364,52,3
147767,397,195,202,60,1
147776,10821,4701,6120,1,4
147776,8950,3998,4952,2,1
147776,8827,3941,4886,3,1
147776,808,353,455,4,1
147776,8019,3588,4431,5,1
147776,123,57,66,11,1
147776,1871,703,1168,12,3
147776,1356,624,732,19,1
147776,6663,2964,3699,20,1
147776,5415,2434,2981,21,4
147776,5068,2286,2782,22,1
147776,5023,2270,2753,23,1
147776,764,327,437,24,1
147776,4259,1943,2316,25,1
147776,45,16,29,31,1
147776,347,148,199,32,3
147776,745,345,400,39,1
147776,3514,1598,1916,40,1
147776,5406,2267,3139,41,4
147776,3882,1712,2170,42,1
147776,3804,1671,2133,43,1
147776,44,26,18,44,1
147776,3760,1645,2115,45,1
147776,78,41,37,51,1
147776,1524,555,969,52,3
147776,611,279,332,59,1
147776,3149,1366,1783,60,1
147800,10866,5288,5578,1,4
147800,10866,5288,5578,2,1
147800,10111,4957,5154,3,1
147800,1262,700,562,4,1
147800,8849,4257,4592,5,1
147800,755,331,424,11,1
147800,1036,515,521,19,1
147800,7813,3742,4071,20,1
147800,2976,1639,1337,21,4
147800,2976,1639,1337,22,1
147800,2976,1639,1337,23,1
147800,749,429,320,24,1
147800,2227,1210,1017,25,1
147800,267,162,105,39,1
147800,1960,1048,912,40,1
147800,7890,3649,4241,41,4
147800,7890,3649,4241,42,1
147800,7135,3318,3817,43,1
147800,513,271,242,44,1
147800,6622,3047,3575,45,1
147800,755,331,424,51,1
147800,769,353,416,59,1
147800,5853,2694,3159,60,1
147819,70,1,69,1,4
147819,70,1,69,2,1
147819,70,1,69,3,1
147819,38,0,38,4,1
147819,32,1,31,5,1
147819,32,1,31,20,1
147819,70,1,69,21,4
147819,70,1,69,22,1
147819,70,1,69,23,1
147819,38,0,38,24,1
147819,32,1,31,25,1
147819,32,1,31,40,1
147828,4579,1484,3095,1,4
147828,3335,1224,2111,2,1
147828,3325,1221,2104,3,1
147828,753,335,418,4,1
147828,2572,886,1686,5,1
147828,10,3,7,11,1
147828,1244,260,984,12,3
147828,344,96,248,19,1
147828,2228,790,1438,20,1
147828,3185,1203,1982,21,4
147828,2905,1142,1763,22,1
147828,2903,1142,1761,23,1
147828,753,335,418,24,1
147828,2150,807,1343,25,1
147828,2,0,2,31,1
147828,280,61,219,32,3
147828,276,82,194,39,1
147828,1874,725,1149,40,1
147828,1394,281,1113,41,4
147828,430,82,348,42,1
147828,422,79,343,43,1
147828,422,79,343,45,1
147828,8,3,5,51,1
147828,964,199,765,52,3
147828,68,14,54,59,1
147828,354,65,289,60,1
147916,8437,4087,4350,1,4
147916,8437,4087,4350,2,1
147916,7429,3796,3633,3,1
147916,1057,635,422,4,1
147916,6372,3161,3211,5,1
147916,1008,291,717,11,1
147916,292,153,139,19,1
147916,6080,3008,3072,20,1
147916,3150,1750,1400,21,4
147916,3150,1750,1400,22,1
147916,3015,1724,1291,23,1
147916,675,437,238,24,1
147916,2340,1287,1053,25,1
147916,135,26,109,31,1
147916,172,101,71,39,1
147916,2168,1186,982,40,1
147916,5287,2337,2950,41,4
147916,5287,2337,2950,42,1
147916,4414,2072,2342,43,1
147916,382,198,184,44,1
147916,4032,1874,2158,45,1
147916,873,265,608,51,1
147916,120,52,68,59,1
147916,3912,1822,2090,60,1
147970,179,17,162,1,4
147970,179,17,162,2,1
147970,179,17,162,3,1
147970,56,8,48,4,1
147970,123,9,114,5,1
147970,123,9,114,20,1
147970,179,17,162,21,4
147970,179,17,162,22,1
147970,179,17,162,23,1
147970,56,8,48,24,1
147970,123,9,114,25,1
147970,123,9,114,40,1
148007,5064,2088,2976,1,4
148007,5064,2088,2976,2,1
148007,4651,1876,2775,3,1
148007,612,288,324,4,1
148007,4039,1588,2451,5,1
148007,413,212,201,11,1
148007,359,121,238,19,1
148007,3680,1467,2213,20,1
148007,1997,893,1104,21,4
148007,1997,893,1104,22,1
148007,1933,863,1070,23,1
148007,418,203,215,24,1
148007,1515,660,855,25,1
148007,64,30,34,31,1
148007,190,69,121,39,1
148007,1325,591,734,40,1
148007,3067,1195,1872,41,4
148007,3067,1195,1872,42,1
148007,2718,1013,1705,43,1
148007,194,85,109,44,1
148007,2524,928,1596,45,1
148007,349,182,167,51,1
148007,169,52,117,59,1
148007,2355,876,1479,60,1
148016,508,235,273,1,4
148016,508,235,273,2,1
148016,495,231,264,3,1
148016,125,54,71,4,1
148016,370,177,193,5,1
148016,13,4,9,11,1
148016,23,13,10,19,1
148016,347,164,183,20,1
148016,490,226,264,21,4
148016,490,226,264,22,1
148016,480,222,258,23,1
148016,125,54,71,24,1
148016,355,168,187,25,1
148016,10,4,6,31,1
148016,22,12,10,39,1
148016,333,156,177,40,1
148016,18,9,9,41,4
148016,18,9,9,42,1
148016,15,9,6,43,1
148016,15,9,6,45,1
148016,3,0,3,51,1
148016,1,1,0,59,1
148016,14,8,6,60,1
148098,49,3,46,1,4
148098,49,3,46,2,1
148098,49,3,46,3,1
148098,8,0,8,4,1
148098,41,3,38,5,1
148098,41,3,38,20,1
148098,35,3,32,21,4
148098,35,3,32,22,1
148098,35,3,32,23,1
148098,8,0,8,24,1
148098,27,3,24,25,1
148098,27,3,24,40,1
148098,14,0,14,41,4
148098,14,0,14,42,1
148098,14,0,14,43,1
148098,14,0,14,45,1
148098,14,0,14,60,1
148131,1455,609,846,1,4
148131,1196,526,670,2,1
148131,1166,514,652,3,1
148131,275,148,127,4,1
148131,891,366,525,5,1
148131,30,12,18,11,1
148131,259,83,176,12,3
148131,103,42,61,19,1
148131,788,324,464,20,1
148131,1162,517,645,21,4
148131,1082,487,595,22,1
148131,1082,487,595,23,1
148131,275,148,127,24,1
148131,807,339,468,25,1
148131,80,30,50,32,3
148131,99,39,60,39,1
148131,708,300,408,40,1
148131,293,92,201,41,4
148131,114,39,75,42,1
148131,84,27,57,43,1
148131,84,27,57,45,1
148131,30,12,18,51,1
148131,179,53,126,52,3
148131,4,3,1,59,1
148131,80,24,56,60,1
148140,200,102,98,1,4
148140,200,102,98,2,1
148140,200,102,98,3,1
148140,23,15,8,4,1
148140,177,87,90,5,1
148140,14,4,10,19,1
148140,163,83,80,20,1
148140,200,102,98,21,4
148140,200,102,98,22,1
148140,200,102,98,23,1
148140,23,15,8,24,1
148140,177,87,90,25,1
148140,14,4,10,39,1
148140,163,83,80,40,1
148177,2322,1037,1285,1,4
148177,2322,1037,1285,2,1
148177,2322,1037,1285,3,1
148177,509,236,273,4,1
148177,1813,801,1012,5,1
148177,318,130,188,19,1
148177,1495,671,824,20,1
148177,1770,787,983,21,4
148177,1770,787,983,22,1
148177,1770,787,983,23,1
148177,449,208,241,24,1
148177,1321,579,742,25,1
148177,236,98,138,39,1
148177,1085,481,604,40,1
148177,552,250,302,41,4
148177,552,250,302,42,1
148177,552,250,302,43,1
148177,60,28,32,44,1
148177,492,222,270,45,1
148177,82,32,50,59,1
148177,410,190,220,60,1
148256,2714,1174,1540,1,4
148256,2714,1174,1540,2,1
148256,1747,773,974,3,1
148256,417,205,212,4,1
148256,1330,568,762,5,1
148256,967,401,566,11,1
148256,79,40,39,19,1
148256,1251,528,723,20,1
148256,1479,673,806,21,4
148256,1479,673,806,22,1
148256,1278,598,680,23,1
148256,355,181,174,24,1
148256,923,417,506,25,1
148256,201,75,126,31,1
148256,53,25,28,39,1
148256,870,392,478,40,1
148256,1235,501,734,41,4
148256,1235,501,734,42,1
148256,469,175,294,43,1
148256,62,24,38,44,1
148256,407,151,256,45,1
148256,766,326,440,51,1
148256,26,15,11,59,1
148256,381,136,245,60,1
148292,3340,1297,2043,1,4
148292,3340,1297,2043,2,1
148292,2634,978,1656,3,1
148292,605,274,331,4,1
148292,2029,704,1325,5,1
148292,706,319,387,11,1
148292,11,5,6,19,1
148292,2018,699,1319,20,1
148292,1061,480,581,21,4
148292,1061,480,581,22,1
148292,1004,452,552,23,1
148292,272,142,130,24,1
148292,732,310,422,25,1
148292,57,28,29,31,1
148292,7,3,4,39,1
148292,725,307,418,40,1
148292,2279,817,1462,41,4
148292,2279,817,1462,42,1
148292,1630,526,1104,43,1
148292,333,132,201,44,1
148292,1297,394,903,45,1
148292,649,291,358,51,1
148292,4,2,2,59,1
148292,1293,392,901,60,1
148335,3233,1563,1670,1,4
148335,2781,1375,1406,2,1
148335,2775,1375,1400,3,1
148335,699,359,340,4,1
148335,2076,1016,1060,5,1
148335,6,0,6,11,1
148335,452,188,264,12,3
148335,754,384,370,19,1
148335,1322,632,690,20,1
148335,2672,1332,1340,21,4
148335,2649,1321,1328,22,1
148335,2649,1321,1328,23,1
148335,698,359,339,24,1
148335,1951,962,989,25,1
148335,23,11,12,32,3
148335,731,373,358,39,1
148335,1220,589,631,40,1
148335,561,231,330,41,4
148335,132,54,78,42,1
148335,126,54,72,43,1
148335,1,0,1,44,1
148335,125,54,71,45,1
148335,6,0,6,51,1
148335,429,177,252,52,3
148335,23,11,12,59,1
148335,102,43,59,60,1
148380,8150,3560,4590,1,4
148380,8150,3560,4590,2,1
148380,7395,3216,4179,3,1
148380,1144,584,560,4,1
148380,6251,2632,3619,5,1
148380,755,344,411,11,1
148380,207,92,115,19,1
148380,6044,2540,3504,20,1
148380,3652,1653,1999,21,4
148380,3652,1653,1999,22,1
148380,3388,1528,1860,23,1
148380,776,386,390,24,1
148380,2612,1142,1470,25,1
148380,264,125,139,31,1
148380,101,45,56,39,1
148380,2511,1097,1414,40,1
148380,4498,1907,2591,41,4
148380,4498,1907,2591,42,1
148380,4007,1688,2319,43,1
148380,368,198,170,44,1
148380,3639,1490,2149,45,1
148380,491,219,272,51,1
148380,106,47,59,59,1
148380,3533,1443,2090,60,1
148399,484,80,404,1,4
148399,484,80,404,2,1
148399,484,80,404,3,1
148399,129,25,104,4,1
148399,355,55,300,5,1
148399,355,55,300,20,1
148399,214,27,187,21,4
148399,214,27,187,22,1
148399,214,27,187,23,1
148399,67,11,56,24,1
148399,147,16,131,25,1
148399,147,16,131,40,1
148399,270,53,217,41,4
148399,270,53,217,42,1
148399,270,53,217,43,1
148399,62,14,48,44,1
148399,208,39,169,45,1
148399,208,39,169,60,1
148405,1230,452,778,1,4
148405,972,357,615,2,1
148405,963,353,610,3,1
148405,110,42,68,4,1
148405,853,311,542,5,1
148405,9,4,5,11,1
148405,258,95,163,12,3
148405,257,104,153,19,1
148405,596,207,389,20,1
148405,876,327,549,21,4
148405,838,308,530,22,1
148405,836,308,528,23,1
148405,103,40,63,24,1
148405,733,268,465,25,1
148405,2,0,2,31,1
148405,38,19,19,32,3
148405,199,73,126,39,1
148405,534,195,339,40,1
148405,354,125,229,41,4
148405,134,49,85,42,1
148405,127,45,82,43,1
148405,7,2,5,44,1
148405,120,43,77,45,1
148405,7,4,3,51,1
148405,220,76,144,52,3
148405,58,31,27,59,1
148405,62,12,50,60,1
148487,6130,2115,4015,1,4
148487,3658,1383,2275,2,1
148487,3596,1357,2239,3,1
148487,444,173,271,4,1
148487,3152,1184,1968,5,1
148487,62,26,36,11,1
148487,2472,732,1740,12,3
148487,637,237,400,19,1
148487,2515,947,1568,20,1
148487,3832,1419,2413,21,4
148487,2731,1080,1651,22,1
148487,2710,1072,1638,23,1
148487,429,168,261,24,1
148487,2281,904,1377,25,1
148487,21,8,13,31,1
148487,1101,339,762,32,3
148487,518,201,317,39,1
148487,1763,703,1060,40,1
148487,2298,696,1602,41,4
148487,927,303,624,42,1
148487,886,285,601,43,1
148487,15,5,10,44,1
148487,871,280,591,45,1
148487,41,18,23,51,1
148487,1371,393,978,52,3
148487,119,36,83,59,1
148487,752,244,508,60,1
148496,3470,1043,2427,1,4
148496,2069,699,1370,2,1
148496,2020,680,1340,3,1
148496,497,182,315,4,1
148496,1523,498,1025,5,1
148496,49,19,30,11,1
148496,1401,344,1057,12,3
148496,125,40,85,19,1
148496,1398,458,940,20,1
148496,2457,795,1662,21,4
148496,1907,643,1264,22,1
148496,1880,632,1248,23,1
148496,497,182,315,24,1
148496,1383,450,933,25,1
148496,27,11,16,31,1
148496,550,152,398,32,3
148496,111,34,77,39,1
148496,1272,416,856,40,1
148496,1013,248,765,41,4
148496,162,56,106,42,1
148496,140,48,92,43,1
148496,140,48,92,45,1
148496,22,8,14,51,1
148496,851,192,659,52,3
148496,14,6,8,59,1
148496,126,42,84,60,1
148511,2280,606,1674,1,4
148511,124,37,87,2,1
148511,121,36,85,3,1
148511,121,36,85,5,1
148511,3,1,2,11,1
148511,2156,569,1587,12,3
148511,55,15,40,19,1
148511,66,21,45,20,1
148511,1442,469,973,21,4
148511,79,18,61,22,1
148511,79,18,61,23,1
148511,79,18,61,25,1
148511,1363,451,912,32,3
148511,47,12,35,39,1
148511,32,6,26,40,1
148511,838,137,701,41,4
148511,45,19,26,42,1
148511,42,18,24,43,1
148511,42,18,24,45,1
148511,3,1,2,51,1
148511,793,118,675,52,3
148511,8,3,5,59,1
148511,34,15,19,60,1
148575,701,70,631,1,4
148575,420,46,374,2,1
148575,417,46,371,3,1
148575,417,46,371,5,1
148575,3,0,3,11,1
148575,281,24,257,12,3
148575,77,10,67,19,1
148575,340,36,304,20,1
148575,327,38,289,21,4
148575,314,37,277,22,1
148575,314,37,277,23,1
148575,314,37,277,25,1
148575,13,1,12,32,3
148575,55,9,46,39,1
148575,259,28,231,40,1
148575,374,32,342,41,4
148575,106,9,97,42,1
148575,103,9,94,43,1
148575,103,9,94,45,1
148575,3,0,3,51,1
148575,268,23,245,52,3
148575,22,1,21,59,1
148575,81,8,73,60,1
148584,3764,932,2832,1,4
148584,1780,565,1215,2,1
148584,1757,552,1205,3,1
148584,237,108,129,4,1
148584,1520,444,1076,5,1
148584,23,13,10,11,1
148584,1984,367,1617,12,3
148584,209,59,150,19,1
148584,1311,385,926,20,1
148584,1589,529,1060,21,4
148584,1403,482,921,22,1
148584,1397,479,918,23,1
148584,237,108,129,24,1
148584,1160,371,789,25,1
148584,6,3,3,31,1
148584,186,47,139,32,3
148584,176,51,125,39,1
148584,984,320,664,40,1
148584,2175,403,1772,41,4
148584,377,83,294,42,1
148584,360,73,287,43,1
148584,360,73,287,45,1
148584,17,10,7,51,1
148584,1798,320,1478,52,3
148584,33,8,25,59,1
148584,327,65,262,60,1
148593,124,12,112,1,4
148593,124,12,112,2,1
148593,124,12,112,3,1
148593,124,12,112,5,1
148593,124,12,112,19,1
148593,115,12,103,21,4
148593,115,12,103,22,1
148593,115,12,103,23,1
148593,115,12,103,25,1
148593,115,12,103,39,1
148593,9,0,9,41,4
148593,9,0,9,42,1
148593,9,0,9,43,1
148593,9,0,9,45,1
148593,9,0,9,59,1
148627,4252,1276,2976,1,4
148627,2920,955,1965,2,1
148627,2891,946,1945,3,1
148627,594,214,380,4,1
148627,2297,732,1565,5,1
148627,29,9,20,11,1
148627,1332,321,1011,12,3
148627,332,102,230,19,1
148627,1965,630,1335,20,1
148627,2635,846,1789,21,4
148627,2452,801,1651,22,1
148627,2443,800,1643,23,1
148627,591,212,379,24,1
148627,1852,588,1264,25,1
148627,9,1,8,31,1
148627,183,45,138,32,3
148627,263,81,182,39,1
148627,1589,507,1082,40,1
148627,1617,430,1187,41,4
148627,468,154,314,42,1
148627,448,146,302,43,1
148627,3,2,1,44,1
148627,445,144,301,45,1
148627,20,8,12,51,1
148627,1149,276,873,52,3
148627,69,21,48,59,1
148627,376,123,253,60,1
148654,5137,2525,2612,1,4
148654,3039,1488,1551,2,1
148654,2959,1452,1507,3,1
148654,316,113,203,4,1
148654,2643,1339,1304,5,1
148654,80,36,44,11,1
148654,2098,1037,1061,12,3
148654,639,337,302,19,1
148654,2004,1002,1002,20,1
148654,2587,1199,1388,21,4
148654,1969,880,1089,22,1
148654,1942,867,1075,23,1
148654,312,112,200,24,1
148654,1630,755,875,25,1
148654,27,13,14,31,1
148654,618,319,299,32,3
148654,402,206,196,39,1
148654,1228,549,679,40,1
148654,2550,1326,1224,41,4
148654,1070,608,462,42,1
148654,1017,585,432,43,1
148654,4,1,3,44,1
148654,1013,584,429,45,1
148654,53,23,30,51,1
148654,1480,718,762,52,3
148654,237,131,106,59,1
148654,776,453,323,60,1
148672,2220,896,1324,1,4
148672,2220,896,1324,2,1
148672,1788,716,1072,3,1
148672,471,220,251,4,1
148672,1317,496,821,5,1
148672,432,180,252,11,1
148672,40,11,29,19,1
148672,1277,485,792,20,1
148672,998,434,564,21,4
148672,998,434,564,22,1
148672,979,421,558,23,1
148672,374,175,199,24,1
148672,605,246,359,25,1
148672,19,13,6,31,1
148672,16,5,11,39,1
148672,589,241,348,40,1
148672,1222,462,760,41,4
148672,1222,462,760,42,1
148672,809,295,514,43,1
148672,97,45,52,44,1
148672,712,250,462,45,1
148672,413,167,246,51,1
148672,24,6,18,59,1
148672,688,244,444,60,1
148724,30,13,17,1,4
148724,30,13,17,12,3
148724,30,13,17,41,4
148724,30,13,17,52,3
148821,1834,741,1093,1,4
148821,1834,741,1093,2,1
148821,1309,473,836,3,1
148821,124,61,63,4,1
148821,1185,412,773,5,1
148821,525,268,257,11,1
148821,116,37,79,19,1
148821,1069,375,694,20,1
148821,870,348,522,21,4
148821,870,348,522,22,1
148821,839,333,506,23,1
148821,100,53,47,24,1
148821,739,280,459,25,1
148821,31,15,16,31,1
148821,72,26,46,39,1
148821,667,254,413,40,1
148821,964,393,571,41,4
148821,964,393,571,42,1
148821,470,140,330,43,1
148821,24,8,16,44,1
148821,446,132,314,45,1
148821,494,253,241,51,1
148821,44,11,33,59,1
148821,402,121,281,60,1
148849,97,57,40,1,4
148849,97,57,40,2,1
148849,97,57,40,3,1
148849,8,4,4,4,1
148849,89,53,36,5,1
148849,12,8,4,19,1
148849,77,45,32,20,1
148849,79,48,31,21,4
148849,79,48,31,22,1
148849,79,48,31,23,1
148849,8,4,4,24,1
148849,71,44,27,25,1
148849,10,7,3,39,1
148849,61,37,24,40,1
148849,18,9,9,41,4
148849,18,9,9,42,1
148849,18,9,9,43,1
148849,18,9,9,45,1
148849,2,1,1,59,1
148849,16,8,8,60,1
148876,1607,354,1253,1,4
148876,1607,354,1253,2,1
148876,1598,350,1248,3,1
148876,292,69,223,4,1
148876,1306,281,1025,5,1
148876,9,4,5,11,1
148876,114,29,85,19,1
148876,1192,252,940,20,1
148876,1143,240,903,21,4
148876,1143,240,903,22,1
148876,1143,240,903,23,1
148876,265,66,199,24,1
148876,878,174,704,25,1
148876,86,18,68,39,1
148876,792,156,636,40,1
148876,464,114,350,41,4
148876,464,114,350,42,1
148876,455,110,345,43,1
148876,27,3,24,44,1
148876,428,107,321,45,1
148876,9,4,5,51,1
148876,28,11,17,59,1
148876,400,96,304,60,1
148885,233,222,11,1,4
148885,233,222,11,12,3
148885,233,222,11,21,4
148885,233,222,11,32,3
148937,1930,780,1150,1,4
148937,1930,780,1150,2,1
148937,1027,454,573,3,1
148937,199,111,88,4,1
148937,828,343,485,5,1
148937,903,326,577,11,1
148937,57,23,34,19,1
148937,771,320,451,20,1
148937,810,352,458,21,4
148937,810,352,458,22,1
148937,700,334,366,23,1
148937,155,87,68,24,1
148937,545,247,298,25,1
148937,110,18,92,31,1
148937,42,20,22,39,1
148937,503,227,276,40,1
148937,1120,428,692,41,4
148937,1120,428,692,42,1
148937,327,120,207,43,1
148937,44,24,20,44,1
148937,283,96,187,45,1
148937,793,308,485,51,1
148937,15,3,12,59,1
148937,268,93,175,60,1
148955,64,4,60,1,4
148955,64,4,60,2,1
148955,64,4,60,3,1
148955,13,0,13,4,1
148955,51,4,47,5,1
148955,51,4,47,20,1
148955,64,4,60,21,4
148955,64,4,60,22,1
148955,64,4,60,23,1
148955,13,0,13,24,1
148955,51,4,47,25,1
148955,51,4,47,40,1
148982,219,75,144,1,4
148982,219,75,144,12,3
148982,3,3,0,21,4
148982,3,3,0,32,3
148982,216,72,144,41,4
148982,216,72,144,52,3
148991,1784,741,1043,1,4
148991,1784,741,1043,2,1
148991,1207,493,714,3,1
148991,485,245,240,4,1
148991,722,248,474,5,1
148991,577,248,329,11,1
148991,199,85,114,19,1
148991,523,163,360,20,1
148991,713,336,377,21,4
148991,713,336,377,22,1
148991,696,328,368,23,1
148991,349,190,159,24,1
148991,347,138,209,25,1
148991,17,8,9,31,1
148991,110,54,56,39,1
148991,237,84,153,40,1
148991,1071,405,666,41,4
148991,1071,405,666,42,1
148991,511,165,346,43,1
148991,136,55,81,44,1
148991,375,110,265,45,1
148991,560,240,320,51,1
148991,89,31,58,59,1
148991,286,79,207,60,1
149028,291,26,265,1,4
149028,227,21,206,2,1
149028,220,19,201,3,1
149028,220,19,201,5,1
149028,7,2,5,11,1
149028,64,5,59,12,3
149028,48,5,43,19,1
149028,172,14,158,20,1
149028,151,13,138,21,4
149028,151,13,138,22,1
149028,151,13,138,23,1
149028,151,13,138,25,1
149028,32,3,29,39,1
149028,119,10,109,40,1
149028,140,13,127,41,4
149028,76,8,68,42,1
149028,69,6,63,43,1
149028,69,6,63,45,1
149028,7,2,5,51,1
149028,64,5,59,52,3
149028,16,2,14,59,1
149028,53,4,49,60,1
149204,45,0,45,1,4
149204,45,0,45,2,1
149204,45,0,45,3,1
149204,17,0,17,4,1
149204,28,0,28,5,1
149204,28,0,28,20,1
149204,45,0,45,21,4
149204,45,0,45,22,1
149204,45,0,45,23,1
149204,17,0,17,24,1
149204,28,0,28,25,1
149204,28,0,28,40,1
149222,17964,9644,8320,1,4
149222,13306,7281,6025,2,1
149222,13220,7246,5974,3,1
149222,2631,1349,1282,4,1
149222,10589,5897,4692,5,1
149222,86,35,51,11,1
149222,4658,2363,2295,12,3
149222,1751,999,752,19,1
149222,8838,4898,3940,20,1
149222,14478,7774,6704,21,4
149222,11803,6403,5400,22,1
149222,11742,6379,5363,23,1
149222,2591,1325,1266,24,1
149222,9151,5054,4097,25,1
149222,61,24,37,31,1
149222,2675,1371,1304,32,3
149222,1574,907,667,39,1
149222,7577,4147,3430,40,1
149222,3486,1870,1616,41,4
149222,1503,878,625,42,1
149222,1478,867,611,43,1
149222,40,24,16,44,1
149222,1438,843,595,45,1
149222,25,11,14,51,1
149222,1983,992,991,52,3
149222,177,92,85,59,1
149222,1261,751,510,60,1
149231,13850,6332,7518,1,4
149231,11229,5294,5935,2,1
149231,11179,5273,5906,3,1
149231,1966,855,1111,4,1
149231,9213,4418,4795,5,1
149231,50,21,29,11,1
149231,2621,1038,1583,12,3
149231,1252,620,632,19,1
149231,7961,3798,4163,20,1
149231,10759,5016,5743,21,4
149231,9556,4480,5076,22,1
149231,9543,4476,5067,23,1
149231,1930,839,1091,24,1
149231,7613,3637,3976,25,1
149231,13,4,9,31,1
149231,1203,536,667,32,3
149231,991,521,470,39,1
149231,6622,3116,3506,40,1
149231,3091,1316,1775,41,4
149231,1673,814,859,42,1
149231,1636,797,839,43,1
149231,36,16,20,44,1
149231,1600,781,819,45,1
149231,37,17,20,51,1
149231,1418,502,916,52,3
149231,261,99,162,59,1
149231,1339,682,657,60,1
149310,257,152,105,1,4
149310,257,152,105,2,1
149310,86,22,64,3,1
149310,28,9,19,4,1
149310,58,13,45,5,1
149310,171,130,41,11,1
149310,58,13,45,20,1
149310,257,152,105,21,4
149310,257,152,105,22,1
149310,86,22,64,23,1
149310,28,9,19,24,1
149310,58,13,45,25,1
149310,171,130,41,31,1
149310,58,13,45,40,1
149329,77,77,0,1,4
149329,67,67,0,2,1
149329,67,67,0,3,1
149329,18,18,0,4,1
149329,49,49,0,5,1
149329,10,10,0,12,3
149329,49,49,0,20,1
149329,77,77,0,21,4
149329,67,67,0,22,1
149329,67,67,0,23,1
149329,18,18,0,24,1
149329,49,49,0,25,1
149329,10,10,0,32,3
149329,49,49,0,40,1
149365,5212,1757,3455,1,4
149365,5212,1757,3455,2,1
149365,4642,1574,3068,3,1
149365,950,417,533,4,1
149365,3692,1157,2535,5,1
149365,570,183,387,11,1
149365,318,95,223,19,1
149365,3374,1062,2312,20,1
149365,2085,798,1287,21,4
149365,2085,798,1287,22,1
149365,1998,767,1231,23,1
149365,502,230,272,24,1
149365,1496,537,959,25,1
149365,87,31,56,31,1
149365,145,51,94,39,1
149365,1351,486,865,40,1
149365,3127,959,2168,41,4
149365,3127,959,2168,42,1
149365,2644,807,1837,43,1
149365,448,187,261,44,1
149365,2196,620,1576,45,1
149365,483,152,331,51,1
149365,173,44,129,59,1
149365,2023,576,1447,60,1
149499,14,0,14,1,4
149499,14,0,14,2,1
149499,14,0,14,3,1
149499,2,0,2,4,1
149499,12,0,12,5,1
149499,12,0,12,20,1
149499,14,0,14,21,4
149499,14,0,14,22,1
149499,14,0,14,23,1
149499,2,0,2,24,1
149499,12,0,12,25,1
149499,12,0,12,40,1
149505,1380,482,898,1,4
149505,1333,471,862,2,1
149505,1191,423,768,3,1
149505,205,83,122,4,1
149505,986,340,646,5,1
149505,142,48,94,11,1
149505,47,11,36,12,3
149505,152,51,101,19,1
149505,834,289,545,20,1
149505,1125,404,721,21,4
149505,1106,397,709,22,1
149505,1025,376,649,23,1
149505,204,83,121,24,1
149505,821,293,528,25,1
149505,81,21,60,31,1
149505,19,7,12,32,3
149505,115,40,75,39,1
149505,706,253,453,40,1
149505,255,78,177,41,4
149505,227,74,153,42,1
149505,166,47,119,43,1
149505,1,0,1,44,1
149505,165,47,118,45,1
149505,61,27,34,51,1
149505,28,4,24,52,3
149505,37,11,26,59,1
149505,128,36,92,60,1
149514,2125,1355,770,1,4
149514,906,466,440,2,1
149514,899,466,433,3,1
149514,182,110,72,4,1
149514,717,356,361,5,1
149514,7,0,7,11,1
149514,1219,889,330,12,3
149514,85,43,42,19,1
149514,632,313,319,20,1
149514,1234,754,480,21,4
149514,744,400,344,22,1
149514,744,400,344,23,1
149514,182,110,72,24,1
149514,562,290,272,25,1
149514,490,354,136,32,3
149514,67,35,32,39,1
149514,495,255,240,40,1
149514,891,601,290,41,4
149514,162,66,96,42,1
149514,155,66,89,43,1
149514,155,66,89,45,1
149514,7,0,7,51,1
149514,729,535,194,52,3
149514,18,8,10,59,1
149514,137,58,79,60,1
149532,11225,4953,6272,1,4
149532,11225,4953,6272,2,1
149532,9184,4130,5054,3,1
149532,1213,643,570,4,1
149532,7971,3487,4484,5,1
149532,2041,823,1218,11,1
149532,429,186,243,19,1
149532,7542,3301,4241,20,1
149532,3559,1664,1895,21,4
149532,3559,1664,1895,22,1
149532,3491,1643,1848,23,1
149532,751,403,348,24,1
149532,2740,1240,1500,25,1
149532,68,21,47,31,1
149532,199,94,105,39,1
149532,2541,1146,1395,40,1
149532,7666,3289,4377,41,4
149532,7666,3289,4377,42,1
149532,5693,2487,3206,43,1
149532,462,240,222,44,1
149532,5231,2247,2984,45,1
149532,1973,802,1171,51,1
149532,230,92,138,59,1
149532,5001,2155,2846,60,1
149550,189,9,180,1,4
149550,189,9,180,2,1
149550,189,9,180,3,1
149550,36,1,35,4,1
149550,153,8,145,5,1
149550,153,8,145,20,1
149550,130,5,125,21,4
149550,130,5,125,22,1
149550,130,5,125,23,1
149550,32,1,31,24,1
149550,98,4,94,25,1
149550,98,4,94,40,1
149550,59,4,55,41,4
149550,59,4,55,42,1
149550,59,4,55,43,1
149550,4,0,4,44,1
149550,55,4,51,45,1
149550,55,4,51,60,1
149639,178,91,87,1,4
149639,133,69,64,2,1
149639,104,51,53,3,1
149639,15,9,6,4,1
149639,89,42,47,5,1
149639,29,18,11,11,1
149639,45,22,23,12,3
149639,8,4,4,19,1
149639,81,38,43,20,1
149639,108,53,55,21,4
149639,99,49,50,22,1
149639,99,49,50,23,1
149639,15,9,6,24,1
149639,84,40,44,25,1
149639,9,4,5,32,3
149639,8,4,4,39,1
149639,76,36,40,40,1
149639,70,38,32,41,4
149639,34,20,14,42,1
149639,5,2,3,43,1
149639,5,2,3,45,1
149639,29,18,11,51,1
149639,36,18,18,52,3
149639,5,2,3,60,1
149727,10721,4747,5974,1,4
149727,10721,4747,5974,2,1
149727,8055,3591,4464,3,1
149727,1475,757,718,4,1
149727,6580,2834,3746,5,1
149727,2666,1156,1510,11,1
149727,413,158,255,19,1
149727,6167,2676,3491,20,1
149727,3469,1757,1712,21,4
149727,3469,1757,1712,22,1
149727,3400,1725,1675,23,1
149727,1006,533,473,24,1
149727,2394,1192,1202,25,1
149727,69,32,37,31,1
149727,189,87,102,39,1
149727,2205,1105,1100,40,1
149727,7252,2990,4262,41,4
149727,7252,2990,4262,42,1
149727,4655,1866,2789,43,1
149727,469,224,245,44,1
149727,4186,1642,2544,45,1
149727,2597,1124,1473,51,1
149727,224,71,153,59,1
149727,3962,1571,2391,60,1
149763,462,60,402,1,4
149763,321,40,281,2,1
149763,321,40,281,3,1
149763,321,40,281,5,1
149763,141,20,121,12,3
149763,128,19,109,19,1
149763,193,21,172,20,1
149763,316,43,273,21,4
149763,221,31,190,22,1
149763,221,31,190,23,1
149763,221,31,190,25,1
149763,95,12,83,32,3
149763,72,12,60,39,1
149763,149,19,130,40,1
149763,146,17,129,41,4
149763,100,9,91,42,1
149763,100,9,91,43,1
149763,100,9,91,45,1
149763,46,8,38,52,3
149763,56,7,49,59,1
149763,44,2,42,60,1
149772,11707,5798,5909,1,4
149772,9873,5053,4820,2,1
149772,9873,5053,4820,3,1
149772,1652,813,839,4,1
149772,8221,4240,3981,5,1
149772,1834,745,1089,12,3
149772,1243,644,599,19,1
149772,6978,3596,3382,20,1
149772,9605,4915,4690,21,4
149772,8805,4531,4274,22,1
149772,8805,4531,4274,23,1
149772,1608,786,822,24,1
149772,7197,3745,3452,25,1
149772,800,384,416,32,3
149772,1068,569,499,39,1
149772,6129,3176,2953,40,1
149772,2102,883,1219,41,4
149772,1068,522,546,42,1
149772,1068,522,546,43,1
149772,44,27,17,44,1
149772,1024,495,529,45,1
149772,1034,361,673,52,3
149772,175,75,100,59,1
149772,849,420,429,60,1
149781,2993,1412,1581,1,4
149781,2444,1190,1254,2,1
149781,2415,1172,1243,3,1
149781,597,281,316,4,1
149781,1818,891,927,5,1
149781,29,18,11,11,1
149781,549,222,327,12,3
149781,61,20,41,19,1
149781,1757,871,886,20,1
149781,2665,1264,1401,21,4
149781,2378,1152,1226,22,1
149781,2376,1151,1225,23,1
149781,597,281,316,24,1
149781,1779,870,909,25,1
149781,2,1,1,31,1
149781,287,112,175,32,3
149781,61,20,41,39,1
149781,1718,850,868,40,1
149781,328,148,180,41,4
149781,66,38,28,42,1
149781,39,21,18,43,1
149781,39,21,18,45,1
149781,27,17,10,51,1
149781,262,110,152,52,3
149781,39,21,18,60,1
149842,14830,6640,8190,1,4
149842,14830,6640,8190,2,1
149842,11217,5029,6188,3,1
149842,2381,1228,1153,4,1
149842,8836,3801,5035,5,1
149842,3613,1611,2002,11,1
149842,1657,606,1051,19,1
149842,7179,3195,3984,20,1
149842,5541,2907,2634,21,4
149842,5541,2907,2634,22,1
149842,4733,2456,2277,23,1
149842,1564,852,712,24,1
149842,3169,1604,1565,25,1
149842,808,451,357,31,1
149842,506,220,286,39,1
149842,2663,1384,1279,40,1
149842,9289,3733,5556,41,4
149842,9289,3733,5556,42,1
149842,6484,2573,3911,43,1
149842,817,376,441,44,1
149842,5667,2197,3470,45,1
149842,2805,1160,1645,51,1
149842,1151,386,765,59,1
149842,4516,1811,2705,60,1
150048,424,181,243,1,4
150048,424,181,243,2,1
150048,398,164,234,3,1
150048,151,82,69,4,1
150048,247,82,165,5,1
150048,26,17,9,11,1
150048,34,13,21,19,1
150048,213,69,144,20,1
150048,284,138,146,21,4
150048,284,138,146,22,1
150048,284,138,146,23,1
150048,143,77,66,24,1
150048,141,61,80,25,1
150048,23,11,12,39,1
150048,118,50,68,40,1
150048,140,43,97,41,4
150048,140,43,97,42,1
150048,114,26,88,43,1
150048,8,5,3,44,1
150048,106,21,85,45,1
150048,26,17,9,51,1
150048,11,2,9,59,1
150048,95,19,76,60,1
150066,2442,1060,1382,1,4
150066,2016,805,1211,2,1
150066,1862,743,1119,3,1
150066,442,175,267,4,1
150066,1420,568,852,5,1
150066,154,62,92,11,1
150066,426,255,171,12,3
150066,96,43,53,19,1
150066,1324,525,799,20,1
150066,1797,744,1053,21,4
150066,1737,703,1034,22,1
150066,1727,698,1029,23,1
150066,434,173,261,24,1
150066,1293,525,768,25,1
150066,10,5,5,31,1
150066,60,41,19,32,3
150066,74,38,36,39,1
150066,1219,487,732,40,1
150066,645,316,329,41,4
150066,279,102,177,42,1
150066,135,45,90,43,1
150066,8,2,6,44,1
150066,127,43,84,45,1
150066,144,57,87,51,1
150066,366,214,152,52,3
150066,22,5,17,59,1
150066,105,38,67,60,1
150075,9,0,9,1,4
150075,9,0,9,2,1
150075,9,0,9,3,1
150075,1,0,1,4,1
150075,8,0,8,5,1
150075,8,0,8,20,1
150075,9,0,9,21,4
150075,9,0,9,22,1
150075,9,0,9,23,1
150075,1,0,1,24,1
150075,8,0,8,25,1
150075,8,0,8,40,1
150136,20503,8210,12293,1,4
150136,16300,6877,9423,2,1
150136,15985,6735,9250,3,1
150136,3616,1381,2235,4,1
150136,12369,5354,7015,5,1
150136,315,142,173,11,1
150136,4203,1333,2870,12,3
150136,762,345,417,19,1
150136,11607,5009,6598,20,1
150136,16588,6929,9659,21,4
150136,15128,6347,8781,22,1
150136,15001,6304,8697,23,1
150136,3605,1378,2227,24,1
150136,11396,4926,6470,25,1
150136,127,43,84,31,1
150136,1460,582,878,32,3
150136,666,319,347,39,1
150136,10730,4607,6123,40,1
150136,3915,1281,2634,41,4
150136,1172,530,642,42,1
150136,984,431,553,43,1
150136,11,3,8,44,1
150136,973,428,545,45,1
150136,188,99,89,51,1
150136,2743,751,1992,52,3
150136,96,26,70,59,1
150136,877,402,475,60,1
150145,1804,634,1170,1,4
150145,1655,560,1095,2,1
150145,1579,532,1047,3,1
150145,248,99,149,4,1
150145,1331,433,898,5,1
150145,76,28,48,11,1
150145,149,74,75,12,3
150145,192,50,142,19,1
150145,1139,383,756,20,1
150145,1333,477,856,21,4
150145,1302,466,836,22,1
150145,1301,466,835,23,1
150145,245,99,146,24,1
150145,1056,367,689,25,1
150145,1,0,1,31,1
150145,31,11,20,32,3
150145,128,38,90,39,1
150145,928,329,599,40,1
150145,471,157,314,41,4
150145,353,94,259,42,1
150145,278,66,212,43,1
150145,3,0,3,44,1
150145,275,66,209,45,1
150145,75,28,47,51,1
150145,118,63,55,52,3
150145,64,12,52,59,1
150145,211,54,157,60,1
150163,4827,1939,2888,1,4
150163,4051,1599,2452,2,1
150163,3998,1573,2425,3,1
150163,1015,380,635,4,1
150163,2983,1193,1790,5,1
150163,53,26,27,11,1
150163,776,340,436,12,3
150163,290,119,171,19,1
150163,2693,1074,1619,20,1
150163,4348,1695,2653,21,4
150163,3974,1553,2421,22,1
150163,3948,1541,2407,23,1
150163,1014,379,635,24,1
150163,2934,1162,1772,25,1
150163,26,12,14,31,1
150163,374,142,232,32,3
150163,275,111,164,39,1
150163,2659,1051,1608,40,1
150163,479,244,235,41,4
150163,77,46,31,42,1
150163,50,32,18,43,1
150163,1,1,0,44,1
150163,49,31,18,45,1
150163,27,14,13,51,1
150163,402,198,204,52,3
150163,15,8,7,59,1
150163,34,23,11,60,1
150172,1140,635,505,1,4
150172,988,557,431,2,1
150172,988,557,431,3,1
150172,168,109,59,4,1
150172,820,448,372,5,1
150172,152,78,74,12,3
150172,138,74,64,19,1
150172,682,374,308,20,1
150172,622,326,296,21,4
150172,580,311,269,22,1
150172,580,311,269,23,1
150172,149,96,53,24,1
150172,431,215,216,25,1
150172,42,15,27,32,3
150172,94,54,40,39,1
150172,337,161,176,40,1
150172,518,309,209,41,4
150172,408,246,162,42,1
150172,408,246,162,43,1
150172,19,13,6,44,1
150172,389,233,156,45,1
150172,110,63,47,52,3
150172,44,20,24,59,1
150172,345,213,132,60,1
150215,188,67,121,1,4
150215,188,67,121,12,3
150215,129,43,86,21,4
150215,129,43,86,32,3
150215,59,24,35,41,4
150215,59,24,35,52,3
150251,265,17,248,1,4
150251,265,17,248,2,1
150251,252,14,238,3,1
150251,92,9,83,4,1
150251,160,5,155,5,1
150251,13,3,10,11,1
150251,160,5,155,20,1
150251,83,4,79,21,4
150251,83,4,79,22,1
150251,83,4,79,23,1
150251,49,4,45,24,1
150251,34,0,34,25,1
150251,34,0,34,40,1
150251,182,13,169,41,4
150251,182,13,169,42,1
150251,169,10,159,43,1
150251,43,5,38,44,1
150251,126,5,121,45,1
150251,13,3,10,51,1
150251,126,5,121,60,1
150288,301,268,33,1,4
150288,301,268,33,12,3
150288,239,210,29,21,4
150288,239,210,29,32,3
150288,62,58,4,41,4
150288,62,58,4,52,3
150303,182,5,177,1,4
150303,182,5,177,2,1
150303,182,5,177,3,1
150303,27,3,24,4,1
150303,155,2,153,5,1
150303,155,2,153,20,1
150303,126,3,123,21,4
150303,126,3,123,22,1
150303,126,3,123,23,1
150303,21,2,19,24,1
150303,105,1,104,25,1
150303,105,1,104,40,1
150303,56,2,54,41,4
150303,56,2,54,42,1
150303,56,2,54,43,1
150303,6,1,5,44,1
150303,50,1,49,45,1
150303,50,1,49,60,1
150400,2304,1045,1259,1,4
150400,2304,1045,1259,2,1
150400,2272,1031,1241,3,1
150400,641,283,358,4,1
150400,1631,748,883,5,1
150400,32,14,18,11,1
150400,21,13,8,19,1
150400,1610,735,875,20,1
150400,2280,1033,1247,21,4
150400,2280,1033,1247,22,1
150400,2269,1030,1239,23,1
150400,641,283,358,24,1
150400,1628,747,881,25,1
150400,11,3,8,31,1
150400,21,13,8,39,1
150400,1607,734,873,40,1
150400,24,12,12,41,4
150400,24,12,12,42,1
150400,3,1,2,43,1
150400,3,1,2,45,1
150400,21,11,10,51,1
150400,3,1,2,60,1
150428,53,2,51,1,4
150428,53,2,51,2,1
150428,53,2,51,3,1
150428,16,1,15,4,1
150428,37,1,36,5,1
150428,37,1,36,20,1
150428,49,2,47,21,4
150428,49,2,47,22,1
150428,49,2,47,23,1
150428,16,1,15,24,1
150428,33,1,32,25,1
150428,33,1,32,40,1
150428,4,0,4,41,4
150428,4,0,4,42,1
150428,4,0,4,43,1
150428,4,0,4,45,1
150428,4,0,4,60,1
150437,77,0,77,1,4
150437,77,0,77,2,1
150437,77,0,77,3,1
150437,20,0,20,4,1
150437,57,0,57,5,1
150437,57,0,57,20,1
150437,35,0,35,21,4
150437,35,0,35,22,1
150437,35,0,35,23,1
150437,20,0,20,24,1
150437,15,0,15,25,1
150437,15,0,15,40,1
150437,42,0,42,41,4
150437,42,0,42,42,1
150437,42,0,42,43,1
150437,42,0,42,45,1
150437,42,0,42,60,1
150455,1159,519,640,1,4
150455,1064,474,590,2,1
150455,1016,452,564,3,1
150455,253,113,140,4,1
150455,763,339,424,5,1
150455,48,22,26,11,1
150455,95,45,50,12,3
150455,18,9,9,19,1
150455,745,330,415,20,1
150455,1099,490,609,21,4
150455,1045,464,581,22,1
150455,1010,448,562,23,1
150455,253,113,140,24,1
150455,757,335,422,25,1
150455,35,16,19,31,1
150455,54,26,28,32,3
150455,18,9,9,39,1
150455,739,326,413,40,1
150455,60,29,31,41,4
150455,19,10,9,42,1
150455,6,4,2,43,1
150455,6,4,2,45,1
150455,13,6,7,51,1
150455,41,19,22,52,3
150455,6,4,2,60,1
150534,2630,1086,1544,1,4
150534,2477,1037,1440,2,1
150534,2373,993,1380,3,1
150534,543,236,307,4,1
150534,1830,757,1073,5,1
150534,104,44,60,11,1
150534,153,49,104,12,3
150534,67,32,35,19,1
150534,1763,725,1038,20,1
150534,2433,1002,1431,21,4
150534,2290,956,1334,22,1
150534,2290,956,1334,23,1
150534,543,236,307,24,1
150534,1747,720,1027,25,1
150534,143,46,97,32,3
150534,59,28,31,39,1
150534,1688,692,996,40,1
150534,197,84,113,41,4
150534,187,81,106,42,1
150534,83,37,46,43,1
150534,83,37,46,45,1
150534,104,44,60,51,1
150534,10,3,7,52,3
150534,8,4,4,59,1
150534,75,33,42,60,1
150604,1014,502,512,1,4
150604,1014,502,512,2,1
150604,969,483,486,3,1
150604,272,135,137,4,1
150604,697,348,349,5,1
150604,45,19,26,11,1
150604,15,9,6,19,1
150604,682,339,343,20,1
150604,952,471,481,21,4
150604,952,471,481,22,1
150604,952,471,481,23,1
150604,272,135,137,24,1
150604,680,336,344,25,1
150604,14,8,6,39,1
150604,666,328,338,40,1
150604,62,31,31,41,4
150604,62,31,31,42,1
150604,17,12,5,43,1
150604,17,12,5,45,1
150604,45,19,26,51,1
150604,1,1,0,59,1
150604,16,11,5,60,1
150668,888,368,520,1,4
150668,828,354,474,2,1
150668,778,327,451,3,1
150668,167,74,93,4,1
150668,611,253,358,5,1
150668,50,27,23,11,1
150668,60,14,46,12,3
150668,42,16,26,19,1
150668,569,237,332,20,1
150668,760,324,436,21,4
150668,745,315,430,22,1
150668,742,314,428,23,1
150668,167,74,93,24,1
150668,575,240,335,25,1
150668,3,1,2,31,1
150668,15,9,6,32,3
150668,40,16,24,39,1
150668,535,224,311,40,1
150668,128,44,84,41,4
150668,83,39,44,42,1
150668,36,13,23,43,1
150668,36,13,23,45,1
150668,47,26,21,51,1
150668,45,5,40,52,3
150668,2,0,2,59,1
150668,34,13,21,60,1
150677,1904,848,1056,1,4
150677,1615,665,950,2,1
150677,1286,544,742,3,1
150677,372,158,214,4,1
150677,914,386,528,5,1
150677,329,121,208,11,1
150677,289,183,106,12,3
150677,52,26,26,19,1
150677,862,360,502,20,1
150677,1416,608,808,21,4
150677,1274,526,748,22,1
150677,1255,524,731,23,1
150677,372,158,214,24,1
150677,883,366,517,25,1
150677,19,2,17,31,1
150677,142,82,60,32,3
150677,51,25,26,39,1
150677,832,341,491,40,1
150677,488,240,248,41,4
150677,341,139,202,42,1
150677,31,20,11,43,1
150677,31,20,11,45,1
150677,310,119,191,51,1
150677,147,101,46,52,3
150677,1,1,0,59,1
150677,30,19,11,60,1
150695,70,2,68,1,4
150695,70,2,68,2,1
150695,70,2,68,3,1
150695,31,1,30,4,1
150695,39,1,38,5,1
150695,39,1,38,20,1
150695,70,2,68,21,4
150695,70,2,68,22,1
150695,70,2,68,23,1
150695,31,1,30,24,1
150695,39,1,38,25,1
150695,39,1,38,40,1
150710,108,59,49,1,4
150710,108,59,49,2,1
150710,108,59,49,3,1
150710,37,21,16,4,1
150710,71,38,33,5,1
150710,71,38,33,20,1
150710,108,59,49,21,4
150710,108,59,49,22,1
150710,108,59,49,23,1
150710,37,21,16,24,1
150710,71,38,33,25,1
150710,71,38,33,40,1
150756,1163,499,664,1,4
150756,1163,499,664,2,1
150756,1159,496,663,3,1
150756,334,136,198,4,1
150756,825,360,465,5,1
150756,4,3,1,11,1
150756,15,7,8,19,1
150756,810,353,457,20,1
150756,1158,497,661,21,4
150756,1158,497,661,22,1
150756,1156,495,661,23,1
150756,334,136,198,24,1
150756,822,359,463,25,1
150756,2,2,0,31,1
150756,15,7,8,39,1
150756,807,352,455,40,1
150756,5,2,3,41,4
150756,5,2,3,42,1
150756,3,1,2,43,1
150756,3,1,2,45,1
150756,2,1,1,51,1
150756,3,1,2,60,1
150765,86,3,83,1,4
150765,86,3,83,2,1
150765,86,3,83,3,1
150765,16,0,16,4,1
150765,70,3,67,5,1
150765,70,3,67,20,1
150765,86,3,83,21,4
150765,86,3,83,22,1
150765,86,3,83,23,1
150765,16,0,16,24,1
150765,70,3,67,25,1
150765,70,3,67,40,1
150774,524,329,195,1,4
150774,524,329,195,2,1
150774,490,305,185,3,1
150774,165,96,69,4,1
150774,325,209,116,5,1
150774,34,24,10,11,1
150774,42,26,16,19,1
150774,283,183,100,20,1
150774,496,311,185,21,4
150774,496,311,185,22,1
150774,481,299,182,23,1
150774,165,96,69,24,1
150774,316,203,113,25,1
150774,15,12,3,31,1
150774,39,25,14,39,1
150774,277,178,99,40,1
150774,28,18,10,41,4
150774,28,18,10,42,1
150774,9,6,3,43,1
150774,9,6,3,45,1
150774,19,12,7,51,1
150774,3,1,2,59,1
150774,6,5,1,60,1
150853,116,5,111,1,4
150853,116,5,111,2,1
150853,116,5,111,3,1
150853,14,1,13,4,1
150853,102,4,98,5,1
150853,102,4,98,20,1
150853,94,5,89,21,4
150853,94,5,89,22,1
150853,94,5,89,23,1
150853,13,1,12,24,1
150853,81,4,77,25,1
150853,81,4,77,40,1
150853,22,0,22,41,4
150853,22,0,22,42,1
150853,22,0,22,43,1
150853,1,0,1,44,1
150853,21,0,21,45,1
150853,21,0,21,60,1
150941,1124,475,649,1,4
150941,1053,448,605,2,1
150941,1030,441,589,3,1
150941,226,106,120,4,1
150941,804,335,469,5,1
150941,23,7,16,11,1
150941,71,27,44,12,3
150941,34,17,17,19,1
150941,770,318,452,20,1
150941,990,413,577,21,4
150941,960,405,555,22,1
150941,960,405,555,23,1
150941,225,105,120,24,1
150941,735,300,435,25,1
150941,30,8,22,32,3
150941,33,17,16,39,1
150941,702,283,419,40,1
150941,134,62,72,41,4
150941,93,43,50,42,1
150941,70,36,34,43,1
150941,1,1,0,44,1
150941,69,35,34,45,1
150941,23,7,16,51,1
150941,41,19,22,52,3
150941,1,0,1,59,1
150941,68,35,33,60,1
150987,98778,40884,57894,1,4
150987,98778,40884,57894,2,1
150987,87017,35595,51422,3,1
150987,16181,7545,8636,4,1
150987,70836,28050,42786,5,1
150987,11761,5289,6472,11,1
150987,5018,2098,2920,19,1
150987,65818,25952,39866,20,1
150987,34212,14511,19701,21,4
150987,34212,14511,19701,22,1
150987,33497,14124,19373,23,1
150987,8051,3836,4215,24,1
150987,25446,10288,15158,25,1
150987,715,387,328,31,1
150987,2275,1017,1258,39,1
150987,23171,9271,13900,40,1
150987,64566,26373,38193,41,4
150987,64566,26373,38193,42,1
150987,53520,21471,32049,43,1
150987,8130,3709,4421,44,1
150987,45390,17762,27628,45,1
150987,11046,4902,6144,51,1
150987,2743,1081,1662,59,1
150987,42647,16681,25966,60,1
151102,13459,6042,7417,1,4
151102,12928,5827,7101,2,1
151102,9795,4537,5258,3,1
151102,1660,762,898,4,1
151102,8135,3775,4360,5,1
151102,3133,1290,1843,11,1
151102,531,215,316,12,3
151102,536,232,304,19,1
151102,7599,3543,4056,20,1
151102,7537,3492,4045,21,4
151102,7418,3431,3987,22,1
151102,7346,3419,3927,23,1
151102,1577,726,851,24,1
151102,5769,2693,3076,25,1
151102,72,12,60,31,1
151102,119,61,58,32,3
151102,407,191,216,39,1
151102,5362,2502,2860,40,1
151102,5922,2550,3372,41,4
151102,5510,2396,3114,42,1
151102,2449,1118,1331,43,1
151102,83,36,47,44,1
151102,2366,1082,1284,45,1
151102,3061,1278,1783,51,1
151102,412,154,258,52,3
151102,129,41,88,59,1
151102,2237,1041,1196,60,1
151111,30488,13273,17215,1,4
151111,22409,9747,12662,2,1
151111,21569,9390,12179,3,1
151111,3795,1613,2182,4,1
151111,17774,7777,9997,5,1
151111,840,357,483,11,1
151111,8079,3526,4553,12,3
151111,1754,770,984,19,1
151111,16020,7007,9013,20,1
151111,21097,9278,11819,21,4
151111,16760,7303,9457,22,1
151111,16616,7239,9377,23,1
151111,3503,1480,2023,24,1
151111,13113,5759,7354,25,1
151111,144,64,80,31,1
151111,4337,1975,2362,32,3
151111,1314,573,741,39,1
151111,11799,5186,6613,40,1
151111,9391,3995,5396,41,4
151111,5649,2444,3205,42,1
151111,4953,2151,2802,43,1
151111,292,133,159,44,1
151111,4661,2018,2643,45,1
151111,696,293,403,51,1
151111,3742,1551,2191,52,3
151111,440,197,243,59,1
151111,4221,1821,2400,60,1
151166,3726,681,3045,1,4
151166,3726,681,3045,2,1
151166,3726,681,3045,3,1
151166,312,78,234,4,1
151166,3414,603,2811,5,1
151166,524,100,424,19,1
151166,2890,503,2387,20,1
151166,2395,451,1944,21,4
151166,2395,451,1944,22,1
151166,2395,451,1944,23,1
151166,214,57,157,24,1
151166,2181,394,1787,25,1
151166,344,75,269,39,1
151166,1837,319,1518,40,1
151166,1331,230,1101,41,4
151166,1331,230,1101,42,1
151166,1331,230,1101,43,1
151166,98,21,77,44,1
151166,1233,209,1024,45,1
151166,180,25,155,59,1
151166,1053,184,869,60,1
151263,5452,1696,3756,1,4
151263,4162,1385,2777,2,1
151263,4108,1362,2746,3,1
151263,834,285,549,4,1
151263,3274,1077,2197,5,1
151263,54,23,31,11,1
151263,1290,311,979,12,3
151263,269,120,149,19,1
151263,3005,957,2048,20,1
151263,3609,1285,2324,21,4
151263,3169,1178,1991,22,1
151263,3167,1176,1991,23,1
151263,800,271,529,24,1
151263,2367,905,1462,25,1
151263,2,2,0,31,1
151263,440,107,333,32,3
151263,170,96,74,39,1
151263,2197,809,1388,40,1
151263,1843,411,1432,41,4
151263,993,207,786,42,1
151263,941,186,755,43,1
151263,34,14,20,44,1
151263,907,172,735,45,1
151263,52,21,31,51,1
151263,850,204,646,52,3
151263,99,24,75,59,1
151263,808,148,660,60,1
151290,6307,2456,3851,1,4
151290,5717,2166,3551,2,1
151290,5670,2143,3527,3,1
151290,920,404,516,4,1
151290,4750,1739,3011,5,1
151290,47,23,24,11,1
151290,590,290,300,12,3
151290,884,265,619,19,1
151290,3866,1474,2392,20,1
151290,4016,1568,2448,21,4
151290,3710,1430,2280,22,1
151290,3686,1416,2270,23,1
151290,571,283,288,24,1
151290,3115,1133,1982,25,1
151290,24,14,10,31,1
151290,306,138,168,32,3
151290,433,126,307,39,1
151290,2682,1007,1675,40,1
151290,2291,888,1403,41,4
151290,2007,736,1271,42,1
151290,1984,727,1257,43,1
151290,349,121,228,44,1
151290,1635,606,1029,45,1
151290,23,9,14,51,1
151290,284,152,132,52,3
151290,451,139,312,59,1
151290,1184,467,717,60,1
151306,9902,3824,6078,1,4
151306,8913,3637,5276,2,1
151306,8764,3578,5186,3,1
151306,1709,703,1006,4,1
151306,7055,2875,4180,5,1
151306,149,59,90,11,1
151306,989,187,802,12,3
151306,570,221,349,19,1
151306,6485,2654,3831,20,1
151306,7513,3110,4403,21,4
151306,7375,3079,4296,22,1
151306,7339,3065,4274,23,1
151306,1688,692,996,24,1
151306,5651,2373,3278,25,1
151306,36,14,22,31,1
151306,138,31,107,32,3
151306,427,186,241,39,1
151306,5224,2187,3037,40,1
151306,2389,714,1675,41,4
151306,1538,558,980,42,1
151306,1425,513,912,43,1
151306,21,11,10,44,1
151306,1404,502,902,45,1
151306,113,45,68,51,1
151306,851,156,695,52,3
151306,143,35,108,59,1
151306,1261,467,794,60,1
151324,12448,5588,6860,1,4
151324,10268,4713,5555,2,1
151324,10173,4673,5500,3,1
151324,2661,1116,1545,4,1
151324,7512,3557,3955,5,1
151324,95,40,55,11,1
151324,2180,875,1305,12,3
151324,719,367,352,19,1
151324,6793,3190,3603,20,1
151324,10068,4645,5423,21,4
151324,9131,4261,4870,22,1
151324,9122,4259,4863,23,1
151324,2654,1110,1544,24,1
151324,6468,3149,3319,25,1
151324,9,2,7,31,1
151324,937,384,553,32,3
151324,549,312,237,39,1
151324,5919,2837,3082,40,1
151324,2380,943,1437,41,4
151324,1137,452,685,42,1
151324,1051,414,637,43,1
151324,7,6,1,44,1
151324,1044,408,636,45,1
151324,86,38,48,51,1
151324,1243,491,752,52,3
151324,170,55,115,59,1
151324,874,353,521,60,1
151333,4178,1503,2675,1,4
151333,3981,1419,2562,2,1
151333,2708,901,1807,3,1
151333,508,179,329,4,1
151333,2200,722,1478,5,1
151333,1273,518,755,11,1
151333,197,84,113,12,3
151333,310,106,204,19,1
151333,1890,616,1274,20,1
151333,2063,730,1333,21,4
151333,2012,692,1320,22,1
151333,2002,686,1316,23,1
151333,461,164,297,24,1
151333,1541,522,1019,25,1
151333,10,6,4,31,1
151333,51,38,13,32,3
151333,210,76,134,39,1
151333,1331,446,885,40,1
151333,2115,773,1342,41,4
151333,1969,727,1242,42,1
151333,706,215,491,43,1
151333,47,15,32,44,1
151333,659,200,459,45,1
151333,1263,512,751,51,1
151333,146,46,100,52,3
151333,100,30,70,59,1
151333,559,170,389,60,1
151342,8073,3138,4935,1,4
151342,7512,2945,4567,2,1
151342,5538,2112,3426,3,1
151342,921,368,553,4,1
151342,4617,1744,2873,5,1
151342,1974,833,1141,11,1
151342,561,193,368,12,3
151342,407,155,252,19,1
151342,4210,1589,2621,20,1
151342,4083,1562,2521,21,4
151342,3984,1529,2455,22,1
151342,3944,1511,2433,23,1
151342,835,332,503,24,1
151342,3109,1179,1930,25,1
151342,40,18,22,31,1
151342,99,33,66,32,3
151342,294,122,172,39,1
151342,2815,1057,1758,40,1
151342,3990,1576,2414,41,4
151342,3528,1416,2112,42,1
151342,1594,601,993,43,1
151342,86,36,50,44,1
151342,1508,565,943,45,1
151342,1934,815,1119,51,1
151342,462,160,302,52,3
151342,113,33,80,59,1
151342,1395,532,863,60,1
151351,46817,23141,23676,1,4
151351,36862,17927,18935,2,1
151351,31984,15938,16046,3,1
151351,7604,3874,3730,4,1
151351,24380,12064,12316,5,1
151351,4878,1989,2889,11,1
151351,9955,5214,4741,12,3
151351,951,541,410,19,1
151351,23429,11523,11906,20,1
151351,37467,18902,18565,21,4
151351,31050,15417,15633,22,1
151351,30910,15352,15558,23,1
151351,7583,3859,3724,24,1
151351,23327,11493,11834,25,1
151351,140,65,75,31,1
151351,6417,3485,2932,32,3
151351,918,521,397,39,1
151351,22409,10972,11437,40,1
151351,9350,4239,5111,41,4
151351,5812,2510,3302,42,1
151351,1074,586,488,43,1
151351,21,15,6,44,1
151351,1053,571,482,45,1
151351,4738,1924,2814,51,1
151351,3538,1729,1809,52,3
151351,33,20,13,59,1
151351,1020,551,469,60,1
151360,6387,2124,4263,1,4
151360,5904,1984,3920,2,1
151360,4764,1510,3254,3,1
151360,830,320,510,4,1
151360,3934,1190,2744,5,1
151360,1140,474,666,11,1
151360,483,140,343,12,3
151360,383,121,262,19,1
151360,3551,1069,2482,20,1
151360,3358,1132,2226,21,4
151360,3221,1077,2144,22,1
151360,3189,1059,2130,23,1
151360,696,267,429,24,1
151360,2493,792,1701,25,1
151360,32,18,14,31,1
151360,137,55,82,32,3
151360,240,84,156,39,1
151360,2253,708,1545,40,1
151360,3029,992,2037,41,4
151360,2683,907,1776,42,1
151360,1575,451,1124,43,1
151360,134,53,81,44,1
151360,1441,398,1043,45,1
151360,1108,456,652,51,1
151360,346,85,261,52,3
151360,143,37,106,59,1
151360,1298,361,937,60,1
151379,6733,2782,3951,1,4
151379,6148,2573,3575,2,1
151379,5699,2405,3294,3,1
151379,1026,429,597,4,1
151379,4673,1976,2697,5,1
151379,449,168,281,11,1
151379,585,209,376,12,3
151379,510,224,286,19,1
151379,4163,1752,2411,20,1
151379,3695,1520,2175,21,4
151379,3665,1510,2155,22,1
151379,3643,1502,2141,23,1
151379,909,362,547,24,1
151379,2734,1140,1594,25,1
151379,22,8,14,31,1
151379,30,10,20,32,3
151379,331,161,170,39,1
151379,2403,979,1424,40,1
151379,3038,1262,1776,41,4
151379,2483,1063,1420,42,1
151379,2056,903,1153,43,1
151379,117,67,50,44,1
151379,1939,836,1103,45,1
151379,427,160,267,51,1
151379,555,199,356,52,3
151379,179,63,116,59,1
151379,1760,773,987,60,1
151388,4456,1563,2893,1,4
151388,4326,1533,2793,2,1
151388,3132,1071,2061,3,1
151388,404,157,247,4,1
151388,2728,914,1814,5,1
151388,1194,462,732,11,1
151388,130,30,100,12,3
151388,471,179,292,19,1
151388,2257,735,1522,20,1
151388,2009,702,1307,21,4
151388,1948,686,1262,22,1
151388,1925,676,1249,23,1
151388,386,151,235,24,1
151388,1539,525,1014,25,1
151388,23,10,13,31,1
151388,61,16,45,32,3
151388,243,92,151,39,1
151388,1296,433,863,40,1
151388,2447,861,1586,41,4
151388,2378,847,1531,42,1
151388,1207,395,812,43,1
151388,18,6,12,44,1
151388,1189,389,800,45,1
151388,1171,452,719,51,1
151388,69,14,55,52,3
151388,228,87,141,59,1
151388,961,302,659,60,1
151458,406,95,311,1,4
151458,406,95,311,2,1
151458,406,95,311,3,1
151458,167,37,130,4,1
151458,239,58,181,5,1
151458,86,13,73,19,1
151458,153,45,108,20,1
151458,406,95,311,21,4
151458,406,95,311,22,1
151458,406,95,311,23,1
151458,167,37,130,24,1
151458,239,58,181,25,1
151458,86,13,73,39,1
151458,153,45,108,40,1
151467,399,81,318,1,4
151467,399,81,318,2,1
151467,399,81,318,3,1
151467,159,35,124,4,1
151467,240,46,194,5,1
151467,101,13,88,19,1
151467,139,33,106,20,1
151467,399,81,318,21,4
151467,399,81,318,22,1
151467,399,81,318,23,1
151467,159,35,124,24,1
151467,240,46,194,25,1
151467,101,13,88,39,1
151467,139,33,106,40,1
151494,525,360,165,1,4
151494,525,360,165,2,1
151494,525,360,165,3,1
151494,55,40,15,4,1
151494,470,320,150,5,1
151494,9,5,4,19,1
151494,461,315,146,20,1
151494,381,288,93,21,4
151494,381,288,93,22,1
151494,381,288,93,23,1
151494,50,37,13,24,1
151494,331,251,80,25,1
151494,5,3,2,39,1
151494,326,248,78,40,1
151494,144,72,72,41,4
151494,144,72,72,42,1
151494,144,72,72,43,1
151494,5,3,2,44,1
151494,139,69,70,45,1
151494,4,2,2,59,1
151494,135,67,68,60,1
151500,283,174,109,1,4
151500,283,174,109,2,1
151500,283,174,109,3,1
151500,41,28,13,4,1
151500,242,146,96,5,1
151500,3,1,2,19,1
151500,239,145,94,20,1
151500,196,127,69,21,4
151500,196,127,69,22,1
151500,196,127,69,23,1
151500,32,24,8,24,1
151500,164,103,61,25,1
151500,3,1,2,39,1
151500,161,102,59,40,1
151500,87,47,40,41,4
151500,87,47,40,42,1
151500,87,47,40,43,1
151500,9,4,5,44,1
151500,78,43,35,45,1
151500,78,43,35,60,1
151519,4397,2804,1593,1,4
151519,4296,2738,1558,2,1
151519,4296,2738,1558,3,1
151519,770,440,330,4,1
151519,3526,2298,1228,5,1
151519,101,66,35,12,3
151519,105,61,44,19,1
151519,3421,2237,1184,20,1
151519,2375,1552,823,21,4
151519,2375,1552,823,22,1
151519,2375,1552,823,23,1
151519,411,238,173,24,1
151519,1964,1314,650,25,1
151519,62,31,31,39,1
151519,1902,1283,619,40,1
151519,2022,1252,770,41,4
151519,1921,1186,735,42,1
151519,1921,1186,735,43,1
151519,359,202,157,44,1
151519,1562,984,578,45,1
151519,101,66,35,52,3
151519,43,30,13,59,1
151519,1519,954,565,60,1
151537,40,3,37,1,4
151537,40,3,37,2,1
151537,40,3,37,3,1
151537,39,3,36,4,1
151537,1,0,1,5,1
151537,1,0,1,20,1
151537,40,3,37,21,4
151537,40,3,37,22,1
151537,40,3,37,23,1
151537,39,3,36,24,1
151537,1,0,1,25,1
151537,1,0,1,40,1
151564,39,0,39,1,4
151564,39,0,39,2,1
151564,39,0,39,3,1
151564,33,0,33,4,1
151564,6,0,6,5,1
151564,6,0,6,20,1
151564,16,0,16,21,4
151564,16,0,16,22,1
151564,16,0,16,23,1
151564,12,0,12,24,1
151564,4,0,4,25,1
151564,4,0,4,40,1
151564,23,0,23,41,4
151564,23,0,23,42,1
151564,23,0,23,43,1
151564,21,0,21,44,1
151564,2,0,2,45,1
151564,2,0,2,60,1
151607,82,1,81,1,4
151607,82,1,81,2,1
151607,82,1,81,3,1
151607,19,0,19,4,1
151607,63,1,62,5,1
151607,63,1,62,20,1
151607,61,1,60,21,4
151607,61,1,60,22,1
151607,61,1,60,23,1
151607,9,0,9,24,1
151607,52,1,51,25,1
151607,52,1,51,40,1
151607,21,0,21,41,4
151607,21,0,21,42,1
151607,21,0,21,43,1
151607,10,0,10,44,1
151607,11,0,11,45,1
151607,11,0,11,60,1
151616,619,139,480,1,4
151616,619,139,480,2,1
151616,619,139,480,3,1
151616,98,43,55,4,1
151616,521,96,425,5,1
151616,102,20,82,19,1
151616,419,76,343,20,1
151616,619,139,480,21,4
151616,619,139,480,22,1
151616,619,139,480,23,1
151616,98,43,55,24,1
151616,521,96,425,25,1
151616,102,20,82,39,1
151616,419,76,343,40,1
151625,290,60,230,1,4
151625,290,60,230,2,1
151625,290,60,230,3,1
151625,42,16,26,4,1
151625,248,44,204,5,1
151625,26,8,18,19,1
151625,222,36,186,20,1
151625,290,60,230,21,4
151625,290,60,230,22,1
151625,290,60,230,23,1
151625,42,16,26,24,1
151625,248,44,204,25,1
151625,26,8,18,39,1
151625,222,36,186,40,1
151652,194,15,179,1,4
151652,194,15,179,2,1
151652,194,15,179,3,1
151652,75,8,67,4,1
151652,119,7,112,5,1
151652,119,7,112,20,1
151652,155,15,140,21,4
151652,155,15,140,22,1
151652,155,15,140,23,1
151652,62,8,54,24,1
151652,93,7,86,25,1
151652,93,7,86,40,1
151652,39,0,39,41,4
151652,39,0,39,42,1
151652,39,0,39,43,1
151652,13,0,13,44,1
151652,26,0,26,45,1
151652,26,0,26,60,1
151661,1240,1208,32,1,4
151661,1240,1208,32,2,1
151661,1240,1208,32,3,1
151661,276,269,7,4,1
151661,964,939,25,5,1
151661,1,1,0,19,1
151661,963,938,25,20,1
151661,1240,1208,32,21,4
151661,1240,1208,32,22,1
151661,1240,1208,32,23,1
151661,276,269,7,24,1
151661,964,939,25,25,1
151661,1,1,0,39,1
151661,963,938,25,40,1
151777,1349,627,722,1,4
151777,1199,568,631,2,1
151777,1188,566,622,3,1
151777,367,182,185,4,1
151777,821,384,437,5,1
151777,11,2,9,11,1
151777,150,59,91,12,3
151777,20,15,5,19,1
151777,801,369,432,20,1
151777,1327,617,710,21,4
151777,1182,560,622,22,1
151777,1179,560,619,23,1
151777,367,182,185,24,1
151777,812,378,434,25,1
151777,3,0,3,31,1
151777,145,57,88,32,3
151777,20,15,5,39,1
151777,792,363,429,40,1
151777,22,10,12,41,4
151777,17,8,9,42,1
151777,9,6,3,43,1
151777,9,6,3,45,1
151777,8,2,6,51,1
151777,5,2,3,52,3
151777,9,6,3,60,1
151786,2714,999,1715,1,4
151786,2203,799,1404,2,1
151786,2054,738,1316,3,1
151786,336,173,163,4,1
151786,1718,565,1153,5,1
151786,149,61,88,11,1
151786,511,200,311,12,3
151786,295,78,217,19,1
151786,1423,487,936,20,1
151786,1863,755,1108,21,4
151786,1679,662,1017,22,1
151786,1675,659,1016,23,1
151786,334,173,161,24,1
151786,1341,486,855,25,1
151786,4,3,1,31,1
151786,184,93,91,32,3
151786,176,57,119,39,1
151786,1165,429,736,40,1
151786,851,244,607,41,4
151786,524,137,387,42,1
151786,379,79,300,43,1
151786,2,0,2,44,1
151786,377,79,298,45,1
151786,145,58,87,51,1
151786,327,107,220,52,3
151786,119,21,98,59,1
151786,258,58,200,60,1
151801,14959,5075,9884,1,4
151801,10766,3598,7168,2,1
151801,10625,3552,7073,3,1
151801,1437,511,926,4,1
151801,9188,3041,6147,5,1
151801,141,46,95,11,1
151801,4193,1477,2716,12,3
151801,1586,484,1102,19,1
151801,7602,2557,5045,20,1
151801,13321,4513,8808,21,4
151801,9581,3189,6392,22,1
151801,9581,3189,6392,23,1
151801,1358,485,873,24,1
151801,8223,2704,5519,25,1
151801,3740,1324,2416,32,3
151801,1499,454,1045,39,1
151801,6724,2250,4474,40,1
151801,1638,562,1076,41,4
151801,1185,409,776,42,1
151801,1044,363,681,43,1
151801,79,26,53,44,1
151801,965,337,628,45,1
151801,141,46,95,51,1
151801,453,153,300,52,3
151801,87,30,57,59,1
151801,878,307,571,60,1
151810,506,157,349,1,4
151810,452,143,309,2,1
151810,452,143,309,3,1
151810,54,19,35,4,1
151810,398,124,274,5,1
151810,54,14,40,12,3
151810,42,10,32,19,1
151810,356,114,242,20,1
151810,215,66,149,21,4
151810,192,56,136,22,1
151810,192,56,136,23,1
151810,23,8,15,24,1
151810,169,48,121,25,1
151810,23,10,13,32,3
151810,27,5,22,39,1
151810,142,43,99,40,1
151810,291,91,200,41,4
151810,260,87,173,42,1
151810,260,87,173,43,1
151810,31,11,20,44,1
151810,229,76,153,45,1
151810,31,4,27,52,3
151810,15,5,10,59,1
151810,214,71,143,60,1
151829,96,4,92,1,4
151829,96,4,92,2,1
151829,96,4,92,3,1
151829,21,0,21,4,1
151829,75,4,71,5,1
151829,75,4,71,20,1
151829,96,4,92,21,4
151829,96,4,92,22,1
151829,96,4,92,23,1
151829,21,0,21,24,1
151829,75,4,71,25,1
151829,75,4,71,40,1
151865,101,50,51,1,4
151865,101,50,51,12,3
151865,31,16,15,21,4
151865,31,16,15,32,3
151865,70,34,36,41,4
151865,70,34,36,52,3
151874,62,27,35,1,4
151874,62,27,35,2,1
151874,62,27,35,3,1
151874,26,10,16,4,1
151874,36,17,19,5,1
151874,36,17,19,20,1
151874,53,22,31,21,4
151874,53,22,31,22,1
151874,53,22,31,23,1
151874,24,10,14,24,1
151874,29,12,17,25,1
151874,29,12,17,40,1
151874,9,5,4,41,4
151874,9,5,4,42,1
151874,9,5,4,43,1
151874,2,0,2,44,1
151874,7,5,2,45,1
151874,7,5,2,60,1
151944,423,86,337,1,4
151944,423,86,337,2,1
151944,423,86,337,3,1
151944,67,17,50,4,1
151944,356,69,287,5,1
151944,66,12,54,19,1
151944,290,57,233,20,1
151944,423,86,337,21,4
151944,423,86,337,22,1
151944,423,86,337,23,1
151944,67,17,50,24,1
151944,356,69,287,25,1
151944,66,12,54,39,1
151944,290,57,233,40,1
151962,63,34,29,1,4
151962,63,34,29,2,1
151962,63,34,29,3,1
151962,16,10,6,4,1
151962,47,24,23,5,1
151962,17,8,9,19,1
151962,30,16,14,20,1
151962,63,34,29,21,4
151962,63,34,29,22,1
151962,63,34,29,23,1
151962,16,10,6,24,1
151962,47,24,23,25,1
151962,17,8,9,39,1
151962,30,16,14,40,1
152044,87,27,60,1,4
152044,87,27,60,2,1
152044,87,27,60,3,1
152044,37,4,33,4,1
152044,50,23,27,5,1
152044,50,23,27,20,1
152044,15,8,7,21,4
152044,15,8,7,22,1
152044,15,8,7,23,1
152044,3,1,2,24,1
152044,12,7,5,25,1
152044,12,7,5,40,1
152044,72,19,53,41,4
152044,72,19,53,42,1
152044,72,19,53,43,1
152044,34,3,31,44,1
152044,38,16,22,45,1
152044,38,16,22,60,1
152080,12124,6650,5474,1,4
152080,8477,4465,4012,2,1
152080,8466,4460,4006,3,1
152080,2070,1077,993,4,1
152080,6396,3383,3013,5,1
152080,11,5,6,11,1
152080,3647,2185,1462,12,3
152080,127,65,62,19,1
152080,6269,3318,2951,20,1
152080,11908,6560,5348,21,4
152080,8459,4452,4007,22,1
152080,8449,4448,4001,23,1
152080,2070,1077,993,24,1
152080,6379,3371,3008,25,1
152080,10,4,6,31,1
152080,3449,2108,1341,32,3
152080,127,65,62,39,1
152080,6252,3306,2946,40,1
152080,216,90,126,41,4
152080,18,13,5,42,1
152080,17,12,5,43,1
152080,17,12,5,45,1
152080,1,1,0,51,1
152080,198,77,121,52,3
152080,17,12,5,60,1
152099,2418,959,1459,1,4
152099,2311,904,1407,2,1
152099,587,284,303,3,1
152099,104,50,54,4,1
152099,483,234,249,5,1
152099,1724,620,1104,11,1
152099,107,55,52,12,3
152099,38,21,17,19,1
152099,445,213,232,20,1
152099,494,233,261,21,4
152099,461,216,245,22,1
152099,461,216,245,23,1
152099,99,47,52,24,1
152099,362,169,193,25,1
152099,33,17,16,32,3
152099,33,17,16,39,1
152099,329,152,177,40,1
152099,1924,726,1198,41,4
152099,1850,688,1162,42,1
152099,126,68,58,43,1
152099,5,3,2,44,1
152099,121,65,56,45,1
152099,1724,620,1104,51,1
152099,74,38,36,52,3
152099,5,4,1,59,1
152099,116,61,55,60,1
152150,37,2,35,1,4
152150,37,2,35,2,1
152150,37,2,35,3,1
152150,18,0,18,4,1
152150,19,2,17,5,1
152150,19,2,17,20,1
152150,15,2,13,21,4
152150,15,2,13,22,1
152150,15,2,13,23,1
152150,4,0,4,24,1
152150,11,2,9,25,1
152150,11,2,9,40,1
152150,22,0,22,41,4
152150,22,0,22,42,1
152150,22,0,22,43,1
152150,14,0,14,44,1
152150,8,0,8,45,1
152150,8,0,8,60,1
152220,81,6,75,1,4
152220,81,6,75,2,1
152220,81,6,75,3,1
152220,81,6,75,5,1
152220,81,6,75,20,1
152220,81,6,75,21,4
152220,81,6,75,22,1
152220,81,6,75,23,1
152220,81,6,75,25,1
152220,81,6,75,40,1
152248,9422,4020,5402,1,4
152248,8390,3599,4791,2,1
152248,7466,3176,4290,3,1
152248,827,447,380,4,1
152248,6639,2729,3910,5,1
152248,924,423,501,11,1
152248,1032,421,611,12,3
152248,710,245,465,19,1
152248,5929,2484,3445,20,1
152248,5168,2629,2539,21,4
152248,4836,2455,2381,22,1
152248,4725,2375,2350,23,1
152248,792,431,361,24,1
152248,3933,1944,1989,25,1
152248,111,80,31,31,1
152248,332,174,158,32,3
152248,383,199,184,39,1
152248,3550,1745,1805,40,1
152248,4254,1391,2863,41,4
152248,3554,1144,2410,42,1
152248,2741,801,1940,43,1
152248,35,16,19,44,1
152248,2706,785,1921,45,1
152248,813,343,470,51,1
152248,700,247,453,52,3
152248,327,46,281,59,1
152248,2379,739,1640,60,1
152266,6102,2456,3646,1,4
152266,6054,2428,3626,2,1
152266,3514,1455,2059,3,1
152266,653,287,366,4,1
152266,2861,1168,1693,5,1
152266,2540,973,1567,11,1
152266,48,28,20,12,3
152266,327,166,161,19,1
152266,2534,1002,1532,20,1
152266,2732,1184,1548,21,4
152266,2732,1184,1548,22,1
152266,2641,1138,1503,23,1
152266,611,267,344,24,1
152266,2030,871,1159,25,1
152266,91,46,45,31,1
152266,246,138,108,39,1
152266,1784,733,1051,40,1
152266,3370,1272,2098,41,4
152266,3322,1244,2078,42,1
152266,873,317,556,43,1
152266,42,20,22,44,1
152266,831,297,534,45,1
152266,2449,927,1522,51,1
152266,48,28,20,52,3
152266,81,28,53,59,1
152266,750,269,481,60,1
152275,187,60,127,1,4
152275,187,60,127,2,1
152275,187,60,127,3,1
152275,16,3,13,4,1
152275,171,57,114,5,1
152275,171,57,114,20,1
152275,122,37,85,21,4
152275,122,37,85,22,1
152275,122,37,85,23,1
152275,10,1,9,24,1
152275,112,36,76,25,1
152275,112,36,76,40,1
152275,65,23,42,41,4
152275,65,23,42,42,1
152275,65,23,42,43,1
152275,6,2,4,44,1
152275,59,21,38,45,1
152275,59,21,38,60,1
152309,51,6,45,1,4
152309,51,6,45,2,1
152309,51,6,45,3,1
152309,49,6,43,4,1
152309,2,0,2,5,1
152309,2,0,2,20,1
152309,49,5,44,21,4
152309,49,5,44,22,1
152309,49,5,44,23,1
152309,48,5,43,24,1
152309,1,0,1,25,1
152309,1,0,1,40,1
152309,2,1,1,41,4
152309,2,1,1,42,1
152309,2,1,1,43,1
152309,1,1,0,44,1
152309,1,0,1,45,1
152309,1,0,1,60,1
152318,2302,1803,499,1,4
152318,2205,1727,478,2,1
152318,2165,1702,463,3,1
152318,559,435,124,4,1
152318,1606,1267,339,5,1
152318,40,25,15,11,1
152318,97,76,21,12,3
152318,14,11,3,19,1
152318,1592,1256,336,20,1
152318,2255,1769,486,21,4
152318,2186,1715,471,22,1
152318,2151,1692,459,23,1
152318,559,435,124,24,1
152318,1592,1257,335,25,1
152318,35,23,12,31,1
152318,69,54,15,32,3
152318,14,11,3,39,1
152318,1578,1246,332,40,1
152318,47,34,13,41,4
152318,19,12,7,42,1
152318,14,10,4,43,1
152318,14,10,4,45,1
152318,5,2,3,51,1
152318,28,22,6,52,3
152318,14,10,4,60,1
152327,39,5,34,1,4
152327,39,5,34,2,1
152327,39,5,34,3,1
152327,10,2,8,4,1
152327,29,3,26,5,1
152327,29,3,26,20,1
152327,39,5,34,21,4
152327,39,5,34,22,1
152327,39,5,34,23,1
152327,10,2,8,24,1
152327,29,3,26,25,1
152327,29,3,26,40,1
152336,2381,686,1695,1,4
152336,1980,567,1413,2,1
152336,1878,537,1341,3,1
152336,388,131,257,4,1
152336,1490,406,1084,5,1
152336,102,30,72,11,1
152336,401,119,282,12,3
152336,202,49,153,19,1
152336,1288,357,931,20,1
152336,1815,559,1256,21,4
152336,1616,492,1124,22,1
152336,1616,492,1124,23,1
152336,385,130,255,24,1
152336,1231,362,869,25,1
152336,199,67,132,32,3
152336,141,41,100,39,1
152336,1090,321,769,40,1
152336,566,127,439,41,4
152336,364,75,289,42,1
152336,262,45,217,43,1
152336,3,1,2,44,1
152336,259,44,215,45,1
152336,102,30,72,51,1
152336,202,52,150,52,3
152336,61,8,53,59,1
152336,198,36,162,60,1
152363,1163,483,680,1,4
152363,1141,469,672,2,1
152363,1096,444,652,3,1
152363,296,167,129,4,1
152363,800,277,523,5,1
152363,45,25,20,11,1
152363,22,14,8,12,3
152363,71,9,62,19,1
152363,729,268,461,20,1
152363,1039,439,600,21,4
152363,1036,438,598,22,1
152363,1036,438,598,23,1
152363,295,167,128,24,1
152363,741,271,470,25,1
152363,3,1,2,32,3
152363,54,9,45,39,1
152363,687,262,425,40,1
152363,124,44,80,41,4
152363,105,31,74,42,1
152363,60,6,54,43,1
152363,1,0,1,44,1
152363,59,6,53,45,1
152363,45,25,20,51,1
152363,19,13,6,52,3
152363,17,0,17,59,1
152363,42,6,36,60,1
152381,887,40,847,1,4
152381,649,21,628,2,1
152381,630,19,611,3,1
152381,65,0,65,4,1
152381,565,19,546,5,1
152381,19,2,17,11,1
152381,238,19,219,12,3
152381,61,3,58,19,1
152381,504,16,488,20,1
152381,548,20,528,21,4
152381,384,9,375,22,1
152381,370,9,361,23,1
152381,61,0,61,24,1
152381,309,9,300,25,1
152381,14,0,14,31,1
152381,164,11,153,32,3
152381,33,1,32,39,1
152381,276,8,268,40,1
152381,339,20,319,41,4
152381,265,12,253,42,1
152381,260,10,250,43,1
152381,4,0,4,44,1
152381,256,10,246,45,1
152381,5,2,3,51,1
152381,74,8,66,52,3
152381,28,2,26,59,1
152381,228,8,220,60,1
152390,1479,0,1479,1,4
152390,1479,0,1479,2,1
152390,1470,0,1470,3,1
152390,437,0,437,4,1
152390,1033,0,1033,5,1
152390,9,0,9,11,1
152390,18,0,18,19,1
152390,1015,0,1015,20,1
152390,1469,0,1469,21,4
152390,1469,0,1469,22,1
152390,1460,0,1460,23,1
152390,437,0,437,24,1
152390,1023,0,1023,25,1
152390,9,0,9,31,1
152390,18,0,18,39,1
152390,1005,0,1005,40,1
152390,10,0,10,41,4
152390,10,0,10,42,1
152390,10,0,10,43,1
152390,10,0,10,45,1
152390,10,0,10,60,1
152415,366,33,333,1,4
152415,366,33,333,2,1
152415,366,33,333,3,1
152415,86,4,82,4,1
152415,280,29,251,5,1
152415,22,3,19,19,1
152415,258,26,232,20,1
152415,366,33,333,21,4
152415,366,33,333,22,1
152415,366,33,333,23,1
152415,86,4,82,24,1
152415,280,29,251,25,1
152415,22,3,19,39,1
152415,258,26,232,40,1
152451,246,203,43,1,4
152451,246,203,43,12,3
152451,163,161,2,21,4
152451,163,161,2,32,3
152451,83,42,41,41,4
152451,83,42,41,52,3
152497,269,8,261,1,4
152497,269,8,261,2,1
152497,269,8,261,3,1
152497,20,0,20,4,1
152497,249,8,241,5,1
152497,249,8,241,20,1
152497,212,8,204,21,4
152497,212,8,204,22,1
152497,212,8,204,23,1
152497,20,0,20,24,1
152497,192,8,184,25,1
152497,192,8,184,40,1
152497,57,0,57,41,4
152497,57,0,57,42,1
152497,57,0,57,43,1
152497,57,0,57,45,1
152497,57,0,57,60,1
152530,2245,1000,1245,1,4
152530,2146,960,1186,2,1
152530,1873,855,1018,3,1
152530,460,198,262,4,1
152530,1413,657,756,5,1
152530,273,105,168,11,1
152530,99,40,59,12,3
152530,51,27,24,19,1
152530,1362,630,732,20,1
152530,1929,875,1054,21,4
152530,1852,841,1011,22,1
152530,1826,833,993,23,1
152530,459,198,261,24,1
152530,1367,635,732,25,1
152530,26,8,18,31,1
152530,77,34,43,32,3
152530,50,27,23,39,1
152530,1317,608,709,40,1
152530,316,125,191,41,4
152530,294,119,175,42,1
152530,47,22,25,43,1
152530,1,0,1,44,1
152530,46,22,24,45,1
152530,247,97,150,51,1
152530,22,6,16,52,3
152530,1,0,1,59,1
152530,45,22,23,60,1
152567,1875,1216,659,1,4
152567,1874,1215,659,2,1
152567,1431,1030,401,3,1
152567,372,272,100,4,1
152567,1059,758,301,5,1
152567,443,185,258,11,1
152567,1,1,0,12,3
152567,31,20,11,19,1
152567,1028,738,290,20,1
152567,1430,1024,406,21,4
152567,1429,1023,406,22,1
152567,1399,1003,396,23,1
152567,372,272,100,24,1
152567,1027,731,296,25,1
152567,30,20,10,31,1
152567,1,1,0,32,3
152567,31,20,11,39,1
152567,996,711,285,40,1
152567,445,192,253,41,4
152567,445,192,253,42,1
152567,32,27,5,43,1
152567,32,27,5,45,1
152567,413,165,248,51,1
152567,32,27,5,60,1
152600,4508,2144,2364,1,4
152600,3251,1566,1685,2,1
152600,3209,1554,1655,3,1
152600,876,433,443,4,1
152600,2333,1121,1212,5,1
152600,42,12,30,11,1
152600,1257,578,679,12,3
152600,173,61,112,19,1
152600,2160,1060,1100,20,1
152600,4062,1985,2077,21,4
152600,3136,1522,1614,22,1
152600,3118,1516,1602,23,1
152600,876,433,443,24,1
152600,2242,1083,1159,25,1
152600,18,6,12,31,1
152600,926,463,463,32,3
152600,163,58,105,39,1
152600,2079,1025,1054,40,1
152600,446,159,287,41,4
152600,115,44,71,42,1
152600,91,38,53,43,1
152600,91,38,53,45,1
152600,24,6,18,51,1
152600,331,115,216,52,3
152600,10,3,7,59,1
152600,81,35,46,60,1
152628,89,1,88,1,4
152628,89,1,88,2,1
152628,89,1,88,3,1
152628,22,0,22,4,1
152628,67,1,66,5,1
152628,67,1,66,20,1
152628,41,1,40,21,4
152628,41,1,40,22,1
152628,41,1,40,23,1
152628,16,0,16,24,1
152628,25,1,24,25,1
152628,25,1,24,40,1
152628,48,0,48,41,4
152628,48,0,48,42,1
152628,48,0,48,43,1
152628,6,0,6,44,1
152628,42,0,42,45,1
152628,42,0,42,60,1
152637,18383,10203,8180,1,4
152637,18383,10203,8180,2,1
152637,8313,4626,3687,3,1
152637,3039,1860,1179,4,1
152637,5274,2766,2508,5,1
152637,10070,5577,4493,11,1
152637,440,206,234,19,1
152637,4834,2560,2274,20,1
152637,6049,3249,2800,21,4
152637,6049,3249,2800,22,1
152637,5642,3054,2588,23,1
152637,2259,1311,948,24,1
152637,3383,1743,1640,25,1
152637,407,195,212,31,1
152637,304,142,162,39,1
152637,3079,1601,1478,40,1
152637,12334,6954,5380,41,4
152637,12334,6954,5380,42,1
152637,2671,1572,1099,43,1
152637,780,549,231,44,1
152637,1891,1023,868,45,1
152637,9663,5382,4281,51,1
152637,136,64,72,59,1
152637,1755,959,796,60,1
152673,902,902,0,1,4
152673,902,902,0,2,1
152673,896,896,0,3,1
152673,241,241,0,4,1
152673,655,655,0,5,1
152673,6,6,0,11,1
152673,4,4,0,19,1
152673,651,651,0,20,1
152673,902,902,0,21,4
152673,902,902,0,22,1
152673,896,896,0,23,1
152673,241,241,0,24,1
152673,655,655,0,25,1
152673,6,6,0,31,1
152673,4,4,0,39,1
152673,651,651,0,40,1
152798,581,40,541,1,4
152798,398,26,372,2,1
152798,398,26,372,3,1
152798,1,0,1,4,1
152798,397,26,371,5,1
152798,183,14,169,12,3
152798,130,16,114,19,1
152798,267,10,257,20,1
152798,279,22,257,21,4
152798,258,20,238,22,1
152798,258,20,238,23,1
152798,1,0,1,24,1
152798,257,20,237,25,1
152798,21,2,19,32,3
152798,88,12,76,39,1
152798,169,8,161,40,1
152798,302,18,284,41,4
152798,140,6,134,42,1
152798,140,6,134,43,1
152798,140,6,134,45,1
152798,162,12,150,52,3
152798,42,4,38,59,1
152798,98,2,96,60,1
152822,1019,453,566,1,4
152822,1019,453,566,2,1
152822,1007,447,560,3,1
152822,184,96,88,4,1
152822,823,351,472,5,1
152822,12,6,6,11,1
152822,178,86,92,19,1
152822,645,265,380,20,1
152822,732,350,382,21,4
152822,732,350,382,22,1
152822,731,350,381,23,1
152822,174,94,80,24,1
152822,557,256,301,25,1
152822,1,0,1,31,1
152822,150,76,74,39,1
152822,407,180,227,40,1
152822,287,103,184,41,4
152822,287,103,184,42,1
152822,276,97,179,43,1
152822,10,2,8,44,1
152822,266,95,171,45,1
152822,11,6,5,51,1
152822,28,10,18,59,1
152822,238,85,153,60,1
152992,1174,486,688,1,4
152992,1042,446,596,2,1
152992,999,426,573,3,1
152992,180,107,73,4,1
152992,819,319,500,5,1
152992,43,20,23,11,1
152992,132,40,92,12,3
152992,147,44,103,19,1
152992,672,275,397,20,1
152992,881,410,471,21,4
152992,848,401,447,22,1
152992,848,401,447,23,1
152992,180,107,73,24,1
152992,668,294,374,25,1
152992,33,9,24,32,3
152992,99,34,65,39,1
152992,569,260,309,40,1
152992,293,76,217,41,4
152992,194,45,149,42,1
152992,151,25,126,43,1
152992,151,25,126,45,1
152992,43,20,23,51,1
152992,99,31,68,52,3
152992,48,10,38,59,1
152992,103,15,88,60,1
153001,2399,805,1594,1,4
153001,2293,790,1503,2,1
153001,2125,739,1386,3,1
153001,269,128,141,4,1
153001,1856,611,1245,5,1
153001,168,51,117,11,1
153001,106,15,91,12,3
153001,374,119,255,19,1
153001,1482,492,990,20,1
153001,1960,691,1269,21,4
153001,1960,691,1269,22,1
153001,1873,673,1200,23,1
153001,269,128,141,24,1
153001,1604,545,1059,25,1
153001,87,18,69,31,1
153001,344,111,233,39,1
153001,1260,434,826,40,1
153001,439,114,325,41,4
153001,333,99,234,42,1
153001,252,66,186,43,1
153001,252,66,186,45,1
153001,81,33,48,51,1
153001,106,15,91,52,3
153001,30,8,22,59,1
153001,222,58,164,60,1
153074,122,4,118,1,4
153074,122,4,118,2,1
153074,122,4,118,3,1
153074,13,0,13,4,1
153074,109,4,105,5,1
153074,109,4,105,20,1
153074,122,4,118,21,4
153074,122,4,118,22,1
153074,122,4,118,23,1
153074,13,0,13,24,1
153074,109,4,105,25,1
153074,109,4,105,40,1
153083,192,4,188,1,4
153083,192,4,188,2,1
153083,192,4,188,3,1
153083,11,0,11,4,1
153083,181,4,177,5,1
153083,181,4,177,20,1
153083,192,4,188,21,4
153083,192,4,188,22,1
153083,192,4,188,23,1
153083,11,0,11,24,1
153083,181,4,177,25,1
153083,181,4,177,40,1
153092,11,6,5,1,4
153092,11,6,5,2,1
153092,11,6,5,3,1
153092,6,3,3,4,1
153092,5,3,2,5,1
153092,5,3,2,20,1
153092,11,6,5,21,4
153092,11,6,5,22,1
153092,11,6,5,23,1
153092,6,3,3,24,1
153092,5,3,2,25,1
153092,5,3,2,40,1
153108,1386,654,732,1,4
153108,1386,654,732,2,1
153108,1303,629,674,3,1
153108,309,158,151,4,1
153108,994,471,523,5,1
153108,83,25,58,11,1
153108,22,11,11,19,1
153108,972,460,512,20,1
153108,1340,629,711,21,4
153108,1340,629,711,22,1
153108,1276,612,664,23,1
153108,309,158,151,24,1
153108,967,454,513,25,1
153108,64,17,47,31,1
153108,22,11,11,39,1
153108,945,443,502,40,1
153108,46,25,21,41,4
153108,46,25,21,42,1
153108,27,17,10,43,1
153108,27,17,10,45,1
153108,19,8,11,51,1
153108,27,17,10,60,1
153126,1225,399,826,1,4
153126,1011,342,669,2,1
153126,995,332,663,3,1
153126,181,57,124,4,1
153126,814,275,539,5,1
153126,16,10,6,11,1
153126,214,57,157,12,3
153126,123,46,77,19,1
153126,691,229,462,20,1
153126,1014,332,682,21,4
153126,877,292,585,22,1
153126,875,291,584,23,1
153126,181,57,124,24,1
153126,694,234,460,25,1
153126,2,1,1,31,1
153126,137,40,97,32,3
153126,98,38,60,39,1
153126,596,196,400,40,1
153126,211,67,144,41,4
153126,134,50,84,42,1
153126,120,41,79,43,1
153126,120,41,79,45,1
153126,14,9,5,51,1
153126,77,17,60,52,3
153126,25,8,17,59,1
153126,95,33,62,60,1
153144,1419,650,769,1,4
153144,1419,650,769,2,1
153144,1355,620,735,3,1
153144,390,158,232,4,1
153144,965,462,503,5,1
153144,64,30,34,11,1
153144,29,15,14,19,1
153144,936,447,489,20,1
153144,1351,618,733,21,4
153144,1351,618,733,22,1
153144,1335,611,724,23,1
153144,389,158,231,24,1
153144,946,453,493,25,1
153144,16,7,9,31,1
153144,29,15,14,39,1
153144,917,438,479,40,1
153144,68,32,36,41,4
153144,68,32,36,42,1
153144,20,9,11,43,1
153144,1,0,1,44,1
153144,19,9,10,45,1
153144,48,23,25,51,1
153144,19,9,10,60,1
153162,1125,506,619,1,4
153162,1125,506,619,2,1
153162,1122,505,617,3,1
153162,270,124,146,4,1
153162,852,381,471,5,1
153162,3,1,2,11,1
153162,45,20,25,19,1
153162,807,361,446,20,1
153162,1117,503,614,21,4
153162,1117,503,614,22,1
153162,1114,502,612,23,1
153162,270,124,146,24,1
153162,844,378,466,25,1
153162,3,1,2,31,1
153162,45,20,25,39,1
153162,799,358,441,40,1
153162,8,3,5,41,4
153162,8,3,5,42,1
153162,8,3,5,43,1
153162,8,3,5,45,1
153162,8,3,5,60,1
153171,34,1,33,1,4
153171,34,1,33,2,1
153171,34,1,33,3,1
153171,9,0,9,4,1
153171,25,1,24,5,1
153171,25,1,24,20,1
153171,34,1,33,21,4
153171,34,1,33,22,1
153171,34,1,33,23,1
153171,9,0,9,24,1
153171,25,1,24,25,1
153171,25,1,24,40,1
153214,20167,9304,10863,1,4
153214,20167,9304,10863,2,1
153214,14928,6634,8294,3,1
153214,3537,1762,1775,4,1
153214,11391,4872,6519,5,1
153214,5239,2670,2569,11,1
153214,1028,468,560,19,1
153214,10363,4404,5959,20,1
153214,7735,3824,3911,21,4
153214,7735,3824,3911,22,1
153214,7614,3765,3849,23,1
153214,2250,1201,1049,24,1
153214,5364,2564,2800,25,1
153214,121,59,62,31,1
153214,636,302,334,39,1
153214,4728,2262,2466,40,1
153214,12432,5480,6952,41,4
153214,12432,5480,6952,42,1
153214,7314,2869,4445,43,1
153214,1287,561,726,44,1
153214,6027,2308,3719,45,1
153214,5118,2611,2507,51,1
153214,392,166,226,59,1
153214,5635,2142,3493,60,1
153241,90,58,32,1,4
153241,90,58,32,2,1
153241,89,57,32,3,1
153241,11,11,0,4,1
153241,78,46,32,5,1
153241,1,1,0,11,1
153241,5,4,1,19,1
153241,73,42,31,20,1
153241,90,58,32,21,4
153241,90,58,32,22,1
153241,89,57,32,23,1
153241,11,11,0,24,1
153241,78,46,32,25,1
153241,1,1,0,31,1
153241,5,4,1,39,1
153241,73,42,31,40,1
153250,1430,772,658,1,4
153250,1376,747,629,2,1
153250,1338,726,612,3,1
153250,379,209,170,4,1
153250,959,517,442,5,1
153250,38,21,17,11,1
153250,54,25,29,12,3
153250,46,24,22,19,1
153250,913,493,420,20,1
153250,1345,728,617,21,4
153250,1345,728,617,22,1
153250,1332,723,609,23,1
153250,378,209,169,24,1
153250,954,514,440,25,1
153250,13,5,8,31,1
153250,46,24,22,39,1
153250,908,490,418,40,1
153250,85,44,41,41,4
153250,31,19,12,42,1
153250,6,3,3,43,1
153250,1,0,1,44,1
153250,5,3,2,45,1
153250,25,16,9,51,1
153250,54,25,29,52,3
153250,5,3,2,60,1
153269,5139,2143,2996,1,4
153269,3383,1475,1908,2,1
153269,3310,1434,1876,3,1
153269,850,355,495,4,1
153269,2460,1079,1381,5,1
153269,73,41,32,11,1
153269,1756,668,1088,12,3
153269,115,52,63,19,1
153269,2345,1027,1318,20,1
153269,4120,1749,2371,21,4
153269,3185,1368,1817,22,1
153269,3177,1363,1814,23,1
153269,850,355,495,24,1
153269,2327,1008,1319,25,1
153269,8,5,3,31,1
153269,935,381,554,32,3
153269,109,51,58,39,1
153269,2218,957,1261,40,1
153269,1019,394,625,41,4
153269,198,107,91,42,1
153269,133,71,62,43,1
153269,133,71,62,45,1
153269,65,36,29,51,1
153269,821,287,534,52,3
153269,6,1,5,59,1
153269,127,70,57,60,1
153278,2023,1142,881,1,4
153278,1694,972,722,2,1
153278,1687,969,718,3,1
153278,443,276,167,4,1
153278,1244,693,551,5,1
153278,7,3,4,11,1
153278,329,170,159,12,3
153278,142,68,74,19,1
153278,1102,625,477,20,1
153278,1754,1024,730,21,4
153278,1544,918,626,22,1
153278,1544,918,626,23,1
153278,441,274,167,24,1
153278,1103,644,459,25,1
153278,210,106,104,32,3
153278,119,65,54,39,1
153278,984,579,405,40,1
153278,269,118,151,41,4
153278,150,54,96,42,1
153278,143,51,92,43,1
153278,2,2,0,44,1
153278,141,49,92,45,1
153278,7,3,4,51,1
153278,119,64,55,52,3
153278,23,3,20,59,1
153278,118,46,72,60,1
153296,1034,516,518,1,4
153296,1034,516,518,2,1
153296,827,423,404,3,1
153296,363,212,151,4,1
153296,464,211,253,5,1
153296,207,93,114,11,1
153296,71,39,32,19,1
153296,393,172,221,20,1
153296,725,407,318,21,4
153296,725,407,318,22,1
153296,709,399,310,23,1
153296,344,206,138,24,1
153296,365,193,172,25,1
153296,16,8,8,31,1
153296,69,38,31,39,1
153296,296,155,141,40,1
153296,309,109,200,41,4
153296,309,109,200,42,1
153296,118,24,94,43,1
153296,19,6,13,44,1
153296,99,18,81,45,1
153296,191,85,106,51,1
153296,2,1,1,59,1
153296,97,17,80,60,1
153302,187,94,93,1,4
153302,187,94,93,2,1
153302,187,94,93,3,1
153302,34,17,17,4,1
153302,153,77,76,5,1
153302,30,16,14,19,1
153302,123,61,62,20,1
153302,179,90,89,21,4
153302,179,90,89,22,1
153302,179,90,89,23,1
153302,33,16,17,24,1
153302,146,74,72,25,1
153302,30,16,14,39,1
153302,116,58,58,40,1
153302,8,4,4,41,4
153302,8,4,4,42,1
153302,8,4,4,43,1
153302,1,1,0,44,1
153302,7,3,4,45,1
153302,7,3,4,60,1
153311,8694,3739,4955,1,4
153311,8694,3739,4955,2,1
153311,5709,2267,3442,3,1
153311,1211,559,652,4,1
153311,4498,1708,2790,5,1
153311,2985,1472,1513,11,1
153311,87,25,62,19,1
153311,4411,1683,2728,20,1
153311,2524,1100,1424,21,4
153311,2524,1100,1424,22,1
153311,2171,939,1232,23,1
153311,759,386,373,24,1
153311,1412,553,859,25,1
153311,353,161,192,31,1
153311,34,15,19,39,1
153311,1378,538,840,40,1
153311,6170,2639,3531,41,4
153311,6170,2639,3531,42,1
153311,3538,1328,2210,43,1
153311,452,173,279,44,1
153311,3086,1155,1931,45,1
153311,2632,1311,1321,51,1
153311,53,10,43,59,1
153311,3033,1145,1888,60,1
153320,267,142,125,1,4
153320,229,106,123,2,1
153320,220,102,118,3,1
153320,60,22,38,4,1
153320,160,80,80,5,1
153320,9,4,5,11,1
153320,38,36,2,12,3
153320,16,6,10,19,1
153320,144,74,70,20,1
153320,222,110,112,21,4
153320,206,95,111,22,1
153320,206,95,111,23,1
153320,60,22,38,24,1
153320,146,73,73,25,1
153320,16,15,1,32,3
153320,16,6,10,39,1
153320,130,67,63,40,1
153320,45,32,13,41,4
153320,23,11,12,42,1
153320,14,7,7,43,1
153320,14,7,7,45,1
153320,9,4,5,51,1
153320,22,21,1,52,3
153320,14,7,7,60,1
153339,21,1,20,1,4
153339,21,1,20,2,1
153339,21,1,20,3,1
153339,10,1,9,4,1
153339,11,0,11,5,1
153339,11,0,11,20,1
153339,21,1,20,21,4
153339,21,1,20,22,1
153339,21,1,20,23,1
153339,10,1,9,24,1
153339,11,0,11,25,1
153339,11,0,11,40,1
153366,2286,759,1527,1,4
153366,1559,678,881,2,1
153366,1434,632,802,3,1
153366,326,183,143,4,1
153366,1108,449,659,5,1
153366,125,46,79,11,1
153366,727,81,646,12,3
153366,221,82,139,19,1
153366,887,367,520,20,1
153366,1650,645,1005,21,4
153366,1293,606,687,22,1
153366,1292,606,686,23,1
153366,326,183,143,24,1
153366,966,423,543,25,1
153366,1,0,1,31,1
153366,357,39,318,32,3
153366,187,70,117,39,1
153366,779,353,426,40,1
153366,636,114,522,41,4
153366,266,72,194,42,1
153366,142,26,116,43,1
153366,142,26,116,45,1
153366,124,46,78,51,1
153366,370,42,328,52,3
153366,34,12,22,59,1
153366,108,14,94,60,1
153375,2129,894,1235,1,4
153375,2096,883,1213,2,1
153375,2079,877,1202,3,1
153375,298,153,145,4,1
153375,1781,724,1057,5,1
153375,17,6,11,11,1
153375,33,11,22,12,3
153375,300,120,180,19,1
153375,1481,604,877,20,1
153375,1728,766,962,21,4
153375,1728,766,962,22,1
153375,1728,766,962,23,1
153375,298,153,145,24,1
153375,1430,613,817,25,1
153375,255,109,146,39,1
153375,1175,504,671,40,1
153375,401,128,273,41,4
153375,368,117,251,42,1
153375,351,111,240,43,1
153375,351,111,240,45,1
153375,17,6,11,51,1
153375,33,11,22,52,3
153375,45,11,34,59,1
153375,306,100,206,60,1
153384,1721,791,930,1,4
153384,1721,791,930,2,1
153384,1661,751,910,3,1
153384,423,183,240,4,1
153384,1238,568,670,5,1
153384,60,40,20,11,1
153384,6,4,2,19,1
153384,1232,564,668,20,1
153384,1664,751,913,21,4
153384,1664,751,913,22,1
153384,1659,750,909,23,1
153384,423,183,240,24,1
153384,1236,567,669,25,1
153384,5,1,4,31,1
153384,6,4,2,39,1
153384,1230,563,667,40,1
153384,57,40,17,41,4
153384,57,40,17,42,1
153384,2,1,1,43,1
153384,2,1,1,45,1
153384,55,39,16,51,1
153384,2,1,1,60,1
153409,228,39,189,1,4
153409,205,35,170,2,1
153409,205,35,170,3,1
153409,24,5,19,4,1
153409,181,30,151,5,1
153409,23,4,19,12,3
153409,83,15,68,19,1
153409,98,15,83,20,1
153409,148,23,125,21,4
153409,139,20,119,22,1
153409,139,20,119,23,1
153409,18,2,16,24,1
153409,121,18,103,25,1
153409,9,3,6,32,3
153409,49,7,42,39,1
153409,72,11,61,40,1
153409,80,16,64,41,4
153409,66,15,51,42,1
153409,66,15,51,43,1
153409,6,3,3,44,1
153409,60,12,48,45,1
153409,14,1,13,52,3
153409,34,8,26,59,1
153409,26,4,22,60,1
153418,512,104,408,1,4
153418,483,93,390,2,1
153418,483,93,390,3,1
153418,39,8,31,4,1
153418,444,85,359,5,1
153418,29,11,18,12,3
153418,147,28,119,19,1
153418,297,57,240,20,1
153418,318,67,251,21,4
153418,296,57,239,22,1
153418,296,57,239,23,1
153418,28,4,24,24,1
153418,268,53,215,25,1
153418,22,10,12,32,3
153418,84,15,69,39,1
153418,184,38,146,40,1
153418,194,37,157,41,4
153418,187,36,151,42,1
153418,187,36,151,43,1
153418,11,4,7,44,1
153418,176,32,144,45,1
153418,7,1,6,52,3
153418,63,13,50,59,1
153418,113,19,94,60,1
153427,177,99,78,1,4
153427,177,99,78,2,1
153427,177,99,78,3,1
153427,88,40,48,4,1
153427,89,59,30,5,1
153427,89,59,30,20,1
153427,177,99,78,21,4
153427,177,99,78,22,1
153427,177,99,78,23,1
153427,88,40,48,24,1
153427,89,59,30,25,1
153427,89,59,30,40,1
153445,5809,2498,3311,1,4
153445,5809,2498,3311,2,1
153445,4276,1863,2413,3,1
153445,1123,565,558,4,1
153445,3153,1298,1855,5,1
153445,1533,635,898,11,1
153445,995,400,595,19,1
153445,2158,898,1260,20,1
153445,3068,1406,1662,21,4
153445,3068,1406,1662,22,1
153445,3036,1392,1644,23,1
153445,912,460,452,24,1
153445,2124,932,1192,25,1
153445,32,14,18,31,1
153445,682,295,387,39,1
153445,1442,637,805,40,1
153445,2741,1092,1649,41,4
153445,2741,1092,1649,42,1
153445,1240,471,769,43,1
153445,211,105,106,44,1
153445,1029,366,663,45,1
153445,1501,621,880,51,1
153445,313,105,208,59,1
153445,716,261,455,60,1
153463,32,0,32,1,4
153463,32,0,32,2,1
153463,32,0,32,3,1
153463,13,0,13,4,1
153463,19,0,19,5,1
153463,19,0,19,20,1
153463,32,0,32,21,4
153463,32,0,32,22,1
153463,32,0,32,23,1
153463,13,0,13,24,1
153463,19,0,19,25,1
153463,19,0,19,40,1
153472,4604,2057,2547,1,4
153472,4604,2057,2547,2,1
153472,3070,1291,1779,3,1
153472,767,413,354,4,1
153472,2303,878,1425,5,1
153472,1534,766,768,11,1
153472,841,256,585,19,1
153472,1462,622,840,20,1
153472,2565,1234,1331,21,4
153472,2565,1234,1331,22,1
153472,2310,1106,1204,23,1
153472,703,384,319,24,1
153472,1607,722,885,25,1
153472,255,128,127,31,1
153472,572,209,363,39,1
153472,1035,513,522,40,1
153472,2039,823,1216,41,4
153472,2039,823,1216,42,1
153472,760,185,575,43,1
153472,64,29,35,44,1
153472,696,156,540,45,1
153472,1279,638,641,51,1
153472,269,47,222,59,1
153472,427,109,318,60,1
153524,5697,2904,2793,1,4
153524,5697,2904,2793,2,1
153524,3494,1752,1742,3,1
153524,1213,710,503,4,1
153524,2281,1042,1239,5,1
153524,2203,1152,1051,11,1
153524,154,70,84,19,1
153524,2127,972,1155,20,1
153524,2998,1602,1396,21,4
153524,2998,1602,1396,22,1
153524,2822,1514,1308,23,1
153524,1141,682,459,24,1
153524,1681,832,849,25,1
153524,176,88,88,31,1
153524,101,44,57,39,1
153524,1580,788,792,40,1
153524,2699,1302,1397,41,4
153524,2699,1302,1397,42,1
153524,672,238,434,43,1
153524,72,28,44,44,1
153524,600,210,390,45,1
153524,2027,1064,963,51,1
153524,53,26,27,59,1
153524,547,184,363,60,1
153533,2574,1167,1407,1,4
153533,2574,1167,1407,2,1
153533,1715,770,945,3,1
153533,428,240,188,4,1
153533,1287,530,757,5,1
153533,859,397,462,11,1
153533,276,90,186,19,1
153533,1011,440,571,20,1
153533,1343,666,677,21,4
153533,1343,666,677,22,1
153533,1306,652,654,23,1
153533,405,232,173,24,1
153533,901,420,481,25,1
153533,37,14,23,31,1
153533,158,55,103,39,1
153533,743,365,378,40,1
153533,1231,501,730,41,4
153533,1231,501,730,42,1
153533,409,118,291,43,1
153533,23,8,15,44,1
153533,386,110,276,45,1
153533,822,383,439,51,1
153533,118,35,83,59,1
153533,268,75,193,60,1
153542,17,3,14,1,4
153542,17,3,14,2,1
153542,17,3,14,3,1
153542,9,0,9,4,1
153542,8,3,5,5,1
153542,8,3,5,20,1
153542,17,3,14,21,4
153542,17,3,14,22,1
153542,17,3,14,23,1
153542,9,0,9,24,1
153542,8,3,5,25,1
153542,8,3,5,40,1
153588,21,18,3,1,4
153588,21,18,3,2,1
153588,21,18,3,3,1
153588,6,6,0,4,1
153588,15,12,3,5,1
153588,15,12,3,20,1
153588,21,18,3,21,4
153588,21,18,3,22,1
153588,21,18,3,23,1
153588,6,6,0,24,1
153588,15,12,3,25,1
153588,15,12,3,40,1
153597,150,6,144,1,4
153597,150,6,144,2,1
153597,150,6,144,3,1
153597,47,1,46,4,1
153597,103,5,98,5,1
153597,103,5,98,20,1
153597,150,6,144,21,4
153597,150,6,144,22,1
153597,150,6,144,23,1
153597,47,1,46,24,1
153597,103,5,98,25,1
153597,103,5,98,40,1
153603,32955,18466,14489,1,4
153603,27659,15658,12001,2,1
153603,27112,15332,11780,3,1
153603,6089,3365,2724,4,1
153603,21023,11967,9056,5,1
153603,547,326,221,11,1
153603,5296,2808,2488,12,3
153603,2042,1128,914,19,1
153603,18981,10839,8142,20,1
153603,29398,16365,13033,21,4
153603,26177,14733,11444,22,1
153603,25985,14600,11385,23,1
153603,6063,3355,2708,24,1
153603,19922,11245,8677,25,1
153603,192,133,59,31,1
153603,3221,1632,1589,32,3
153603,1948,1083,865,39,1
153603,17974,10162,7812,40,1
153603,3557,2101,1456,41,4
153603,1482,925,557,42,1
153603,1127,732,395,43,1
153603,26,10,16,44,1
153603,1101,722,379,45,1
153603,355,193,162,51,1
153603,2075,1176,899,52,3
153603,94,45,49,59,1
153603,1007,677,330,60,1
153621,599,217,382,1,4
153621,599,217,382,2,1
153621,578,212,366,3,1
153621,103,59,44,4,1
153621,475,153,322,5,1
153621,21,5,16,11,1
153621,101,26,75,19,1
153621,374,127,247,20,1
153621,482,187,295,21,4
153621,482,187,295,22,1
153621,478,184,294,23,1
153621,102,58,44,24,1
153621,376,126,250,25,1
153621,4,3,1,31,1
153621,76,21,55,39,1
153621,300,105,195,40,1
153621,117,30,87,41,4
153621,117,30,87,42,1
153621,100,28,72,43,1
153621,1,1,0,44,1
153621,99,27,72,45,1
153621,17,2,15,51,1
153621,25,5,20,59,1
153621,74,22,52,60,1
153630,6861,2893,3968,1,4
153630,6861,2893,3968,2,1
153630,5097,2112,2985,3,1
153630,1393,774,619,4,1
153630,3704,1338,2366,5,1
153630,1764,781,983,11,1
153630,686,261,425,19,1
153630,3018,1077,1941,20,1
153630,3490,1623,1867,21,4
153630,3490,1623,1867,22,1
153630,3462,1609,1853,23,1
153630,1163,668,495,24,1
153630,2299,941,1358,25,1
153630,28,14,14,31,1
153630,481,215,266,39,1
153630,1818,726,1092,40,1
153630,3371,1270,2101,41,4
153630,3371,1270,2101,42,1
153630,1635,503,1132,43,1
153630,230,106,124,44,1
153630,1405,397,1008,45,1
153630,1736,767,969,51,1
153630,205,46,159,59,1
153630,1200,351,849,60,1
153658,29748,14372,15376,1,4
153658,21974,10550,11424,2,1
153658,21314,10260,11054,3,1
153658,4460,2036,2424,4,1
153658,16854,8224,8630,5,1
153658,660,290,370,11,1
153658,7774,3822,3952,12,3
153658,1140,596,544,19,1
153658,15714,7628,8086,20,1
153658,24295,11678,12617,21,4
153658,19522,9390,10132,22,1
153658,19301,9289,10012,23,1
153658,4270,1933,2337,24,1
153658,15031,7356,7675,25,1
153658,221,101,120,31,1
153658,4773,2288,2485,32,3
153658,937,531,406,39,1
153658,14094,6825,7269,40,1
153658,5453,2694,2759,41,4
153658,2452,1160,1292,42,1
153658,2013,971,1042,43,1
153658,190,103,87,44,1
153658,1823,868,955,45,1
153658,439,189,250,51,1
153658,3001,1534,1467,52,3
153658,203,65,138,59,1
153658,1620,803,817,60,1
153737,15076,7500,7576,1,4
153737,15076,7500,7576,2,1
153737,10645,4950,5695,3,1
153737,2712,1397,1315,4,1
153737,7933,3553,4380,5,1
153737,4431,2550,1881,11,1
153737,542,267,275,19,1
153737,7391,3286,4105,20,1
153737,6960,3608,3352,21,4
153737,6960,3608,3352,22,1
153737,6619,3398,3221,23,1
153737,2319,1231,1088,24,1
153737,4300,2167,2133,25,1
153737,341,210,131,31,1
153737,368,202,166,39,1
153737,3932,1965,1967,40,1
153737,8116,3892,4224,41,4
153737,8116,3892,4224,42,1
153737,4026,1552,2474,43,1
153737,393,166,227,44,1
153737,3633,1386,2247,45,1
153737,4090,2340,1750,51,1
153737,174,65,109,59,1
153737,3459,1321,2138,60,1
153746,92,5,87,1,4
153746,92,5,87,2,1
153746,92,5,87,3,1
153746,28,3,25,4,1
153746,64,2,62,5,1
153746,64,2,62,20,1
153746,92,5,87,21,4
153746,92,5,87,22,1
153746,92,5,87,23,1
153746,28,3,25,24,1
153746,64,2,62,25,1
153746,64,2,62,40,1
153764,100,6,94,1,4
153764,100,6,94,2,1
153764,100,6,94,3,1
153764,33,3,30,4,1
153764,67,3,64,5,1
153764,67,3,64,20,1
153764,100,6,94,21,4
153764,100,6,94,22,1
153764,100,6,94,23,1
153764,33,3,30,24,1
153764,67,3,64,25,1
153764,67,3,64,40,1
153773,103,3,100,1,4
153773,103,3,100,2,1
153773,103,3,100,3,1
153773,64,3,61,4,1
153773,39,0,39,5,1
153773,39,0,39,20,1
153773,103,3,100,21,4
153773,103,3,100,22,1
153773,103,3,100,23,1
153773,64,3,61,24,1
153773,39,0,39,25,1
153773,39,0,39,40,1
153782,84,3,81,1,4
153782,84,3,81,2,1
153782,84,3,81,3,1
153782,24,1,23,4,1
153782,60,2,58,5,1
153782,60,2,58,20,1
153782,84,3,81,21,4
153782,84,3,81,22,1
153782,84,3,81,23,1
153782,24,1,23,24,1
153782,60,2,58,25,1
153782,60,2,58,40,1
153825,1621,827,794,1,4
153825,1554,805,749,2,1
153825,1521,785,736,3,1
153825,414,213,201,4,1
153825,1107,572,535,5,1
153825,33,20,13,11,1
153825,67,22,45,12,3
153825,49,30,19,19,1
153825,1058,542,516,20,1
153825,1500,765,735,21,4
153825,1484,762,722,22,1
153825,1482,760,722,23,1
153825,414,213,201,24,1
153825,1068,547,521,25,1
153825,2,2,0,31,1
153825,16,3,13,32,3
153825,47,30,17,39,1
153825,1021,517,504,40,1
153825,121,62,59,41,4
153825,70,43,27,42,1
153825,39,25,14,43,1
153825,39,25,14,45,1
153825,31,18,13,51,1
153825,51,19,32,52,3
153825,2,0,2,59,1
153825,37,25,12,60,1
153834,2466,1066,1400,1,4
153834,2466,1066,1400,2,1
153834,2388,1031,1357,3,1
153834,628,273,355,4,1
153834,1760,758,1002,5,1
153834,78,35,43,11,1
153834,39,24,15,19,1
153834,1721,734,987,20,1
153834,2413,1040,1373,21,4
153834,2413,1040,1373,22,1
153834,2376,1024,1352,23,1
153834,627,273,354,24,1
153834,1749,751,998,25,1
153834,37,16,21,31,1
153834,39,24,15,39,1
153834,1710,727,983,40,1
153834,53,26,27,41,4
153834,53,26,27,42,1
153834,12,7,5,43,1
153834,1,0,1,44,1
153834,11,7,4,45,1
153834,41,19,22,51,1
153834,11,7,4,60,1
153861,1136,785,351,1,4
153861,319,172,147,2,1
153861,316,170,146,3,1
153861,19,9,10,4,1
153861,297,161,136,5,1
153861,3,2,1,11,1
153861,817,613,204,12,3
153861,54,27,27,19,1
153861,243,134,109,20,1
153861,832,568,264,21,4
153861,304,163,141,22,1
153861,304,163,141,23,1
153861,18,9,9,24,1
153861,286,154,132,25,1
153861,528,405,123,32,3
153861,49,24,25,39,1
153861,237,130,107,40,1
153861,304,217,87,41,4
153861,15,9,6,42,1
153861,12,7,5,43,1
153861,1,0,1,44,1
153861,11,7,4,45,1
153861,3,2,1,51,1
153861,289,208,81,52,3
153861,5,3,2,59,1
153861,6,4,2,60,1
153922,2101,838,1263,1,4
153922,2101,838,1263,2,1
153922,1266,478,788,3,1
153922,436,201,235,4,1
153922,830,277,553,5,1
153922,835,360,475,11,1
153922,69,24,45,19,1
153922,761,253,508,20,1
153922,937,393,544,21,4
153922,937,393,544,22,1
153922,919,387,532,23,1
153922,360,175,185,24,1
153922,559,212,347,25,1
153922,18,6,12,31,1
153922,56,20,36,39,1
153922,503,192,311,40,1
153922,1164,445,719,41,4
153922,1164,445,719,42,1
153922,347,91,256,43,1
153922,76,26,50,44,1
153922,271,65,206,45,1
153922,817,354,463,51,1
153922,13,4,9,59,1
153922,258,61,197,60,1
153977,831,123,708,1,4
153977,831,123,708,2,1
153977,826,121,705,3,1
153977,46,8,38,4,1
153977,780,113,667,5,1
153977,5,2,3,11,1
153977,237,43,194,19,1
153977,543,70,473,20,1
153977,357,56,301,21,4
153977,357,56,301,22,1
153977,357,56,301,23,1
153977,32,5,27,24,1
153977,325,51,274,25,1
153977,136,29,107,39,1
153977,189,22,167,40,1
153977,474,67,407,41,4
153977,474,67,407,42,1
153977,469,65,404,43,1
153977,14,3,11,44,1
153977,455,62,393,45,1
153977,5,2,3,51,1
153977,101,14,87,59,1
153977,354,48,306,60,1
154004,2542,840,1702,1,4
154004,1305,616,689,2,1
154004,1267,600,667,3,1
154004,357,160,197,4,1
154004,910,440,470,5,1
154004,38,16,22,11,1
154004,1237,224,1013,12,3
154004,69,26,43,19,1
154004,841,414,427,20,1
154004,1275,599,676,21,4
154004,1263,596,667,22,1
154004,1240,587,653,23,1
154004,357,160,197,24,1
154004,883,427,456,25,1
154004,23,9,14,31,1
154004,12,3,9,32,3
154004,69,26,43,39,1
154004,814,401,413,40,1
154004,1267,241,1026,41,4
154004,42,20,22,42,1
154004,27,13,14,43,1
154004,27,13,14,45,1
154004,15,7,8,51,1
154004,1225,221,1004,52,3
154004,27,13,14,60,1
154013,1761,542,1219,1,4
154013,1476,454,1022,2,1
154013,1454,444,1010,3,1
154013,154,40,114,4,1
154013,1300,404,896,5,1
154013,22,10,12,11,1
154013,285,88,197,12,3
154013,276,101,175,19,1
154013,1024,303,721,20,1
154013,995,299,696,21,4
154013,882,273,609,22,1
154013,880,273,607,23,1
154013,154,40,114,24,1
154013,726,233,493,25,1
154013,2,0,2,31,1
154013,113,26,87,32,3
154013,148,64,84,39,1
154013,578,169,409,40,1
154013,766,243,523,41,4
154013,594,181,413,42,1
154013,574,171,403,43,1
154013,574,171,403,45,1
154013,20,10,10,51,1
154013,172,62,110,52,3
154013,128,37,91,59,1
154013,446,134,312,60,1
154022,58104,16414,41690,1,4
154022,50895,14706,36189,2,1
154022,50403,14371,36032,3,1
154022,866,257,609,4,1
154022,49537,14114,35423,5,1
154022,492,335,157,11,1
154022,7209,1708,5501,12,3
154022,5789,1543,4246,19,1
154022,43748,12571,31177,20,1
154022,58078,16407,41671,21,4
154022,50869,14699,36170,22,1
154022,50394,14366,36028,23,1
154022,866,257,609,24,1
154022,49528,14109,35419,25,1
154022,475,333,142,31,1
154022,7209,1708,5501,32,3
154022,5789,1543,4246,39,1
154022,43739,12566,31173,40,1
154022,26,7,19,41,4
154022,26,7,19,42,1
154022,9,5,4,43,1
154022,9,5,4,45,1
154022,17,2,15,51,1
154022,9,5,4,60,1
154059,3207,1420,1787,1,4
154059,3207,1420,1787,2,1
154059,2139,941,1198,3,1
154059,647,354,293,4,1
154059,1492,587,905,5,1
154059,1068,479,589,11,1
154059,151,51,100,19,1
154059,1341,536,805,20,1
154059,1561,791,770,21,4
154059,1561,791,770,22,1
154059,1520,760,760,23,1
154059,572,324,248,24,1
154059,948,436,512,25,1
154059,41,31,10,31,1
154059,107,41,66,39,1
154059,841,395,446,40,1
154059,1646,629,1017,41,4
154059,1646,629,1017,42,1
154059,619,181,438,43,1
154059,75,30,45,44,1
154059,544,151,393,45,1
154059,1027,448,579,51,1
154059,44,10,34,59,1
154059,500,141,359,60,1
154095,12159,5030,7129,1,4
154095,10380,4471,5909,2,1
154095,10170,4384,5786,3,1
154095,1722,646,1076,4,1
154095,8448,3738,4710,5,1
154095,210,87,123,11,1
154095,1779,559,1220,12,3
154095,912,449,463,19,1
154095,7536,3289,4247,20,1
154095,9968,4118,5850,21,4
154095,9330,3926,5404,22,1
154095,9298,3920,5378,23,1
154095,1689,636,1053,24,1
154095,7609,3284,4325,25,1
154095,32,6,26,31,1
154095,638,192,446,32,3
154095,827,404,423,39,1
154095,6782,2880,3902,40,1
154095,2191,912,1279,41,4
154095,1050,545,505,42,1
154095,872,464,408,43,1
154095,33,10,23,44,1
154095,839,454,385,45,1
154095,178,81,97,51,1
154095,1141,367,774,52,3
154095,85,45,40,59,1
154095,754,409,345,60,1
154101,1233,532,701,1,4
154101,1233,532,701,2,1
154101,1147,509,638,3,1
154101,284,135,149,4,1
154101,863,374,489,5,1
154101,86,23,63,11,1
154101,40,22,18,19,1
154101,823,352,471,20,1
154101,1133,500,633,21,4
154101,1133,500,633,22,1
154101,1121,497,624,23,1
154101,284,135,149,24,1
154101,837,362,475,25,1
154101,12,3,9,31,1
154101,37,21,16,39,1
154101,800,341,459,40,1
154101,100,32,68,41,4
154101,100,32,68,42,1
154101,26,12,14,43,1
154101,26,12,14,45,1
154101,74,20,54,51,1
154101,3,1,2,59,1
154101,23,11,12,60,1
154110,5201,2080,3121,1,4
154110,5201,2080,3121,2,1
154110,3025,1088,1937,3,1
154110,770,381,389,4,1
154110,2255,707,1548,5,1
154110,2176,992,1184,11,1
154110,234,88,146,19,1
154110,2021,619,1402,20,1
154110,1856,798,1058,21,4
154110,1856,798,1058,22,1
154110,1774,761,1013,23,1
154110,592,308,284,24,1
154110,1182,453,729,25,1
154110,82,37,45,31,1
154110,134,54,80,39,1
154110,1048,399,649,40,1
154110,3345,1282,2063,41,4
154110,3345,1282,2063,42,1
154110,1251,327,924,43,1
154110,178,73,105,44,1
154110,1073,254,819,45,1
154110,2094,955,1139,51,1
154110,100,34,66,59,1
154110,973,220,753,60,1
154129,1628,716,912,1,4
154129,1628,716,912,2,1
154129,826,394,432,3,1
154129,246,162,84,4,1
154129,580,232,348,5,1
154129,802,322,480,11,1
154129,203,80,123,19,1
154129,377,152,225,20,1
154129,631,355,276,21,4
154129,631,355,276,22,1
154129,613,348,265,23,1
154129,225,159,66,24,1
154129,388,189,199,25,1
154129,18,7,11,31,1
154129,139,67,72,39,1
154129,249,122,127,40,1
154129,997,361,636,41,4
154129,997,361,636,42,1
154129,213,46,167,43,1
154129,21,3,18,44,1
154129,192,43,149,45,1
154129,784,315,469,51,1
154129,64,13,51,59,1
154129,128,30,98,60,1
154156,1763,814,949,1,4
154156,1763,814,949,12,3
154156,1408,737,671,21,4
154156,1408,737,671,32,3
154156,355,77,278,41,4
154156,355,77,278,52,3
154165,63,1,62,1,4
154165,63,1,62,2,1
154165,63,1,62,3,1
154165,14,0,14,4,1
154165,49,1,48,5,1
154165,49,1,48,20,1
154165,63,1,62,21,4
154165,63,1,62,22,1
154165,63,1,62,23,1
154165,14,0,14,24,1
154165,49,1,48,25,1
154165,49,1,48,40,1
154174,2135,1286,849,1,4
154174,39,19,20,2,1
154174,39,19,20,3,1
154174,6,1,5,4,1
154174,33,18,15,5,1
154174,2096,1267,829,12,3
154174,12,6,6,19,1
154174,21,12,9,20,1
154174,2100,1264,836,21,4
154174,36,19,17,22,1
154174,36,19,17,23,1
154174,5,1,4,24,1
154174,31,18,13,25,1
154174,2064,1245,819,32,3
154174,11,6,5,39,1
154174,20,12,8,40,1
154174,35,22,13,41,4
154174,3,0,3,42,1
154174,3,0,3,43,1
154174,1,0,1,44,1
154174,2,0,2,45,1
154174,32,22,10,52,3
154174,1,0,1,59,1
154174,1,0,1,60,1
154208,141,4,137,1,4
154208,141,4,137,2,1
154208,141,4,137,3,1
154208,32,1,31,4,1
154208,109,3,106,5,1
154208,109,3,106,20,1
154208,141,4,137,21,4
154208,141,4,137,22,1
154208,141,4,137,23,1
154208,32,1,31,24,1
154208,109,3,106,25,1
154208,109,3,106,40,1
154235,3607,1456,2151,1,4
154235,2743,1137,1606,2,1
154235,2716,1129,1587,3,1
154235,562,242,320,4,1
154235,2154,887,1267,5,1
154235,27,8,19,11,1
154235,864,319,545,12,3
154235,267,114,153,19,1
154235,1887,773,1114,20,1
154235,2832,1129,1703,21,4
154235,2440,1043,1397,22,1
154235,2435,1043,1392,23,1
154235,561,242,319,24,1
154235,1874,801,1073,25,1
154235,5,0,5,31,1
154235,392,86,306,32,3
154235,219,99,120,39,1
154235,1655,702,953,40,1
154235,775,327,448,41,4
154235,303,94,209,42,1
154235,281,86,195,43,1
154235,1,0,1,44,1
154235,280,86,194,45,1
154235,22,8,14,51,1
154235,472,233,239,52,3
154235,48,15,33,59,1
154235,232,71,161,60,1
154262,184,28,156,1,4
154262,184,28,156,2,1
154262,184,28,156,3,1
154262,1,0,1,4,1
154262,183,28,155,5,1
154262,63,10,53,19,1
154262,120,18,102,20,1
154262,139,20,119,21,4
154262,139,20,119,22,1
154262,139,20,119,23,1
154262,1,0,1,24,1
154262,138,20,118,25,1
154262,33,6,27,39,1
154262,105,14,91,40,1
154262,45,8,37,41,4
154262,45,8,37,42,1
154262,45,8,37,43,1
154262,45,8,37,45,1
154262,30,4,26,59,1
154262,15,4,11,60,1
154332,47,2,45,1,4
154332,47,2,45,2,1
154332,47,2,45,3,1
154332,13,0,13,4,1
154332,34,2,32,5,1
154332,34,2,32,20,1
154332,47,2,45,21,4
154332,47,2,45,22,1
154332,47,2,45,23,1
154332,13,0,13,24,1
154332,34,2,32,25,1
154332,34,2,32,40,1
154341,64,5,59,1,4
154341,64,5,59,2,1
154341,64,5,59,3,1
154341,20,0,20,4,1
154341,44,5,39,5,1
154341,44,5,39,20,1
154341,64,5,59,21,4
154341,64,5,59,22,1
154341,64,5,59,23,1
154341,20,0,20,24,1
154341,44,5,39,25,1
154341,44,5,39,40,1
154350,1773,768,1005,1,4
154350,1712,749,963,2,1
154350,1687,740,947,3,1
154350,377,152,225,4,1
154350,1310,588,722,5,1
154350,25,9,16,11,1
154350,61,19,42,12,3
154350,111,52,59,19,1
154350,1199,536,663,20,1
154350,1500,647,853,21,4
154350,1486,641,845,22,1
154350,1486,641,845,23,1
154350,373,150,223,24,1
154350,1113,491,622,25,1
154350,14,6,8,32,3
154350,82,35,47,39,1
154350,1031,456,575,40,1
154350,273,121,152,41,4
154350,226,108,118,42,1
154350,201,99,102,43,1
154350,4,2,2,44,1
154350,197,97,100,45,1
154350,25,9,16,51,1
154350,47,13,34,52,3
154350,29,17,12,59,1
154350,168,80,88,60,1
154378,3225,1302,1923,1,4
154378,3225,1302,1923,2,1
154378,2698,1070,1628,3,1
154378,381,181,200,4,1
154378,2317,889,1428,5,1
154378,527,232,295,11,1
154378,102,45,57,19,1
154378,2215,844,1371,20,1
154378,1611,683,928,21,4
154378,1611,683,928,22,1
154378,1482,621,861,23,1
154378,311,160,151,24,1
154378,1171,461,710,25,1
154378,129,62,67,31,1
154378,80,40,40,39,1
154378,1091,421,670,40,1
154378,1614,619,995,41,4
154378,1614,619,995,42,1
154378,1216,449,767,43,1
154378,70,21,49,44,1
154378,1146,428,718,45,1
154378,398,170,228,51,1
154378,22,5,17,59,1
154378,1124,423,701,60,1
154396,1573,645,928,1,4
154396,1573,645,928,2,1
154396,942,370,572,3,1
154396,313,162,151,4,1
154396,629,208,421,5,1
154396,631,275,356,11,1
154396,100,31,69,19,1
154396,529,177,352,20,1
154396,739,332,407,21,4
154396,739,332,407,22,1
154396,726,324,402,23,1
154396,289,155,134,24,1
154396,437,169,268,25,1
154396,13,8,5,31,1
154396,67,26,41,39,1
154396,370,143,227,40,1
154396,834,313,521,41,4
154396,834,313,521,42,1
154396,216,46,170,43,1
154396,24,7,17,44,1
154396,192,39,153,45,1
154396,618,267,351,51,1
154396,33,5,28,59,1
154396,159,34,125,60,1
154448,190,7,183,1,4
154448,190,7,183,2,1
154448,190,7,183,3,1
154448,22,1,21,4,1
154448,168,6,162,5,1
154448,168,6,162,20,1
154448,190,7,183,21,4
154448,190,7,183,22,1
154448,190,7,183,23,1
154448,22,1,21,24,1
154448,168,6,162,25,1
154448,168,6,162,40,1
154457,54,0,54,1,4
154457,54,0,54,2,1
154457,54,0,54,3,1
154457,19,0,19,4,1
154457,35,0,35,5,1
154457,35,0,35,20,1
154457,54,0,54,21,4
154457,54,0,54,22,1
154457,54,0,54,23,1
154457,19,0,19,24,1
154457,35,0,35,25,1
154457,35,0,35,40,1
154466,68,1,67,1,4
154466,68,1,67,2,1
154466,68,1,67,3,1
154466,19,0,19,4,1
154466,49,1,48,5,1
154466,49,1,48,20,1
154466,68,1,67,21,4
154466,68,1,67,22,1
154466,68,1,67,23,1
154466,19,0,19,24,1
154466,49,1,48,25,1
154466,49,1,48,40,1
154493,5304,2048,3256,1,4
154493,4632,1853,2779,2,1
154493,4513,1808,2705,3,1
154493,267,139,128,4,1
154493,4246,1669,2577,5,1
154493,119,45,74,11,1
154493,672,195,477,12,3
154493,183,56,127,19,1
154493,4063,1613,2450,20,1
154493,3651,1414,2237,21,4
154493,2981,1220,1761,22,1
154493,2946,1201,1745,23,1
154493,241,132,109,24,1
154493,2705,1069,1636,25,1
154493,35,19,16,31,1
154493,670,194,476,32,3
154493,115,39,76,39,1
154493,2590,1030,1560,40,1
154493,1653,634,1019,41,4
154493,1651,633,1018,42,1
154493,1567,607,960,43,1
154493,26,7,19,44,1
154493,1541,600,941,45,1
154493,84,26,58,51,1
154493,2,1,1,52,3
154493,68,17,51,59,1
154493,1473,583,890,60,1
154518,1150,700,450,1,4
154518,1150,700,450,2,1
154518,1090,671,419,3,1
154518,120,65,55,4,1
154518,970,606,364,5,1
154518,60,29,31,11,1
154518,183,120,63,19,1
154518,787,486,301,20,1
154518,923,556,367,21,4
154518,923,556,367,22,1
154518,921,554,367,23,1
154518,119,64,55,24,1
154518,802,490,312,25,1
154518,2,2,0,31,1
154518,145,96,49,39,1
154518,657,394,263,40,1
154518,227,144,83,41,4
154518,227,144,83,42,1
154518,169,117,52,43,1
154518,1,1,0,44,1
154518,168,116,52,45,1
154518,58,27,31,51,1
154518,38,24,14,59,1
154518,130,92,38,60,1
154527,1714,812,902,1,4
154527,1714,812,902,2,1
154527,1669,794,875,3,1
154527,451,207,244,4,1
154527,1218,587,631,5,1
154527,45,18,27,11,1
154527,36,23,13,19,1
154527,1182,564,618,20,1
154527,1643,772,871,21,4
154527,1643,772,871,22,1
154527,1641,771,870,23,1
154527,451,207,244,24,1
154527,1190,564,626,25,1
154527,2,1,1,31,1
154527,35,22,13,39,1
154527,1155,542,613,40,1
154527,71,40,31,41,4
154527,71,40,31,42,1
154527,28,23,5,43,1
154527,28,23,5,45,1
154527,43,17,26,51,1
154527,1,1,0,59,1
154527,27,22,5,60,1
154536,139,63,76,1,4
154536,139,63,76,12,3
154536,127,60,67,21,4
154536,127,60,67,32,3
154536,12,3,9,41,4
154536,12,3,9,52,3
154545,46,7,39,1,4
154545,46,7,39,2,1
154545,46,7,39,3,1
154545,11,2,9,4,1
154545,35,5,30,5,1
154545,35,5,30,20,1
154545,46,7,39,21,4
154545,46,7,39,22,1
154545,46,7,39,23,1
154545,11,2,9,24,1
154545,35,5,30,25,1
154545,35,5,30,40,1
154572,6331,2669,3662,1,4
154572,6331,2669,3662,2,1
154572,3557,1386,2171,3,1
154572,570,273,297,4,1
154572,2987,1113,1874,5,1
154572,2774,1283,1491,11,1
154572,1173,441,732,19,1
154572,1814,672,1142,20,1
154572,2459,1106,1353,21,4
154572,2459,1106,1353,22,1
154572,2195,985,1210,23,1
154572,427,215,212,24,1
154572,1768,770,998,25,1
154572,264,121,143,31,1
154572,690,299,391,39,1
154572,1078,471,607,40,1
154572,3872,1563,2309,41,4
154572,3872,1563,2309,42,1
154572,1362,401,961,43,1
154572,143,58,85,44,1
154572,1219,343,876,45,1
154572,2510,1162,1348,51,1
154572,483,142,341,59,1
154572,736,201,535,60,1
154590,1875,910,965,1,4
154590,1728,862,866,2,1
154590,1558,792,766,3,1
154590,264,173,91,4,1
154590,1294,619,675,5,1
154590,170,70,100,11,1
154590,147,48,99,12,3
154590,217,106,111,19,1
154590,1077,513,564,20,1
154590,1655,831,824,21,4
154590,1536,787,749,22,1
154590,1526,783,743,23,1
154590,264,173,91,24,1
154590,1262,610,652,25,1
154590,10,4,6,31,1
154590,119,44,75,32,3
154590,209,105,104,39,1
154590,1053,505,548,40,1
154590,220,79,141,41,4
154590,192,75,117,42,1
154590,32,9,23,43,1
154590,32,9,23,45,1
154590,160,66,94,51,1
154590,28,4,24,52,3
154590,8,1,7,59,1
154590,24,8,16,60,1
154642,2852,1007,1845,1,4
154642,2852,1007,1845,2,1
154642,2852,1007,1845,3,1
154642,551,226,325,4,1
154642,2301,781,1520,5,1
154642,200,83,117,19,1
154642,2101,698,1403,20,1
154642,1327,454,873,21,4
154642,1327,454,873,22,1
154642,1327,454,873,23,1
154642,418,176,242,24,1
154642,909,278,631,25,1
154642,138,58,80,39,1
154642,771,220,551,40,1
154642,1525,553,972,41,4
154642,1525,553,972,42,1
154642,1525,553,972,43,1
154642,133,50,83,44,1
154642,1392,503,889,45,1
154642,62,25,37,59,1
154642,1330,478,852,60,1
154688,3076,1237,1839,1,4
154688,1897,814,1083,2,1
154688,1759,773,986,3,1
154688,235,122,113,4,1
154688,1524,651,873,5,1
154688,138,41,97,11,1
154688,1179,423,756,12,3
154688,180,62,118,19,1
154688,1344,589,755,20,1
154688,1315,584,731,21,4
154688,1069,479,590,22,1
154688,1066,479,587,23,1
154688,235,122,113,24,1
154688,831,357,474,25,1
154688,3,0,3,31,1
154688,246,105,141,32,3
154688,96,29,67,39,1
154688,735,328,407,40,1
154688,1761,653,1108,41,4
154688,828,335,493,42,1
154688,693,294,399,43,1
154688,693,294,399,45,1
154688,135,41,94,51,1
154688,933,318,615,52,3
154688,84,33,51,59,1
154688,609,261,348,60,1
154697,5210,2713,2497,1,4
154697,5210,2713,2497,2,1
154697,2585,1163,1422,3,1
154697,712,349,363,4,1
154697,1873,814,1059,5,1
154697,2625,1550,1075,11,1
154697,179,64,115,19,1
154697,1694,750,944,20,1
154697,1402,582,820,21,4
154697,1402,582,820,22,1
154697,1282,524,758,23,1
154697,430,190,240,24,1
154697,852,334,518,25,1
154697,120,58,62,31,1
154697,109,44,65,39,1
154697,743,290,453,40,1
154697,3808,2131,1677,41,4
154697,3808,2131,1677,42,1
154697,1303,639,664,43,1
154697,282,159,123,44,1
154697,1021,480,541,45,1
154697,2505,1492,1013,51,1
154697,70,20,50,59,1
154697,951,460,491,60,1
154712,2177,1037,1140,1,4
154712,2113,1005,1108,2,1
154712,1750,826,924,3,1
154712,494,232,262,4,1
154712,1256,594,662,5,1
154712,363,179,184,11,1
154712,64,32,32,12,3
154712,69,44,25,19,1
154712,1187,550,637,20,1
154712,1796,856,940,21,4
154712,1750,831,919,22,1
154712,1728,817,911,23,1
154712,494,232,262,24,1
154712,1234,585,649,25,1
154712,22,14,8,31,1
154712,46,25,21,32,3
154712,68,44,24,39,1
154712,1166,541,625,40,1
154712,381,181,200,41,4
154712,363,174,189,42,1
154712,22,9,13,43,1
154712,22,9,13,45,1
154712,341,165,176,51,1
154712,18,7,11,52,3
154712,1,0,1,59,1
154712,21,9,12,60,1
154721,665,396,269,1,4
154721,665,396,269,2,1
154721,604,361,243,3,1
154721,184,117,67,4,1
154721,420,244,176,5,1
154721,61,35,26,11,1
154721,75,53,22,19,1
154721,345,191,154,20,1
154721,603,360,243,21,4
154721,603,360,243,22,1
154721,602,359,243,23,1
154721,184,117,67,24,1
154721,418,242,176,25,1
154721,1,1,0,31,1
154721,75,53,22,39,1
154721,343,189,154,40,1
154721,62,36,26,41,4
154721,62,36,26,42,1
154721,2,2,0,43,1
154721,2,2,0,45,1
154721,60,34,26,51,1
154721,2,2,0,60,1
154749,482,237,245,1,4
154749,482,237,245,2,1
154749,482,237,245,3,1
154749,123,77,46,4,1
154749,359,160,199,5,1
154749,74,32,42,19,1
154749,285,128,157,20,1
154749,464,232,232,21,4
154749,464,232,232,22,1
154749,464,232,232,23,1
154749,123,77,46,24,1
154749,341,155,186,25,1
154749,71,32,39,39,1
154749,270,123,147,40,1
154749,18,5,13,41,4
154749,18,5,13,42,1
154749,18,5,13,43,1
154749,18,5,13,45,1
154749,3,0,3,59,1
154749,15,5,10,60,1
154767,486,78,408,1,4
154767,486,78,408,2,1
154767,486,78,408,3,1
154767,134,19,115,4,1
154767,352,59,293,5,1
154767,17,2,15,19,1
154767,335,57,278,20,1
154767,486,78,408,21,4
154767,486,78,408,22,1
154767,486,78,408,23,1
154767,134,19,115,24,1
154767,352,59,293,25,1
154767,17,2,15,39,1
154767,335,57,278,40,1
154776,508,127,381,1,4
154776,508,127,381,2,1
154776,506,126,380,3,1
154776,187,64,123,4,1
154776,319,62,257,5,1
154776,2,1,1,11,1
154776,2,0,2,19,1
154776,317,62,255,20,1
154776,508,127,381,21,4
154776,508,127,381,22,1
154776,506,126,380,23,1
154776,187,64,123,24,1
154776,319,62,257,25,1
154776,2,1,1,31,1
154776,2,0,2,39,1
154776,317,62,255,40,1
154794,88,31,57,1,4
154794,88,31,57,2,1
154794,88,31,57,3,1
154794,8,7,1,4,1
154794,80,24,56,5,1
154794,10,2,8,19,1
154794,70,22,48,20,1
154794,88,31,57,21,4
154794,88,31,57,22,1
154794,88,31,57,23,1
154794,8,7,1,24,1
154794,80,24,56,25,1
154794,10,2,8,39,1
154794,70,22,48,40,1
154800,9142,3814,5328,1,4
154800,9142,3814,5328,2,1
154800,6861,2835,4026,3,1
154800,1700,790,910,4,1
154800,5161,2045,3116,5,1
154800,2281,979,1302,11,1
154800,618,255,363,19,1
154800,4543,1790,2753,20,1
154800,4111,1923,2188,21,4
154800,4111,1923,2188,22,1
154800,3521,1653,1868,23,1
154800,1250,586,664,24,1
154800,2271,1067,1204,25,1
154800,590,270,320,31,1
154800,304,142,162,39,1
154800,1967,925,1042,40,1
154800,5031,1891,3140,41,4
154800,5031,1891,3140,42,1
154800,3340,1182,2158,43,1
154800,450,204,246,44,1
154800,2890,978,1912,45,1
154800,1691,709,982,51,1
154800,314,113,201,59,1
154800,2576,865,1711,60,1
154837,337,173,164,1,4
154837,82,29,53,2,1
154837,82,29,53,3,1
154837,32,8,24,4,1
154837,50,21,29,5,1
154837,255,144,111,12,3
154837,29,11,18,19,1
154837,21,10,11,20,1
154837,248,132,116,21,4
154837,77,25,52,22,1
154837,77,25,52,23,1
154837,30,6,24,24,1
154837,47,19,28,25,1
154837,171,107,64,32,3
154837,28,11,17,39,1
154837,19,8,11,40,1
154837,89,41,48,41,4
154837,5,4,1,42,1
154837,5,4,1,43,1
154837,2,2,0,44,1
154837,3,2,1,45,1
154837,84,37,47,52,3
154837,1,0,1,59,1
154837,2,2,0,60,1
154855,1037,533,504,1,4
154855,1037,533,504,2,1
154855,765,421,344,3,1
154855,173,102,71,4,1
154855,592,319,273,5,1
154855,272,112,160,11,1
154855,94,56,38,19,1
154855,498,263,235,20,1
154855,741,412,329,21,4
154855,741,412,329,22,1
154855,739,412,327,23,1
154855,173,102,71,24,1
154855,566,310,256,25,1
154855,2,0,2,31,1
154855,93,55,38,39,1
154855,473,255,218,40,1
154855,296,121,175,41,4
154855,296,121,175,42,1
154855,26,9,17,43,1
154855,26,9,17,45,1
154855,270,112,158,51,1
154855,1,1,0,59,1
154855,25,8,17,60,1
154907,2318,884,1434,1,4
154907,2318,884,1434,2,1
154907,1296,460,836,3,1
154907,406,185,221,4,1
154907,890,275,615,5,1
154907,1022,424,598,11,1
154907,182,62,120,19,1
154907,708,213,495,20,1
154907,883,386,497,21,4
154907,883,386,497,22,1
154907,851,374,477,23,1
154907,357,175,182,24,1
154907,494,199,295,25,1
154907,32,12,20,31,1
154907,98,47,51,39,1
154907,396,152,244,40,1
154907,1435,498,937,41,4
154907,1435,498,937,42,1
154907,445,86,359,43,1
154907,49,10,39,44,1
154907,396,76,320,45,1
154907,990,412,578,51,1
154907,84,15,69,59,1
154907,312,61,251,60,1
154925,1866,937,929,1,4
154925,1866,937,929,2,1
154925,1273,716,557,3,1
154925,528,318,210,4,1
154925,745,398,347,5,1
154925,593,221,372,11,1
154925,70,37,33,19,1
154925,675,361,314,20,1
154925,1072,631,441,21,4
154925,1072,631,441,22,1
154925,1072,631,441,23,1
154925,495,305,190,24,1
154925,577,326,251,25,1
154925,65,34,31,39,1
154925,512,292,220,40,1
154925,794,306,488,41,4
154925,794,306,488,42,1
154925,201,85,116,43,1
154925,33,13,20,44,1
154925,168,72,96,45,1
154925,593,221,372,51,1
154925,5,3,2,59,1
154925,163,69,94,60,1
154934,1402,497,905,1,4
154934,1402,497,905,2,1
154934,815,255,560,3,1
154934,320,122,198,4,1
154934,495,133,362,5,1
154934,587,242,345,11,1
154934,121,27,94,19,1
154934,374,106,268,20,1
154934,643,252,391,21,4
154934,643,252,391,22,1
154934,570,211,359,23,1
154934,275,110,165,24,1
154934,295,101,194,25,1
154934,73,41,32,31,1
154934,63,19,44,39,1
154934,232,82,150,40,1
154934,759,245,514,41,4
154934,759,245,514,42,1
154934,245,44,201,43,1
154934,45,12,33,44,1
154934,200,32,168,45,1
154934,514,201,313,51,1
154934,58,8,50,59,1
154934,142,24,118,60,1
154952,3888,1504,2384,1,4
154952,3888,1504,2384,2,1
154952,3395,1333,2062,3,1
154952,762,354,408,4,1
154952,2633,979,1654,5,1
154952,493,171,322,11,1
154952,126,51,75,19,1
154952,2507,928,1579,20,1
154952,2071,853,1218,21,4
154952,2071,853,1218,22,1
154952,2071,853,1218,23,1
154952,561,257,304,24,1
154952,1510,596,914,25,1
154952,60,18,42,39,1
154952,1450,578,872,40,1
154952,1817,651,1166,41,4
154952,1817,651,1166,42,1
154952,1324,480,844,43,1
154952,201,97,104,44,1
154952,1123,383,740,45,1
154952,493,171,322,51,1
154952,66,33,33,59,1
154952,1057,350,707,60,1
154970,111,10,101,1,4
154970,111,10,101,2,1
154970,111,10,101,3,1
154970,31,3,28,4,1
154970,80,7,73,5,1
154970,80,7,73,20,1
154970,105,10,95,21,4
154970,105,10,95,22,1
154970,105,10,95,23,1
154970,31,3,28,24,1
154970,74,7,67,25,1
154970,74,7,67,40,1
154970,6,0,6,41,4
154970,6,0,6,42,1
154970,6,0,6,43,1
154970,6,0,6,45,1
154970,6,0,6,60,1
154998,1785,888,897,1,4
154998,1785,888,897,2,1
154998,1161,611,550,3,1
154998,461,250,211,4,1
154998,700,361,339,5,1
154998,624,277,347,11,1
154998,88,59,29,19,1
154998,612,302,310,20,1
154998,975,526,449,21,4
154998,975,526,449,22,1
154998,888,498,390,23,1
154998,407,229,178,24,1
154998,481,269,212,25,1
154998,87,28,59,31,1
154998,63,47,16,39,1
154998,418,222,196,40,1
154998,810,362,448,41,4
154998,810,362,448,42,1
154998,273,113,160,43,1
154998,54,21,33,44,1
154998,219,92,127,45,1
154998,537,249,288,51,1
154998,25,12,13,59,1
154998,194,80,114,60,1
155007,474,145,329,1,4
155007,474,145,329,2,1
155007,419,127,292,3,1
155007,135,48,87,4,1
155007,284,79,205,5,1
155007,55,18,37,11,1
155007,19,7,12,19,1
155007,265,72,193,20,1
155007,271,99,172,21,4
155007,271,99,172,22,1
155007,220,81,139,23,1
155007,105,42,63,24,1
155007,115,39,76,25,1
155007,51,18,33,31,1
155007,7,3,4,39,1
155007,108,36,72,40,1
155007,203,46,157,41,4
155007,203,46,157,42,1
155007,199,46,153,43,1
155007,30,6,24,44,1
155007,169,40,129,45,1
155007,4,0,4,51,1
155007,12,4,8,59,1
155007,157,36,121,60,1
155025,6033,2235,3798,1,4
155025,3873,1532,2341,2,1
155025,3724,1477,2247,3,1
155025,696,233,463,4,1
155025,3028,1244,1784,5,1
155025,149,55,94,11,1
155025,2160,703,1457,12,3
155025,387,147,240,19,1
155025,2641,1097,1544,20,1
155025,3787,1465,2322,21,4
155025,3445,1353,2092,22,1
155025,3384,1328,2056,23,1
155025,668,218,450,24,1
155025,2716,1110,1606,25,1
155025,61,25,36,31,1
155025,342,112,230,32,3
155025,339,134,205,39,1
155025,2377,976,1401,40,1
155025,2246,770,1476,41,4
155025,428,179,249,42,1
155025,340,149,191,43,1
155025,28,15,13,44,1
155025,312,134,178,45,1
155025,88,30,58,51,1
155025,1818,591,1227,52,3
155025,48,13,35,59,1
155025,264,121,143,60,1
155052,834,450,384,1,4
155052,834,450,384,2,1
155052,600,337,263,3,1
155052,174,103,71,4,1
155052,426,234,192,5,1
155052,234,113,121,11,1
155052,116,46,70,19,1
155052,310,188,122,20,1
155052,509,292,217,21,4
155052,509,292,217,22,1
155052,493,285,208,23,1
155052,155,97,58,24,1
155052,338,188,150,25,1
155052,16,7,9,31,1
155052,96,40,56,39,1
155052,242,148,94,40,1
155052,325,158,167,41,4
155052,325,158,167,42,1
155052,107,52,55,43,1
155052,19,6,13,44,1
155052,88,46,42,45,1
155052,218,106,112,51,1
155052,20,6,14,59,1
155052,68,40,28,60,1
155061,13441,5469,7972,1,4
155061,11433,4703,6730,2,1
155061,11064,4523,6541,3,1
155061,1063,466,597,4,1
155061,10001,4057,5944,5,1
155061,369,180,189,11,1
155061,2008,766,1242,12,3
155061,2091,871,1220,19,1
155061,7910,3186,4724,20,1
155061,5999,2530,3469,21,4
155061,5449,2312,3137,22,1
155061,5317,2230,3087,23,1
155061,981,429,552,24,1
155061,4336,1801,2535,25,1
155061,132,82,50,31,1
155061,550,218,332,32,3
155061,629,277,352,39,1
155061,3707,1524,2183,40,1
155061,7442,2939,4503,41,4
155061,5984,2391,3593,42,1
155061,5747,2293,3454,43,1
155061,82,37,45,44,1
155061,5665,2256,3409,45,1
155061,237,98,139,51,1
155061,1458,548,910,52,3
155061,1462,594,868,59,1
155061,4203,1662,2541,60,1
155070,260,133,127,1,4
155070,234,113,121,2,1
155070,233,113,120,3,1
155070,49,28,21,4,1
155070,184,85,99,5,1
155070,1,0,1,11,1
155070,26,20,6,12,3
155070,31,18,13,19,1
155070,153,67,86,20,1
155070,209,104,105,21,4
155070,183,84,99,22,1
155070,183,84,99,23,1
155070,37,17,20,24,1
155070,146,67,79,25,1
155070,26,20,6,32,3
155070,20,10,10,39,1
155070,126,57,69,40,1
155070,51,29,22,41,4
155070,51,29,22,42,1
155070,50,29,21,43,1
155070,12,11,1,44,1
155070,38,18,20,45,1
155070,1,0,1,51,1
155070,11,8,3,59,1
155070,27,10,17,60,1
155089,2178,913,1265,1,4
155089,1609,713,896,2,1
155089,1568,693,875,3,1
155089,184,91,93,4,1
155089,1384,602,782,5,1
155089,41,20,21,11,1
155089,569,200,369,12,3
155089,263,109,154,19,1
155089,1121,493,628,20,1
155089,1206,530,676,21,4
155089,1045,480,565,22,1
155089,1045,480,565,23,1
155089,178,90,88,24,1
155089,867,390,477,25,1
155089,161,50,111,32,3
155089,160,67,93,39,1
155089,707,323,384,40,1
155089,972,383,589,41,4
155089,564,233,331,42,1
155089,523,213,310,43,1
155089,6,1,5,44,1
155089,517,212,305,45,1
155089,41,20,21,51,1
155089,408,150,258,52,3
155089,103,42,61,59,1
155089,414,170,244,60,1
155098,1931,951,980,1,4
155098,1931,951,980,2,1
155098,1409,754,655,3,1
155098,503,286,217,4,1
155098,906,468,438,5,1
155098,522,197,325,11,1
155098,289,152,137,19,1
155098,617,316,301,20,1
155098,962,570,392,21,4
155098,962,570,392,22,1
155098,920,550,370,23,1
155098,385,231,154,24,1
155098,535,319,216,25,1
155098,42,20,22,31,1
155098,151,104,47,39,1
155098,384,215,169,40,1
155098,969,381,588,41,4
155098,969,381,588,42,1
155098,489,204,285,43,1
155098,118,55,63,44,1
155098,371,149,222,45,1
155098,480,177,303,51,1
155098,138,48,90,59,1
155098,233,101,132,60,1
155104,1997,916,1081,1,4
155104,1997,916,1081,2,1
155104,1448,677,771,3,1
155104,507,291,216,4,1
155104,941,386,555,5,1
155104,549,239,310,11,1
155104,66,36,30,19,1
155104,875,350,525,20,1
155104,1069,545,524,21,4
155104,1069,545,524,22,1
155104,1050,537,513,23,1
155104,445,269,176,24,1
155104,605,268,337,25,1
155104,19,8,11,31,1
155104,50,28,22,39,1
155104,555,240,315,40,1
155104,928,371,557,41,4
155104,928,371,557,42,1
155104,398,140,258,43,1
155104,62,22,40,44,1
155104,336,118,218,45,1
155104,530,231,299,51,1
155104,16,8,8,59,1
155104,320,110,210,60,1
155140,742,371,371,1,4
155140,742,371,371,2,1
155140,741,371,370,3,1
155140,146,82,64,4,1
155140,595,289,306,5,1
155140,1,0,1,11,1
155140,52,21,31,19,1
155140,543,268,275,20,1
155140,721,363,358,21,4
155140,721,363,358,22,1
155140,720,363,357,23,1
155140,145,81,64,24,1
155140,575,282,293,25,1
155140,1,0,1,31,1
155140,40,21,19,39,1
155140,535,261,274,40,1
155140,21,8,13,41,4
155140,21,8,13,42,1
155140,21,8,13,43,1
155140,1,1,0,44,1
155140,20,7,13,45,1
155140,12,0,12,59,1
155140,8,7,1,60,1
155159,77,2,75,1,4
155159,77,2,75,2,1
155159,77,2,75,3,1
155159,40,1,39,4,1
155159,37,1,36,5,1
155159,37,1,36,20,1
155159,77,2,75,21,4
155159,77,2,75,22,1
155159,77,2,75,23,1
155159,40,1,39,24,1
155159,37,1,36,25,1
155159,37,1,36,40,1
155177,445,188,257,1,4
155177,445,188,257,2,1
155177,440,183,257,3,1
155177,165,78,87,4,1
155177,275,105,170,5,1
155177,5,5,0,11,1
155177,50,15,35,19,1
155177,225,90,135,20,1
155177,376,169,207,21,4
155177,376,169,207,22,1
155177,376,169,207,23,1
155177,163,76,87,24,1
155177,213,93,120,25,1
155177,22,12,10,39,1
155177,191,81,110,40,1
155177,69,19,50,41,4
155177,69,19,50,42,1
155177,64,14,50,43,1
155177,2,2,0,44,1
155177,62,12,50,45,1
155177,5,5,0,51,1
155177,28,3,25,59,1
155177,34,9,25,60,1
155186,3226,1387,1839,1,4
155186,3226,1387,1839,2,1
155186,1777,772,1005,3,1
155186,579,319,260,4,1
155186,1198,453,745,5,1
155186,1449,615,834,11,1
155186,282,111,171,19,1
155186,916,342,574,20,1
155186,1178,589,589,21,4
155186,1178,589,589,22,1
155186,1118,569,549,23,1
155186,477,276,201,24,1
155186,641,293,348,25,1
155186,60,20,40,31,1
155186,131,62,69,39,1
155186,510,231,279,40,1
155186,2048,798,1250,41,4
155186,2048,798,1250,42,1
155186,659,203,456,43,1
155186,102,43,59,44,1
155186,557,160,397,45,1
155186,1389,595,794,51,1
155186,151,49,102,59,1
155186,406,111,295,60,1
155195,6127,2815,3312,1,4
155195,6127,2815,3312,2,1
155195,4064,1737,2327,3,1
155195,1094,560,534,4,1
155195,2970,1177,1793,5,1
155195,2063,1078,985,11,1
155195,320,114,206,19,1
155195,2650,1063,1587,20,1
155195,2371,1166,1205,21,4
155195,2371,1166,1205,22,1
155195,2330,1139,1191,23,1
155195,915,478,437,24,1
155195,1415,661,754,25,1
155195,41,27,14,31,1
155195,142,62,80,39,1
155195,1273,599,674,40,1
155195,3756,1649,2107,41,4
155195,3756,1649,2107,42,1
155195,1734,598,1136,43,1
155195,179,82,97,44,1
155195,1555,516,1039,45,1
155195,2022,1051,971,51,1
155195,178,52,126,59,1
155195,1377,464,913,60,1
155201,1031,468,563,1,4
155201,1031,468,563,2,1
155201,678,320,358,3,1
155201,310,169,141,4,1
155201,368,151,217,5,1
155201,353,148,205,11,1
155201,59,25,34,19,1
155201,309,126,183,20,1
155201,575,295,280,21,4
155201,575,295,280,22,1
155201,559,288,271,23,1
155201,291,163,128,24,1
155201,268,125,143,25,1
155201,16,7,9,31,1
155201,45,23,22,39,1
155201,223,102,121,40,1
155201,456,173,283,41,4
155201,456,173,283,42,1
155201,119,32,87,43,1
155201,19,6,13,44,1
155201,100,26,74,45,1
155201,337,141,196,51,1
155201,14,2,12,59,1
155201,86,24,62,60,1
155210,19672,9157,10515,1,4
155210,19672,9157,10515,2,1
155210,12361,5795,6566,3,1
155210,2100,1123,977,4,1
155210,10261,4672,5589,5,1
155210,7311,3362,3949,11,1
155210,997,446,551,19,1
155210,9264,4226,5038,20,1
155210,6331,3135,3196,21,4
155210,6331,3135,3196,22,1
155210,5335,2619,2716,23,1
155210,1377,743,634,24,1
155210,3958,1876,2082,25,1
155210,996,516,480,31,1
155210,449,219,230,39,1
155210,3509,1657,1852,40,1
155210,13341,6022,7319,41,4
155210,13341,6022,7319,42,1
155210,7026,3176,3850,43,1
155210,723,380,343,44,1
155210,6303,2796,3507,45,1
155210,6315,2846,3469,51,1
155210,548,227,321,59,1
155210,5755,2569,3186,60,1
155283,783,112,671,1,4
155283,783,112,671,2,1
155283,783,112,671,3,1
155283,207,28,179,4,1
155283,576,84,492,5,1
155283,576,84,492,20,1
155283,783,112,671,21,4
155283,783,112,671,22,1
155283,783,112,671,23,1
155283,207,28,179,24,1
155283,576,84,492,25,1
155283,576,84,492,40,1
155292,6570,2587,3983,1,4
155292,6570,2587,3983,2,1
155292,5327,2093,3234,3,1
155292,1023,504,519,4,1
155292,4304,1589,2715,5,1
155292,1243,494,749,11,1
155292,103,55,48,19,1
155292,4201,1534,2667,20,1
155292,2397,1050,1347,21,4
155292,2397,1050,1347,22,1
155292,2221,975,1246,23,1
155292,578,311,267,24,1
155292,1643,664,979,25,1
155292,176,75,101,31,1
155292,38,22,16,39,1
155292,1605,642,963,40,1
155292,4173,1537,2636,41,4
155292,4173,1537,2636,42,1
155292,3106,1118,1988,43,1
155292,445,193,252,44,1
155292,2661,925,1736,45,1
155292,1067,419,648,51,1
155292,65,33,32,59,1
155292,2596,892,1704,60,1
155317,26968,13137,13831,1,4
155317,19217,9639,9578,2,1
155317,18731,9398,9333,3,1
155317,4000,1948,2052,4,1
155317,14731,7450,7281,5,1
155317,486,241,245,11,1
155317,7751,3498,4253,12,3
155317,1421,689,732,19,1
155317,13310,6761,6549,20,1
155317,23034,11389,11645,21,4
155317,17193,8611,8582,22,1
155317,16877,8446,8431,23,1
155317,3898,1886,2012,24,1
155317,12979,6560,6419,25,1
155317,316,165,151,31,1
155317,5841,2778,3063,32,3
155317,1189,588,601,39,1
155317,11790,5972,5818,40,1
155317,3934,1748,2186,41,4
155317,2024,1028,996,42,1
155317,1854,952,902,43,1
155317,102,62,40,44,1
155317,1752,890,862,45,1
155317,170,76,94,51,1
155317,1910,720,1190,52,3
155317,232,101,131,59,1
155317,1520,789,731,60,1
155335,3736,1281,2455,1,4
155335,2795,1062,1733,2,1
155335,1276,438,838,3,1
155335,165,64,101,4,1
155335,1111,374,737,5,1
155335,1519,624,895,11,1
155335,941,219,722,12,3
155335,206,77,129,19,1
155335,905,297,608,20,1
155335,1275,436,839,21,4
155335,1121,394,727,22,1
155335,1107,390,717,23,1
155335,164,64,100,24,1
155335,943,326,617,25,1
155335,14,4,10,31,1
155335,154,42,112,32,3
155335,183,71,112,39,1
155335,760,255,505,40,1
155335,2461,845,1616,41,4
155335,1674,668,1006,42,1
155335,169,48,121,43,1
155335,1,0,1,44,1
155335,168,48,120,45,1
155335,1505,620,885,51,1
155335,787,177,610,52,3
155335,23,6,17,59,1
155335,145,42,103,60,1
155353,40,32,8,1,4
155353,40,32,8,2,1
155353,40,32,8,3,1
155353,33,26,7,4,1
155353,7,6,1,5,1
155353,7,6,1,20,1
155353,40,32,8,21,4
155353,40,32,8,22,1
155353,40,32,8,23,1
155353,33,26,7,24,1
155353,7,6,1,25,1
155353,7,6,1,40,1
155399,24581,12459,12122,1,4
155399,20169,10503,9666,2,1
155399,19647,10283,9364,3,1
155399,3821,1894,1927,4,1
155399,15826,8389,7437,5,1
155399,522,220,302,11,1
155399,4412,1956,2456,12,3
155399,1509,807,702,19,1
155399,14317,7582,6735,20,1
155399,20549,10631,9918,21,4
155399,18110,9496,8614,22,1
155399,17884,9392,8492,23,1
155399,3755,1860,1895,24,1
155399,14129,7532,6597,25,1
155399,226,104,122,31,1
155399,2439,1135,1304,32,3
155399,1313,717,596,39,1
155399,12816,6815,6001,40,1
155399,4032,1828,2204,41,4
155399,2059,1007,1052,42,1
155399,1763,891,872,43,1
155399,66,34,32,44,1
155399,1697,857,840,45,1
155399,296,116,180,51,1
155399,1973,821,1152,52,3
155399,196,90,106,59,1
155399,1501,767,734,60,1
155414,729,337,392,1,4
155414,684,317,367,2,1
155414,664,308,356,3,1
155414,151,77,74,4,1
155414,513,231,282,5,1
155414,20,9,11,11,1
155414,45,20,25,12,3
155414,104,63,41,19,1
155414,409,168,241,20,1
155414,624,290,334,21,4
155414,624,290,334,22,1
155414,624,290,334,23,1
155414,151,77,74,24,1
155414,473,213,260,25,1
155414,96,57,39,39,1
155414,377,156,221,40,1
155414,105,47,58,41,4
155414,60,27,33,42,1
155414,40,18,22,43,1
155414,40,18,22,45,1
155414,20,9,11,51,1
155414,45,20,25,52,3
155414,8,6,2,59,1
155414,32,12,20,60,1
155423,1162,679,483,1,4
155423,1162,679,483,2,1
155423,1161,679,482,3,1
155423,298,206,92,4,1
155423,863,473,390,5,1
155423,1,0,1,11,1
155423,863,473,390,20,1
155423,262,155,107,21,4
155423,262,155,107,22,1
155423,262,155,107,23,1
155423,83,69,14,24,1
155423,179,86,93,25,1
155423,179,86,93,40,1
155423,900,524,376,41,4
155423,900,524,376,42,1
155423,899,524,375,43,1
155423,215,137,78,44,1
155423,684,387,297,45,1
155423,1,0,1,51,1
155423,684,387,297,60,1
155441,37,4,33,1,4
155441,37,4,33,2,1
155441,37,4,33,3,1
155441,15,1,14,4,1
155441,22,3,19,5,1
155441,22,3,19,20,1
155441,24,1,23,21,4
155441,24,1,23,22,1
155441,24,1,23,23,1
155441,8,0,8,24,1
155441,16,1,15,25,1
155441,16,1,15,40,1
155441,13,3,10,41,4
155441,13,3,10,42,1
155441,13,3,10,43,1
155441,7,1,6,44,1
155441,6,2,4,45,1
155441,6,2,4,60,1
155450,1959,653,1306,1,4
155450,1959,653,1306,2,1
155450,1374,488,886,3,1
155450,201,99,102,4,1
155450,1173,389,784,5,1
155450,585,165,420,11,1
155450,82,30,52,19,1
155450,1091,359,732,20,1
155450,689,256,433,21,4
155450,689,256,433,22,1
155450,641,236,405,23,1
155450,176,85,91,24,1
155450,465,151,314,25,1
155450,48,20,28,31,1
155450,59,26,33,39,1
155450,406,125,281,40,1
155450,1270,397,873,41,4
155450,1270,397,873,42,1
155450,733,252,481,43,1
155450,25,14,11,44,1
155450,708,238,470,45,1
155450,537,145,392,51,1
155450,23,4,19,59,1
155450,685,234,451,60,1
155487,825,356,469,1,4
155487,825,356,469,2,1
155487,750,345,405,3,1
155487,235,110,125,4,1
155487,515,235,280,5,1
155487,75,11,64,11,1
155487,116,52,64,19,1
155487,399,183,216,20,1
155487,491,263,228,21,4
155487,491,263,228,22,1
155487,474,259,215,23,1
155487,128,86,42,24,1
155487,346,173,173,25,1
155487,17,4,13,31,1
155487,81,40,41,39,1
155487,265,133,132,40,1
155487,334,93,241,41,4
155487,334,93,241,42,1
155487,276,86,190,43,1
155487,107,24,83,44,1
155487,169,62,107,45,1
155487,58,7,51,51,1
155487,35,12,23,59,1
155487,134,50,84,60,1
155496,327,181,146,1,4
155496,327,181,146,2,1
155496,301,170,131,3,1
155496,73,42,31,4,1
155496,228,128,100,5,1
155496,26,11,15,11,1
155496,23,17,6,19,1
155496,205,111,94,20,1
155496,222,124,98,21,4
155496,222,124,98,22,1
155496,222,124,98,23,1
155496,73,42,31,24,1
155496,149,82,67,25,1
155496,22,16,6,39,1
155496,127,66,61,40,1
155496,105,57,48,41,4
155496,105,57,48,42,1
155496,79,46,33,43,1
155496,79,46,33,45,1
155496,26,11,15,51,1
155496,1,1,0,59,1
155496,78,45,33,60,1
155511,656,382,274,1,4
155511,637,378,259,2,1
155511,632,374,258,3,1
155511,170,99,71,4,1
155511,462,275,187,5,1
155511,5,4,1,11,1
155511,19,4,15,12,3
155511,92,61,31,19,1
155511,370,214,156,20,1
155511,603,353,250,21,4
155511,602,353,249,22,1
155511,602,353,249,23,1
155511,170,99,71,24,1
155511,432,254,178,25,1
155511,1,0,1,32,3
155511,84,58,26,39,1
155511,348,196,152,40,1
155511,53,29,24,41,4
155511,35,25,10,42,1
155511,30,21,9,43,1
155511,30,21,9,45,1
155511,5,4,1,51,1
155511,18,4,14,52,3
155511,8,3,5,59,1
155511,22,18,4,60,1
155520,1907,671,1236,1,4
155520,1438,563,875,2,1
155520,1390,542,848,3,1
155520,223,100,123,4,1
155520,1167,442,725,5,1
155520,48,21,27,11,1
155520,469,108,361,12,3
155520,335,101,234,19,1
155520,832,341,491,20,1
155520,1491,548,943,21,4
155520,1131,452,679,22,1
155520,1129,452,677,23,1
155520,218,96,122,24,1
155520,911,356,555,25,1
155520,2,0,2,31,1
155520,360,96,264,32,3
155520,206,75,131,39,1
155520,705,281,424,40,1
155520,416,123,293,41,4
155520,307,111,196,42,1
155520,261,90,171,43,1
155520,5,4,1,44,1
155520,256,86,170,45,1
155520,46,21,25,51,1
155520,109,12,97,52,3
155520,129,26,103,59,1
155520,127,60,67,60,1
155566,2667,967,1700,1,4
155566,2667,967,1700,2,1
155566,1434,429,1005,3,1
155566,363,171,192,4,1
155566,1071,258,813,5,1
155566,1233,538,695,11,1
155566,194,53,141,19,1
155566,877,205,672,20,1
155566,934,338,596,21,4
155566,934,338,596,22,1
155566,891,320,571,23,1
155566,326,154,172,24,1
155566,565,166,399,25,1
155566,43,18,25,31,1
155566,102,32,70,39,1
155566,463,134,329,40,1
155566,1733,629,1104,41,4
155566,1733,629,1104,42,1
155566,543,109,434,43,1
155566,37,17,20,44,1
155566,506,92,414,45,1
155566,1190,520,670,51,1
155566,92,21,71,59,1
155566,414,71,343,60,1
155593,844,510,334,1,4
155593,844,510,334,2,1
155593,504,355,149,3,1
155593,219,200,19,4,1
155593,285,155,130,5,1
155593,340,155,185,11,1
155593,74,32,42,19,1
155593,211,123,88,20,1
155593,535,366,169,21,4
155593,535,366,169,22,1
155593,474,352,122,23,1
155593,218,200,18,24,1
155593,256,152,104,25,1
155593,61,14,47,31,1
155593,74,32,42,39,1
155593,182,120,62,40,1
155593,309,144,165,41,4
155593,309,144,165,42,1
155593,30,3,27,43,1
155593,1,0,1,44,1
155593,29,3,26,45,1
155593,279,141,138,51,1
155593,29,3,26,60,1
155618,626,388,238,1,4
155618,626,388,238,2,1
155618,391,262,129,3,1
155618,190,131,59,4,1
155618,201,131,70,5,1
155618,235,126,109,11,1
155618,20,11,9,19,1
155618,181,120,61,20,1
155618,392,261,131,21,4
155618,392,261,131,22,1
155618,384,258,126,23,1
155618,188,129,59,24,1
155618,196,129,67,25,1
155618,8,3,5,31,1
155618,19,11,8,39,1
155618,177,118,59,40,1
155618,234,127,107,41,4
155618,234,127,107,42,1
155618,7,4,3,43,1
155618,2,2,0,44,1
155618,5,2,3,45,1
155618,227,123,104,51,1
155618,1,0,1,59,1
155618,4,2,2,60,1
155627,558,313,245,1,4
155627,538,303,235,2,1
155627,533,300,233,3,1
155627,145,89,56,4,1
155627,388,211,177,5,1
155627,5,3,2,11,1
155627,20,10,10,12,3
155627,40,27,13,19,1
155627,348,184,164,20,1
155627,523,292,231,21,4
155627,522,292,230,22,1
155627,520,290,230,23,1
155627,144,88,56,24,1
155627,376,202,174,25,1
155627,2,2,0,31,1
155627,1,0,1,32,3
155627,37,26,11,39,1
155627,339,176,163,40,1
155627,35,21,14,41,4
155627,16,11,5,42,1
155627,13,10,3,43,1
155627,1,1,0,44,1
155627,12,9,3,45,1
155627,3,1,2,51,1
155627,19,10,9,52,3
155627,3,1,2,59,1
155627,9,8,1,60,1
155636,356,98,258,1,4
155636,292,81,211,2,1
155636,246,72,174,3,1
155636,3,0,3,4,1
155636,243,72,171,5,1
155636,46,9,37,11,1
155636,64,17,47,12,3
155636,74,25,49,19,1
155636,169,47,122,20,1
155636,356,98,258,41,4
155636,292,81,211,42,1
155636,246,72,174,43,1
155636,3,0,3,44,1
155636,243,72,171,45,1
155636,46,9,37,51,1
155636,64,17,47,52,3
155636,74,25,49,59,1
155636,169,47,122,60,1
155681,7400,3656,3744,1,4
155681,6236,3230,3006,2,1
155681,6005,3107,2898,3,1
155681,1144,577,567,4,1
155681,4861,2530,2331,5,1
155681,231,123,108,11,1
155681,1164,426,738,12,3
155681,584,284,300,19,1
155681,4277,2246,2031,20,1
155681,6006,3085,2921,21,4
155681,5625,2909,2716,22,1
155681,5621,2907,2714,23,1
155681,1128,569,559,24,1
155681,4493,2338,2155,25,1
155681,4,2,2,31,1
155681,381,176,205,32,3
155681,533,264,269,39,1
155681,3960,2074,1886,40,1
155681,1394,571,823,41,4
155681,611,321,290,42,1
155681,384,200,184,43,1
155681,16,8,8,44,1
155681,368,192,176,45,1
155681,227,121,106,51,1
155681,783,250,533,52,3
155681,51,20,31,59,1
155681,317,172,145,60,1
155715,1541,617,924,1,4
155715,1541,617,924,2,1
155715,928,411,517,3,1
155715,323,186,137,4,1
155715,605,225,380,5,1
155715,613,206,407,11,1
155715,173,71,102,19,1
155715,432,154,278,20,1
155715,741,358,383,21,4
155715,741,358,383,22,1
155715,722,353,369,23,1
155715,301,178,123,24,1
155715,421,175,246,25,1
155715,19,5,14,31,1
155715,133,55,78,39,1
155715,288,120,168,40,1
155715,800,259,541,41,4
155715,800,259,541,42,1
155715,206,58,148,43,1
155715,22,8,14,44,1
155715,184,50,134,45,1
155715,594,201,393,51,1
155715,40,16,24,59,1
155715,144,34,110,60,1
155812,1325,461,864,1,4
155812,890,312,578,2,1
155812,782,277,505,3,1
155812,104,48,56,4,1
155812,678,229,449,5,1
155812,108,35,73,11,1
155812,435,149,286,12,3
155812,104,35,69,19,1
155812,574,194,380,20,1
155812,914,374,540,21,4
155812,566,252,314,22,1
155812,563,251,312,23,1
155812,104,48,56,24,1
155812,459,203,256,25,1
155812,3,1,2,31,1
155812,348,122,226,32,3
155812,76,31,45,39,1
155812,383,172,211,40,1
155812,411,87,324,41,4
155812,324,60,264,42,1
155812,219,26,193,43,1
155812,219,26,193,45,1
155812,105,34,71,51,1
155812,87,27,60,52,3
155812,28,4,24,59,1
155812,191,22,169,60,1
155830,447,305,142,1,4
155830,447,305,142,2,1
155830,294,215,79,3,1
155830,159,115,44,4,1
155830,135,100,35,5,1
155830,153,90,63,11,1
155830,35,27,8,19,1
155830,100,73,27,20,1
155830,270,204,66,21,4
155830,270,204,66,22,1
155830,258,194,64,23,1
155830,143,106,37,24,1
155830,115,88,27,25,1
155830,12,10,2,31,1
155830,32,24,8,39,1
155830,83,64,19,40,1
155830,177,101,76,41,4
155830,177,101,76,42,1
155830,36,21,15,43,1
155830,16,9,7,44,1
155830,20,12,8,45,1
155830,141,80,61,51,1
155830,3,3,0,59,1
155830,17,9,8,60,1
155858,1857,760,1097,1,4
155858,1857,760,1097,2,1
155858,1618,669,949,3,1
155858,348,165,183,4,1
155858,1270,504,766,5,1
155858,239,91,148,11,1
155858,96,31,65,19,1
155858,1174,473,701,20,1
155858,823,359,464,21,4
155858,823,359,464,22,1
155858,820,359,461,23,1
155858,300,152,148,24,1
155858,520,207,313,25,1
155858,3,0,3,31,1
155858,59,22,37,39,1
155858,461,185,276,40,1
155858,1034,401,633,41,4
155858,1034,401,633,42,1
155858,798,310,488,43,1
155858,48,13,35,44,1
155858,750,297,453,45,1
155858,236,91,145,51,1
155858,37,9,28,59,1
155858,713,288,425,60,1
155867,48,4,44,1,4
155867,48,4,44,2,1
155867,48,4,44,3,1
155867,15,1,14,4,1
155867,33,3,30,5,1
155867,33,3,30,20,1
155867,48,4,44,21,4
155867,48,4,44,22,1
155867,48,4,44,23,1
155867,15,1,14,24,1
155867,33,3,30,25,1
155867,33,3,30,40,1
155900,1661,903,758,1,4
155900,1358,772,586,2,1
155900,1332,755,577,3,1
155900,128,70,58,4,1
155900,1204,685,519,5,1
155900,26,17,9,11,1
155900,303,131,172,12,3
155900,238,143,95,19,1
155900,966,542,424,20,1
155900,574,287,287,21,4
155900,553,279,274,22,1
155900,552,279,273,23,1
155900,128,70,58,24,1
155900,424,209,215,25,1
155900,1,0,1,31,1
155900,21,8,13,32,3
155900,71,44,27,39,1
155900,353,165,188,40,1
155900,1087,616,471,41,4
155900,805,493,312,42,1
155900,780,476,304,43,1
155900,780,476,304,45,1
155900,25,17,8,51,1
155900,282,123,159,52,3
155900,167,99,68,59,1
155900,613,377,236,60,1
155937,690,376,314,1,4
155937,690,376,314,2,1
155937,640,351,289,3,1
155937,169,90,79,4,1
155937,471,261,210,5,1
155937,50,25,25,11,1
155937,63,45,18,19,1
155937,408,216,192,20,1
155937,595,336,259,21,4
155937,595,336,259,22,1
155937,595,336,259,23,1
155937,169,90,79,24,1
155937,426,246,180,25,1
155937,63,45,18,39,1
155937,363,201,162,40,1
155937,95,40,55,41,4
155937,95,40,55,42,1
155937,45,15,30,43,1
155937,45,15,30,45,1
155937,50,25,25,51,1
155937,45,15,30,60,1
155973,736,386,350,1,4
155973,725,376,349,2,1
155973,706,367,339,3,1
155973,159,98,61,4,1
155973,547,269,278,5,1
155973,19,9,10,11,1
155973,11,10,1,12,3
155973,103,47,56,19,1
155973,444,222,222,20,1
155973,565,335,230,21,4
155973,565,335,230,22,1
155973,565,335,230,23,1
155973,159,98,61,24,1
155973,406,237,169,25,1
155973,58,39,19,39,1
155973,348,198,150,40,1
155973,171,51,120,41,4
155973,160,41,119,42,1
155973,141,32,109,43,1
155973,141,32,109,45,1
155973,19,9,10,51,1
155973,11,10,1,52,3
155973,45,8,37,59,1
155973,96,24,72,60,1
156082,6973,2849,4124,1,4
156082,6179,2518,3661,2,1
156082,5320,2165,3155,3,1
156082,851,361,490,4,1
156082,4469,1804,2665,5,1
156082,859,353,506,11,1
156082,794,331,463,12,3
156082,494,197,297,19,1
156082,3975,1607,2368,20,1
156082,4562,1919,2643,21,4
156082,4072,1671,2401,22,1
156082,3956,1628,2328,23,1
156082,779,325,454,24,1
156082,3177,1303,1874,25,1
156082,116,43,73,31,1
156082,490,248,242,32,3
156082,368,152,216,39,1
156082,2809,1151,1658,40,1
156082,2411,930,1481,41,4
156082,2107,847,1260,42,1
156082,1364,537,827,43,1
156082,72,36,36,44,1
156082,1292,501,791,45,1
156082,743,310,433,51,1
156082,304,83,221,52,3
156082,126,45,81,59,1
156082,1166,456,710,60,1
156107,2934,1361,1573,1,4
156107,2934,1361,1573,2,1
156107,1690,810,880,3,1
156107,380,204,176,4,1
156107,1310,606,704,5,1
156107,1244,551,693,11,1
156107,210,81,129,19,1
156107,1100,525,575,20,1
156107,1087,541,546,21,4
156107,1087,541,546,22,1
156107,868,471,397,23,1
156107,189,137,52,24,1
156107,679,334,345,25,1
156107,219,70,149,31,1
156107,128,57,71,39,1
156107,551,277,274,40,1
156107,1847,820,1027,41,4
156107,1847,820,1027,42,1
156107,822,339,483,43,1
156107,191,67,124,44,1
156107,631,272,359,45,1
156107,1025,481,544,51,1
156107,82,24,58,59,1
156107,549,248,301,60,1
156125,14386,6882,7504,1,4
156125,11670,5564,6106,2,1
156125,11198,5291,5907,3,1
156125,1283,629,654,4,1
156125,9915,4662,5253,5,1
156125,472,273,199,11,1
156125,2716,1318,1398,12,3
156125,1296,601,695,19,1
156125,8619,4061,4558,20,1
156125,10184,4904,5280,21,4
156125,8807,4240,4567,22,1
156125,8566,4076,4490,23,1
156125,1218,591,627,24,1
156125,7348,3485,3863,25,1
156125,241,164,77,31,1
156125,1377,664,713,32,3
156125,956,460,496,39,1
156125,6392,3025,3367,40,1
156125,4202,1978,2224,41,4
156125,2863,1324,1539,42,1
156125,2632,1215,1417,43,1
156125,65,38,27,44,1
156125,2567,1177,1390,45,1
156125,231,109,122,51,1
156125,1339,654,685,52,3
156125,340,141,199,59,1
156125,2227,1036,1191,60,1
156134,967,517,450,1,4
156134,967,517,450,2,1
156134,967,517,450,3,1
156134,180,113,67,4,1
156134,787,404,383,5,1
156134,787,404,383,20,1
156134,967,517,450,21,4
156134,967,517,450,22,1
156134,967,517,450,23,1
156134,180,113,67,24,1
156134,787,404,383,25,1
156134,787,404,383,40,1
156189,631,289,342,1,4
156189,631,289,342,2,1
156189,617,286,331,3,1
156189,189,82,107,4,1
156189,428,204,224,5,1
156189,14,3,11,11,1
156189,39,24,15,19,1
156189,389,180,209,20,1
156189,606,281,325,21,4
156189,606,281,325,22,1
156189,606,281,325,23,1
156189,189,82,107,24,1
156189,417,199,218,25,1
156189,39,24,15,39,1
156189,378,175,203,40,1
156189,25,8,17,41,4
156189,25,8,17,42,1
156189,11,5,6,43,1
156189,11,5,6,45,1
156189,14,3,11,51,1
156189,11,5,6,60,1
156213,1797,672,1125,1,4
156213,1547,618,929,2,1
156213,1392,551,841,3,1
156213,322,117,205,4,1
156213,1070,434,636,5,1
156213,155,67,88,11,1
156213,250,54,196,12,3
156213,124,54,70,19,1
156213,946,380,566,20,1
156213,1390,529,861,21,4
156213,1326,517,809,22,1
156213,1308,514,794,23,1
156213,322,117,205,24,1
156213,986,397,589,25,1
156213,18,3,15,31,1
156213,64,12,52,32,3
156213,84,33,51,39,1
156213,902,364,538,40,1
156213,407,143,264,41,4
156213,221,101,120,42,1
156213,84,37,47,43,1
156213,84,37,47,45,1
156213,137,64,73,51,1
156213,186,42,144,52,3
156213,40,21,19,59,1
156213,44,16,28,60,1
156222,1440,941,499,1,4
156222,1440,941,499,12,3
156222,658,432,226,21,4
156222,658,432,226,32,3
156222,782,509,273,41,4
156222,782,509,273,52,3
156231,3359,1453,1906,1,4
156231,3359,1453,1906,2,1
156231,2525,1108,1417,3,1
156231,546,275,271,4,1
156231,1979,833,1146,5,1
156231,834,345,489,11,1
156231,125,45,80,19,1
156231,1854,788,1066,20,1
156231,1824,836,988,21,4
156231,1824,836,988,22,1
156231,1750,806,944,23,1
156231,418,215,203,24,1
156231,1332,591,741,25,1
156231,74,30,44,31,1
156231,76,30,46,39,1
156231,1256,561,695,40,1
156231,1535,617,918,41,4
156231,1535,617,918,42,1
156231,775,302,473,43,1
156231,128,60,68,44,1
156231,647,242,405,45,1
156231,760,315,445,51,1
156231,49,15,34,59,1
156231,598,227,371,60,1
156277,93,9,84,1,4
156277,93,9,84,2,1
156277,93,9,84,3,1
156277,31,3,28,4,1
156277,62,6,56,5,1
156277,62,6,56,20,1
156277,93,9,84,21,4
156277,93,9,84,22,1
156277,93,9,84,23,1
156277,31,3,28,24,1
156277,62,6,56,25,1
156277,62,6,56,40,1
156286,3419,1196,2223,1,4
156286,2593,945,1648,2,1
156286,2508,911,1597,3,1
156286,676,269,407,4,1
156286,1832,642,1190,5,1
156286,85,34,51,11,1
156286,826,251,575,12,3
156286,70,28,42,19,1
156286,1762,614,1148,20,1
156286,2682,998,1684,21,4
156286,2378,882,1496,22,1
156286,2354,874,1480,23,1
156286,674,267,407,24,1
156286,1680,607,1073,25,1
156286,24,8,16,31,1
156286,304,116,188,32,3
156286,55,22,33,39,1
156286,1625,585,1040,40,1
156286,737,198,539,41,4
156286,215,63,152,42,1
156286,154,37,117,43,1
156286,2,2,0,44,1
156286,152,35,117,45,1
156286,61,26,35,51,1
156286,522,135,387,52,3
156286,15,6,9,59,1
156286,137,29,108,60,1
156295,1623,695,928,1,4
156295,1623,695,928,2,1
156295,1587,679,908,3,1
156295,397,181,216,4,1
156295,1190,498,692,5,1
156295,36,16,20,11,1
156295,42,18,24,19,1
156295,1148,480,668,20,1
156295,1587,680,907,21,4
156295,1587,680,907,22,1
156295,1581,677,904,23,1
156295,397,181,216,24,1
156295,1184,496,688,25,1
156295,6,3,3,31,1
156295,42,18,24,39,1
156295,1142,478,664,40,1
156295,36,15,21,41,4
156295,36,15,21,42,1
156295,6,2,4,43,1
156295,6,2,4,45,1
156295,30,13,17,51,1
156295,6,2,4,60,1
156310,372,6,366,1,4
156310,372,6,366,2,1
156310,372,6,366,3,1
156310,46,0,46,4,1
156310,326,6,320,5,1
156310,326,6,320,20,1
156310,311,5,306,21,4
156310,311,5,306,22,1
156310,311,5,306,23,1
156310,43,0,43,24,1
156310,268,5,263,25,1
156310,268,5,263,40,1
156310,61,1,60,41,4
156310,61,1,60,42,1
156310,61,1,60,43,1
156310,3,0,3,44,1
156310,58,1,57,45,1
156310,58,1,57,60,1
156338,4758,2090,2668,1,4
156338,4758,2090,2668,2,1
156338,3122,1220,1902,3,1
156338,480,213,267,4,1
156338,2642,1007,1635,5,1
156338,1636,870,766,11,1
156338,187,79,108,19,1
156338,2455,928,1527,20,1
156338,1744,704,1040,21,4
156338,1744,704,1040,22,1
156338,1739,702,1037,23,1
156338,306,132,174,24,1
156338,1433,570,863,25,1
156338,5,2,3,31,1
156338,102,40,62,39,1
156338,1331,530,801,40,1
156338,3014,1386,1628,41,4
156338,3014,1386,1628,42,1
156338,1383,518,865,43,1
156338,174,81,93,44,1
156338,1209,437,772,45,1
156338,1631,868,763,51,1
156338,85,39,46,59,1
156338,1124,398,726,60,1
156356,949,265,684,1,4
156356,928,257,671,2,1
156356,869,238,631,3,1
156356,151,62,89,4,1
156356,718,176,542,5,1
156356,59,19,40,11,1
156356,21,8,13,12,3
156356,165,39,126,19,1
156356,553,137,416,20,1
156356,695,217,478,21,4
156356,688,215,473,22,1
156356,688,215,473,23,1
156356,151,62,89,24,1
156356,537,153,384,25,1
156356,7,2,5,32,3
156356,100,29,71,39,1
156356,437,124,313,40,1
156356,254,48,206,41,4
156356,240,42,198,42,1
156356,181,23,158,43,1
156356,181,23,158,45,1
156356,59,19,40,51,1
156356,14,6,8,52,3
156356,65,10,55,59,1
156356,116,13,103,60,1
156365,3520,1440,2080,1,4
156365,3048,1269,1779,2,1
156365,2213,1001,1212,3,1
156365,531,273,258,4,1
156365,1682,728,954,5,1
156365,835,268,567,11,1
156365,472,171,301,12,3
156365,215,96,119,19,1
156365,1467,632,835,20,1
156365,2195,999,1196,21,4
156365,1982,937,1045,22,1
156365,1975,936,1039,23,1
156365,522,269,253,24,1
156365,1453,667,786,25,1
156365,7,1,6,31,1
156365,213,62,151,32,3
156365,167,84,83,39,1
156365,1286,583,703,40,1
156365,1325,441,884,41,4
156365,1066,332,734,42,1
156365,238,65,173,43,1
156365,9,4,5,44,1
156365,229,61,168,45,1
156365,828,267,561,51,1
156365,259,109,150,52,3
156365,48,12,36,59,1
156365,181,49,132,60,1
156392,12365,5072,7293,1,4
156392,12365,5072,7293,2,1
156392,10467,4309,6158,3,1
156392,2089,946,1143,4,1
156392,8378,3363,5015,5,1
156392,1898,763,1135,11,1
156392,670,280,390,19,1
156392,7708,3083,4625,20,1
156392,5446,2376,3070,21,4
156392,5446,2376,3070,22,1
156392,5422,2366,3056,23,1
156392,1369,622,747,24,1
156392,4053,1744,2309,25,1
156392,24,10,14,31,1
156392,339,143,196,39,1
156392,3714,1601,2113,40,1
156392,6919,2696,4223,41,4
156392,6919,2696,4223,42,1
156392,5045,1943,3102,43,1
156392,720,324,396,44,1
156392,4325,1619,2706,45,1
156392,1874,753,1121,51,1
156392,331,137,194,59,1
156392,3994,1482,2512,60,1
156408,1381,678,703,1,4
156408,1381,678,703,2,1
156408,1372,675,697,3,1
156408,377,185,192,4,1
156408,995,490,505,5,1
156408,9,3,6,11,1
156408,8,5,3,19,1
156408,987,485,502,20,1
156408,1378,677,701,21,4
156408,1378,677,701,22,1
156408,1371,674,697,23,1
156408,377,185,192,24,1
156408,994,489,505,25,1
156408,7,3,4,31,1
156408,8,5,3,39,1
156408,986,484,502,40,1
156408,3,1,2,41,4
156408,3,1,2,42,1
156408,1,1,0,43,1
156408,1,1,0,45,1
156408,2,0,2,51,1
156408,1,1,0,60,1
156417,152,120,32,1,4
156417,152,120,32,2,1
156417,136,110,26,3,1
156417,6,6,0,4,1
156417,130,104,26,5,1
156417,16,10,6,11,1
156417,18,16,2,19,1
156417,112,88,24,20,1
156417,103,82,21,21,4
156417,103,82,21,22,1
156417,103,82,21,23,1
156417,5,5,0,24,1
156417,98,77,21,25,1
156417,14,12,2,39,1
156417,84,65,19,40,1
156417,49,38,11,41,4
156417,49,38,11,42,1
156417,33,28,5,43,1
156417,1,1,0,44,1
156417,32,27,5,45,1
156417,16,10,6,51,1
156417,4,4,0,59,1
156417,28,23,5,60,1
156426,278,14,264,1,4
156426,278,14,264,2,1
156426,278,14,264,3,1
156426,29,0,29,4,1
156426,249,14,235,5,1
156426,249,14,235,20,1
156426,186,11,175,21,4
156426,186,11,175,22,1
156426,186,11,175,23,1
156426,22,0,22,24,1
156426,164,11,153,25,1
156426,164,11,153,40,1
156426,92,3,89,41,4
156426,92,3,89,42,1
156426,92,3,89,43,1
156426,7,0,7,44,1
156426,85,3,82,45,1
156426,85,3,82,60,1
156444,29,1,28,1,4
156444,29,1,28,2,1
156444,29,1,28,3,1
156444,11,1,10,4,1
156444,18,0,18,5,1
156444,18,0,18,20,1
156444,29,1,28,21,4
156444,29,1,28,22,1
156444,29,1,28,23,1
156444,11,1,10,24,1
156444,18,0,18,25,1
156444,18,0,18,40,1
156471,847,99,748,1,4
156471,847,99,748,2,1
156471,847,99,748,3,1
156471,76,9,67,4,1
156471,771,90,681,5,1
156471,168,16,152,19,1
156471,603,74,529,20,1
156471,490,57,433,21,4
156471,490,57,433,22,1
156471,490,57,433,23,1
156471,75,9,66,24,1
156471,415,48,367,25,1
156471,85,10,75,39,1
156471,330,38,292,40,1
156471,357,42,315,41,4
156471,357,42,315,42,1
156471,357,42,315,43,1
156471,1,0,1,44,1
156471,356,42,314,45,1
156471,83,6,77,59,1
156471,273,36,237,60,1
156541,4924,1814,3110,1,4
156541,2096,1051,1045,2,1
156541,1545,811,734,3,1
156541,488,270,218,4,1
156541,1057,541,516,5,1
156541,551,240,311,11,1
156541,2828,763,2065,12,3
156541,89,56,33,19,1
156541,968,485,483,20,1
156541,2439,1047,1392,21,4
156541,1514,795,719,22,1
156541,1494,788,706,23,1
156541,488,270,218,24,1
156541,1006,518,488,25,1
156541,20,7,13,31,1
156541,925,252,673,32,3
156541,88,55,33,39,1
156541,918,463,455,40,1
156541,2485,767,1718,41,4
156541,582,256,326,42,1
156541,51,23,28,43,1
156541,51,23,28,45,1
156541,531,233,298,51,1
156541,1903,511,1392,52,3
156541,1,1,0,59,1
156541,50,22,28,60,1
156620,16111,6949,9162,1,4
156620,13891,6109,7782,2,1
156620,13247,5893,7354,3,1
156620,2431,1032,1399,4,1
156620,10816,4861,5955,5,1
156620,644,216,428,11,1
156620,2220,840,1380,12,3
156620,1096,512,584,19,1
156620,9720,4349,5371,20,1
156620,11651,5144,6507,21,4
156620,10969,4900,6069,22,1
156620,10955,4893,6062,23,1
156620,2380,1004,1376,24,1
156620,8575,3889,4686,25,1
156620,14,7,7,31,1
156620,682,244,438,32,3
156620,797,375,422,39,1
156620,7778,3514,4264,40,1
156620,4460,1805,2655,41,4
156620,2922,1209,1713,42,1
156620,2292,1000,1292,43,1
156620,51,28,23,44,1
156620,2241,972,1269,45,1
156620,630,209,421,51,1
156620,1538,596,942,52,3
156620,299,137,162,59,1
156620,1942,835,1107,60,1
156648,6929,2942,3987,1,4
156648,6929,2942,3987,2,1
156648,5742,2246,3496,3,1
156648,1272,544,728,4,1
156648,4470,1702,2768,5,1
156648,1187,696,491,11,1
156648,375,140,235,19,1
156648,4095,1562,2533,20,1
156648,3058,1260,1798,21,4
156648,3058,1260,1798,22,1
156648,2992,1230,1762,23,1
156648,835,349,486,24,1
156648,2157,881,1276,25,1
156648,66,30,36,31,1
156648,189,77,112,39,1
156648,1968,804,1164,40,1
156648,3871,1682,2189,41,4
156648,3871,1682,2189,42,1
156648,2750,1016,1734,43,1
156648,437,195,242,44,1
156648,2313,821,1492,45,1
156648,1121,666,455,51,1
156648,186,63,123,59,1
156648,2127,758,1369,60,1
156727,1427,66,1361,1,4
156727,1427,66,1361,12,3
156727,777,35,742,21,4
156727,777,35,742,32,3
156727,650,31,619,41,4
156727,650,31,619,52,3
156745,1399,554,845,1,4
156745,1043,478,565,2,1
156745,1034,474,560,3,1
156745,268,108,160,4,1
156745,766,366,400,5,1
156745,9,4,5,11,1
156745,356,76,280,12,3
156745,53,40,13,19,1
156745,713,326,387,20,1
156745,1017,472,545,21,4
156745,1000,466,534,22,1
156745,998,465,533,23,1
156745,243,104,139,24,1
156745,755,361,394,25,1
156745,2,1,1,31,1
156745,17,6,11,32,3
156745,50,39,11,39,1
156745,705,322,383,40,1
156745,382,82,300,41,4
156745,43,12,31,42,1
156745,36,9,27,43,1
156745,25,4,21,44,1
156745,11,5,6,45,1
156745,7,3,4,51,1
156745,339,70,269,52,3
156745,3,1,2,59,1
156745,8,4,4,60,1
156754,74,1,73,1,4
156754,74,1,73,2,1
156754,74,1,73,3,1
156754,8,0,8,4,1
156754,66,1,65,5,1
156754,66,1,65,20,1
156754,74,1,73,21,4
156754,74,1,73,22,1
156754,74,1,73,23,1
156754,8,0,8,24,1
156754,66,1,65,25,1
156754,66,1,65,40,1
156790,3790,1740,2050,1,4
156790,3790,1740,2050,2,1
156790,2585,940,1645,3,1
156790,583,251,332,4,1
156790,2002,689,1313,5,1
156790,1205,800,405,11,1
156790,100,44,56,19,1
156790,1902,645,1257,20,1
156790,1805,702,1103,21,4
156790,1805,702,1103,22,1
156790,1802,700,1102,23,1
156790,486,209,277,24,1
156790,1316,491,825,25,1
156790,3,2,1,31,1
156790,76,37,39,39,1
156790,1240,454,786,40,1
156790,1985,1038,947,41,4
156790,1985,1038,947,42,1
156790,783,240,543,43,1
156790,97,42,55,44,1
156790,686,198,488,45,1
156790,1202,798,404,51,1
156790,24,7,17,59,1
156790,662,191,471,60,1
156842,247,17,230,1,4
156842,247,17,230,2,1
156842,247,17,230,3,1
156842,14,2,12,4,1
156842,233,15,218,5,1
156842,233,15,218,20,1
156842,245,17,228,21,4
156842,245,17,228,22,1
156842,245,17,228,23,1
156842,13,2,11,24,1
156842,232,15,217,25,1
156842,232,15,217,40,1
156842,2,0,2,41,4
156842,2,0,2,42,1
156842,2,0,2,43,1
156842,1,0,1,44,1
156842,1,0,1,45,1
156842,1,0,1,60,1
156851,2036,778,1258,1,4
156851,2036,778,1258,2,1
156851,1375,351,1024,3,1
156851,258,87,171,4,1
156851,1117,264,853,5,1
156851,661,427,234,11,1
156851,78,23,55,19,1
156851,1039,241,798,20,1
156851,538,162,376,21,4
156851,538,162,376,22,1
156851,536,161,375,23,1
156851,171,55,116,24,1
156851,365,106,259,25,1
156851,2,1,1,31,1
156851,26,10,16,39,1
156851,339,96,243,40,1
156851,1498,616,882,41,4
156851,1498,616,882,42,1
156851,839,190,649,43,1
156851,87,32,55,44,1
156851,752,158,594,45,1
156851,659,426,233,51,1
156851,52,13,39,59,1
156851,700,145,555,60,1
156860,3609,1218,2391,1,4
156860,3609,1218,2391,2,1
156860,3191,1029,2162,3,1
156860,650,280,370,4,1
156860,2541,749,1792,5,1
156860,418,189,229,11,1
156860,247,72,175,19,1
156860,2294,677,1617,20,1
156860,1627,523,1104,21,4
156860,1627,523,1104,22,1
156860,1623,523,1100,23,1
156860,395,157,238,24,1
156860,1228,366,862,25,1
156860,4,0,4,31,1
156860,115,28,87,39,1
156860,1113,338,775,40,1
156860,1982,695,1287,41,4
156860,1982,695,1287,42,1
156860,1568,506,1062,43,1
156860,255,123,132,44,1
156860,1313,383,930,45,1
156860,414,189,225,51,1
156860,132,44,88,59,1
156860,1181,339,842,60,1
156903,86,22,64,1,4
156903,86,22,64,2,1
156903,86,22,64,3,1
156903,12,5,7,4,1
156903,74,17,57,5,1
156903,6,1,5,19,1
156903,68,16,52,20,1
156903,67,20,47,21,4
156903,67,20,47,22,1
156903,67,20,47,23,1
156903,8,4,4,24,1
156903,59,16,43,25,1
156903,2,1,1,39,1
156903,57,15,42,40,1
156903,19,2,17,41,4
156903,19,2,17,42,1
156903,19,2,17,43,1
156903,4,1,3,44,1
156903,15,1,14,45,1
156903,4,0,4,59,1
156903,11,1,10,60,1
156921,13498,5587,7911,1,4
156921,13498,5587,7911,2,1
156921,11632,4754,6878,3,1
156921,1864,868,996,4,1
156921,9768,3886,5882,5,1
156921,1866,833,1033,11,1
156921,753,300,453,19,1
156921,9015,3586,5429,20,1
156921,4637,2097,2540,21,4
156921,4637,2097,2540,22,1
156921,4496,2009,2487,23,1
156921,874,412,462,24,1
156921,3622,1597,2025,25,1
156921,141,88,53,31,1
156921,305,133,172,39,1
156921,3317,1464,1853,40,1
156921,8861,3490,5371,41,4
156921,8861,3490,5371,42,1
156921,7136,2745,4391,43,1
156921,990,456,534,44,1
156921,6146,2289,3857,45,1
156921,1725,745,980,51,1
156921,448,167,281,59,1
156921,5698,2122,3576,60,1
156949,26,2,24,1,4
156949,26,2,24,2,1
156949,26,2,24,3,1
156949,15,2,13,4,1
156949,11,0,11,5,1
156949,11,0,11,20,1
156949,21,1,20,21,4
156949,21,1,20,22,1
156949,21,1,20,23,1
156949,11,1,10,24,1
156949,10,0,10,25,1
156949,10,0,10,40,1
156949,5,1,4,41,4
156949,5,1,4,42,1
156949,5,1,4,43,1
156949,4,1,3,44,1
156949,1,0,1,45,1
156949,1,0,1,60,1
156967,132,7,125,1,4
156967,132,7,125,2,1
156967,132,7,125,3,1
156967,21,1,20,4,1
156967,111,6,105,5,1
156967,111,6,105,20,1
156967,132,7,125,21,4
156967,132,7,125,22,1
156967,132,7,125,23,1
156967,21,1,20,24,1
156967,111,6,105,25,1
156967,111,6,105,40,1
157021,1282,296,986,1,4
157021,1282,296,986,2,1
157021,1275,294,981,3,1
157021,64,22,42,4,1
157021,1211,272,939,5,1
157021,7,2,5,11,1
157021,206,44,162,19,1
157021,1005,228,777,20,1
157021,794,206,588,21,4
157021,794,206,588,22,1
157021,794,206,588,23,1
157021,53,19,34,24,1
157021,741,187,554,25,1
157021,145,34,111,39,1
157021,596,153,443,40,1
157021,488,90,398,41,4
157021,488,90,398,42,1
157021,481,88,393,43,1
157021,11,3,8,44,1
157021,470,85,385,45,1
157021,7,2,5,51,1
157021,61,10,51,59,1
157021,409,75,334,60,1
157030,79,42,37,1,4
157030,79,42,37,2,1
157030,73,41,32,3,1
157030,20,12,8,4,1
157030,53,29,24,5,1
157030,6,1,5,11,1
157030,7,5,2,19,1
157030,46,24,22,20,1
157030,64,35,29,21,4
157030,64,35,29,22,1
157030,64,35,29,23,1
157030,20,12,8,24,1
157030,44,23,21,25,1
157030,6,4,2,39,1
157030,38,19,19,40,1
157030,15,7,8,41,4
157030,15,7,8,42,1
157030,9,6,3,43,1
157030,9,6,3,45,1
157030,6,1,5,51,1
157030,1,1,0,59,1
157030,8,5,3,60,1
157058,2533,1040,1493,1,4
157058,2370,963,1407,2,1
157058,2131,857,1274,3,1
157058,537,226,311,4,1
157058,1594,631,963,5,1
157058,239,106,133,11,1
157058,163,77,86,12,3
157058,173,61,112,19,1
157058,1421,570,851,20,1
157058,1887,787,1100,21,4
157058,1813,747,1066,22,1
157058,1810,746,1064,23,1
157058,519,219,300,24,1
157058,1291,527,764,25,1
157058,3,1,2,31,1
157058,74,40,34,32,3
157058,146,56,90,39,1
157058,1145,471,674,40,1
157058,646,253,393,41,4
157058,557,216,341,42,1
157058,321,111,210,43,1
157058,18,7,11,44,1
157058,303,104,199,45,1
157058,236,105,131,51,1
157058,89,37,52,52,3
157058,27,5,22,59,1
157058,276,99,177,60,1
157076,657,340,317,1,4
157076,657,340,317,2,1
157076,652,338,314,3,1
157076,163,87,76,4,1
157076,489,251,238,5,1
157076,5,2,3,11,1
157076,58,35,23,19,1
157076,431,216,215,20,1
157076,621,321,300,21,4
157076,621,321,300,22,1
157076,621,321,300,23,1
157076,163,87,76,24,1
157076,458,234,224,25,1
157076,55,33,22,39,1
157076,403,201,202,40,1
157076,36,19,17,41,4
157076,36,19,17,42,1
157076,31,17,14,43,1
157076,31,17,14,45,1
157076,5,2,3,51,1
157076,3,2,1,59,1
157076,28,15,13,60,1
157085,28435,13569,14866,1,4
157085,21441,10462,10979,2,1
157085,21050,10259,10791,3,1
157085,4684,2061,2623,4,1
157085,16366,8198,8168,5,1
157085,391,203,188,11,1
157085,6994,3107,3887,12,3
157085,1100,561,539,19,1
157085,15266,7637,7629,20,1
157085,25658,12305,13353,21,4
157085,19884,9626,10258,22,1
157085,19802,9582,10220,23,1
157085,4619,2019,2600,24,1
157085,15183,7563,7620,25,1
157085,82,44,38,31,1
157085,5774,2679,3095,32,3
157085,941,489,452,39,1
157085,14242,7074,7168,40,1
157085,2777,1264,1513,41,4
157085,1557,836,721,42,1
157085,1248,677,571,43,1
157085,65,42,23,44,1
157085,1183,635,548,45,1
157085,309,159,150,51,1
157085,1220,428,792,52,3
157085,159,72,87,59,1
157085,1024,563,461,60,1
157100,594,332,262,1,4
157100,559,301,258,2,1
157100,547,297,250,3,1
157100,129,85,44,4,1
157100,418,212,206,5,1
157100,12,4,8,11,1
157100,35,31,4,12,3
157100,63,29,34,19,1
157100,355,183,172,20,1
157100,496,291,205,21,4
157100,494,289,205,22,1
157100,494,289,205,23,1
157100,129,85,44,24,1
157100,365,204,161,25,1
157100,2,2,0,32,3
157100,40,27,13,39,1
157100,325,177,148,40,1
157100,98,41,57,41,4
157100,65,12,53,42,1
157100,53,8,45,43,1
157100,53,8,45,45,1
157100,12,4,8,51,1
157100,33,29,4,52,3
157100,23,2,21,59,1
157100,30,6,24,60,1
157207,84,35,49,1,4
157207,84,35,49,12,3
157207,19,7,12,21,4
157207,19,7,12,32,3
157207,65,28,37,41,4
157207,65,28,37,52,3
157216,2644,1009,1635,1,4
157216,2200,903,1297,2,1
157216,2127,884,1243,3,1
157216,514,258,256,4,1
157216,1613,626,987,5,1
157216,73,19,54,11,1
157216,444,106,338,12,3
157216,333,93,240,19,1
157216,1280,533,747,20,1
157216,2520,971,1549,21,4
157216,2101,873,1228,22,1
157216,2084,870,1214,23,1
157216,513,258,255,24,1
157216,1571,612,959,25,1
157216,17,3,14,31,1
157216,419,98,321,32,3
157216,320,88,232,39,1
157216,1251,524,727,40,1
157216,124,38,86,41,4
157216,99,30,69,42,1
157216,43,14,29,43,1
157216,1,0,1,44,1
157216,42,14,28,45,1
157216,56,16,40,51,1
157216,25,8,17,52,3
157216,13,5,8,59,1
157216,29,9,20,60,1
157270,381,276,105,1,4
157270,381,276,105,2,1
157270,368,266,102,3,1
157270,50,32,18,4,1
157270,318,234,84,5,1
157270,13,10,3,11,1
157270,7,5,2,19,1
157270,311,229,82,20,1
157270,238,175,63,21,4
157270,238,175,63,22,1
157270,238,175,63,23,1
157270,44,28,16,24,1
157270,194,147,47,25,1
157270,5,4,1,39,1
157270,189,143,46,40,1
157270,143,101,42,41,4
157270,143,101,42,42,1
157270,130,91,39,43,1
157270,6,4,2,44,1
157270,124,87,37,45,1
157270,13,10,3,51,1
157270,2,1,1,59,1
157270,122,86,36,60,1
157289,21444,10338,11106,1,4
157289,15954,7768,8186,2,1
157289,15023,7331,7692,3,1
157289,2855,1438,1417,4,1
157289,12168,5893,6275,5,1
157289,931,437,494,11,1
157289,5490,2570,2920,12,3
157289,1142,496,646,19,1
157289,11026,5397,5629,20,1
157289,16364,7908,8456,21,4
157289,12426,5975,6451,22,1
157289,12301,5897,6404,23,1
157289,2807,1414,1393,24,1
157289,9494,4483,5011,25,1
157289,125,78,47,31,1
157289,3938,1933,2005,32,3
157289,862,386,476,39,1
157289,8632,4097,4535,40,1
157289,5080,2430,2650,41,4
157289,3528,1793,1735,42,1
157289,2722,1434,1288,43,1
157289,48,24,24,44,1
157289,2674,1410,1264,45,1
157289,806,359,447,51,1
157289,1552,637,915,52,3
157289,280,110,170,59,1
157289,2394,1300,1094,60,1
157298,199,76,123,1,4
157298,199,76,123,12,3
157298,115,42,73,21,4
157298,115,42,73,32,3
157298,84,34,50,41,4
157298,84,34,50,52,3
157304,4522,2249,2273,1,4
157304,4522,2249,2273,2,1
157304,2625,887,1738,3,1
157304,407,172,235,4,1
157304,2218,715,1503,5,1
157304,1897,1362,535,11,1
157304,88,28,60,19,1
157304,2130,687,1443,20,1
157304,1455,465,990,21,4
157304,1455,465,990,22,1
157304,1430,454,976,23,1
157304,286,118,168,24,1
157304,1144,336,808,25,1
157304,25,11,14,31,1
157304,25,11,14,39,1
157304,1119,325,794,40,1
157304,3067,1784,1283,41,4
157304,3067,1784,1283,42,1
157304,1195,433,762,43,1
157304,121,54,67,44,1
157304,1074,379,695,45,1
157304,1872,1351,521,51,1
157304,63,17,46,59,1
157304,1011,362,649,60,1
157331,3595,1347,2248,1,4
157331,3595,1347,2248,2,1
157331,2821,947,1874,3,1
157331,584,249,335,4,1
157331,2237,698,1539,5,1
157331,774,400,374,11,1
157331,145,52,93,19,1
157331,2092,646,1446,20,1
157331,1640,637,1003,21,4
157331,1640,637,1003,22,1
157331,1604,625,979,23,1
157331,402,185,217,24,1
157331,1202,440,762,25,1
157331,36,12,24,31,1
157331,61,26,35,39,1
157331,1141,414,727,40,1
157331,1955,710,1245,41,4
157331,1955,710,1245,42,1
157331,1217,322,895,43,1
157331,182,64,118,44,1
157331,1035,258,777,45,1
157331,738,388,350,51,1
157331,84,26,58,59,1
157331,951,232,719,60,1
157359,2251,789,1462,1,4
157359,2154,761,1393,2,1
157359,2142,755,1387,3,1
157359,231,98,133,4,1
157359,1911,657,1254,5,1
157359,12,6,6,11,1
157359,97,28,69,12,3
157359,423,129,294,19,1
157359,1488,528,960,20,1
157359,1905,650,1255,21,4
157359,1822,629,1193,22,1
157359,1822,629,1193,23,1
157359,205,90,115,24,1
157359,1617,539,1078,25,1
157359,83,21,62,32,3
157359,375,110,265,39,1
157359,1242,429,813,40,1
157359,346,139,207,41,4
157359,332,132,200,42,1
157359,320,126,194,43,1
157359,26,8,18,44,1
157359,294,118,176,45,1
157359,12,6,6,51,1
157359,14,7,7,52,3
157359,48,19,29,59,1
157359,246,99,147,60,1
157377,1351,281,1070,1,4
157377,1247,238,1009,2,1
157377,1247,238,1009,3,1
157377,107,9,98,4,1
157377,1140,229,911,5,1
157377,104,43,61,12,3
157377,177,43,134,19,1
157377,963,186,777,20,1
157377,745,160,585,21,4
157377,731,152,579,22,1
157377,731,152,579,23,1
157377,79,6,73,24,1
157377,652,146,506,25,1
157377,14,8,6,32,3
157377,100,31,69,39,1
157377,552,115,437,40,1
157377,606,121,485,41,4
157377,516,86,430,42,1
157377,516,86,430,43,1
157377,28,3,25,44,1
157377,488,83,405,45,1
157377,90,35,55,52,3
157377,77,12,65,59,1
157377,411,71,340,60,1
157386,11358,4447,6911,1,4
157386,10076,3965,6111,2,1
157386,7344,2886,4458,3,1
157386,1701,722,979,4,1
157386,5643,2164,3479,5,1
157386,2732,1079,1653,11,1
157386,1282,482,800,12,3
157386,501,208,293,19,1
157386,5142,1956,3186,20,1
157386,6472,2688,3784,21,4
157386,6209,2565,3644,22,1
157386,6150,2546,3604,23,1
157386,1691,719,972,24,1
157386,4459,1827,2632,25,1
157386,59,19,40,31,1
157386,263,123,140,32,3
157386,337,165,172,39,1
157386,4122,1662,2460,40,1
157386,4886,1759,3127,41,4
157386,3867,1400,2467,42,1
157386,1194,340,854,43,1
157386,10,3,7,44,1
157386,1184,337,847,45,1
157386,2673,1060,1613,51,1
157386,1019,359,660,52,3
157386,164,43,121,59,1
157386,1020,294,726,60,1
157401,10943,4464,6479,1,4
157401,9172,3810,5362,2,1
157401,7956,3378,4578,3,1
157401,1581,666,915,4,1
157401,6375,2712,3663,5,1
157401,1216,432,784,11,1
157401,1771,654,1117,12,3
157401,692,275,417,19,1
157401,5683,2437,3246,20,1
157401,7838,3342,4496,21,4
157401,7153,3044,4109,22,1
157401,7044,3014,4030,23,1
157401,1569,662,907,24,1
157401,5475,2352,3123,25,1
157401,109,30,79,31,1
157401,685,298,387,32,3
157401,508,221,287,39,1
157401,4967,2131,2836,40,1
157401,3105,1122,1983,41,4
157401,2019,766,1253,42,1
157401,912,364,548,43,1
157401,12,4,8,44,1
157401,900,360,540,45,1
157401,1107,402,705,51,1
157401,1086,356,730,52,3
157401,184,54,130,59,1
157401,716,306,410,60,1
157438,4646,2187,2459,1,4
157438,4646,2187,2459,2,1
157438,3810,1644,2166,3,1
157438,576,294,282,4,1
157438,3234,1350,1884,5,1
157438,836,543,293,11,1
157438,239,106,133,19,1
157438,2995,1244,1751,20,1
157438,1467,672,795,21,4
157438,1467,672,795,22,1
157438,1459,666,793,23,1
157438,243,118,125,24,1
157438,1216,548,668,25,1
157438,8,6,2,31,1
157438,101,55,46,39,1
157438,1115,493,622,40,1
157438,3179,1515,1664,41,4
157438,3179,1515,1664,42,1
157438,2351,978,1373,43,1
157438,333,176,157,44,1
157438,2018,802,1216,45,1
157438,828,537,291,51,1
157438,138,51,87,59,1
157438,1880,751,1129,60,1
157447,15263,6713,8550,1,4
157447,12794,5812,6982,2,1
157447,11976,5482,6494,3,1
157447,2273,994,1279,4,1
157447,9703,4488,5215,5,1
157447,818,330,488,11,1
157447,2469,901,1568,12,3
157447,799,387,412,19,1
157447,8904,4101,4803,20,1
157447,10597,4835,5762,21,4
157447,9736,4478,5258,22,1
157447,9686,4465,5221,23,1
157447,2218,961,1257,24,1
157447,7468,3504,3964,25,1
157447,50,13,37,31,1
157447,861,357,504,32,3
157447,606,310,296,39,1
157447,6862,3194,3668,40,1
157447,4666,1878,2788,41,4
157447,3058,1334,1724,42,1
157447,2290,1017,1273,43,1
157447,55,33,22,44,1
157447,2235,984,1251,45,1
157447,768,317,451,51,1
157447,1608,544,1064,52,3
157447,193,77,116,59,1
157447,2042,907,1135,60,1
157456,18,0,18,1,4
157456,18,0,18,2,1
157456,18,0,18,3,1
157456,3,0,3,4,1
157456,15,0,15,5,1
157456,15,0,15,20,1
157456,18,0,18,21,4
157456,18,0,18,22,1
157456,18,0,18,23,1
157456,3,0,3,24,1
157456,15,0,15,25,1
157456,15,0,15,40,1
157465,122,11,111,1,4
157465,122,11,111,2,1
157465,122,11,111,3,1
157465,3,0,3,4,1
157465,119,11,108,5,1
157465,26,1,25,19,1
157465,93,10,83,20,1
157465,75,5,70,21,4
157465,75,5,70,22,1
157465,75,5,70,23,1
157465,3,0,3,24,1
157465,72,5,67,25,1
157465,15,1,14,39,1
157465,57,4,53,40,1
157465,47,6,41,41,4
157465,47,6,41,42,1
157465,47,6,41,43,1
157465,47,6,41,45,1
157465,11,0,11,59,1
157465,36,6,30,60,1
157483,7104,3072,4032,1,4
157483,7104,3072,4032,2,1
157483,4648,1730,2918,3,1
157483,864,338,526,4,1
157483,3784,1392,2392,5,1
157483,2456,1342,1114,11,1
157483,220,93,127,19,1
157483,3564,1299,2265,20,1
157483,2481,985,1496,21,4
157483,2481,985,1496,22,1
157483,2354,941,1413,23,1
157483,649,255,394,24,1
157483,1705,686,1019,25,1
157483,127,44,83,31,1
157483,107,43,64,39,1
157483,1598,643,955,40,1
157483,4623,2087,2536,41,4
157483,4623,2087,2536,42,1
157483,2294,789,1505,43,1
157483,215,83,132,44,1
157483,2079,706,1373,45,1
157483,2329,1298,1031,51,1
157483,113,50,63,59,1
157483,1966,656,1310,60,1
157508,73,3,70,1,4
157508,73,3,70,2,1
157508,73,3,70,3,1
157508,27,3,24,4,1
157508,46,0,46,5,1
157508,46,0,46,20,1
157508,44,2,42,21,4
157508,44,2,42,22,1
157508,44,2,42,23,1
157508,14,2,12,24,1
157508,30,0,30,25,1
157508,30,0,30,40,1
157508,29,1,28,41,4
157508,29,1,28,42,1
157508,29,1,28,43,1
157508,13,1,12,44,1
157508,16,0,16,45,1
157508,16,0,16,60,1
157535,2205,1059,1146,1,4
157535,1738,812,926,2,1
157535,1313,656,657,3,1
157535,386,205,181,4,1
157535,927,451,476,5,1
157535,425,156,269,11,1
157535,467,247,220,12,3
157535,113,59,54,19,1
157535,814,392,422,20,1
157535,1749,894,855,21,4
157535,1282,647,635,22,1
157535,1282,647,635,23,1
157535,386,205,181,24,1
157535,896,442,454,25,1
157535,467,247,220,32,3
157535,107,59,48,39,1
157535,789,383,406,40,1
157535,456,165,291,41,4
157535,456,165,291,42,1
157535,31,9,22,43,1
157535,31,9,22,45,1
157535,425,156,269,51,1
157535,6,0,6,59,1
157535,25,9,16,60,1
157553,4715,2491,2224,1,4
157553,4715,2491,2224,2,1
157553,3283,1356,1927,3,1
157553,434,212,222,4,1
157553,2849,1144,1705,5,1
157553,1432,1135,297,11,1
157553,79,31,48,19,1
157553,2770,1113,1657,20,1
157553,2425,1029,1396,21,4
157553,2425,1029,1396,22,1
157553,2369,1015,1354,23,1
157553,361,170,191,24,1
157553,2008,845,1163,25,1
157553,56,14,42,31,1
157553,53,25,28,39,1
157553,1955,820,1135,40,1
157553,2290,1462,828,41,4
157553,2290,1462,828,42,1
157553,914,341,573,43,1
157553,73,42,31,44,1
157553,841,299,542,45,1
157553,1376,1121,255,51,1
157553,26,6,20,59,1
157553,815,293,522,60,1
157599,1420,343,1077,1,4
157599,1420,343,1077,2,1
157599,1420,343,1077,3,1
157599,279,61,218,4,1
157599,1141,282,859,5,1
157599,138,25,113,19,1
157599,1003,257,746,20,1
157599,1420,343,1077,21,4
157599,1420,343,1077,22,1
157599,1420,343,1077,23,1
157599,279,61,218,24,1
157599,1141,282,859,25,1
157599,138,25,113,39,1
157599,1003,257,746,40,1
157614,107,6,101,1,4
157614,107,6,101,2,1
157614,107,6,101,3,1
157614,27,0,27,4,1
157614,80,6,74,5,1
157614,80,6,74,20,1
157614,80,5,75,21,4
157614,80,5,75,22,1
157614,80,5,75,23,1
157614,18,0,18,24,1
157614,62,5,57,25,1
157614,62,5,57,40,1
157614,27,1,26,41,4
157614,27,1,26,42,1
157614,27,1,26,43,1
157614,9,0,9,44,1
157614,18,1,17,45,1
157614,18,1,17,60,1
157632,767,275,492,1,4
157632,748,264,484,2,1
157632,605,218,387,3,1
157632,118,47,71,4,1
157632,487,171,316,5,1
157632,143,46,97,11,1
157632,19,11,8,12,3
157632,77,31,46,19,1
157632,410,140,270,20,1
157632,575,221,354,21,4
157632,570,217,353,22,1
157632,552,211,341,23,1
157632,115,47,68,24,1
157632,437,164,273,25,1
157632,18,6,12,31,1
157632,5,4,1,32,3
157632,64,30,34,39,1
157632,373,134,239,40,1
157632,192,54,138,41,4
157632,178,47,131,42,1
157632,53,7,46,43,1
157632,3,0,3,44,1
157632,50,7,43,45,1
157632,125,40,85,51,1
157632,14,7,7,52,3
157632,13,1,12,59,1
157632,37,6,31,60,1
157650,168,9,159,1,4
157650,168,9,159,2,1
157650,168,9,159,3,1
157650,44,1,43,4,1
157650,124,8,116,5,1
157650,124,8,116,20,1
157650,134,6,128,21,4
157650,134,6,128,22,1
157650,134,6,128,23,1
157650,35,1,34,24,1
157650,99,5,94,25,1
157650,99,5,94,40,1
157650,34,3,31,41,4
157650,34,3,31,42,1
157650,34,3,31,43,1
157650,9,0,9,44,1
157650,25,3,22,45,1
157650,25,3,22,60,1
157669,123,7,116,1,4
157669,123,7,116,2,1
157669,123,7,116,3,1
157669,40,2,38,4,1
157669,83,5,78,5,1
157669,83,5,78,20,1
157669,107,7,100,21,4
157669,107,7,100,22,1
157669,107,7,100,23,1
157669,33,2,31,24,1
157669,74,5,69,25,1
157669,74,5,69,40,1
157669,16,0,16,41,4
157669,16,0,16,42,1
157669,16,0,16,43,1
157669,7,0,7,44,1
157669,9,0,9,45,1
157669,9,0,9,60,1
157678,165,9,156,1,4
157678,165,9,156,2,1
157678,165,9,156,3,1
157678,60,6,54,4,1
157678,105,3,102,5,1
157678,105,3,102,20,1
157678,128,8,120,21,4
157678,128,8,120,22,1
157678,128,8,120,23,1
157678,48,6,42,24,1
157678,80,2,78,25,1
157678,80,2,78,40,1
157678,37,1,36,41,4
157678,37,1,36,42,1
157678,37,1,36,43,1
157678,12,0,12,44,1
157678,25,1,24,45,1
157678,25,1,24,60,1
157696,443,113,330,1,4
157696,443,113,330,2,1
157696,443,113,330,3,1
157696,49,9,40,4,1
157696,394,104,290,5,1
157696,80,24,56,19,1
157696,314,80,234,20,1
157696,443,113,330,21,4
157696,443,113,330,22,1
157696,443,113,330,23,1
157696,49,9,40,24,1
157696,394,104,290,25,1
157696,80,24,56,39,1
157696,314,80,234,40,1
157711,7504,2975,4529,1,4
157711,7504,2975,4529,2,1
157711,6037,2080,3957,3,1
157711,1210,526,684,4,1
157711,4827,1554,3273,5,1
157711,1467,895,572,11,1
157711,252,86,166,19,1
157711,4575,1468,3107,20,1
157711,3442,1318,2124,21,4
157711,3442,1318,2124,22,1
157711,3437,1316,2121,23,1
157711,866,382,484,24,1
157711,2571,934,1637,25,1
157711,5,2,3,31,1
157711,150,55,95,39,1
157711,2421,879,1542,40,1
157711,4062,1657,2405,41,4
157711,4062,1657,2405,42,1
157711,2600,764,1836,43,1
157711,344,144,200,44,1
157711,2256,620,1636,45,1
157711,1462,893,569,51,1
157711,102,31,71,59,1
157711,2154,589,1565,60,1
157739,5221,2887,2334,1,4
157739,5221,2887,2334,2,1
157739,2582,1010,1572,3,1
157739,357,160,197,4,1
157739,2225,850,1375,5,1
157739,2639,1877,762,11,1
157739,66,19,47,19,1
157739,2159,831,1328,20,1
157739,1968,784,1184,21,4
157739,1968,784,1184,22,1
157739,1961,782,1179,23,1
157739,296,136,160,24,1
157739,1665,646,1019,25,1
157739,7,2,5,31,1
157739,49,14,35,39,1
157739,1616,632,984,40,1
157739,3253,2103,1150,41,4
157739,3253,2103,1150,42,1
157739,621,228,393,43,1
157739,61,24,37,44,1
157739,560,204,356,45,1
157739,2632,1875,757,51,1
157739,17,5,12,59,1
157739,543,199,344,60,1
157748,3226,2668,558,1,4
157748,723,460,263,2,1
157748,616,409,207,3,1
157748,120,75,45,4,1
157748,496,334,162,5,1
157748,107,51,56,11,1
157748,2503,2208,295,12,3
157748,65,46,19,19,1
157748,431,288,143,20,1
157748,1944,1616,328,21,4
157748,433,269,164,22,1
157748,427,266,161,23,1
157748,96,55,41,24,1
157748,331,211,120,25,1
157748,6,3,3,31,1
157748,1511,1347,164,32,3
157748,48,34,14,39,1
157748,283,177,106,40,1
157748,1282,1052,230,41,4
157748,290,191,99,42,1
157748,189,143,46,43,1
157748,24,20,4,44,1
157748,165,123,42,45,1
157748,101,48,53,51,1
157748,992,861,131,52,3
157748,17,12,5,59,1
157748,148,111,37,60,1
157757,2367,631,1736,1,4
157757,1371,415,956,2,1
157757,1277,356,921,3,1
157757,213,72,141,4,1
157757,1064,284,780,5,1
157757,94,59,35,11,1
157757,996,216,780,12,3
157757,148,36,112,19,1
157757,916,248,668,20,1
157757,1726,444,1282,21,4
157757,954,274,680,22,1
157757,954,274,680,23,1
157757,182,58,124,24,1
157757,772,216,556,25,1
157757,772,170,602,32,3
157757,90,21,69,39,1
157757,682,195,487,40,1
157757,641,187,454,41,4
157757,417,141,276,42,1
157757,323,82,241,43,1
157757,31,14,17,44,1
157757,292,68,224,45,1
157757,94,59,35,51,1
157757,224,46,178,52,3
157757,58,15,43,59,1
157757,234,53,181,60,1
157766,533,73,460,1,4
157766,533,73,460,2,1
157766,528,71,457,3,1
157766,131,16,115,4,1
157766,397,55,342,5,1
157766,5,2,3,11,1
157766,397,55,342,20,1
157766,426,54,372,21,4
157766,426,54,372,22,1
157766,421,52,369,23,1
157766,125,16,109,24,1
157766,296,36,260,25,1
157766,5,2,3,31,1
157766,296,36,260,40,1
157766,107,19,88,41,4
157766,107,19,88,42,1
157766,107,19,88,43,1
157766,6,0,6,44,1
157766,101,19,82,45,1
157766,101,19,82,60,1
157793,5017,2019,2998,1,4
157793,3687,1399,2288,2,1
157793,3404,1317,2087,3,1
157793,364,135,229,4,1
157793,3040,1182,1858,5,1
157793,283,82,201,11,1
157793,1330,620,710,12,3
157793,3040,1182,1858,20,1
157793,3214,1330,1884,21,4
157793,2226,836,1390,22,1
157793,2033,785,1248,23,1
157793,302,109,193,24,1
157793,1731,676,1055,25,1
157793,193,51,142,31,1
157793,988,494,494,32,3
157793,1731,676,1055,40,1
157793,1803,689,1114,41,4
157793,1461,563,898,42,1
157793,1371,532,839,43,1
157793,62,26,36,44,1
157793,1309,506,803,45,1
157793,90,31,59,51,1
157793,342,126,216,52,3
157793,1309,506,803,60,1
157809,1600,774,826,1,4
157809,1502,718,784,2,1
157809,1208,616,592,3,1
157809,264,144,120,4,1
157809,944,472,472,5,1
157809,294,102,192,11,1
157809,98,56,42,12,3
157809,45,25,20,19,1
157809,899,447,452,20,1
157809,1221,629,592,21,4
157809,1140,579,561,22,1
157809,1137,577,560,23,1
157809,264,144,120,24,1
157809,873,433,440,25,1
157809,3,2,1,31,1
157809,81,50,31,32,3
157809,43,24,19,39,1
157809,830,409,421,40,1
157809,379,145,234,41,4
157809,362,139,223,42,1
157809,71,39,32,43,1
157809,71,39,32,45,1
157809,291,100,191,51,1
157809,17,6,11,52,3
157809,2,1,1,59,1
157809,69,38,31,60,1
157818,1082,463,619,1,4
157818,1082,463,619,2,1
157818,1081,462,619,3,1
157818,290,139,151,4,1
157818,791,323,468,5,1
157818,1,1,0,11,1
157818,15,12,3,19,1
157818,776,311,465,20,1
157818,1067,454,613,21,4
157818,1067,454,613,22,1
157818,1066,453,613,23,1
157818,289,138,151,24,1
157818,777,315,462,25,1
157818,1,1,0,31,1
157818,15,12,3,39,1
157818,762,303,459,40,1
157818,15,9,6,41,4
157818,15,9,6,42,1
157818,15,9,6,43,1
157818,1,1,0,44,1
157818,14,8,6,45,1
157818,14,8,6,60,1
157827,95,12,83,1,4
157827,95,12,83,2,1
157827,95,12,83,3,1
157827,58,11,47,4,1
157827,37,1,36,5,1
157827,37,1,36,20,1
157827,54,3,51,21,4
157827,54,3,51,22,1
157827,54,3,51,23,1
157827,29,2,27,24,1
157827,25,1,24,25,1
157827,25,1,24,40,1
157827,41,9,32,41,4
157827,41,9,32,42,1
157827,41,9,32,43,1
157827,29,9,20,44,1
157827,12,0,12,45,1
157827,12,0,12,60,1
157863,1164,546,618,1,4
157863,818,415,403,2,1
157863,808,412,396,3,1
157863,241,116,125,4,1
157863,567,296,271,5,1
157863,10,3,7,11,1
157863,346,131,215,12,3
157863,75,41,34,19,1
157863,492,255,237,20,1
157863,858,427,431,21,4
157863,729,385,344,22,1
157863,729,385,344,23,1
157863,239,115,124,24,1
157863,490,270,220,25,1
157863,129,42,87,32,3
157863,64,38,26,39,1
157863,426,232,194,40,1
157863,306,119,187,41,4
157863,89,30,59,42,1
157863,79,27,52,43,1
157863,2,1,1,44,1
157863,77,26,51,45,1
157863,10,3,7,51,1
157863,217,89,128,52,3
157863,11,3,8,59,1
157863,66,23,43,60,1
157951,20448,8559,11889,1,4
157951,17509,7616,9893,2,1
157951,15780,6978,8802,3,1
157951,3117,1428,1689,4,1
157951,12663,5550,7113,5,1
157951,1729,638,1091,11,1
157951,2939,943,1996,12,3
157951,993,460,533,19,1
157951,11670,5090,6580,20,1
157951,14315,6428,7887,21,4
157951,13382,6091,7291,22,1
157951,13234,6020,7214,23,1
157951,3065,1407,1658,24,1
157951,10169,4613,5556,25,1
157951,148,71,77,31,1
157951,933,337,596,32,3
157951,704,349,355,39,1
157951,9465,4264,5201,40,1
157951,6133,2131,4002,41,4
157951,4127,1525,2602,42,1
157951,2546,958,1588,43,1
157951,52,21,31,44,1
157951,2494,937,1557,45,1
157951,1581,567,1014,51,1
157951,2006,606,1400,52,3
157951,289,111,178,59,1
157951,2205,826,1379,60,1
158088,2242,1286,956,1,4
158088,2242,1286,956,2,1
158088,1439,804,635,3,1
158088,472,289,183,4,1
158088,967,515,452,5,1
158088,803,482,321,11,1
158088,145,36,109,19,1
158088,822,479,343,20,1
158088,1079,547,532,21,4
158088,1079,547,532,22,1
158088,993,482,511,23,1
158088,346,188,158,24,1
158088,647,294,353,25,1
158088,86,65,21,31,1
158088,129,32,97,39,1
158088,518,262,256,40,1
158088,1163,739,424,41,4
158088,1163,739,424,42,1
158088,446,322,124,43,1
158088,126,101,25,44,1
158088,320,221,99,45,1
158088,717,417,300,51,1
158088,16,4,12,59,1
158088,304,217,87,60,1
158158,85,29,56,1,4
158158,85,29,56,2,1
158158,85,29,56,3,1
158158,67,27,40,4,1
158158,18,2,16,5,1
158158,18,2,16,20,1
158158,61,18,43,21,4
158158,61,18,43,22,1
158158,61,18,43,23,1
158158,49,17,32,24,1
158158,12,1,11,25,1
158158,12,1,11,40,1
158158,24,11,13,41,4
158158,24,11,13,42,1
158158,24,11,13,43,1
158158,18,10,8,44,1
158158,6,1,5,45,1
158158,6,1,5,60,1
158246,267,109,158,1,4
158246,267,109,158,2,1
158246,267,109,158,3,1
158246,71,26,45,4,1
158246,196,83,113,5,1
158246,196,83,113,20,1
158246,267,109,158,21,4
158246,267,109,158,22,1
158246,267,109,158,23,1
158246,71,26,45,24,1
158246,196,83,113,25,1
158246,196,83,113,40,1
158325,56,3,53,1,4
158325,56,3,53,2,1
158325,56,3,53,3,1
158325,56,3,53,5,1
158325,56,3,53,20,1
158325,56,3,53,21,4
158325,56,3,53,22,1
158325,56,3,53,23,1
158325,56,3,53,25,1
158325,56,3,53,40,1
158334,22,3,19,1,4
158334,22,3,19,2,1
158334,22,3,19,3,1
158334,22,3,19,5,1
158334,22,3,19,20,1
158334,22,3,19,21,4
158334,22,3,19,22,1
158334,22,3,19,23,1
158334,22,3,19,25,1
158334,22,3,19,40,1
158343,81,40,41,1,4
158343,81,40,41,2,1
158343,80,39,41,3,1
158343,41,20,21,4,1
158343,39,19,20,5,1
158343,1,1,0,11,1
158343,39,19,20,20,1
158343,54,27,27,21,4
158343,54,27,27,22,1
158343,54,27,27,23,1
158343,28,14,14,24,1
158343,26,13,13,25,1
158343,26,13,13,40,1
158343,27,13,14,41,4
158343,27,13,14,42,1
158343,26,12,14,43,1
158343,13,6,7,44,1
158343,13,6,7,45,1
158343,1,1,0,51,1
158343,13,6,7,60,1
158352,2324,1434,890,1,4
158352,2324,1434,890,2,1
158352,1610,1117,493,3,1
158352,405,297,108,4,1
158352,1205,820,385,5,1
158352,714,317,397,11,1
158352,163,84,79,19,1
158352,1042,736,306,20,1
158352,832,552,280,21,4
158352,832,552,280,22,1
158352,743,488,255,23,1
158352,155,119,36,24,1
158352,588,369,219,25,1
158352,89,64,25,31,1
158352,85,32,53,39,1
158352,503,337,166,40,1
158352,1492,882,610,41,4
158352,1492,882,610,42,1
158352,867,629,238,43,1
158352,250,178,72,44,1
158352,617,451,166,45,1
158352,625,253,372,51,1
158352,78,52,26,59,1
158352,539,399,140,60,1
158431,8464,3050,5414,1,4
158431,8464,3050,5414,2,1
158431,7222,2513,4709,3,1
158431,1432,593,839,4,1
158431,5790,1920,3870,5,1
158431,1242,537,705,11,1
158431,1012,365,647,19,1
158431,4778,1555,3223,20,1
158431,4976,1868,3108,21,4
158431,4976,1868,3108,22,1
158431,4409,1602,2807,23,1
158431,1027,406,621,24,1
158431,3382,1196,2186,25,1
158431,567,266,301,31,1
158431,625,229,396,39,1
158431,2757,967,1790,40,1
158431,3488,1182,2306,41,4
158431,3488,1182,2306,42,1
158431,2813,911,1902,43,1
158431,405,187,218,44,1
158431,2408,724,1684,45,1
158431,675,271,404,51,1
158431,387,136,251,59,1
158431,2021,588,1433,60,1
158440,23,4,19,1,4
158440,23,4,19,2,1
158440,23,4,19,3,1
158440,17,3,14,4,1
158440,6,1,5,5,1
158440,6,1,5,20,1
158440,23,4,19,21,4
158440,23,4,19,22,1
158440,23,4,19,23,1
158440,17,3,14,24,1
158440,6,1,5,25,1
158440,6,1,5,40,1
158477,661,287,374,1,4
158477,586,258,328,2,1
158477,579,255,324,3,1
158477,128,56,72,4,1
158477,451,199,252,5,1
158477,7,3,4,11,1
158477,75,29,46,12,3
158477,19,14,5,19,1
158477,432,185,247,20,1
158477,578,253,325,21,4
158477,571,248,323,22,1
158477,571,248,323,23,1
158477,127,56,71,24,1
158477,444,192,252,25,1
158477,7,5,2,32,3
158477,19,14,5,39,1
158477,425,178,247,40,1
158477,83,34,49,41,4
158477,15,10,5,42,1
158477,8,7,1,43,1
158477,1,0,1,44,1
158477,7,7,0,45,1
158477,7,3,4,51,1
158477,68,24,44,52,3
158477,7,7,0,60,1
158538,51,2,49,1,4
158538,51,2,49,2,1
158538,51,2,49,3,1
158538,21,2,19,4,1
158538,30,0,30,5,1
158538,30,0,30,20,1
158538,51,2,49,21,4
158538,51,2,49,22,1
158538,51,2,49,23,1
158538,21,2,19,24,1
158538,30,0,30,25,1
158538,30,0,30,40,1
158617,469,198,271,1,4
158617,469,198,271,2,1
158617,469,198,271,3,1
158617,244,101,143,4,1
158617,225,97,128,5,1
158617,225,97,128,20,1
158617,469,198,271,21,4
158617,469,198,271,22,1
158617,469,198,271,23,1
158617,244,101,143,24,1
158617,225,97,128,25,1
158617,225,97,128,40,1
158644,63,3,60,1,4
158644,63,3,60,2,1
158644,63,3,60,3,1
158644,27,1,26,4,1
158644,36,2,34,5,1
158644,36,2,34,20,1
158644,55,1,54,21,4
158644,55,1,54,22,1
158644,55,1,54,23,1
158644,20,0,20,24,1
158644,35,1,34,25,1
158644,35,1,34,40,1
158644,8,2,6,41,4
158644,8,2,6,42,1
158644,8,2,6,43,1
158644,7,1,6,44,1
158644,1,1,0,45,1
158644,1,1,0,60,1
158662,18698,6379,12319,1,4
158662,18698,6379,12319,2,1
158662,17467,5949,11518,3,1
158662,3009,1288,1721,4,1
158662,14458,4661,9797,5,1
158662,1231,430,801,11,1
158662,2253,800,1453,19,1
158662,12205,3861,8344,20,1
158662,7906,2977,4929,21,4
158662,7906,2977,4929,22,1
158662,7569,2855,4714,23,1
158662,1984,847,1137,24,1
158662,5585,2008,3577,25,1
158662,337,122,215,31,1
158662,1057,423,634,39,1
158662,4528,1585,2943,40,1
158662,10792,3402,7390,41,4
158662,10792,3402,7390,42,1
158662,9898,3094,6804,43,1
158662,1025,441,584,44,1
158662,8873,2653,6220,45,1
158662,894,308,586,51,1
158662,1196,377,819,59,1
158662,7677,2276,5401,60,1
158723,199,26,173,1,4
158723,199,26,173,2,1
158723,199,26,173,3,1
158723,109,13,96,4,1
158723,90,13,77,5,1
158723,90,13,77,20,1
158723,199,26,173,21,4
158723,199,26,173,22,1
158723,199,26,173,23,1
158723,109,13,96,24,1
158723,90,13,77,25,1
158723,90,13,77,40,1
158778,58,1,57,1,4
158778,58,1,57,2,1
158778,58,1,57,3,1
158778,24,1,23,4,1
158778,34,0,34,5,1
158778,34,0,34,20,1
158778,58,1,57,21,4
158778,58,1,57,22,1
158778,58,1,57,23,1
158778,24,1,23,24,1
158778,34,0,34,25,1
158778,34,0,34,40,1
158787,91,1,90,1,4
158787,91,1,90,2,1
158787,91,1,90,3,1
158787,33,0,33,4,1
158787,58,1,57,5,1
158787,58,1,57,20,1
158787,91,1,90,21,4
158787,91,1,90,22,1
158787,91,1,90,23,1
158787,33,0,33,24,1
158787,58,1,57,25,1
158787,58,1,57,40,1
158802,1183,343,840,1,4
158802,1183,343,840,2,1
158802,1183,343,840,3,1
158802,229,61,168,4,1
158802,954,282,672,5,1
158802,38,15,23,19,1
158802,916,267,649,20,1
158802,1128,319,809,21,4
158802,1128,319,809,22,1
158802,1128,319,809,23,1
158802,224,61,163,24,1
158802,904,258,646,25,1
158802,36,13,23,39,1
158802,868,245,623,40,1
158802,55,24,31,41,4
158802,55,24,31,42,1
158802,55,24,31,43,1
158802,5,0,5,44,1
158802,50,24,26,45,1
158802,2,2,0,59,1
158802,48,22,26,60,1
158884,2506,857,1649,1,4
158884,2506,857,1649,2,1
158884,1675,563,1112,3,1
158884,296,139,157,4,1
158884,1379,424,955,5,1
158884,831,294,537,11,1
158884,335,121,214,19,1
158884,1044,303,741,20,1
158884,918,314,604,21,4
158884,918,314,604,22,1
158884,904,310,594,23,1
158884,195,91,104,24,1
158884,709,219,490,25,1
158884,14,4,10,31,1
158884,169,65,104,39,1
158884,540,154,386,40,1
158884,1588,543,1045,41,4
158884,1588,543,1045,42,1
158884,771,253,518,43,1
158884,101,48,53,44,1
158884,670,205,465,45,1
158884,817,290,527,51,1
158884,166,56,110,59,1
158884,504,149,355,60,1
159009,5071,1896,3175,1,4
159009,4155,1659,2496,2,1
159009,4100,1630,2470,3,1
159009,714,298,416,4,1
159009,3386,1332,2054,5,1
159009,55,29,26,11,1
159009,916,237,679,12,3
159009,264,112,152,19,1
159009,3122,1220,1902,20,1
159009,4325,1684,2641,21,4
159009,3860,1544,2316,22,1
159009,3857,1543,2314,23,1
159009,701,291,410,24,1
159009,3156,1252,1904,25,1
159009,3,1,2,31,1
159009,465,140,325,32,3
159009,257,111,146,39,1
159009,2899,1141,1758,40,1
159009,746,212,534,41,4
159009,295,115,180,42,1
159009,243,87,156,43,1
159009,13,7,6,44,1
159009,230,80,150,45,1
159009,52,28,24,51,1
159009,451,97,354,52,3
159009,7,1,6,59,1
159009,223,79,144,60,1
159027,62,4,58,1,4
159027,62,4,58,2,1
159027,62,4,58,3,1
159027,6,0,6,4,1
159027,56,4,52,5,1
159027,56,4,52,20,1
159027,62,4,58,21,4
159027,62,4,58,22,1
159027,62,4,58,23,1
159027,6,0,6,24,1
159027,56,4,52,25,1
159027,56,4,52,40,1
159197,630,529,101,1,4
159197,630,529,101,2,1
159197,569,494,75,3,1
159197,157,133,24,4,1
159197,412,361,51,5,1
159197,61,35,26,11,1
159197,412,361,51,20,1
159197,630,529,101,21,4
159197,630,529,101,22,1
159197,569,494,75,23,1
159197,157,133,24,24,1
159197,412,361,51,25,1
159197,61,35,26,31,1
159197,412,361,51,40,1
159319,36,1,35,1,4
159319,36,1,35,2,1
159319,36,1,35,3,1
159319,7,0,7,4,1
159319,29,1,28,5,1
159319,29,1,28,20,1
159319,36,1,35,21,4
159319,36,1,35,22,1
159319,36,1,35,23,1
159319,7,0,7,24,1
159319,29,1,28,25,1
159319,29,1,28,40,1
159328,76,3,73,1,4
159328,76,3,73,2,1
159328,76,3,73,3,1
159328,9,0,9,4,1
159328,67,3,64,5,1
159328,67,3,64,20,1
159328,76,3,73,21,4
159328,76,3,73,22,1
159328,76,3,73,23,1
159328,9,0,9,24,1
159328,67,3,64,25,1
159328,67,3,64,40,1
159373,2829,919,1910,1,4
159373,915,111,804,2,1
159373,915,111,804,3,1
159373,915,111,804,5,1
159373,1914,808,1106,12,3
159373,257,37,220,19,1
159373,658,74,584,20,1
159373,2359,854,1505,21,4
159373,599,71,528,22,1
159373,599,71,528,23,1
159373,599,71,528,25,1
159373,1760,783,977,32,3
159373,119,20,99,39,1
159373,480,51,429,40,1
159373,470,65,405,41,4
159373,316,40,276,42,1
159373,316,40,276,43,1
159373,316,40,276,45,1
159373,154,25,129,52,3
159373,138,17,121,59,1
159373,178,23,155,60,1
159382,2229,670,1559,1,4
159382,2211,665,1546,2,1
159382,1984,574,1410,3,1
159382,391,135,256,4,1
159382,1593,439,1154,5,1
159382,227,91,136,11,1
159382,18,5,13,12,3
159382,174,48,126,19,1
159382,1419,391,1028,20,1
159382,1257,422,835,21,4
159382,1257,422,835,22,1
159382,1248,417,831,23,1
159382,332,121,211,24,1
159382,916,296,620,25,1
159382,9,5,4,31,1
159382,119,38,81,39,1
159382,797,258,539,40,1
159382,972,248,724,41,4
159382,954,243,711,42,1
159382,736,157,579,43,1
159382,59,14,45,44,1
159382,677,143,534,45,1
159382,218,86,132,51,1
159382,18,5,13,52,3
159382,55,10,45,59,1
159382,622,133,489,60,1
159391,30478,14793,15685,1,4
159391,24923,12080,12843,2,1
159391,23990,11620,12370,3,1
159391,5501,2420,3081,4,1
159391,18489,9200,9289,5,1
159391,933,460,473,11,1
159391,5555,2713,2842,12,3
159391,933,500,433,19,1
159391,17556,8700,8856,20,1
159391,27172,13177,13995,21,4
159391,22811,10979,11832,22,1
159391,22707,10920,11787,23,1
159391,5498,2418,3080,24,1
159391,17209,8502,8707,25,1
159391,104,59,45,31,1
159391,4361,2198,2163,32,3
159391,885,472,413,39,1
159391,16324,8030,8294,40,1
159391,3306,1616,1690,41,4
159391,2112,1101,1011,42,1
159391,1283,700,583,43,1
159391,3,2,1,44,1
159391,1280,698,582,45,1
159391,829,401,428,51,1
159391,1194,515,679,52,3
159391,48,28,20,59,1
159391,1232,670,562,60,1
159407,2673,804,1869,1,4
159407,2673,804,1869,2,1
159407,2424,716,1708,3,1
159407,704,258,446,4,1
159407,1720,458,1262,5,1
159407,249,88,161,11,1
159407,146,48,98,19,1
159407,1574,410,1164,20,1
159407,1283,422,861,21,4
159407,1283,422,861,22,1
159407,1279,420,859,23,1
159407,524,196,328,24,1
159407,755,224,531,25,1
159407,4,2,2,31,1
159407,60,17,43,39,1
159407,695,207,488,40,1
159407,1390,382,1008,41,4
159407,1390,382,1008,42,1
159407,1145,296,849,43,1
159407,180,62,118,44,1
159407,965,234,731,45,1
159407,245,86,159,51,1
159407,86,31,55,59,1
159407,879,203,676,60,1
159416,4114,1628,2486,1,4
159416,3674,1501,2173,2,1
159416,2796,1157,1639,3,1
159416,345,146,199,4,1
159416,2451,1011,1440,5,1
159416,878,344,534,11,1
159416,440,127,313,12,3
159416,366,141,225,19,1
159416,2085,870,1215,20,1
159416,2229,904,1325,21,4
159416,2097,868,1229,22,1
159416,2064,859,1205,23,1
159416,334,140,194,24,1
159416,1730,719,1011,25,1
159416,33,9,24,31,1
159416,132,36,96,32,3
159416,264,103,161,39,1
159416,1466,616,850,40,1
159416,1885,724,1161,41,4
159416,1577,633,944,42,1
159416,732,298,434,43,1
159416,11,6,5,44,1
159416,721,292,429,45,1
159416,845,335,510,51,1
159416,308,91,217,52,3
159416,102,38,64,59,1
159416,619,254,365,60,1
159443,2832,1386,1446,1,4
159443,2832,1386,1446,2,1
159443,1713,846,867,3,1
159443,506,287,219,4,1
159443,1207,559,648,5,1
159443,1119,540,579,11,1
159443,94,47,47,19,1
159443,1113,512,601,20,1
159443,1308,663,645,21,4
159443,1308,663,645,22,1
159443,1220,618,602,23,1
159443,397,241,156,24,1
159443,823,377,446,25,1
159443,88,45,43,31,1
159443,62,31,31,39,1
159443,761,346,415,40,1
159443,1524,723,801,41,4
159443,1524,723,801,42,1
159443,493,228,265,43,1
159443,109,46,63,44,1
159443,384,182,202,45,1
159443,1031,495,536,51,1
159443,32,16,16,59,1
159443,352,166,186,60,1
159513,226,19,207,1,4
159513,226,19,207,2,1
159513,226,19,207,3,1
159513,126,9,117,4,1
159513,100,10,90,5,1
159513,100,10,90,20,1
159513,226,19,207,21,4
159513,226,19,207,22,1
159513,226,19,207,23,1
159513,126,9,117,24,1
159513,100,10,90,25,1
159513,100,10,90,40,1
159522,116,10,106,1,4
159522,116,10,106,2,1
159522,116,10,106,3,1
159522,66,6,60,4,1
159522,50,4,46,5,1
159522,50,4,46,20,1
159522,116,10,106,21,4
159522,116,10,106,22,1
159522,116,10,106,23,1
159522,66,6,60,24,1
159522,50,4,46,25,1
159522,50,4,46,40,1
159531,42,1,41,1,4
159531,42,1,41,2,1
159531,42,1,41,3,1
159531,32,0,32,4,1
159531,10,1,9,5,1
159531,10,1,9,20,1
159531,42,1,41,21,4
159531,42,1,41,22,1
159531,42,1,41,23,1
159531,32,0,32,24,1
159531,10,1,9,25,1
159531,10,1,9,40,1
159568,1400,686,714,1,4
159568,1116,585,531,2,1
159568,1081,559,522,3,1
159568,265,148,117,4,1
159568,816,411,405,5,1
159568,35,26,9,11,1
159568,284,101,183,12,3
159568,60,33,27,19,1
159568,756,378,378,20,1
159568,1092,566,526,21,4
159568,1035,537,498,22,1
159568,1008,519,489,23,1
159568,265,148,117,24,1
159568,743,371,372,25,1
159568,27,18,9,31,1
159568,57,29,28,32,3
159568,50,31,19,39,1
159568,693,340,353,40,1
159568,308,120,188,41,4
159568,81,48,33,42,1
159568,73,40,33,43,1
159568,73,40,33,45,1
159568,8,8,0,51,1
159568,227,72,155,52,3
159568,10,2,8,59,1
159568,63,38,25,60,1
159601,14,0,14,1,4
159601,14,0,14,2,1
159601,14,0,14,3,1
159601,8,0,8,4,1
159601,6,0,6,5,1
159601,6,0,6,20,1
159601,14,0,14,21,4
159601,14,0,14,22,1
159601,14,0,14,23,1
159601,8,0,8,24,1
159601,6,0,6,25,1
159601,6,0,6,40,1
159647,11015,5591,5424,1,4
159647,9245,4895,4350,2,1
159647,7047,3985,3062,3,1
159647,1553,915,638,4,1
159647,5494,3070,2424,5,1
159647,2198,910,1288,11,1
159647,1770,696,1074,12,3
159647,370,177,193,19,1
159647,5124,2893,2231,20,1
159647,7549,4140,3409,21,4
159647,6585,3685,2900,22,1
159647,6273,3550,2723,23,1
159647,1504,881,623,24,1
159647,4769,2669,2100,25,1
159647,312,135,177,31,1
159647,964,455,509,32,3
159647,300,141,159,39,1
159647,4469,2528,1941,40,1
159647,3466,1451,2015,41,4
159647,2660,1210,1450,42,1
159647,774,435,339,43,1
159647,49,34,15,44,1
159647,725,401,324,45,1
159647,1886,775,1111,51,1
159647,806,241,565,52,3
159647,70,36,34,59,1
159647,655,365,290,60,1
159656,4686,1797,2889,1,4
159656,2946,1214,1732,2,1
159656,2910,1197,1713,3,1
159656,624,247,377,4,1
159656,2286,950,1336,5,1
159656,36,17,19,11,1
159656,1740,583,1157,12,3
159656,161,75,86,19,1
159656,2125,875,1250,20,1
159656,3589,1455,2134,21,4
159656,2741,1120,1621,22,1
159656,2721,1110,1611,23,1
159656,620,245,375,24,1
159656,2101,865,1236,25,1
159656,20,10,10,31,1
159656,848,335,513,32,3
159656,131,60,71,39,1
159656,1970,805,1165,40,1
159656,1097,342,755,41,4
159656,205,94,111,42,1
159656,189,87,102,43,1
159656,4,2,2,44,1
159656,185,85,100,45,1
159656,16,7,9,51,1
159656,892,248,644,52,3
159656,30,15,15,59,1
159656,155,70,85,60,1
159717,8341,3152,5189,1,4
159717,7575,2907,4668,2,1
159717,6777,2567,4210,3,1
159717,1330,512,818,4,1
159717,5447,2055,3392,5,1
159717,798,340,458,11,1
159717,766,245,521,12,3
159717,320,127,193,19,1
159717,5127,1928,3199,20,1
159717,6307,2425,3882,21,4
159717,5973,2304,3669,22,1
159717,5958,2297,3661,23,1
159717,1312,502,810,24,1
159717,4646,1795,2851,25,1
159717,15,7,8,31,1
159717,334,121,213,32,3
159717,271,115,156,39,1
159717,4375,1680,2695,40,1
159717,2034,727,1307,41,4
159717,1602,603,999,42,1
159717,819,270,549,43,1
159717,18,10,8,44,1
159717,801,260,541,45,1
159717,783,333,450,51,1
159717,432,124,308,52,3
159717,49,12,37,59,1
159717,752,248,504,60,1
159939,9323,4483,4840,1,4
159939,7144,3547,3597,2,1
159939,6854,3410,3444,3,1
159939,857,443,414,4,1
159939,5997,2967,3030,5,1
159939,290,137,153,11,1
159939,2179,936,1243,12,3
159939,733,317,416,19,1
159939,5264,2650,2614,20,1
159939,6548,3197,3351,21,4
159939,5376,2655,2721,22,1
159939,5307,2617,2690,23,1
159939,842,436,406,24,1
159939,4465,2181,2284,25,1
159939,69,38,31,31,1
159939,1172,542,630,32,3
159939,598,259,339,39,1
159939,3867,1922,1945,40,1
159939,2775,1286,1489,41,4
159939,1768,892,876,42,1
159939,1547,793,754,43,1
159939,15,7,8,44,1
159939,1532,786,746,45,1
159939,221,99,122,51,1
159939,1007,394,613,52,3
159939,135,58,77,59,1
159939,1397,728,669,60,1
159948,2638,1971,667,1,4
159948,1081,759,322,2,1
159948,1079,759,320,3,1
159948,189,122,67,4,1
159948,890,637,253,5,1
159948,2,0,2,11,1
159948,1557,1212,345,12,3
159948,22,13,9,19,1
159948,868,624,244,20,1
159948,894,647,247,21,4
159948,324,230,94,22,1
159948,324,230,94,23,1
159948,36,24,12,24,1
159948,288,206,82,25,1
159948,570,417,153,32,3
159948,15,9,6,39,1
159948,273,197,76,40,1
159948,1744,1324,420,41,4
159948,757,529,228,42,1
159948,755,529,226,43,1
159948,153,98,55,44,1
159948,602,431,171,45,1
159948,2,0,2,51,1
159948,987,795,192,52,3
159948,7,4,3,59,1
159948,595,427,168,60,1
159966,6532,2389,4143,1,4
159966,5888,2233,3655,2,1
159966,5682,2145,3537,3,1
159966,1242,506,736,4,1
159966,4440,1639,2801,5,1
159966,206,88,118,11,1
159966,644,156,488,12,3
159966,262,112,150,19,1
159966,4178,1527,2651,20,1
159966,4947,1856,3091,21,4
159966,4729,1803,2926,22,1
159966,4707,1792,2915,23,1
159966,1059,431,628,24,1
159966,3648,1361,2287,25,1
159966,22,11,11,31,1
159966,218,53,165,32,3
159966,203,91,112,39,1
159966,3445,1270,2175,40,1
159966,1585,533,1052,41,4
159966,1159,430,729,42,1
159966,975,353,622,43,1
159966,183,75,108,44,1
159966,792,278,514,45,1
159966,184,77,107,51,1
159966,426,103,323,52,3
159966,59,21,38,59,1
159966,733,257,476,60,1
159993,8645,3208,5437,1,4
159993,7276,2727,4549,2,1
159993,5863,2105,3758,3,1
159993,1338,463,875,4,1
159993,4525,1642,2883,5,1
159993,1413,622,791,11,1
159993,1369,481,888,12,3
159993,416,158,258,19,1
159993,4109,1484,2625,20,1
159993,5739,2092,3647,21,4
159993,4894,1785,3109,22,1
159993,4851,1770,3081,23,1
159993,1318,453,865,24,1
159993,3533,1317,2216,25,1
159993,43,15,28,31,1
159993,845,307,538,32,3
159993,296,115,181,39,1
159993,3237,1202,2035,40,1
159993,2906,1116,1790,41,4
159993,2382,942,1440,42,1
159993,1012,335,677,43,1
159993,20,10,10,44,1
159993,992,325,667,45,1
159993,1370,607,763,51,1
159993,524,174,350,52,3
159993,120,43,77,59,1
159993,872,282,590,60,1
160010,2694,1576,1118,1,4
160010,2694,1576,1118,2,1
160010,1495,829,666,3,1
160010,565,348,217,4,1
160010,930,481,449,5,1
160010,1199,747,452,11,1
160010,93,31,62,19,1
160010,837,450,387,20,1
160010,1009,611,398,21,4
160010,1009,611,398,22,1
160010,939,557,382,23,1
160010,348,226,122,24,1
160010,591,331,260,25,1
160010,70,54,16,31,1
160010,47,21,26,39,1
160010,544,310,234,40,1
160010,1685,965,720,41,4
160010,1685,965,720,42,1
160010,556,272,284,43,1
160010,217,122,95,44,1
160010,339,150,189,45,1
160010,1129,693,436,51,1
160010,46,10,36,59,1
160010,293,140,153,60,1
160029,184,147,37,1,4
160029,184,147,37,12,3
160029,109,102,7,21,4
160029,109,102,7,32,3
160029,75,45,30,41,4
160029,75,45,30,52,3
160038,8944,2749,6195,1,4
160038,7836,2513,5323,2,1
160038,7026,2232,4794,3,1
160038,1231,453,778,4,1
160038,5795,1779,4016,5,1
160038,810,281,529,11,1
160038,1108,236,872,12,3
160038,474,141,333,19,1
160038,5321,1638,3683,20,1
160038,5249,1828,3421,21,4
160038,5013,1767,3246,22,1
160038,4990,1759,3231,23,1
160038,1160,431,729,24,1
160038,3830,1328,2502,25,1
160038,23,8,15,31,1
160038,236,61,175,32,3
160038,284,90,194,39,1
160038,3546,1238,2308,40,1
160038,3695,921,2774,41,4
160038,2823,746,2077,42,1
160038,2036,473,1563,43,1
160038,71,22,49,44,1
160038,1965,451,1514,45,1
160038,787,273,514,51,1
160038,872,175,697,52,3
160038,190,51,139,59,1
160038,1775,400,1375,60,1
160065,1112,191,921,1,4
160065,878,145,733,2,1
160065,842,128,714,3,1
160065,58,9,49,4,1
160065,784,119,665,5,1
160065,36,17,19,11,1
160065,234,46,188,12,3
160065,80,15,65,19,1
160065,704,104,600,20,1
160065,602,97,505,21,4
160065,521,81,440,22,1
160065,521,81,440,23,1
160065,54,9,45,24,1
160065,467,72,395,25,1
160065,81,16,65,32,3
160065,45,10,35,39,1
160065,422,62,360,40,1
160065,510,94,416,41,4
160065,357,64,293,42,1
160065,321,47,274,43,1
160065,4,0,4,44,1
160065,317,47,270,45,1
160065,36,17,19,51,1
160065,153,30,123,52,3
160065,35,5,30,59,1
160065,282,42,240,60,1
160074,1703,277,1426,1,4
160074,1486,200,1286,2,1
160074,1483,200,1283,3,1
160074,111,10,101,4,1
160074,1372,190,1182,5,1
160074,3,0,3,11,1
160074,217,77,140,12,3
160074,185,25,160,19,1
160074,1187,165,1022,20,1
160074,1011,171,840,21,4
160074,873,117,756,22,1
160074,873,117,756,23,1
160074,107,10,97,24,1
160074,766,107,659,25,1
160074,138,54,84,32,3
160074,120,15,105,39,1
160074,646,92,554,40,1
160074,692,106,586,41,4
160074,613,83,530,42,1
160074,610,83,527,43,1
160074,4,0,4,44,1
160074,606,83,523,45,1
160074,3,0,3,51,1
160074,79,23,56,52,3
160074,65,10,55,59,1
160074,541,73,468,60,1
160117,25,2,23,1,4
160117,25,2,23,2,1
160117,25,2,23,3,1
160117,24,2,22,4,1
160117,1,0,1,5,1
160117,1,0,1,20,1
160117,25,2,23,21,4
160117,25,2,23,22,1
160117,25,2,23,23,1
160117,24,2,22,24,1
160117,1,0,1,25,1
160117,1,0,1,40,1
160126,28,0,28,1,4
160126,28,0,28,2,1
160126,28,0,28,3,1
160126,7,0,7,4,1
160126,21,0,21,5,1
160126,21,0,21,20,1
160126,28,0,28,21,4
160126,28,0,28,22,1
160126,28,0,28,23,1
160126,7,0,7,24,1
160126,21,0,21,25,1
160126,21,0,21,40,1
160135,28,0,28,1,4
160135,28,0,28,2,1
160135,28,0,28,3,1
160135,25,0,25,4,1
160135,3,0,3,5,1
160135,3,0,3,20,1
160135,28,0,28,21,4
160135,28,0,28,22,1
160135,28,0,28,23,1
160135,25,0,25,24,1
160135,3,0,3,25,1
160135,3,0,3,40,1
160199,75,3,72,1,4
160199,75,3,72,2,1
160199,75,3,72,3,1
160199,16,1,15,4,1
160199,59,2,57,5,1
160199,59,2,57,20,1
160199,75,3,72,21,4
160199,75,3,72,22,1
160199,75,3,72,23,1
160199,16,1,15,24,1
160199,59,2,57,25,1
160199,59,2,57,40,1
160320,1707,110,1597,1,4
160320,1707,110,1597,2,1
160320,1707,110,1597,3,1
160320,850,57,793,4,1
160320,857,53,804,5,1
160320,857,53,804,20,1
160320,1707,110,1597,21,4
160320,1707,110,1597,22,1
160320,1707,110,1597,23,1
160320,850,57,793,24,1
160320,857,53,804,25,1
160320,857,53,804,40,1
160409,133,133,0,1,4
160409,133,133,0,2,1
160409,133,133,0,3,1
160409,14,14,0,4,1
160409,119,119,0,5,1
160409,48,48,0,19,1
160409,71,71,0,20,1
160409,129,129,0,21,4
160409,129,129,0,22,1
160409,129,129,0,23,1
160409,14,14,0,24,1
160409,115,115,0,25,1
160409,47,47,0,39,1
160409,68,68,0,40,1
160409,4,4,0,41,4
160409,4,4,0,42,1
160409,4,4,0,43,1
160409,4,4,0,45,1
160409,1,1,0,59,1
160409,3,3,0,60,1
160445,107,1,106,1,4
160445,107,1,106,2,1
160445,107,1,106,3,1
160445,15,0,15,4,1
160445,92,1,91,5,1
160445,92,1,91,20,1
160445,107,1,106,21,4
160445,107,1,106,22,1
160445,107,1,106,23,1
160445,15,0,15,24,1
160445,92,1,91,25,1
160445,92,1,91,40,1
160472,41,1,40,1,4
160472,41,1,40,2,1
160472,41,1,40,3,1
160472,21,0,21,4,1
160472,20,1,19,5,1
160472,20,1,19,20,1
160472,41,1,40,21,4
160472,41,1,40,22,1
160472,41,1,40,23,1
160472,21,0,21,24,1
160472,20,1,19,25,1
160472,20,1,19,40,1
160481,1968,698,1270,1,4
160481,1968,698,1270,2,1
160481,1776,623,1153,3,1
160481,585,239,346,4,1
160481,1191,384,807,5,1
160481,192,75,117,11,1
160481,213,80,133,19,1
160481,978,304,674,20,1
160481,1259,481,778,21,4
160481,1259,481,778,22,1
160481,1225,459,766,23,1
160481,495,206,289,24,1
160481,730,253,477,25,1
160481,34,22,12,31,1
160481,136,54,82,39,1
160481,594,199,395,40,1
160481,709,217,492,41,4
160481,709,217,492,42,1
160481,551,164,387,43,1
160481,90,33,57,44,1
160481,461,131,330,45,1
160481,158,53,105,51,1
160481,77,26,51,59,1
160481,384,105,279,60,1
160524,326,58,268,1,4
160524,326,58,268,2,1
160524,326,58,268,3,1
160524,116,20,96,4,1
160524,210,38,172,5,1
160524,1,0,1,19,1
160524,209,38,171,20,1
160524,326,58,268,21,4
160524,326,58,268,22,1
160524,326,58,268,23,1
160524,116,20,96,24,1
160524,210,38,172,25,1
160524,1,0,1,39,1
160524,209,38,171,40,1
160579,3225,1871,1354,1,4
160579,3225,1871,1354,2,1
160579,2609,1538,1071,3,1
160579,761,448,313,4,1
160579,1848,1090,758,5,1
160579,616,333,283,11,1
160579,405,226,179,19,1
160579,1443,864,579,20,1
160579,1702,928,774,21,4
160579,1702,928,774,22,1
160579,1644,902,742,23,1
160579,523,295,228,24,1
160579,1121,607,514,25,1
160579,58,26,32,31,1
160579,244,128,116,39,1
160579,877,479,398,40,1
160579,1523,943,580,41,4
160579,1523,943,580,42,1
160579,965,636,329,43,1
160579,238,153,85,44,1
160579,727,483,244,45,1
160579,558,307,251,51,1
160579,161,98,63,59,1
160579,566,385,181,60,1
160597,116,39,77,1,4
160597,116,39,77,2,1
160597,116,39,77,3,1
160597,4,2,2,4,1
160597,112,37,75,5,1
160597,112,37,75,20,1
160597,74,18,56,21,4
160597,74,18,56,22,1
160597,74,18,56,23,1
160597,2,1,1,24,1
160597,72,17,55,25,1
160597,72,17,55,40,1
160597,42,21,21,41,4
160597,42,21,21,42,1
160597,42,21,21,43,1
160597,2,1,1,44,1
160597,40,20,20,45,1
160597,40,20,20,60,1
160612,14934,5748,9186,1,4
160612,13730,5479,8251,2,1
160612,11704,4565,7139,3,1
160612,2546,1020,1526,4,1
160612,9158,3545,5613,5,1
160612,2026,914,1112,11,1
160612,1204,269,935,12,3
160612,598,231,367,19,1
160612,8560,3314,5246,20,1
160612,10360,4026,6334,21,4
160612,9999,3934,6065,22,1
160612,9981,3930,6051,23,1
160612,2370,950,1420,24,1
160612,7611,2980,4631,25,1
160612,18,4,14,31,1
160612,361,92,269,32,3
160612,478,196,282,39,1
160612,7133,2784,4349,40,1
160612,4574,1722,2852,41,4
160612,3731,1545,2186,42,1
160612,1723,635,1088,43,1
160612,176,70,106,44,1
160612,1547,565,982,45,1
160612,2008,910,1098,51,1
160612,843,177,666,52,3
160612,120,35,85,59,1
160612,1427,530,897,60,1
160621,6777,2403,4374,1,4
160621,5746,2133,3613,2,1
160621,5666,2083,3583,3,1
160621,1123,437,686,4,1
160621,4543,1646,2897,5,1
160621,80,50,30,11,1
160621,1031,270,761,12,3
160621,341,106,235,19,1
160621,4202,1540,2662,20,1
160621,5641,1972,3669,21,4
160621,4708,1733,2975,22,1
160621,4702,1727,2975,23,1
160621,1104,429,675,24,1
160621,3598,1298,2300,25,1
160621,6,6,0,31,1
160621,933,239,694,32,3
160621,296,98,198,39,1
160621,3302,1200,2102,40,1
160621,1136,431,705,41,4
160621,1038,400,638,42,1
160621,964,356,608,43,1
160621,19,8,11,44,1
160621,945,348,597,45,1
160621,74,44,30,51,1
160621,98,31,67,52,3
160621,45,8,37,59,1
160621,900,340,560,60,1
160630,2292,544,1748,1,4
160630,1809,454,1355,2,1
160630,1782,446,1336,3,1
160630,269,90,179,4,1
160630,1513,356,1157,5,1
160630,27,8,19,11,1
160630,483,90,393,12,3
160630,243,55,188,19,1
160630,1270,301,969,20,1
160630,1655,378,1277,21,4
160630,1222,296,926,22,1
160630,1221,295,926,23,1
160630,200,61,139,24,1
160630,1021,234,787,25,1
160630,1,1,0,31,1
160630,433,82,351,32,3
160630,166,36,130,39,1
160630,855,198,657,40,1
160630,637,166,471,41,4
160630,587,158,429,42,1
160630,561,151,410,43,1
160630,69,29,40,44,1
160630,492,122,370,45,1
160630,26,7,19,51,1
160630,50,8,42,52,3
160630,77,19,58,59,1
160630,415,103,312,60,1
160649,3018,867,2151,1,4
160649,3018,867,2151,2,1
160649,2784,812,1972,3,1
160649,405,146,259,4,1
160649,2379,666,1713,5,1
160649,234,55,179,11,1
160649,206,51,155,19,1
160649,2173,615,1558,20,1
160649,2121,696,1425,21,4
160649,2121,696,1425,22,1
160649,2121,696,1425,23,1
160649,377,136,241,24,1
160649,1744,560,1184,25,1
160649,154,45,109,39,1
160649,1590,515,1075,40,1
160649,897,171,726,41,4
160649,897,171,726,42,1
160649,663,116,547,43,1
160649,28,10,18,44,1
160649,635,106,529,45,1
160649,234,55,179,51,1
160649,52,6,46,59,1
160649,583,100,483,60,1
160658,16646,7435,9211,1,4
160658,15053,6724,8329,2,1
160658,14261,6400,7861,3,1
160658,2693,1251,1442,4,1
160658,11568,5149,6419,5,1
160658,792,324,468,11,1
160658,1593,711,882,12,3
160658,751,319,432,19,1
160658,10817,4830,5987,20,1
160658,13221,6112,7109,21,4
160658,12295,5655,6640,22,1
160658,12274,5643,6631,23,1
160658,2679,1245,1434,24,1
160658,9595,4398,5197,25,1
160658,21,12,9,31,1
160658,926,457,469,32,3
160658,544,269,275,39,1
160658,9051,4129,4922,40,1
160658,3425,1323,2102,41,4
160658,2758,1069,1689,42,1
160658,1987,757,1230,43,1
160658,14,6,8,44,1
160658,1973,751,1222,45,1
160658,771,312,459,51,1
160658,667,254,413,52,3
160658,207,50,157,59,1
160658,1766,701,1065,60,1
160667,3151,1610,1541,1,4
160667,3151,1610,1541,2,1
160667,1705,871,834,3,1
160667,508,278,230,4,1
160667,1197,593,604,5,1
160667,1446,739,707,11,1
160667,221,78,143,19,1
160667,976,515,461,20,1
160667,1078,543,535,21,4
160667,1078,543,535,22,1
160667,1000,479,521,23,1
160667,293,156,137,24,1
160667,707,323,384,25,1
160667,78,64,14,31,1
160667,134,46,88,39,1
160667,573,277,296,40,1
160667,2073,1067,1006,41,4
160667,2073,1067,1006,42,1
160667,705,392,313,43,1
160667,215,122,93,44,1
160667,490,270,220,45,1
160667,1368,675,693,51,1
160667,87,32,55,59,1
160667,403,238,165,60,1
160755,12938,5631,7307,1,4
160755,8290,3476,4814,2,1
160755,8290,3476,4814,3,1
160755,1609,665,944,4,1
160755,6681,2811,3870,5,1
160755,4648,2155,2493,12,3
160755,90,42,48,19,1
160755,6591,2769,3822,20,1
160755,10572,4617,5955,21,4
160755,6487,2740,3747,22,1
160755,6487,2740,3747,23,1
160755,1609,665,944,24,1
160755,4878,2075,2803,25,1
160755,4085,1877,2208,32,3
160755,90,42,48,39,1
160755,4788,2033,2755,40,1
160755,2366,1014,1352,41,4
160755,1803,736,1067,42,1
160755,1803,736,1067,43,1
160755,1803,736,1067,45,1
160755,563,278,285,52,3
160755,1803,736,1067,60,1
160904,3121,898,2223,1,4
160904,2504,714,1790,2,1
160904,2459,700,1759,3,1
160904,675,183,492,4,1
160904,1784,517,1267,5,1
160904,45,14,31,11,1
160904,617,184,433,12,3
160904,124,47,77,19,1
160904,1660,470,1190,20,1
160904,2942,845,2097,21,4
160904,2375,674,1701,22,1
160904,2363,668,1695,23,1
160904,674,182,492,24,1
160904,1689,486,1203,25,1
160904,12,6,6,31,1
160904,567,171,396,32,3
160904,118,46,72,39,1
160904,1571,440,1131,40,1
160904,179,53,126,41,4
160904,129,40,89,42,1
160904,96,32,64,43,1
160904,1,1,0,44,1
160904,95,31,64,45,1
160904,33,8,25,51,1
160904,50,13,37,52,3
160904,6,1,5,59,1
160904,89,30,59,60,1
160913,2410,1608,802,1,4
160913,2410,1608,802,2,1
160913,1460,1070,390,3,1
160913,562,437,125,4,1
160913,898,633,265,5,1
160913,950,538,412,11,1
160913,347,264,83,19,1
160913,551,369,182,20,1
160913,600,364,236,21,4
160913,600,364,236,22,1
160913,593,358,235,23,1
160913,215,134,81,24,1
160913,378,224,154,25,1
160913,7,6,1,31,1
160913,115,72,43,39,1
160913,263,152,111,40,1
160913,1810,1244,566,41,4
160913,1810,1244,566,42,1
160913,867,712,155,43,1
160913,347,303,44,44,1
160913,520,409,111,45,1
160913,943,532,411,51,1
160913,232,192,40,59,1
160913,288,217,71,60,1
160940,1017,232,785,1,4
160940,988,225,763,2,1
160940,977,220,757,3,1
160940,146,38,108,4,1
160940,831,182,649,5,1
160940,11,5,6,11,1
160940,29,7,22,12,3
160940,295,59,236,19,1
160940,536,123,413,20,1
160940,478,110,368,21,4
160940,453,105,348,22,1
160940,452,105,347,23,1
160940,81,22,59,24,1
160940,371,83,288,25,1
160940,1,0,1,31,1
160940,25,5,20,32,3
160940,130,23,107,39,1
160940,241,60,181,40,1
160940,539,122,417,41,4
160940,535,120,415,42,1
160940,525,115,410,43,1
160940,65,16,49,44,1
160940,460,99,361,45,1
160940,10,5,5,51,1
160940,4,2,2,52,3
160940,165,36,129,59,1
160940,295,63,232,60,1
160959,370,120,250,1,4
160959,362,119,243,2,1
160959,356,114,242,3,1
160959,104,37,67,4,1
160959,252,77,175,5,1
160959,6,5,1,11,1
160959,8,1,7,12,3
160959,28,9,19,19,1
160959,224,68,156,20,1
160959,351,113,238,21,4
160959,344,112,232,22,1
160959,344,112,232,23,1
160959,103,37,66,24,1
160959,241,75,166,25,1
160959,7,1,6,32,3
160959,27,9,18,39,1
160959,214,66,148,40,1
160959,19,7,12,41,4
160959,18,7,11,42,1
160959,12,2,10,43,1
160959,1,0,1,44,1
160959,11,2,9,45,1
160959,6,5,1,51,1
160959,1,0,1,52,3
160959,1,0,1,59,1
160959,10,2,8,60,1
160977,1791,890,901,1,4
160977,1791,890,901,2,1
160977,1791,890,901,3,1
160977,500,270,230,4,1
160977,1291,620,671,5,1
160977,3,2,1,19,1
160977,1288,618,670,20,1
160977,1791,890,901,21,4
160977,1791,890,901,22,1
160977,1791,890,901,23,1
160977,500,270,230,24,1
160977,1291,620,671,25,1
160977,3,2,1,39,1
160977,1288,618,670,40,1
160995,464,157,307,1,4
160995,464,157,307,2,1
160995,461,157,304,3,1
160995,93,40,53,4,1
160995,368,117,251,5,1
160995,3,0,3,11,1
160995,48,20,28,19,1
160995,320,97,223,20,1
160995,363,136,227,21,4
160995,363,136,227,22,1
160995,363,136,227,23,1
160995,89,40,49,24,1
160995,274,96,178,25,1
160995,48,20,28,39,1
160995,226,76,150,40,1
160995,101,21,80,41,4
160995,101,21,80,42,1
160995,98,21,77,43,1
160995,4,0,4,44,1
160995,94,21,73,45,1
160995,3,0,3,51,1
160995,94,21,73,60,1
161004,1795,902,893,1,4
161004,1795,902,893,2,1
161004,1789,901,888,3,1
161004,497,245,252,4,1
161004,1292,656,636,5,1
161004,6,1,5,11,1
161004,5,2,3,19,1
161004,1287,654,633,20,1
161004,1791,901,890,21,4
161004,1791,901,890,22,1
161004,1788,901,887,23,1
161004,497,245,252,24,1
161004,1291,656,635,25,1
161004,3,0,3,31,1
161004,5,2,3,39,1
161004,1286,654,632,40,1
161004,4,1,3,41,4
161004,4,1,3,42,1
161004,1,0,1,43,1
161004,1,0,1,45,1
161004,3,1,2,51,1
161004,1,0,1,60,1
161022,225,26,199,1,4
161022,225,26,199,2,1
161022,178,20,158,3,1
161022,2,0,2,4,1
161022,176,20,156,5,1
161022,47,6,41,11,1
161022,176,20,156,20,1
161022,59,9,50,21,4
161022,59,9,50,22,1
161022,55,7,48,23,1
161022,2,0,2,24,1
161022,53,7,46,25,1
161022,4,2,2,31,1
161022,53,7,46,40,1
161022,166,17,149,41,4
161022,166,17,149,42,1
161022,123,13,110,43,1
161022,123,13,110,45,1
161022,43,4,39,51,1
161022,123,13,110,60,1
161077,3109,1462,1647,1,4
161077,3109,1462,1647,2,1
161077,2531,1119,1412,3,1
161077,600,301,299,4,1
161077,1931,818,1113,5,1
161077,578,343,235,11,1
161077,436,153,283,19,1
161077,1495,665,830,20,1
161077,1447,749,698,21,4
161077,1447,749,698,22,1
161077,1442,748,694,23,1
161077,439,235,204,24,1
161077,1003,513,490,25,1
161077,5,1,4,31,1
161077,218,95,123,39,1
161077,785,418,367,40,1
161077,1662,713,949,41,4
161077,1662,713,949,42,1
161077,1089,371,718,43,1
161077,161,66,95,44,1
161077,928,305,623,45,1
161077,573,342,231,51,1
161077,218,58,160,59,1
161077,710,247,463,60,1
161086,1820,874,946,1,4
161086,1820,874,946,2,1
161086,1820,874,946,3,1
161086,483,243,240,4,1
161086,1337,631,706,5,1
161086,9,5,4,19,1
161086,1328,626,702,20,1
161086,1820,874,946,21,4
161086,1820,874,946,22,1
161086,1820,874,946,23,1
161086,483,243,240,24,1
161086,1337,631,706,25,1
161086,9,5,4,39,1
161086,1328,626,702,40,1
161138,2558,1262,1296,1,4
161138,2558,1262,1296,2,1
161138,2046,995,1051,3,1
161138,477,264,213,4,1
161138,1569,731,838,5,1
161138,512,267,245,11,1
161138,215,107,108,19,1
161138,1354,624,730,20,1
161138,1355,680,675,21,4
161138,1355,680,675,22,1
161138,1331,669,662,23,1
161138,381,213,168,24,1
161138,950,456,494,25,1
161138,24,11,13,31,1
161138,143,76,67,39,1
161138,807,380,427,40,1
161138,1203,582,621,41,4
161138,1203,582,621,42,1
161138,715,326,389,43,1
161138,96,51,45,44,1
161138,619,275,344,45,1
161138,488,256,232,51,1
161138,72,31,41,59,1
161138,547,244,303,60,1
161165,3049,1218,1831,1,4
161165,2350,958,1392,2,1
161165,2290,946,1344,3,1
161165,455,186,269,4,1
161165,1835,760,1075,5,1
161165,60,12,48,11,1
161165,699,260,439,12,3
161165,157,74,83,19,1
161165,1678,686,992,20,1
161165,2288,955,1333,21,4
161165,1868,782,1086,22,1
161165,1868,782,1086,23,1
161165,452,184,268,24,1
161165,1416,598,818,25,1
161165,420,173,247,32,3
161165,108,47,61,39,1
161165,1308,551,757,40,1
161165,761,263,498,41,4
161165,482,176,306,42,1
161165,422,164,258,43,1
161165,3,2,1,44,1
161165,419,162,257,45,1
161165,60,12,48,51,1
161165,279,87,192,52,3
161165,49,27,22,59,1
161165,370,135,235,60,1
161192,2263,757,1506,1,4
161192,2263,757,1506,2,1
161192,1627,518,1109,3,1
161192,225,87,138,4,1
161192,1402,431,971,5,1
161192,636,239,397,11,1
161192,177,64,113,19,1
161192,1225,367,858,20,1
161192,664,283,381,21,4
161192,664,283,381,22,1
161192,656,277,379,23,1
161192,150,63,87,24,1
161192,506,214,292,25,1
161192,8,6,2,31,1
161192,80,34,46,39,1
161192,426,180,246,40,1
161192,1599,474,1125,41,4
161192,1599,474,1125,42,1
161192,971,241,730,43,1
161192,75,24,51,44,1
161192,896,217,679,45,1
161192,628,233,395,51,1
161192,97,30,67,59,1
161192,799,187,612,60,1
161208,83,78,5,1,4
161208,83,78,5,2,1
161208,83,78,5,3,1
161208,25,23,2,4,1
161208,58,55,3,5,1
161208,34,31,3,19,1
161208,24,24,0,20,1
161208,83,78,5,21,4
161208,83,78,5,22,1
161208,83,78,5,23,1
161208,25,23,2,24,1
161208,58,55,3,25,1
161208,34,31,3,39,1
161208,24,24,0,40,1
161217,4770,1365,3405,1,4
161217,4770,1365,3405,2,1
161217,4306,1222,3084,3,1
161217,454,149,305,4,1
161217,3852,1073,2779,5,1
161217,464,143,321,11,1
161217,519,160,359,19,1
161217,3333,913,2420,20,1
161217,1726,596,1130,21,4
161217,1726,596,1130,22,1
161217,1717,593,1124,23,1
161217,273,98,175,24,1
161217,1444,495,949,25,1
161217,9,3,6,31,1
161217,254,94,160,39,1
161217,1190,401,789,40,1
161217,3044,769,2275,41,4
161217,3044,769,2275,42,1
161217,2589,629,1960,43,1
161217,181,51,130,44,1
161217,2408,578,1830,45,1
161217,455,140,315,51,1
161217,265,66,199,59,1
161217,2143,512,1631,60,1
161226,2061,672,1389,1,4
161226,1901,639,1262,2,1
161226,1858,630,1228,3,1
161226,439,143,296,4,1
161226,1419,487,932,5,1
161226,43,9,34,11,1
161226,160,33,127,12,3
161226,110,40,70,19,1
161226,1309,447,862,20,1
161226,1783,608,1175,21,4
161226,1783,608,1175,22,1
161226,1773,605,1168,23,1
161226,438,142,296,24,1
161226,1335,463,872,25,1
161226,10,3,7,31,1
161226,99,38,61,39,1
161226,1236,425,811,40,1
161226,278,64,214,41,4
161226,118,31,87,42,1
161226,85,25,60,43,1
161226,1,1,0,44,1
161226,84,24,60,45,1
161226,33,6,27,51,1
161226,160,33,127,52,3
161226,11,2,9,59,1
161226,73,22,51,60,1
161235,1209,353,856,1,4
161235,1209,353,856,2,1
161235,913,269,644,3,1
161235,162,51,111,4,1
161235,751,218,533,5,1
161235,296,84,212,11,1
161235,206,54,152,19,1
161235,545,164,381,20,1
161235,594,202,392,21,4
161235,594,202,392,22,1
161235,593,202,391,23,1
161235,155,48,107,24,1
161235,438,154,284,25,1
161235,1,0,1,31,1
161235,114,40,74,39,1
161235,324,114,210,40,1
161235,615,151,464,41,4
161235,615,151,464,42,1
161235,320,67,253,43,1
161235,7,3,4,44,1
161235,313,64,249,45,1
161235,295,84,211,51,1
161235,92,14,78,59,1
161235,221,50,171,60,1
161244,892,268,624,1,4
161244,892,268,624,2,1
161244,596,202,394,3,1
161244,104,44,60,4,1
161244,492,158,334,5,1
161244,296,66,230,11,1
161244,54,25,29,19,1
161244,438,133,305,20,1
161244,439,165,274,21,4
161244,439,165,274,22,1
161244,435,165,270,23,1
161244,98,42,56,24,1
161244,337,123,214,25,1
161244,4,0,4,31,1
161244,31,16,15,39,1
161244,306,107,199,40,1
161244,453,103,350,41,4
161244,453,103,350,42,1
161244,161,37,124,43,1
161244,6,2,4,44,1
161244,155,35,120,45,1
161244,292,66,226,51,1
161244,23,9,14,59,1
161244,132,26,106,60,1
161253,11247,5475,5772,1,4
161253,9182,4769,4413,2,1
161253,8619,4544,4075,3,1
161253,2166,1159,1007,4,1
161253,6453,3385,3068,5,1
161253,563,225,338,11,1
161253,2065,706,1359,12,3
161253,454,241,213,19,1
161253,5999,3144,2855,20,1
161253,8739,4569,4170,21,4
161253,7922,4165,3757,22,1
161253,7874,4145,3729,23,1
161253,2148,1150,998,24,1
161253,5726,2995,2731,25,1
161253,48,20,28,31,1
161253,817,404,413,32,3
161253,402,220,182,39,1
161253,5324,2775,2549,40,1
161253,2508,906,1602,41,4
161253,1260,604,656,42,1
161253,745,399,346,43,1
161253,18,9,9,44,1
161253,727,390,337,45,1
161253,515,205,310,51,1
161253,1248,302,946,52,3
161253,52,21,31,59,1
161253,675,369,306,60,1
161299,1018,876,142,1,4
161299,994,863,131,2,1
161299,994,863,131,3,1
161299,234,204,30,4,1
161299,760,659,101,5,1
161299,24,13,11,12,3
161299,151,136,15,19,1
161299,609,523,86,20,1
161299,1001,861,140,21,4
161299,979,850,129,22,1
161299,979,850,129,23,1
161299,234,204,30,24,1
161299,745,646,99,25,1
161299,22,11,11,32,3
161299,151,136,15,39,1
161299,594,510,84,40,1
161299,17,15,2,41,4
161299,15,13,2,42,1
161299,15,13,2,43,1
161299,15,13,2,45,1
161299,2,2,0,52,3
161299,15,13,2,60,1
161341,1263,463,800,1,4
161341,1263,463,800,2,1
161341,924,365,559,3,1
161341,197,78,119,4,1
161341,727,287,440,5,1
161341,339,98,241,11,1
161341,92,29,63,19,1
161341,635,258,377,20,1
161341,718,298,420,21,4
161341,718,298,420,22,1
161341,709,297,412,23,1
161341,178,76,102,24,1
161341,531,221,310,25,1
161341,9,1,8,31,1
161341,66,22,44,39,1
161341,465,199,266,40,1
161341,545,165,380,41,4
161341,545,165,380,42,1
161341,215,68,147,43,1
161341,19,2,17,44,1
161341,196,66,130,45,1
161341,330,97,233,51,1
161341,26,7,19,59,1
161341,170,59,111,60,1
161457,6032,1686,4346,1,4
161457,2653,778,1875,2,1
161457,2179,642,1537,3,1
161457,633,175,458,4,1
161457,1546,467,1079,5,1
161457,474,136,338,11,1
161457,3379,908,2471,12,3
161457,72,26,46,19,1
161457,1474,441,1033,20,1
161457,4961,1441,3520,21,4
161457,2156,633,1523,22,1
161457,2154,632,1522,23,1
161457,633,175,458,24,1
161457,1521,457,1064,25,1
161457,2,1,1,31,1
161457,2805,808,1997,32,3
161457,70,25,45,39,1
161457,1451,432,1019,40,1
161457,1071,245,826,41,4
161457,497,145,352,42,1
161457,25,10,15,43,1
161457,25,10,15,45,1
161457,472,135,337,51,1
161457,574,100,474,52,3
161457,2,1,1,59,1
161457,23,9,14,60,1
161484,1086,492,594,1,4
161484,1086,492,594,2,1
161484,765,359,406,3,1
161484,159,87,72,4,1
161484,606,272,334,5,1
161484,321,133,188,11,1
161484,93,39,54,19,1
161484,513,233,280,20,1
161484,561,302,259,21,4
161484,561,302,259,22,1
161484,561,302,259,23,1
161484,120,71,49,24,1
161484,441,231,210,25,1
161484,82,38,44,39,1
161484,359,193,166,40,1
161484,525,190,335,41,4
161484,525,190,335,42,1
161484,204,57,147,43,1
161484,39,16,23,44,1
161484,165,41,124,45,1
161484,321,133,188,51,1
161484,11,1,10,59,1
161484,154,40,114,60,1
161493,314,16,298,1,4
161493,314,16,298,2,1
161493,314,16,298,3,1
161493,121,5,116,4,1
161493,193,11,182,5,1
161493,193,11,182,20,1
161493,266,14,252,21,4
161493,266,14,252,22,1
161493,266,14,252,23,1
161493,109,5,104,24,1
161493,157,9,148,25,1
161493,157,9,148,40,1
161493,48,2,46,41,4
161493,48,2,46,42,1
161493,48,2,46,43,1
161493,12,0,12,44,1
161493,36,2,34,45,1
161493,36,2,34,60,1
161509,409,121,288,1,4
161509,378,110,268,2,1
161509,375,110,265,3,1
161509,105,26,79,4,1
161509,270,84,186,5,1
161509,3,0,3,11,1
161509,31,11,20,12,3
161509,27,5,22,19,1
161509,243,79,164,20,1
161509,392,116,276,21,4
161509,361,105,256,22,1
161509,361,105,256,23,1
161509,103,25,78,24,1
161509,258,80,178,25,1
161509,31,11,20,32,3
161509,25,5,20,39,1
161509,233,75,158,40,1
161509,17,5,12,41,4
161509,17,5,12,42,1
161509,14,5,9,43,1
161509,2,1,1,44,1
161509,12,4,8,45,1
161509,3,0,3,51,1
161509,2,0,2,59,1
161509,10,4,6,60,1
161518,1614,489,1125,1,4
161518,1276,417,859,2,1
161518,1276,417,859,3,1
161518,388,157,231,4,1
161518,888,260,628,5,1
161518,338,72,266,12,3
161518,94,41,53,19,1
161518,794,219,575,20,1
161518,896,298,598,21,4
161518,895,298,597,22,1
161518,895,298,597,23,1
161518,258,89,169,24,1
161518,637,209,428,25,1
161518,1,0,1,32,3
161518,93,41,52,39,1
161518,544,168,376,40,1
161518,718,191,527,41,4
161518,381,119,262,42,1
161518,381,119,262,43,1
161518,130,68,62,44,1
161518,251,51,200,45,1
161518,337,72,265,52,3
161518,1,0,1,59,1
161518,250,51,199,60,1
161527,245,16,229,1,4
161527,245,16,229,2,1
161527,245,16,229,3,1
161527,45,0,45,4,1
161527,200,16,184,5,1
161527,200,16,184,20,1
161527,194,14,180,21,4
161527,194,14,180,22,1
161527,194,14,180,23,1
161527,42,0,42,24,1
161527,152,14,138,25,1
161527,152,14,138,40,1
161527,51,2,49,41,4
161527,51,2,49,42,1
161527,51,2,49,43,1
161527,3,0,3,44,1
161527,48,2,46,45,1
161527,48,2,46,60,1
161545,7157,3755,3402,1,4
161545,7157,3755,3402,2,1
161545,5958,2941,3017,3,1
161545,1383,767,616,4,1
161545,4575,2174,2401,5,1
161545,1199,814,385,11,1
161545,551,254,297,19,1
161545,4024,1920,2104,20,1
161545,3045,1669,1376,21,4
161545,3045,1669,1376,22,1
161545,3009,1639,1370,23,1
161545,1002,559,443,24,1
161545,2007,1080,927,25,1
161545,36,30,6,31,1
161545,296,153,143,39,1
161545,1711,927,784,40,1
161545,4112,2086,2026,41,4
161545,4112,2086,2026,42,1
161545,2949,1302,1647,43,1
161545,381,208,173,44,1
161545,2568,1094,1474,45,1
161545,1163,784,379,51,1
161545,255,101,154,59,1
161545,2313,993,1320,60,1
161554,8923,3629,5294,1,4
161554,7098,3045,4053,2,1
161554,6079,2597,3482,3,1
161554,780,341,439,4,1
161554,5299,2256,3043,5,1
161554,1019,448,571,11,1
161554,1825,584,1241,12,3
161554,817,347,470,19,1
161554,4482,1909,2573,20,1
161554,5020,2133,2887,21,4
161554,4281,1869,2412,22,1
161554,4238,1848,2390,23,1
161554,741,322,419,24,1
161554,3497,1526,1971,25,1
161554,43,21,22,31,1
161554,739,264,475,32,3
161554,557,243,314,39,1
161554,2940,1283,1657,40,1
161554,3903,1496,2407,41,4
161554,2817,1176,1641,42,1
161554,1841,749,1092,43,1
161554,39,19,20,44,1
161554,1802,730,1072,45,1
161554,976,427,549,51,1
161554,1086,320,766,52,3
161554,260,104,156,59,1
161554,1542,626,916,60,1
161563,1522,707,815,1,4
161563,1339,640,699,2,1
161563,846,433,413,3,1
161563,260,135,125,4,1
161563,586,298,288,5,1
161563,493,207,286,11,1
161563,183,67,116,12,3
161563,37,20,17,19,1
161563,549,278,271,20,1
161563,835,441,394,21,4
161563,780,415,365,22,1
161563,780,415,365,23,1
161563,256,133,123,24,1
161563,524,282,242,25,1
161563,55,26,29,32,3
161563,35,20,15,39,1
161563,489,262,227,40,1
161563,687,266,421,41,4
161563,559,225,334,42,1
161563,66,18,48,43,1
161563,4,2,2,44,1
161563,62,16,46,45,1
161563,493,207,286,51,1
161563,128,41,87,52,3
161563,2,0,2,59,1
161563,60,16,44,60,1
161572,553,272,281,1,4
161572,553,272,281,2,1
161572,553,272,281,3,1
161572,146,83,63,4,1
161572,407,189,218,5,1
161572,33,21,12,19,1
161572,374,168,206,20,1
161572,547,268,279,21,4
161572,547,268,279,22,1
161572,547,268,279,23,1
161572,146,83,63,24,1
161572,401,185,216,25,1
161572,32,20,12,39,1
161572,369,165,204,40,1
161572,6,4,2,41,4
161572,6,4,2,42,1
161572,6,4,2,43,1
161572,6,4,2,45,1
161572,1,1,0,59,1
161572,5,3,2,60,1
161581,463,218,245,1,4
161581,463,218,245,2,1
161581,330,161,169,3,1
161581,151,93,58,4,1
161581,179,68,111,5,1
161581,133,57,76,11,1
161581,12,5,7,19,1
161581,167,63,104,20,1
161581,291,152,139,21,4
161581,291,152,139,22,1
161581,261,142,119,23,1
161581,146,91,55,24,1
161581,115,51,64,25,1
161581,30,10,20,31,1
161581,5,3,2,39,1
161581,110,48,62,40,1
161581,172,66,106,41,4
161581,172,66,106,42,1
161581,69,19,50,43,1
161581,5,2,3,44,1
161581,64,17,47,45,1
161581,103,47,56,51,1
161581,7,2,5,59,1
161581,57,15,42,60,1
161615,39,3,36,1,4
161615,39,3,36,2,1
161615,39,3,36,3,1
161615,9,1,8,4,1
161615,30,2,28,5,1
161615,30,2,28,20,1
161615,37,3,34,21,4
161615,37,3,34,22,1
161615,37,3,34,23,1
161615,8,1,7,24,1
161615,29,2,27,25,1
161615,29,2,27,40,1
161615,2,0,2,41,4
161615,2,0,2,42,1
161615,2,0,2,43,1
161615,1,0,1,44,1
161615,1,0,1,45,1
161615,1,0,1,60,1
161651,40,0,40,1,4
161651,40,0,40,2,1
161651,40,0,40,3,1
161651,15,0,15,4,1
161651,25,0,25,5,1
161651,25,0,25,20,1
161651,18,0,18,21,4
161651,18,0,18,22,1
161651,18,0,18,23,1
161651,2,0,2,24,1
161651,16,0,16,25,1
161651,16,0,16,40,1
161651,22,0,22,41,4
161651,22,0,22,42,1
161651,22,0,22,43,1
161651,13,0,13,44,1
161651,9,0,9,45,1
161651,9,0,9,60,1
161688,3191,1062,2129,1,4
161688,3191,1062,2129,2,1
161688,2677,860,1817,3,1
161688,625,256,369,4,1
161688,2052,604,1448,5,1
161688,514,202,312,11,1
161688,218,64,154,19,1
161688,1834,540,1294,20,1
161688,1719,592,1127,21,4
161688,1719,592,1127,22,1
161688,1706,585,1121,23,1
161688,509,208,301,24,1
161688,1197,377,820,25,1
161688,13,7,6,31,1
161688,128,43,85,39,1
161688,1069,334,735,40,1
161688,1472,470,1002,41,4
161688,1472,470,1002,42,1
161688,971,275,696,43,1
161688,116,48,68,44,1
161688,855,227,628,45,1
161688,501,195,306,51,1
161688,90,21,69,59,1
161688,765,206,559,60,1
161767,16463,6679,9784,1,4
161767,16463,6679,9784,2,1
161767,14125,5747,8378,3,1
161767,2696,1288,1408,4,1
161767,11429,4459,6970,5,1
161767,2338,932,1406,11,1
161767,840,335,505,19,1
161767,10589,4124,6465,20,1
161767,4940,2395,2545,21,4
161767,4940,2395,2545,22,1
161767,4920,2382,2538,23,1
161767,1640,793,847,24,1
161767,3280,1589,1691,25,1
161767,20,13,7,31,1
161767,307,157,150,39,1
161767,2973,1432,1541,40,1
161767,11523,4284,7239,41,4
161767,11523,4284,7239,42,1
161767,9205,3365,5840,43,1
161767,1056,495,561,44,1
161767,8149,2870,5279,45,1
161767,2318,919,1399,51,1
161767,533,178,355,59,1
161767,7616,2692,4924,60,1
161776,360,100,260,1,4
161776,360,100,260,2,1
161776,360,100,260,3,1
161776,89,18,71,4,1
161776,271,82,189,5,1
161776,18,2,16,19,1
161776,253,80,173,20,1
161776,360,100,260,21,4
161776,360,100,260,22,1
161776,360,100,260,23,1
161776,89,18,71,24,1
161776,271,82,189,25,1
161776,18,2,16,39,1
161776,253,80,173,40,1
161800,170,5,165,1,4
161800,170,5,165,2,1
161800,170,5,165,3,1
161800,54,2,52,4,1
161800,116,3,113,5,1
161800,116,3,113,20,1
161800,133,3,130,21,4
161800,133,3,130,22,1
161800,133,3,130,23,1
161800,46,0,46,24,1
161800,87,3,84,25,1
161800,87,3,84,40,1
161800,37,2,35,41,4
161800,37,2,35,42,1
161800,37,2,35,43,1
161800,8,2,6,44,1
161800,29,0,29,45,1
161800,29,0,29,60,1
161855,72,3,69,1,4
161855,72,3,69,2,1
161855,72,3,69,3,1
161855,21,2,19,4,1
161855,51,1,50,5,1
161855,51,1,50,20,1
161855,53,3,50,21,4
161855,53,3,50,22,1
161855,53,3,50,23,1
161855,18,2,16,24,1
161855,35,1,34,25,1
161855,35,1,34,40,1
161855,19,0,19,41,4
161855,19,0,19,42,1
161855,19,0,19,43,1
161855,3,0,3,44,1
161855,16,0,16,45,1
161855,16,0,16,60,1
161864,5394,1722,3672,1,4
161864,5394,1722,3672,2,1
161864,4986,1597,3389,3,1
161864,1074,414,660,4,1
161864,3912,1183,2729,5,1
161864,408,125,283,11,1
161864,565,180,385,19,1
161864,3347,1003,2344,20,1
161864,1772,666,1106,21,4
161864,1772,666,1106,22,1
161864,1754,656,1098,23,1
161864,470,185,285,24,1
161864,1284,471,813,25,1
161864,18,10,8,31,1
161864,200,77,123,39,1
161864,1084,394,690,40,1
161864,3622,1056,2566,41,4
161864,3622,1056,2566,42,1
161864,3232,941,2291,43,1
161864,604,229,375,44,1
161864,2628,712,1916,45,1
161864,390,115,275,51,1
161864,365,103,262,59,1
161864,2263,609,1654,60,1
161873,6518,2744,3774,1,4
161873,3526,1505,2021,2,1
161873,3479,1482,1997,3,1
161873,241,95,146,4,1
161873,3238,1387,1851,5,1
161873,47,23,24,11,1
161873,2992,1239,1753,12,3
161873,592,254,338,19,1
161873,2646,1133,1513,20,1
161873,3457,1561,1896,21,4
161873,2061,909,1152,22,1
161873,2061,909,1152,23,1
161873,236,93,143,24,1
161873,1825,816,1009,25,1
161873,1396,652,744,32,3
161873,388,172,216,39,1
161873,1437,644,793,40,1
161873,3061,1183,1878,41,4
161873,1465,596,869,42,1
161873,1418,573,845,43,1
161873,5,2,3,44,1
161873,1413,571,842,45,1
161873,47,23,24,51,1
161873,1596,587,1009,52,3
161873,204,82,122,59,1
161873,1209,489,720,60,1
162007,5561,2026,3535,1,4
162007,4358,1657,2701,2,1
162007,4313,1642,2671,3,1
162007,629,253,376,4,1
162007,3684,1389,2295,5,1
162007,45,15,30,11,1
162007,1203,369,834,12,3
162007,564,217,347,19,1
162007,3120,1172,1948,20,1
162007,3974,1514,2460,21,4
162007,3521,1356,2165,22,1
162007,3511,1353,2158,23,1
162007,625,251,374,24,1
162007,2886,1102,1784,25,1
162007,10,3,7,31,1
162007,453,158,295,32,3
162007,415,171,244,39,1
162007,2471,931,1540,40,1
162007,1587,512,1075,41,4
162007,837,301,536,42,1
162007,802,289,513,43,1
162007,4,2,2,44,1
162007,798,287,511,45,1
162007,35,12,23,51,1
162007,750,211,539,52,3
162007,149,46,103,59,1
162007,649,241,408,60,1
162061,843,672,171,1,4
162061,442,351,91,2,1
162061,430,345,85,3,1
162061,50,41,9,4,1
162061,380,304,76,5,1
162061,12,6,6,11,1
162061,401,321,80,12,3
162061,46,41,5,19,1
162061,334,263,71,20,1
162061,485,391,94,21,4
162061,330,264,66,22,1
162061,330,264,66,23,1
162061,50,41,9,24,1
162061,280,223,57,25,1
162061,155,127,28,32,3
162061,33,30,3,39,1
162061,247,193,54,40,1
162061,358,281,77,41,4
162061,112,87,25,42,1
162061,100,81,19,43,1
162061,100,81,19,45,1
162061,12,6,6,51,1
162061,246,194,52,52,3
162061,13,11,2,59,1
162061,87,70,17,60,1
162104,2604,979,1625,1,4
162104,2604,979,1625,2,1
162104,2426,907,1519,3,1
162104,485,227,258,4,1
162104,1941,680,1261,5,1
162104,178,72,106,11,1
162104,107,39,68,19,1
162104,1834,641,1193,20,1
162104,1038,462,576,21,4
162104,1038,462,576,22,1
162104,1026,456,570,23,1
162104,250,128,122,24,1
162104,776,328,448,25,1
162104,12,6,6,31,1
162104,57,24,33,39,1
162104,719,304,415,40,1
162104,1566,517,1049,41,4
162104,1566,517,1049,42,1
162104,1400,451,949,43,1
162104,235,99,136,44,1
162104,1165,352,813,45,1
162104,166,66,100,51,1
162104,50,15,35,59,1
162104,1115,337,778,60,1
162122,8781,3382,5399,1,4
162122,8781,3382,5399,2,1
162122,8358,3214,5144,3,1
162122,2105,965,1140,4,1
162122,6253,2249,4004,5,1
162122,423,168,255,11,1
162122,567,239,328,19,1
162122,5686,2010,3676,20,1
162122,3317,1470,1847,21,4
162122,3317,1470,1847,22,1
162122,3252,1439,1813,23,1
162122,1268,608,660,24,1
162122,1984,831,1153,25,1
162122,65,31,34,31,1
162122,242,130,112,39,1
162122,1742,701,1041,40,1
162122,5464,1912,3552,41,4
162122,5464,1912,3552,42,1
162122,5106,1775,3331,43,1
162122,837,357,480,44,1
162122,4269,1418,2851,45,1
162122,358,137,221,51,1
162122,325,109,216,59,1
162122,3944,1309,2635,60,1
162168,2563,935,1628,1,4
162168,2563,935,1628,2,1
162168,2184,796,1388,3,1
162168,622,282,340,4,1
162168,1562,514,1048,5,1
162168,379,139,240,11,1
162168,85,30,55,19,1
162168,1477,484,993,20,1
162168,854,381,473,21,4
162168,854,381,473,22,1
162168,842,376,466,23,1
162168,370,177,193,24,1
162168,472,199,273,25,1
162168,12,5,7,31,1
162168,42,17,25,39,1
162168,430,182,248,40,1
162168,1709,554,1155,41,4
162168,1709,554,1155,42,1
162168,1342,420,922,43,1
162168,252,105,147,44,1
162168,1090,315,775,45,1
162168,367,134,233,51,1
162168,43,13,30,59,1
162168,1047,302,745,60,1
162210,1185,399,786,1,4
162210,1011,355,656,2,1
162210,951,331,620,3,1
162210,126,49,77,4,1
162210,825,282,543,5,1
162210,60,24,36,11,1
162210,174,44,130,12,3
162210,101,28,73,19,1
162210,724,254,470,20,1
162210,874,302,572,21,4
162210,806,289,517,22,1
162210,805,288,517,23,1
162210,126,49,77,24,1
162210,679,239,440,25,1
162210,1,1,0,31,1
162210,68,13,55,32,3
162210,71,20,51,39,1
162210,608,219,389,40,1
162210,311,97,214,41,4
162210,205,66,139,42,1
162210,146,43,103,43,1
162210,146,43,103,45,1
162210,59,23,36,51,1
162210,106,31,75,52,3
162210,30,8,22,59,1
162210,116,35,81,60,1
162283,3383,865,2518,1,4
162283,2920,755,2165,2,1
162283,2880,748,2132,3,1
162283,368,110,258,4,1
162283,2512,638,1874,5,1
162283,40,7,33,11,1
162283,463,110,353,12,3
162283,318,91,227,19,1
162283,2194,547,1647,20,1
162283,2384,668,1716,21,4
162283,2251,629,1622,22,1
162283,2244,627,1617,23,1
162283,353,107,246,24,1
162283,1891,520,1371,25,1
162283,7,2,5,31,1
162283,133,39,94,32,3
162283,231,75,156,39,1
162283,1660,445,1215,40,1
162283,999,197,802,41,4
162283,669,126,543,42,1
162283,636,121,515,43,1
162283,15,3,12,44,1
162283,621,118,503,45,1
162283,33,5,28,51,1
162283,330,71,259,52,3
162283,87,16,71,59,1
162283,534,102,432,60,1
162335,67,5,62,1,4
162335,67,5,62,2,1
162335,67,5,62,3,1
162335,8,1,7,4,1
162335,59,4,55,5,1
162335,59,4,55,20,1
162335,67,5,62,21,4
162335,67,5,62,22,1
162335,67,5,62,23,1
162335,8,1,7,24,1
162335,59,4,55,25,1
162335,59,4,55,40,1
162371,545,534,11,1,4
162371,545,534,11,2,1
162371,545,534,11,3,1
162371,235,231,4,4,1
162371,310,303,7,5,1
162371,310,303,7,20,1
162371,545,534,11,21,4
162371,545,534,11,22,1
162371,545,534,11,23,1
162371,235,231,4,24,1
162371,310,303,7,25,1
162371,310,303,7,40,1
162557,6050,2614,3436,1,4
162557,6050,2614,3436,2,1
162557,5375,2335,3040,3,1
162557,1302,629,673,4,1
162557,4073,1706,2367,5,1
162557,675,279,396,11,1
162557,249,107,142,19,1
162557,3824,1599,2225,20,1
162557,2267,1125,1142,21,4
162557,2267,1125,1142,22,1
162557,2236,1104,1132,23,1
162557,834,433,401,24,1
162557,1402,671,731,25,1
162557,31,21,10,31,1
162557,108,52,56,39,1
162557,1294,619,675,40,1
162557,3783,1489,2294,41,4
162557,3783,1489,2294,42,1
162557,3139,1231,1908,43,1
162557,468,196,272,44,1
162557,2671,1035,1636,45,1
162557,644,258,386,51,1
162557,141,55,86,59,1
162557,2530,980,1550,60,1
162584,5473,2704,2769,1,4
162584,4703,2400,2303,2,1
162584,4575,2335,2240,3,1
162584,895,501,394,4,1
162584,3680,1834,1846,5,1
162584,128,65,63,11,1
162584,770,304,466,12,3
162584,441,188,253,19,1
162584,3239,1646,1593,20,1
162584,4408,2310,2098,21,4
162584,4192,2220,1972,22,1
162584,4116,2187,1929,23,1
162584,889,497,392,24,1
162584,3227,1690,1537,25,1
162584,76,33,43,31,1
162584,216,90,126,32,3
162584,332,163,169,39,1
162584,2895,1527,1368,40,1
162584,1065,394,671,41,4
162584,511,180,331,42,1
162584,459,148,311,43,1
162584,6,4,2,44,1
162584,453,144,309,45,1
162584,52,32,20,51,1
162584,554,214,340,52,3
162584,109,25,84,59,1
162584,344,119,225,60,1
162609,769,402,367,1,4
162609,769,402,367,2,1
162609,586,342,244,3,1
162609,219,135,84,4,1
162609,367,207,160,5,1
162609,183,60,123,11,1
162609,42,26,16,19,1
162609,325,181,144,20,1
162609,597,330,267,21,4
162609,597,330,267,22,1
162609,504,306,198,23,1
162609,216,134,82,24,1
162609,288,172,116,25,1
162609,93,24,69,31,1
162609,33,23,10,39,1
162609,255,149,106,40,1
162609,172,72,100,41,4
162609,172,72,100,42,1
162609,82,36,46,43,1
162609,3,1,2,44,1
162609,79,35,44,45,1
162609,90,36,54,51,1
162609,9,3,6,59,1
162609,70,32,38,60,1
162654,2111,644,1467,1,4
162654,1449,488,961,2,1
162654,1444,485,959,3,1
162654,401,129,272,4,1
162654,1043,356,687,5,1
162654,5,3,2,11,1
162654,662,156,506,12,3
162654,36,10,26,19,1
162654,1007,346,661,20,1
162654,1585,512,1073,21,4
162654,1424,473,951,22,1
162654,1423,472,951,23,1
162654,401,129,272,24,1
162654,1022,343,679,25,1
162654,1,1,0,31,1
162654,161,39,122,32,3
162654,35,9,26,39,1
162654,987,334,653,40,1
162654,526,132,394,41,4
162654,25,15,10,42,1
162654,21,13,8,43,1
162654,21,13,8,45,1
162654,4,2,2,51,1
162654,501,117,384,52,3
162654,1,1,0,59,1
162654,20,12,8,60,1
162681,893,194,699,1,4
162681,845,180,665,2,1
162681,845,180,665,3,1
162681,129,24,105,4,1
162681,716,156,560,5,1
162681,48,14,34,12,3
162681,207,47,160,19,1
162681,509,109,400,20,1
162681,266,65,201,21,4
162681,230,53,177,22,1
162681,230,53,177,23,1
162681,1,1,0,24,1
162681,229,52,177,25,1
162681,36,12,24,32,3
162681,20,3,17,39,1
162681,209,49,160,40,1
162681,627,129,498,41,4
162681,615,127,488,42,1
162681,615,127,488,43,1
162681,128,23,105,44,1
162681,487,104,383,45,1
162681,12,2,10,52,3
162681,187,44,143,59,1
162681,300,60,240,60,1
162690,4905,1845,3060,1,4
162690,4905,1845,3060,2,1
162690,3997,1509,2488,3,1
162690,950,436,514,4,1
162690,3047,1073,1974,5,1
162690,908,336,572,11,1
162690,339,117,222,19,1
162690,2708,956,1752,20,1
162690,1236,609,627,21,4
162690,1236,609,627,22,1
162690,1192,586,606,23,1
162690,410,218,192,24,1
162690,782,368,414,25,1
162690,44,23,21,31,1
162690,123,60,63,39,1
162690,659,308,351,40,1
162690,3669,1236,2433,41,4
162690,3669,1236,2433,42,1
162690,2805,923,1882,43,1
162690,540,218,322,44,1
162690,2265,705,1560,45,1
162690,864,313,551,51,1
162690,216,57,159,59,1
162690,2049,648,1401,60,1
162706,6992,2912,4080,1,4
162706,6992,2912,4080,2,1
162706,6016,2499,3517,3,1
162706,1547,766,781,4,1
162706,4469,1733,2736,5,1
162706,976,413,563,11,1
162706,328,130,198,19,1
162706,4141,1603,2538,20,1
162706,2601,1293,1308,21,4
162706,2601,1293,1308,22,1
162706,2441,1213,1228,23,1
162706,1030,522,508,24,1
162706,1411,691,720,25,1
162706,160,80,80,31,1
162706,110,55,55,39,1
162706,1301,636,665,40,1
162706,4391,1619,2772,41,4
162706,4391,1619,2772,42,1
162706,3575,1286,2289,43,1
162706,517,244,273,44,1
162706,3058,1042,2016,45,1
162706,816,333,483,51,1
162706,218,75,143,59,1
162706,2840,967,1873,60,1
162760,2392,826,1566,1,4
162760,1388,478,910,2,1
162760,1347,463,884,3,1
162760,281,111,170,4,1
162760,1066,352,714,5,1
162760,41,15,26,11,1
162760,1004,348,656,12,3
162760,119,36,83,19,1
162760,947,316,631,20,1
162760,1406,513,893,21,4
162760,1266,442,824,22,1
162760,1255,438,817,23,1
162760,281,111,170,24,1
162760,974,327,647,25,1
162760,11,4,7,31,1
162760,140,71,69,32,3
162760,96,33,63,39,1
162760,878,294,584,40,1
162760,986,313,673,41,4
162760,122,36,86,42,1
162760,92,25,67,43,1
162760,92,25,67,45,1
162760,30,11,19,51,1
162760,864,277,587,52,3
162760,23,3,20,59,1
162760,69,22,47,60,1
162779,9969,4398,5571,1,4
162779,9969,4398,5571,2,1
162779,9287,4123,5164,3,1
162779,1816,944,872,4,1
162779,7471,3179,4292,5,1
162779,682,275,407,11,1
162779,771,292,479,19,1
162779,6700,2887,3813,20,1
162779,3691,1881,1810,21,4
162779,3691,1881,1810,22,1
162779,3557,1824,1733,23,1
162779,1151,623,528,24,1
162779,2406,1201,1205,25,1
162779,134,57,77,31,1
162779,217,104,113,39,1
162779,2189,1097,1092,40,1
162779,6278,2517,3761,41,4
162779,6278,2517,3761,42,1
162779,5730,2299,3431,43,1
162779,665,321,344,44,1
162779,5065,1978,3087,45,1
162779,548,218,330,51,1
162779,554,188,366,59,1
162779,4511,1790,2721,60,1
162830,55,2,53,1,4
162830,55,2,53,2,1
162830,55,2,53,3,1
162830,20,1,19,4,1
162830,35,1,34,5,1
162830,35,1,34,20,1
162830,55,2,53,21,4
162830,55,2,53,22,1
162830,55,2,53,23,1
162830,20,1,19,24,1
162830,35,1,34,25,1
162830,35,1,34,40,1
162928,20918,10230,10688,1,4
162928,6117,2981,3136,2,1
162928,5932,2939,2993,3,1
162928,1390,700,690,4,1
162928,4542,2239,2303,5,1
162928,185,42,143,11,1
162928,14801,7249,7552,12,3
162928,277,84,193,19,1
162928,4265,2155,2110,20,1
162928,13256,6516,6740,21,4
162928,5865,2919,2946,22,1
162928,5838,2901,2937,23,1
162928,1390,700,690,24,1
162928,4448,2201,2247,25,1
162928,27,18,9,31,1
162928,7391,3597,3794,32,3
162928,277,84,193,39,1
162928,4171,2117,2054,40,1
162928,7662,3714,3948,41,4
162928,252,62,190,42,1
162928,94,38,56,43,1
162928,94,38,56,45,1
162928,158,24,134,51,1
162928,7410,3652,3758,52,3
162928,94,38,56,60,1
162982,46,18,28,1,4
162982,46,18,28,2,1
162982,46,18,28,3,1
162982,11,4,7,4,1
162982,35,14,21,5,1
162982,35,14,21,20,1
162982,46,18,28,21,4
162982,46,18,28,22,1
162982,46,18,28,23,1
162982,11,4,7,24,1
162982,35,14,21,25,1
162982,35,14,21,40,1
163028,693,632,61,1,4
163028,693,632,61,2,1
163028,693,632,61,3,1
163028,199,178,21,4,1
163028,494,454,40,5,1
163028,494,454,40,20,1
163028,533,487,46,21,4
163028,533,487,46,22,1
163028,533,487,46,23,1
163028,162,145,17,24,1
163028,371,342,29,25,1
163028,371,342,29,40,1
163028,160,145,15,41,4
163028,160,145,15,42,1
163028,160,145,15,43,1
163028,37,33,4,44,1
163028,123,112,11,45,1
163028,123,112,11,60,1
163046,5977,2283,3694,1,4
163046,4004,1628,2376,2,1
163046,3972,1616,2356,3,1
163046,1096,477,619,4,1
163046,2876,1139,1737,5,1
163046,32,12,20,11,1
163046,1973,655,1318,12,3
163046,50,24,26,19,1
163046,2826,1115,1711,20,1
163046,4585,1752,2833,21,4
163046,3951,1602,2349,22,1
163046,3939,1599,2340,23,1
163046,1096,477,619,24,1
163046,2843,1122,1721,25,1
163046,12,3,9,31,1
163046,634,150,484,32,3
163046,50,24,26,39,1
163046,2793,1098,1695,40,1
163046,1392,531,861,41,4
163046,53,26,27,42,1
163046,33,17,16,43,1
163046,33,17,16,45,1
163046,20,9,11,51,1
163046,1339,505,834,52,3
163046,33,17,16,60,1
163107,30,1,29,1,4
163107,30,1,29,2,1
163107,30,1,29,3,1
163107,8,1,7,4,1
163107,22,0,22,5,1
163107,22,0,22,20,1
163107,11,0,11,21,4
163107,11,0,11,22,1
163107,11,0,11,23,1
163107,6,0,6,24,1
163107,5,0,5,25,1
163107,5,0,5,40,1
163107,19,1,18,41,4
163107,19,1,18,42,1
163107,19,1,18,43,1
163107,2,1,1,44,1
163107,17,0,17,45,1
163107,17,0,17,60,1
163204,39557,19544,20013,1,4
163204,26740,13618,13122,2,1
163204,26006,13224,12782,3,1
163204,603,288,315,4,1
163204,25403,12936,12467,5,1
163204,734,394,340,11,1
163204,12817,5926,6891,12,3
163204,3738,1892,1846,19,1
163204,21665,11044,10621,20,1
163204,6131,2965,3166,21,4
163204,5917,2874,3043,22,1
163204,5895,2858,3037,23,1
163204,88,43,45,24,1
163204,5807,2815,2992,25,1
163204,22,16,6,31,1
163204,214,91,123,32,3
163204,794,388,406,39,1
163204,5013,2427,2586,40,1
163204,33426,16579,16847,41,4
163204,20823,10744,10079,42,1
163204,20111,10366,9745,43,1
163204,515,245,270,44,1
163204,19596,10121,9475,45,1
163204,712,378,334,51,1
163204,12603,5835,6768,52,3
163204,2944,1504,1440,59,1
163204,16652,8617,8035,60,1
163259,6284,1816,4468,1,4
163259,746,112,634,2,1
163259,738,110,628,3,1
163259,738,110,628,5,1
163259,8,2,6,11,1
163259,5538,1704,3834,12,3
163259,220,32,188,19,1
163259,518,78,440,20,1
163259,5028,1616,3412,21,4
163259,549,73,476,22,1
163259,549,73,476,23,1
163259,549,73,476,25,1
163259,4479,1543,2936,32,3
163259,169,25,144,39,1
163259,380,48,332,40,1
163259,1256,200,1056,41,4
163259,197,39,158,42,1
163259,189,37,152,43,1
163259,189,37,152,45,1
163259,8,2,6,51,1
163259,1059,161,898,52,3
163259,51,7,44,59,1
163259,138,30,108,60,1
163268,13908,7490,6418,1,4
163268,11136,6083,5053,2,1
163268,11012,6024,4988,3,1
163268,1657,953,704,4,1
163268,9355,5071,4284,5,1
163268,124,59,65,11,1
163268,2772,1407,1365,12,3
163268,1262,604,658,19,1
163268,8093,4467,3626,20,1
163268,10699,5836,4863,21,4
163268,9508,5222,4286,22,1
163268,9491,5214,4277,23,1
163268,1653,949,704,24,1
163268,7838,4265,3573,25,1
163268,17,8,9,31,1
163268,1191,614,577,32,3
163268,1047,502,545,39,1
163268,6791,3763,3028,40,1
163268,3209,1654,1555,41,4
163268,1628,861,767,42,1
163268,1521,810,711,43,1
163268,4,4,0,44,1
163268,1517,806,711,45,1
163268,107,51,56,51,1
163268,1581,793,788,52,3
163268,215,102,113,59,1
163268,1302,704,598,60,1
163286,37272,19712,17560,1,4
163286,26658,14223,12435,2,1
163286,26045,13897,12148,3,1
163286,4020,2125,1895,4,1
163286,22025,11772,10253,5,1
163286,613,326,287,11,1
163286,10614,5489,5125,12,3
163286,2022,1107,915,19,1
163286,20003,10665,9338,20,1
163286,32199,16983,15216,21,4
163286,24522,12965,11557,22,1
163286,24400,12891,11509,23,1
163286,4011,2119,1892,24,1
163286,20389,10772,9617,25,1
163286,122,74,48,31,1
163286,7677,4018,3659,32,3
163286,1823,994,829,39,1
163286,18566,9778,8788,40,1
163286,5073,2729,2344,41,4
163286,2136,1258,878,42,1
163286,1645,1006,639,43,1
163286,9,6,3,44,1
163286,1636,1000,636,45,1
163286,491,252,239,51,1
163286,2937,1471,1466,52,3
163286,199,113,86,59,1
163286,1437,887,550,60,1
163295,2273,664,1609,1,4
163295,1896,535,1361,2,1
163295,1892,533,1359,3,1
163295,400,98,302,4,1
163295,1492,435,1057,5,1
163295,4,2,2,11,1
163295,377,129,248,12,3
163295,102,41,61,19,1
163295,1390,394,996,20,1
163295,2020,597,1423,21,4
163295,1759,504,1255,22,1
163295,1759,504,1255,23,1
163295,400,98,302,24,1
163295,1359,406,953,25,1
163295,261,93,168,32,3
163295,99,39,60,39,1
163295,1260,367,893,40,1
163295,253,67,186,41,4
163295,137,31,106,42,1
163295,133,29,104,43,1
163295,133,29,104,45,1
163295,4,2,2,51,1
163295,116,36,80,52,3
163295,3,2,1,59,1
163295,130,27,103,60,1
163338,4220,1831,2389,1,4
163338,3530,1572,1958,2,1
163338,3421,1522,1899,3,1
163338,610,257,353,4,1
163338,2811,1265,1546,5,1
163338,109,50,59,11,1
163338,690,259,431,12,3
163338,205,105,100,19,1
163338,2606,1160,1446,20,1
163338,3601,1566,2035,21,4
163338,3171,1390,1781,22,1
163338,3171,1390,1781,23,1
163338,604,254,350,24,1
163338,2567,1136,1431,25,1
163338,430,176,254,32,3
163338,162,82,80,39,1
163338,2405,1054,1351,40,1
163338,619,265,354,41,4
163338,359,182,177,42,1
163338,250,132,118,43,1
163338,6,3,3,44,1
163338,244,129,115,45,1
163338,109,50,59,51,1
163338,260,83,177,52,3
163338,43,23,20,59,1
163338,201,106,95,60,1
163347,748,66,682,1,4
163347,748,66,682,2,1
163347,748,66,682,3,1
163347,111,9,102,4,1
163347,637,57,580,5,1
163347,637,57,580,20,1
163347,748,66,682,21,4
163347,748,66,682,22,1
163347,748,66,682,23,1
163347,111,9,102,24,1
163347,637,57,580,25,1
163347,637,57,580,40,1
163408,134,3,131,1,4
163408,134,3,131,2,1
163408,134,3,131,3,1
163408,22,0,22,4,1
163408,112,3,109,5,1
163408,112,3,109,20,1
163408,83,1,82,21,4
163408,83,1,82,22,1
163408,83,1,82,23,1
163408,9,0,9,24,1
163408,74,1,73,25,1
163408,74,1,73,40,1
163408,51,2,49,41,4
163408,51,2,49,42,1
163408,51,2,49,43,1
163408,13,0,13,44,1
163408,38,2,36,45,1
163408,38,2,36,60,1
163426,26155,12288,13867,1,4
163426,26155,12288,13867,2,1
163426,19064,9659,9405,3,1
163426,3297,1821,1476,4,1
163426,15767,7838,7929,5,1
163426,7091,2629,4462,11,1
163426,1380,692,688,19,1
163426,14387,7146,7241,20,1
163426,9240,4690,4550,21,4
163426,9240,4690,4550,22,1
163426,7782,4158,3624,23,1
163426,1903,1073,830,24,1
163426,5879,3085,2794,25,1
163426,1458,532,926,31,1
163426,721,373,348,39,1
163426,5158,2712,2446,40,1
163426,16915,7598,9317,41,4
163426,16915,7598,9317,42,1
163426,11282,5501,5781,43,1
163426,1394,748,646,44,1
163426,9888,4753,5135,45,1
163426,5633,2097,3536,51,1
163426,659,319,340,59,1
163426,9229,4434,4795,60,1
163453,7546,3318,4228,1,4
163453,6252,2785,3467,2,1
163453,6197,2750,3447,3,1
163453,899,395,504,4,1
163453,5298,2355,2943,5,1
163453,55,35,20,11,1
163453,1294,533,761,12,3
163453,441,189,252,19,1
163453,4857,2166,2691,20,1
163453,6101,2719,3382,21,4
163453,5504,2459,3045,22,1
163453,5485,2446,3039,23,1
163453,886,390,496,24,1
163453,4599,2056,2543,25,1
163453,19,13,6,31,1
163453,597,260,337,32,3
163453,372,162,210,39,1
163453,4227,1894,2333,40,1
163453,1445,599,846,41,4
163453,748,326,422,42,1
163453,712,304,408,43,1
163453,13,5,8,44,1
163453,699,299,400,45,1
163453,36,22,14,51,1
163453,697,273,424,52,3
163453,69,27,42,59,1
163453,630,272,358,60,1
163462,2240,1076,1164,1,4
163462,1741,777,964,2,1
163462,1729,772,957,3,1
163462,429,194,235,4,1
163462,1300,578,722,5,1
163462,12,5,7,11,1
163462,499,299,200,12,3
163462,77,38,39,19,1
163462,1223,540,683,20,1
163462,1907,936,971,21,4
163462,1650,737,913,22,1
163462,1650,737,913,23,1
163462,429,194,235,24,1
163462,1221,543,678,25,1
163462,257,199,58,32,3
163462,48,26,22,39,1
163462,1173,517,656,40,1
163462,333,140,193,41,4
163462,91,40,51,42,1
163462,79,35,44,43,1
163462,79,35,44,45,1
163462,12,5,7,51,1
163462,242,100,142,52,3
163462,29,12,17,59,1
163462,50,23,27,60,1
163532,523,523,0,1,4
163532,340,340,0,2,1
163532,340,340,0,3,1
163532,41,41,0,4,1
163532,299,299,0,5,1
163532,183,183,0,12,3
163532,63,63,0,19,1
163532,236,236,0,20,1
163532,505,505,0,21,4
163532,340,340,0,22,1
163532,340,340,0,23,1
163532,41,41,0,24,1
163532,299,299,0,25,1
163532,165,165,0,32,3
163532,63,63,0,39,1
163532,236,236,0,40,1
163532,18,18,0,41,4
163532,18,18,0,52,3
163541,374,3,371,1,4
163541,374,3,371,2,1
163541,374,3,371,3,1
163541,95,1,94,4,1
163541,279,2,277,5,1
163541,279,2,277,20,1
163541,249,3,246,21,4
163541,249,3,246,22,1
163541,249,3,246,23,1
163541,68,1,67,24,1
163541,181,2,179,25,1
163541,181,2,179,40,1
163541,125,0,125,41,4
163541,125,0,125,42,1
163541,125,0,125,43,1
163541,27,0,27,44,1
163541,98,0,98,45,1
163541,98,0,98,60,1
163578,2877,367,2510,1,4
163578,1234,57,1177,2,1
163578,1220,53,1167,3,1
163578,104,0,104,4,1
163578,1116,53,1063,5,1
163578,14,4,10,11,1
163578,1643,310,1333,12,3
163578,188,10,178,19,1
163578,928,43,885,20,1
163578,888,99,789,21,4
163578,525,4,521,22,1
163578,525,4,521,23,1
163578,104,0,104,24,1
163578,421,4,417,25,1
163578,363,95,268,32,3
163578,58,0,58,39,1
163578,363,4,359,40,1
163578,1989,268,1721,41,4
163578,709,53,656,42,1
163578,695,49,646,43,1
163578,695,49,646,45,1
163578,14,4,10,51,1
163578,1280,215,1065,52,3
163578,130,10,120,59,1
163578,565,39,526,60,1
163657,13825,5298,8527,1,4
163657,13825,5298,8527,2,1
163657,12956,5006,7950,3,1
163657,2793,1242,1551,4,1
163657,10163,3764,6399,5,1
163657,869,292,577,11,1
163657,1186,453,733,19,1
163657,8977,3311,5666,20,1
163657,4095,1791,2304,21,4
163657,4095,1791,2304,22,1
163657,3934,1726,2208,23,1
163657,1169,566,603,24,1
163657,2765,1160,1605,25,1
163657,161,65,96,31,1
163657,433,195,238,39,1
163657,2332,965,1367,40,1
163657,9730,3507,6223,41,4
163657,9730,3507,6223,42,1
163657,9022,3280,5742,43,1
163657,1624,676,948,44,1
163657,7398,2604,4794,45,1
163657,708,227,481,51,1
163657,753,258,495,59,1
163657,6645,2346,4299,60,1
163736,683,215,468,1,4
163736,683,215,468,2,1
163736,661,212,449,3,1
163736,134,30,104,4,1
163736,527,182,345,5,1
163736,22,3,19,11,1
163736,58,14,44,19,1
163736,469,168,301,20,1
163736,683,215,468,21,4
163736,683,215,468,22,1
163736,661,212,449,23,1
163736,134,30,104,24,1
163736,527,182,345,25,1
163736,22,3,19,31,1
163736,58,14,44,39,1
163736,469,168,301,40,1
163754,29,1,28,1,4
163754,29,1,28,2,1
163754,29,1,28,3,1
163754,13,0,13,4,1
163754,16,1,15,5,1
163754,16,1,15,20,1
163754,19,0,19,21,4
163754,19,0,19,22,1
163754,19,0,19,23,1
163754,9,0,9,24,1
163754,10,0,10,25,1
163754,10,0,10,40,1
163754,10,1,9,41,4
163754,10,1,9,42,1
163754,10,1,9,43,1
163754,4,0,4,44,1
163754,6,1,5,45,1
163754,6,1,5,60,1
163815,101,7,94,1,4
163815,101,7,94,2,1
163815,101,7,94,3,1
163815,31,0,31,4,1
163815,70,7,63,5,1
163815,70,7,63,20,1
163815,37,4,33,21,4
163815,37,4,33,22,1
163815,37,4,33,23,1
163815,18,0,18,24,1
163815,19,4,15,25,1
163815,19,4,15,40,1
163815,64,3,61,41,4
163815,64,3,61,42,1
163815,64,3,61,43,1
163815,13,0,13,44,1
163815,51,3,48,45,1
163815,51,3,48,60,1
163851,8643,3647,4996,1,4
163851,8004,3479,4525,2,1
163851,7767,3359,4408,3,1
163851,1246,509,737,4,1
163851,6521,2850,3671,5,1
163851,237,120,117,11,1
163851,639,168,471,12,3
163851,915,394,521,19,1
163851,5606,2456,3150,20,1
163851,7665,3245,4420,21,4
163851,7374,3172,4202,22,1
163851,7363,3171,4192,23,1
163851,1241,507,734,24,1
163851,6122,2664,3458,25,1
163851,11,1,10,31,1
163851,291,73,218,32,3
163851,859,377,482,39,1
163851,5263,2287,2976,40,1
163851,978,402,576,41,4
163851,630,307,323,42,1
163851,404,188,216,43,1
163851,5,2,3,44,1
163851,399,186,213,45,1
163851,226,119,107,51,1
163851,348,95,253,52,3
163851,56,17,39,59,1
163851,343,169,174,60,1
163912,1858,751,1107,1,4
163912,1819,744,1075,2,1
163912,1794,729,1065,3,1
163912,383,156,227,4,1
163912,1411,573,838,5,1
163912,25,15,10,11,1
163912,39,7,32,12,3
163912,95,43,52,19,1
163912,1316,530,786,20,1
163912,1789,726,1063,21,4
163912,1762,720,1042,22,1
163912,1758,717,1041,23,1
163912,383,156,227,24,1
163912,1375,561,814,25,1
163912,4,3,1,31,1
163912,27,6,21,32,3
163912,88,43,45,39,1
163912,1287,518,769,40,1
163912,69,25,44,41,4
163912,57,24,33,42,1
163912,36,12,24,43,1
163912,36,12,24,45,1
163912,21,12,9,51,1
163912,12,1,11,52,3
163912,7,0,7,59,1
163912,29,12,17,60,1
163921,1080,123,957,1,4
163921,1037,119,918,2,1
163921,1037,119,918,3,1
163921,91,11,80,4,1
163921,946,108,838,5,1
163921,43,4,39,12,3
163921,66,8,58,19,1
163921,880,100,780,20,1
163921,549,71,478,21,4
163921,530,67,463,22,1
163921,530,67,463,23,1
163921,11,1,10,24,1
163921,519,66,453,25,1
163921,19,4,15,32,3
163921,41,8,33,39,1
163921,478,58,420,40,1
163921,531,52,479,41,4
163921,507,52,455,42,1
163921,507,52,455,43,1
163921,80,10,70,44,1
163921,427,42,385,45,1
163921,24,0,24,52,3
163921,25,0,25,59,1
163921,402,42,360,60,1
163976,490,275,215,1,4
163976,443,244,199,2,1
163976,443,244,199,3,1
163976,122,70,52,4,1
163976,321,174,147,5,1
163976,47,31,16,12,3
163976,321,174,147,20,1
163976,486,273,213,21,4
163976,440,242,198,22,1
163976,440,242,198,23,1
163976,122,70,52,24,1
163976,318,172,146,25,1
163976,46,31,15,32,3
163976,318,172,146,40,1
163976,4,2,2,41,4
163976,3,2,1,42,1
163976,3,2,1,43,1
163976,3,2,1,45,1
163976,1,0,1,52,3
163976,3,2,1,60,1
164058,462,253,209,1,4
164058,462,253,209,2,1
164058,462,253,209,3,1
164058,102,46,56,4,1
164058,360,207,153,5,1
164058,30,11,19,19,1
164058,330,196,134,20,1
164058,462,253,209,21,4
164058,462,253,209,22,1
164058,462,253,209,23,1
164058,102,46,56,24,1
164058,360,207,153,25,1
164058,30,11,19,39,1
164058,330,196,134,40,1
164076,22499,8572,13927,1,4
164076,18779,7467,11312,2,1
164076,18534,7348,11186,3,1
164076,2748,995,1753,4,1
164076,15786,6353,9433,5,1
164076,245,119,126,11,1
164076,3720,1105,2615,12,3
164076,2299,1001,1298,19,1
164076,13487,5352,8135,20,1
164076,17786,6781,11005,21,4
164076,16588,6427,10161,22,1
164076,16510,6390,10120,23,1
164076,2747,995,1752,24,1
164076,13763,5395,8368,25,1
164076,78,37,41,31,1
164076,1198,354,844,32,3
164076,1998,870,1128,39,1
164076,11765,4525,7240,40,1
164076,4713,1791,2922,41,4
164076,2191,1040,1151,42,1
164076,2024,958,1066,43,1
164076,1,0,1,44,1
164076,2023,958,1065,45,1
164076,167,82,85,51,1
164076,2522,751,1771,52,3
164076,301,131,170,59,1
164076,1722,827,895,60,1
164085,591,79,512,1,4
164085,591,79,512,12,3
164085,447,63,384,21,4
164085,447,63,384,32,3
164085,144,16,128,41,4
164085,144,16,128,52,3
164100,193,36,157,1,4
164100,193,36,157,2,1
164100,193,36,157,3,1
164100,184,34,150,4,1
164100,9,2,7,5,1
164100,9,2,7,20,1
164100,193,36,157,21,4
164100,193,36,157,22,1
164100,193,36,157,23,1
164100,184,34,150,24,1
164100,9,2,7,25,1
164100,9,2,7,40,1
164155,4526,3550,976,1,4
164155,4526,3550,976,2,1
164155,4526,3550,976,3,1
164155,1171,905,266,4,1
164155,3355,2645,710,5,1
164155,3355,2645,710,20,1
164155,4526,3550,976,21,4
164155,4526,3550,976,22,1
164155,4526,3550,976,23,1
164155,1171,905,266,24,1
164155,3355,2645,710,25,1
164155,3355,2645,710,40,1
164173,4404,1482,2922,1,4
164173,3965,1371,2594,2,1
164173,3923,1357,2566,3,1
164173,753,292,461,4,1
164173,3170,1065,2105,5,1
164173,42,14,28,11,1
164173,439,111,328,12,3
164173,240,107,133,19,1
164173,2930,958,1972,20,1
164173,3368,1252,2116,21,4
164173,3288,1224,2064,22,1
164173,3288,1224,2064,23,1
164173,752,292,460,24,1
164173,2536,932,1604,25,1
164173,80,28,52,32,3
164173,227,102,125,39,1
164173,2309,830,1479,40,1
164173,1036,230,806,41,4
164173,677,147,530,42,1
164173,635,133,502,43,1
164173,1,0,1,44,1
164173,634,133,501,45,1
164173,42,14,28,51,1
164173,359,83,276,52,3
164173,13,5,8,59,1
164173,621,128,493,60,1
164216,1512,645,867,1,4
164216,1483,630,853,2,1
164216,1424,603,821,3,1
164216,349,147,202,4,1
164216,1075,456,619,5,1
164216,59,27,32,11,1
164216,29,15,14,12,3
164216,35,21,14,19,1
164216,1040,435,605,20,1
164216,1441,609,832,21,4
164216,1440,609,831,22,1
164216,1411,598,813,23,1
164216,349,147,202,24,1
164216,1062,451,611,25,1
164216,29,11,18,31,1
164216,1,0,1,32,3
164216,35,21,14,39,1
164216,1027,430,597,40,1
164216,71,36,35,41,4
164216,43,21,22,42,1
164216,13,5,8,43,1
164216,13,5,8,45,1
164216,30,16,14,51,1
164216,28,15,13,52,3
164216,13,5,8,60,1
164270,3229,1157,2072,1,4
164270,1692,793,899,2,1
164270,1662,784,878,3,1
164270,453,226,227,4,1
164270,1209,558,651,5,1
164270,30,9,21,11,1
164270,1537,364,1173,12,3
164270,69,38,31,19,1
164270,1140,520,620,20,1
164270,1817,820,997,21,4
164270,1660,777,883,22,1
164270,1648,774,874,23,1
164270,453,226,227,24,1
164270,1195,548,647,25,1
164270,12,3,9,31,1
164270,157,43,114,32,3
164270,69,38,31,39,1
164270,1126,510,616,40,1
164270,1412,337,1075,41,4
164270,32,16,16,42,1
164270,14,10,4,43,1
164270,14,10,4,45,1
164270,18,6,12,51,1
164270,1380,321,1059,52,3
164270,14,10,4,60,1
164313,3416,1249,2167,1,4
164313,3416,1249,2167,2,1
164313,3090,1120,1970,3,1
164313,678,287,391,4,1
164313,2412,833,1579,5,1
164313,326,129,197,11,1
164313,236,102,134,19,1
164313,2176,731,1445,20,1
164313,1091,454,637,21,4
164313,1091,454,637,22,1
164313,1072,440,632,23,1
164313,409,180,229,24,1
164313,663,260,403,25,1
164313,19,14,5,31,1
164313,88,43,45,39,1
164313,575,217,358,40,1
164313,2325,795,1530,41,4
164313,2325,795,1530,42,1
164313,2018,680,1338,43,1
164313,269,107,162,44,1
164313,1749,573,1176,45,1
164313,307,115,192,51,1
164313,148,59,89,59,1
164313,1601,514,1087,60,1
164368,641,440,201,1,4
164368,641,440,201,12,3
164368,641,440,201,21,4
164368,641,440,201,32,3
164438,1145,345,800,1,4
164438,940,261,679,2,1
164438,918,253,665,3,1
164438,24,9,15,4,1
164438,894,244,650,5,1
164438,22,8,14,11,1
164438,205,84,121,12,3
164438,176,40,136,19,1
164438,718,204,514,20,1
164438,298,105,193,21,4
164438,194,71,123,22,1
164438,188,69,119,23,1
164438,6,3,3,24,1
164438,182,66,116,25,1
164438,6,2,4,31,1
164438,104,34,70,32,3
164438,26,8,18,39,1
164438,156,58,98,40,1
164438,847,240,607,41,4
164438,746,190,556,42,1
164438,730,184,546,43,1
164438,18,6,12,44,1
164438,712,178,534,45,1
164438,16,6,10,51,1
164438,101,50,51,52,3
164438,150,32,118,59,1
164438,562,146,416,60,1
164447,3657,1117,2540,1,4
164447,1513,635,878,2,1
164447,1513,635,878,3,1
164447,346,164,182,4,1
164447,1167,471,696,5,1
164447,2144,482,1662,12,3
164447,173,54,119,19,1
164447,994,417,577,20,1
164447,1722,697,1025,21,4
164447,1397,604,793,22,1
164447,1397,604,793,23,1
164447,344,164,180,24,1
164447,1053,440,613,25,1
164447,325,93,232,32,3
164447,164,51,113,39,1
164447,889,389,500,40,1
164447,1935,420,1515,41,4
164447,116,31,85,42,1
164447,116,31,85,43,1
164447,2,0,2,44,1
164447,114,31,83,45,1
164447,1819,389,1430,52,3
164447,9,3,6,59,1
164447,105,28,77,60,1
164465,1785,900,885,1,4
164465,1785,900,885,2,1
164465,1785,900,885,3,1
164465,466,231,235,4,1
164465,1319,669,650,5,1
164465,13,10,3,19,1
164465,1306,659,647,20,1
164465,1785,900,885,21,4
164465,1785,900,885,22,1
164465,1785,900,885,23,1
164465,466,231,235,24,1
164465,1319,669,650,25,1
164465,13,10,3,39,1
164465,1306,659,647,40,1
164474,272,96,176,1,4
164474,272,96,176,12,3
164474,59,21,38,21,4
164474,59,21,38,32,3
164474,213,75,138,41,4
164474,213,75,138,52,3
164492,1540,716,824,1,4
164492,1143,493,650,2,1
164492,1135,487,648,3,1
164492,243,93,150,4,1
164492,892,394,498,5,1
164492,8,6,2,11,1
164492,397,223,174,12,3
164492,45,19,26,19,1
164492,847,375,472,20,1
164492,907,386,521,21,4
164492,845,360,485,22,1
164492,845,360,485,23,1
164492,242,93,149,24,1
164492,603,267,336,25,1
164492,62,26,36,32,3
164492,44,19,25,39,1
164492,559,248,311,40,1
164492,633,330,303,41,4
164492,298,133,165,42,1
164492,290,127,163,43,1
164492,1,0,1,44,1
164492,289,127,162,45,1
164492,8,6,2,51,1
164492,335,197,138,52,3
164492,1,0,1,59,1
164492,288,127,161,60,1
164535,46,4,42,1,4
164535,46,4,42,2,1
164535,46,4,42,3,1
164535,16,1,15,4,1
164535,30,3,27,5,1
164535,30,3,27,20,1
164535,46,4,42,21,4
164535,46,4,42,22,1
164535,46,4,42,23,1
164535,16,1,15,24,1
164535,30,3,27,25,1
164535,30,3,27,40,1
164562,2756,1009,1747,1,4
164562,2240,864,1376,2,1
164562,2181,841,1340,3,1
164562,502,215,287,4,1
164562,1679,626,1053,5,1
164562,59,23,36,11,1
164562,516,145,371,12,3
164562,44,18,26,19,1
164562,1635,608,1027,20,1
164562,2192,842,1350,21,4
164562,2022,806,1216,22,1
164562,2016,801,1215,23,1
164562,502,215,287,24,1
164562,1514,586,928,25,1
164562,6,5,1,31,1
164562,170,36,134,32,3
164562,44,18,26,39,1
164562,1470,568,902,40,1
164562,564,167,397,41,4
164562,218,58,160,42,1
164562,165,40,125,43,1
164562,165,40,125,45,1
164562,53,18,35,51,1
164562,346,109,237,52,3
164562,165,40,125,60,1
164580,3343,1992,1351,1,4
164580,2106,1151,955,2,1
164580,2106,1151,955,3,1
164580,489,252,237,4,1
164580,1617,899,718,5,1
164580,1237,841,396,12,3
164580,45,24,21,19,1
164580,1572,875,697,20,1
164580,2547,1450,1097,21,4
164580,2106,1151,955,22,1
164580,2106,1151,955,23,1
164580,489,252,237,24,1
164580,1617,899,718,25,1
164580,441,299,142,32,3
164580,45,24,21,39,1
164580,1572,875,697,40,1
164580,796,542,254,41,4
164580,796,542,254,52,3
164599,66,15,51,1,4
164599,66,15,51,2,1
164599,66,15,51,3,1
164599,23,6,17,4,1
164599,43,9,34,5,1
164599,43,9,34,20,1
164599,66,15,51,41,4
164599,66,15,51,42,1
164599,66,15,51,43,1
164599,23,6,17,44,1
164599,43,9,34,45,1
164599,43,9,34,60,1
164614,96,55,41,1,4
164614,96,55,41,2,1
164614,83,51,32,3,1
164614,15,8,7,4,1
164614,68,43,25,5,1
164614,13,4,9,11,1
164614,11,6,5,19,1
164614,57,37,20,20,1
164614,73,46,27,21,4
164614,73,46,27,22,1
164614,73,46,27,23,1
164614,13,7,6,24,1
164614,60,39,21,25,1
164614,10,6,4,39,1
164614,50,33,17,40,1
164614,23,9,14,41,4
164614,23,9,14,42,1
164614,10,5,5,43,1
164614,2,1,1,44,1
164614,8,4,4,45,1
164614,13,4,9,51,1
164614,1,0,1,59,1
164614,7,4,3,60,1
164632,2357,105,2252,1,4
164632,1458,0,1458,2,1
164632,1454,0,1454,3,1
164632,136,0,136,4,1
164632,1318,0,1318,5,1
164632,4,0,4,11,1
164632,899,105,794,12,3
164632,277,0,277,19,1
164632,1041,0,1041,20,1
164632,1588,64,1524,21,4
164632,1179,0,1179,22,1
164632,1179,0,1179,23,1
164632,136,0,136,24,1
164632,1043,0,1043,25,1
164632,409,64,345,32,3
164632,224,0,224,39,1
164632,819,0,819,40,1
164632,769,41,728,41,4
164632,279,0,279,42,1
164632,275,0,275,43,1
164632,275,0,275,45,1
164632,4,0,4,51,1
164632,490,41,449,52,3
164632,53,0,53,59,1
164632,222,0,222,60,1
164641,1204,334,870,1,4
164641,1204,334,870,2,1
164641,1196,329,867,3,1
164641,178,77,101,4,1
164641,1018,252,766,5,1
164641,8,5,3,11,1
164641,278,83,195,19,1
164641,740,169,571,20,1
164641,774,199,575,21,4
164641,774,199,575,22,1
164641,769,196,573,23,1
164641,123,49,74,24,1
164641,646,147,499,25,1
164641,5,3,2,31,1
164641,154,42,112,39,1
164641,492,105,387,40,1
164641,430,135,295,41,4
164641,430,135,295,42,1
164641,427,133,294,43,1
164641,55,28,27,44,1
164641,372,105,267,45,1
164641,3,2,1,51,1
164641,124,41,83,59,1
164641,248,64,184,60,1
164678,200,196,4,1,4
164678,200,196,4,2,1
164678,200,196,4,3,1
164678,49,47,2,4,1
164678,151,149,2,5,1
164678,151,149,2,20,1
164678,126,122,4,21,4
164678,126,122,4,22,1
164678,126,122,4,23,1
164678,29,27,2,24,1
164678,97,95,2,25,1
164678,97,95,2,40,1
164678,74,74,0,41,4
164678,74,74,0,42,1
164678,74,74,0,43,1
164678,20,20,0,44,1
164678,54,54,0,45,1
164678,54,54,0,60,1
164720,1902,820,1082,1,4
164720,1902,820,1082,2,1
164720,1871,807,1064,3,1
164720,359,188,171,4,1
164720,1512,619,893,5,1
164720,31,13,18,11,1
164720,213,84,129,19,1
164720,1299,535,764,20,1
164720,1449,719,730,21,4
164720,1449,719,730,22,1
164720,1449,719,730,23,1
164720,359,188,171,24,1
164720,1090,531,559,25,1
164720,158,76,82,39,1
164720,932,455,477,40,1
164720,453,101,352,41,4
164720,453,101,352,42,1
164720,422,88,334,43,1
164720,422,88,334,45,1
164720,31,13,18,51,1
164720,55,8,47,59,1
164720,367,80,287,60,1
164739,5658,3255,2403,1,4
164739,4247,2549,1698,2,1
164739,4172,2512,1660,3,1
164739,974,604,370,4,1
164739,3198,1908,1290,5,1
164739,75,37,38,11,1
164739,1411,706,705,12,3
164739,155,100,55,19,1
164739,3043,1808,1235,20,1
164739,4893,2816,2077,21,4
164739,4142,2482,1660,22,1
164739,4081,2452,1629,23,1
164739,974,604,370,24,1
164739,3107,1848,1259,25,1
164739,61,30,31,31,1
164739,751,334,417,32,3
164739,149,97,52,39,1
164739,2958,1751,1207,40,1
164739,765,439,326,41,4
164739,105,67,38,42,1
164739,91,60,31,43,1
164739,91,60,31,45,1
164739,14,7,7,51,1
164739,660,372,288,52,3
164739,6,3,3,59,1
164739,85,57,28,60,1
164748,4519,3121,1398,1,4
164748,4402,3036,1366,2,1
164748,4402,3036,1366,3,1
164748,910,601,309,4,1
164748,3492,2435,1057,5,1
164748,117,85,32,12,3
164748,162,107,55,19,1
164748,3330,2328,1002,20,1
164748,4065,2810,1255,21,4
164748,3950,2725,1225,22,1
164748,3950,2725,1225,23,1
164748,909,600,309,24,1
164748,3041,2125,916,25,1
164748,115,85,30,32,3
164748,162,107,55,39,1
164748,2879,2018,861,40,1
164748,454,311,143,41,4
164748,452,311,141,42,1
164748,452,311,141,43,1
164748,1,1,0,44,1
164748,451,310,141,45,1
164748,2,0,2,52,3
164748,451,310,141,60,1
164775,2400,921,1479,1,4
164775,2400,921,1479,2,1
164775,2024,797,1227,3,1
164775,469,223,246,4,1
164775,1555,574,981,5,1
164775,376,124,252,11,1
164775,126,48,78,19,1
164775,1429,526,903,20,1
164775,821,392,429,21,4
164775,821,392,429,22,1
164775,810,386,424,23,1
164775,278,155,123,24,1
164775,532,231,301,25,1
164775,11,6,5,31,1
164775,58,26,32,39,1
164775,474,205,269,40,1
164775,1579,529,1050,41,4
164775,1579,529,1050,42,1
164775,1214,411,803,43,1
164775,191,68,123,44,1
164775,1023,343,680,45,1
164775,365,118,247,51,1
164775,68,22,46,59,1
164775,955,321,634,60,1
164845,241,19,222,1,4
164845,241,19,222,2,1
164845,241,19,222,3,1
164845,109,6,103,4,1
164845,132,13,119,5,1
164845,132,13,119,20,1
164845,170,14,156,21,4
164845,170,14,156,22,1
164845,170,14,156,23,1
164845,86,3,83,24,1
164845,84,11,73,25,1
164845,84,11,73,40,1
164845,71,5,66,41,4
164845,71,5,66,42,1
164845,71,5,66,43,1
164845,23,3,20,44,1
164845,48,2,46,45,1
164845,48,2,46,60,1
164872,1037,564,473,1,4
164872,578,330,248,2,1
164872,423,284,139,3,1
164872,15,11,4,4,1
164872,408,273,135,5,1
164872,155,46,109,11,1
164872,459,234,225,12,3
164872,44,22,22,19,1
164872,364,251,113,20,1
164872,856,506,350,21,4
164872,413,279,134,22,1
164872,399,275,124,23,1
164872,15,11,4,24,1
164872,384,264,120,25,1
164872,14,4,10,31,1
164872,443,227,216,32,3
164872,43,21,22,39,1
164872,341,243,98,40,1
164872,181,58,123,41,4
164872,165,51,114,42,1
164872,24,9,15,43,1
164872,24,9,15,45,1
164872,141,42,99,51,1
164872,16,7,9,52,3
164872,1,1,0,59,1
164872,23,8,15,60,1
164915,147,45,102,1,4
164915,147,45,102,12,3
164915,46,16,30,21,4
164915,46,16,30,32,3
164915,101,29,72,41,4
164915,101,29,72,52,3
164924,14309,6500,7809,1,4
164924,9698,4530,5168,2,1
164924,9465,4408,5057,3,1
164924,2309,1066,1243,4,1
164924,7156,3342,3814,5,1
164924,233,122,111,11,1
164924,4611,1970,2641,12,3
164924,125,50,75,19,1
164924,7031,3292,3739,20,1
164924,12916,5902,7014,21,4
164924,9390,4379,5011,22,1
164924,9345,4348,4997,23,1
164924,2305,1065,1240,24,1
164924,7040,3283,3757,25,1
164924,45,31,14,31,1
164924,3526,1523,2003,32,3
164924,125,50,75,39,1
164924,6915,3233,3682,40,1
164924,1393,598,795,41,4
164924,308,151,157,42,1
164924,120,60,60,43,1
164924,4,1,3,44,1
164924,116,59,57,45,1
164924,188,91,97,51,1
164924,1085,447,638,52,3
164924,116,59,57,60,1
164933,774,308,466,1,4
164933,545,215,330,2,1
164933,545,215,330,3,1
164933,133,52,81,4,1
164933,412,163,249,5,1
164933,229,93,136,12,3
164933,16,6,10,19,1
164933,396,157,239,20,1
164933,752,298,454,21,4
164933,540,213,327,22,1
164933,540,213,327,23,1
164933,133,52,81,24,1
164933,407,161,246,25,1
164933,212,85,127,32,3
164933,16,6,10,39,1
164933,391,155,236,40,1
164933,22,10,12,41,4
164933,5,2,3,42,1
164933,5,2,3,43,1
164933,5,2,3,45,1
164933,17,8,9,52,3
164933,5,2,3,60,1
164988,32411,13628,18783,1,4
164988,18165,7348,10817,2,1
164988,16460,6527,9933,3,1
164988,3807,1445,2362,4,1
164988,12653,5082,7571,5,1
164988,1705,821,884,11,1
164988,14246,6280,7966,12,3
164988,366,154,212,19,1
164988,12287,4928,7359,20,1
164988,25797,10563,15234,21,4
164988,16593,6538,10055,22,1
164988,16035,6320,9715,23,1
164988,3807,1445,2362,24,1
164988,12228,4875,7353,25,1
164988,558,218,340,31,1
164988,9204,4025,5179,32,3
164988,365,154,211,39,1
164988,11863,4721,7142,40,1
164988,6614,3065,3549,41,4
164988,1572,810,762,42,1
164988,425,207,218,43,1
164988,425,207,218,45,1
164988,1147,603,544,51,1
164988,5042,2255,2787,52,3
164988,1,0,1,59,1
164988,424,207,217,60,1
165015,5825,2658,3167,1,4
165015,3614,1568,2046,2,1
165015,3603,1565,2038,3,1
165015,833,376,457,4,1
165015,2770,1189,1581,5,1
165015,11,3,8,11,1
165015,2211,1090,1121,12,3
165015,69,31,38,19,1
165015,2701,1158,1543,20,1
165015,5386,2405,2981,21,4
165015,3599,1562,2037,22,1
165015,3597,1561,2036,23,1
165015,833,376,457,24,1
165015,2764,1185,1579,25,1
165015,2,1,1,31,1
165015,1787,843,944,32,3
165015,69,31,38,39,1
165015,2695,1154,1541,40,1
165015,439,253,186,41,4
165015,15,6,9,42,1
165015,6,4,2,43,1
165015,6,4,2,45,1
165015,9,2,7,51,1
165015,424,247,177,52,3
165015,6,4,2,60,1
165024,11267,4453,6814,1,4
165024,9615,3998,5617,2,1
165024,9489,3943,5546,3,1
165024,1474,590,884,4,1
165024,8015,3353,4662,5,1
165024,126,55,71,11,1
165024,1652,455,1197,12,3
165024,1019,431,588,19,1
165024,6996,2922,4074,20,1
165024,8473,3450,5023,21,4
165024,8034,3336,4698,22,1
165024,7979,3323,4656,23,1
165024,1451,576,875,24,1
165024,6528,2747,3781,25,1
165024,55,13,42,31,1
165024,439,114,325,32,3
165024,836,360,476,39,1
165024,5692,2387,3305,40,1
165024,2794,1003,1791,41,4
165024,1581,662,919,42,1
165024,1510,620,890,43,1
165024,23,14,9,44,1
165024,1487,606,881,45,1
165024,71,42,29,51,1
165024,1213,341,872,52,3
165024,183,71,112,59,1
165024,1304,535,769,60,1
165033,9335,3627,5708,1,4
165033,9335,3627,5708,2,1
165033,8250,3196,5054,3,1
165033,2158,943,1215,4,1
165033,6092,2253,3839,5,1
165033,1085,431,654,11,1
165033,478,146,332,19,1
165033,5614,2107,3507,20,1
165033,4429,1932,2497,21,4
165033,4429,1932,2497,22,1
165033,4274,1858,2416,23,1
165033,1493,680,813,24,1
165033,2781,1178,1603,25,1
165033,155,74,81,31,1
165033,231,85,146,39,1
165033,2550,1093,1457,40,1
165033,4906,1695,3211,41,4
165033,4906,1695,3211,42,1
165033,3976,1338,2638,43,1
165033,665,263,402,44,1
165033,3311,1075,2236,45,1
165033,930,357,573,51,1
165033,247,61,186,59,1
165033,3064,1014,2050,60,1
165060,323,30,293,1,4
165060,323,30,293,2,1
165060,323,30,293,3,1
165060,6,0,6,4,1
165060,317,30,287,5,1
165060,317,30,287,20,1
165060,201,16,185,21,4
165060,201,16,185,22,1
165060,201,16,185,23,1
165060,3,0,3,24,1
165060,198,16,182,25,1
165060,198,16,182,40,1
165060,122,14,108,41,4
165060,122,14,108,42,1
165060,122,14,108,43,1
165060,3,0,3,44,1
165060,119,14,105,45,1
165060,119,14,105,60,1
165112,14023,6097,7926,1,4
165112,14023,6097,7926,2,1
165112,12535,5525,7010,3,1
165112,2216,1108,1108,4,1
165112,10319,4417,5902,5,1
165112,1488,572,916,11,1
165112,1093,505,588,19,1
165112,9226,3912,5314,20,1
165112,4651,2315,2336,21,4
165112,4651,2315,2336,22,1
165112,4563,2270,2293,23,1
165112,1140,592,548,24,1
165112,3423,1678,1745,25,1
165112,88,45,43,31,1
165112,463,250,213,39,1
165112,2960,1428,1532,40,1
165112,9372,3782,5590,41,4
165112,9372,3782,5590,42,1
165112,7972,3255,4717,43,1
165112,1076,516,560,44,1
165112,6896,2739,4157,45,1
165112,1400,527,873,51,1
165112,630,255,375,59,1
165112,6266,2484,3782,60,1
165167,3114,880,2234,1,4
165167,1050,367,683,2,1
165167,1042,367,675,3,1
165167,186,83,103,4,1
165167,856,284,572,5,1
165167,8,0,8,11,1
165167,2064,513,1551,12,3
165167,89,27,62,19,1
165167,767,257,510,20,1
165167,1198,305,893,21,4
165167,234,76,158,22,1
165167,234,76,158,23,1
165167,28,14,14,24,1
165167,206,62,144,25,1
165167,964,229,735,32,3
165167,31,14,17,39,1
165167,175,48,127,40,1
165167,1916,575,1341,41,4
165167,816,291,525,42,1
165167,808,291,517,43,1
165167,158,69,89,44,1
165167,650,222,428,45,1
165167,8,0,8,51,1
165167,1100,284,816,52,3
165167,58,13,45,59,1
165167,592,209,383,60,1
165194,4051,1559,2492,1,4
165194,4051,1559,2492,2,1
165194,3459,1334,2125,3,1
165194,865,413,452,4,1
165194,2594,921,1673,5,1
165194,592,225,367,11,1
165194,183,62,121,19,1
165194,2411,859,1552,20,1
165194,1311,572,739,21,4
165194,1311,572,739,22,1
165194,1270,556,714,23,1
165194,485,240,245,24,1
165194,785,316,469,25,1
165194,41,16,25,31,1
165194,55,21,34,39,1
165194,730,295,435,40,1
165194,2740,987,1753,41,4
165194,2740,987,1753,42,1
165194,2189,778,1411,43,1
165194,380,173,207,44,1
165194,1809,605,1204,45,1
165194,551,209,342,51,1
165194,128,41,87,59,1
165194,1681,564,1117,60,1
165255,171,0,171,1,4
165255,171,0,171,2,1
165255,171,0,171,3,1
165255,80,0,80,4,1
165255,91,0,91,5,1
165255,91,0,91,20,1
165255,98,0,98,21,4
165255,98,0,98,22,1
165255,98,0,98,23,1
165255,53,0,53,24,1
165255,45,0,45,25,1
165255,45,0,45,40,1
165255,73,0,73,41,4
165255,73,0,73,42,1
165255,73,0,73,43,1
165255,27,0,27,44,1
165255,46,0,46,45,1
165255,46,0,46,60,1
165264,698,75,623,1,4
165264,698,75,623,2,1
165264,680,74,606,3,1
165264,18,3,15,4,1
165264,662,71,591,5,1
165264,18,1,17,11,1
165264,2,0,2,19,1
165264,660,71,589,20,1
165264,100,12,88,21,4
165264,100,12,88,22,1
165264,99,12,87,23,1
165264,2,0,2,24,1
165264,97,12,85,25,1
165264,1,0,1,31,1
165264,97,12,85,40,1
165264,598,63,535,41,4
165264,598,63,535,42,1
165264,581,62,519,43,1
165264,16,3,13,44,1
165264,565,59,506,45,1
165264,17,1,16,51,1
165264,2,0,2,59,1
165264,563,59,504,60,1
165334,3551,1508,2043,1,4
165334,2380,997,1383,2,1
165334,2312,971,1341,3,1
165334,621,235,386,4,1
165334,1691,736,955,5,1
165334,68,26,42,11,1
165334,1171,511,660,12,3
165334,51,24,27,19,1
165334,1640,712,928,20,1
165334,3153,1336,1817,21,4
165334,2270,949,1321,22,1
165334,2262,946,1316,23,1
165334,614,232,382,24,1
165334,1648,714,934,25,1
165334,8,3,5,31,1
165334,883,387,496,32,3
165334,45,22,23,39,1
165334,1603,692,911,40,1
165334,398,172,226,41,4
165334,110,48,62,42,1
165334,50,25,25,43,1
165334,7,3,4,44,1
165334,43,22,21,45,1
165334,60,23,37,51,1
165334,288,124,164,52,3
165334,6,2,4,59,1
165334,37,20,17,60,1
165495,16,6,10,1,4
165495,16,6,10,12,3
165495,16,6,10,21,4
165495,16,6,10,32,3
165529,3074,1154,1920,1,4
165529,2849,1067,1782,2,1
165529,2794,1052,1742,3,1
165529,657,289,368,4,1
165529,2137,763,1374,5,1
165529,55,15,40,11,1
165529,225,87,138,12,3
165529,175,53,122,19,1
165529,1962,710,1252,20,1
165529,2106,899,1207,21,4
165529,2068,896,1172,22,1
165529,2068,896,1172,23,1
165529,640,285,355,24,1
165529,1428,611,817,25,1
165529,38,3,35,32,3
165529,70,37,33,39,1
165529,1358,574,784,40,1
165529,968,255,713,41,4
165529,781,171,610,42,1
165529,726,156,570,43,1
165529,17,4,13,44,1
165529,709,152,557,45,1
165529,55,15,40,51,1
165529,187,84,103,52,3
165529,105,16,89,59,1
165529,604,136,468,60,1
165556,331,111,220,1,4
165556,331,111,220,2,1
165556,331,111,220,3,1
165556,83,37,46,4,1
165556,248,74,174,5,1
165556,248,74,174,20,1
165556,212,69,143,21,4
165556,212,69,143,22,1
165556,212,69,143,23,1
165556,59,21,38,24,1
165556,153,48,105,25,1
165556,153,48,105,40,1
165556,119,42,77,41,4
165556,119,42,77,42,1
165556,119,42,77,43,1
165556,24,16,8,44,1
165556,95,26,69,45,1
165556,95,26,69,60,1
165574,1300,689,611,1,4
165574,1300,689,611,2,1
165574,1238,664,574,3,1
165574,528,317,211,4,1
165574,710,347,363,5,1
165574,62,25,37,11,1
165574,40,21,19,19,1
165574,670,326,344,20,1
165574,1076,586,490,21,4
165574,1076,586,490,22,1
165574,1076,586,490,23,1
165574,528,317,211,24,1
165574,548,269,279,25,1
165574,31,16,15,39,1
165574,517,253,264,40,1
165574,224,103,121,41,4
165574,224,103,121,42,1
165574,162,78,84,43,1
165574,162,78,84,45,1
165574,62,25,37,51,1
165574,9,5,4,59,1
165574,153,73,80,60,1
165608,80,11,69,1,4
165608,80,11,69,2,1
165608,80,11,69,3,1
165608,10,1,9,4,1
165608,70,10,60,5,1
165608,70,10,60,20,1
165608,45,5,40,21,4
165608,45,5,40,22,1
165608,45,5,40,23,1
165608,8,1,7,24,1
165608,37,4,33,25,1
165608,37,4,33,40,1
165608,35,6,29,41,4
165608,35,6,29,42,1
165608,35,6,29,43,1
165608,2,0,2,44,1
165608,33,6,27,45,1
165608,33,6,27,60,1
165635,247,233,14,1,4
165635,247,233,14,2,1
165635,247,233,14,3,1
165635,28,27,1,4,1
165635,219,206,13,5,1
165635,219,206,13,20,1
165635,247,233,14,21,4
165635,247,233,14,22,1
165635,247,233,14,23,1
165635,28,27,1,24,1
165635,219,206,13,25,1
165635,219,206,13,40,1
165644,1478,383,1095,1,4
165644,1321,352,969,2,1
165644,1313,348,965,3,1
165644,165,65,100,4,1
165644,1148,283,865,5,1
165644,8,4,4,11,1
165644,157,31,126,12,3
165644,51,19,32,19,1
165644,1097,264,833,20,1
165644,1409,367,1042,21,4
165644,1302,342,960,22,1
165644,1302,342,960,23,1
165644,165,65,100,24,1
165644,1137,277,860,25,1
165644,107,25,82,32,3
165644,51,19,32,39,1
165644,1086,258,828,40,1
165644,69,16,53,41,4
165644,19,10,9,42,1
165644,11,6,5,43,1
165644,11,6,5,45,1
165644,8,4,4,51,1
165644,50,6,44,52,3
165644,11,6,5,60,1
165662,4561,1604,2957,1,4
165662,3758,1406,2352,2,1
165662,3720,1399,2321,3,1
165662,863,304,559,4,1
165662,2857,1095,1762,5,1
165662,38,7,31,11,1
165662,803,198,605,12,3
165662,188,66,122,19,1
165662,2669,1029,1640,20,1
165662,4375,1551,2824,21,4
165662,3668,1376,2292,22,1
165662,3667,1376,2291,23,1
165662,862,304,558,24,1
165662,2805,1072,1733,25,1
165662,1,0,1,31,1
165662,707,175,532,32,3
165662,186,65,121,39,1
165662,2619,1007,1612,40,1
165662,186,53,133,41,4
165662,90,30,60,42,1
165662,53,23,30,43,1
165662,1,0,1,44,1
165662,52,23,29,45,1
165662,37,7,30,51,1
165662,96,23,73,52,3
165662,2,1,1,59,1
165662,50,22,28,60,1
165671,2436,630,1806,1,4
165671,2176,580,1596,2,1
165671,2040,555,1485,3,1
165671,515,128,387,4,1
165671,1525,427,1098,5,1
165671,136,25,111,11,1
165671,260,50,210,12,3
165671,55,15,40,19,1
165671,1470,412,1058,20,1
165671,1874,538,1336,21,4
165671,1857,533,1324,22,1
165671,1857,533,1324,23,1
165671,515,128,387,24,1
165671,1342,405,937,25,1
165671,17,5,12,32,3
165671,43,13,30,39,1
165671,1299,392,907,40,1
165671,562,92,470,41,4
165671,319,47,272,42,1
165671,183,22,161,43,1
165671,183,22,161,45,1
165671,136,25,111,51,1
165671,243,45,198,52,3
165671,12,2,10,59,1
165671,171,20,151,60,1
165699,5029,1613,3416,1,4
165699,2724,1079,1645,2,1
165699,2621,1017,1604,3,1
165699,662,249,413,4,1
165699,1959,768,1191,5,1
165699,103,62,41,11,1
165699,2305,534,1771,12,3
165699,99,30,69,19,1
165699,1860,738,1122,20,1
165699,2819,1078,1741,21,4
165699,2430,950,1480,22,1
165699,2419,945,1474,23,1
165699,641,244,397,24,1
165699,1778,701,1077,25,1
165699,11,5,6,31,1
165699,389,128,261,32,3
165699,62,23,39,39,1
165699,1716,678,1038,40,1
165699,2210,535,1675,41,4
165699,294,129,165,42,1
165699,202,72,130,43,1
165699,21,5,16,44,1
165699,181,67,114,45,1
165699,92,57,35,51,1
165699,1916,406,1510,52,3
165699,37,7,30,59,1
165699,144,60,84,60,1
165705,70,24,46,1,4
165705,70,24,46,12,3
165705,36,15,21,21,4
165705,36,15,21,32,3
165705,34,9,25,41,4
165705,34,9,25,52,3
165750,105,49,56,1,4
165750,105,49,56,2,1
165750,105,49,56,3,1
165750,38,16,22,4,1
165750,67,33,34,5,1
165750,67,33,34,20,1
165750,105,49,56,21,4
165750,105,49,56,22,1
165750,105,49,56,23,1
165750,38,16,22,24,1
165750,67,33,34,25,1
165750,67,33,34,40,1
165802,1930,504,1426,1,4
165802,1930,504,1426,2,1
165802,1733,487,1246,3,1
165802,335,103,232,4,1
165802,1398,384,1014,5,1
165802,197,17,180,11,1
165802,553,134,419,19,1
165802,845,250,595,20,1
165802,1229,419,810,21,4
165802,1229,419,810,22,1
165802,1174,413,761,23,1
165802,292,98,194,24,1
165802,882,315,567,25,1
165802,55,6,49,31,1
165802,338,115,223,39,1
165802,544,200,344,40,1
165802,701,85,616,41,4
165802,701,85,616,42,1
165802,559,74,485,43,1
165802,43,5,38,44,1
165802,516,69,447,45,1
165802,142,11,131,51,1
165802,215,19,196,59,1
165802,301,50,251,60,1
165820,6680,2431,4249,1,4
165820,4245,1853,2392,2,1
165820,4148,1816,2332,3,1
165820,801,347,454,4,1
165820,3347,1469,1878,5,1
165820,97,37,60,11,1
165820,2435,578,1857,12,3
165820,398,175,223,19,1
165820,2949,1294,1655,20,1
165820,3632,1608,2024,21,4
165820,3438,1529,1909,22,1
165820,3414,1527,1887,23,1
165820,790,341,449,24,1
165820,2624,1186,1438,25,1
165820,24,2,22,31,1
165820,194,79,115,32,3
165820,301,151,150,39,1
165820,2323,1035,1288,40,1
165820,3048,823,2225,41,4
165820,807,324,483,42,1
165820,734,289,445,43,1
165820,11,6,5,44,1
165820,723,283,440,45,1
165820,73,35,38,51,1
165820,2241,499,1742,52,3
165820,97,24,73,59,1
165820,626,259,367,60,1
165866,6429,2036,4393,1,4
165866,4584,1690,2894,2,1
165866,4255,1512,2743,3,1
165866,809,249,560,4,1
165866,3446,1263,2183,5,1
165866,329,178,151,11,1
165866,1845,346,1499,12,3
165866,413,181,232,19,1
165866,3033,1082,1951,20,1
165866,3982,1414,2568,21,4
165866,3884,1390,2494,22,1
165866,3832,1362,2470,23,1
165866,804,248,556,24,1
165866,3028,1114,1914,25,1
165866,52,28,24,31,1
165866,98,24,74,32,3
165866,345,158,187,39,1
165866,2683,956,1727,40,1
165866,2447,622,1825,41,4
165866,700,300,400,42,1
165866,423,150,273,43,1
165866,5,1,4,44,1
165866,418,149,269,45,1
165866,277,150,127,51,1
165866,1747,322,1425,52,3
165866,68,23,45,59,1
165866,350,126,224,60,1
165884,482,434,48,1,4
165884,482,434,48,2,1
165884,463,416,47,3,1
165884,184,170,14,4,1
165884,279,246,33,5,1
165884,19,18,1,11,1
165884,27,23,4,19,1
165884,252,223,29,20,1
165884,412,369,43,21,4
165884,412,369,43,22,1
165884,412,369,43,23,1
165884,182,168,14,24,1
165884,230,201,29,25,1
165884,26,23,3,39,1
165884,204,178,26,40,1
165884,70,65,5,41,4
165884,70,65,5,42,1
165884,51,47,4,43,1
165884,2,2,0,44,1
165884,49,45,4,45,1
165884,19,18,1,51,1
165884,1,0,1,59,1
165884,48,45,3,60,1
165936,2073,721,1352,1,4
165936,1710,652,1058,2,1
165936,1681,644,1037,3,1
165936,478,176,302,4,1
165936,1203,468,735,5,1
165936,29,8,21,11,1
165936,363,69,294,12,3
165936,73,21,52,19,1
165936,1130,447,683,20,1
165936,1768,656,1112,21,4
165936,1668,636,1032,22,1
165936,1651,632,1019,23,1
165936,477,175,302,24,1
165936,1174,457,717,25,1
165936,17,4,13,31,1
165936,100,20,80,32,3
165936,70,21,49,39,1
165936,1104,436,668,40,1
165936,305,65,240,41,4
165936,42,16,26,42,1
165936,30,12,18,43,1
165936,1,1,0,44,1
165936,29,11,18,45,1
165936,12,4,8,51,1
165936,263,49,214,52,3
165936,3,0,3,59,1
165936,26,11,15,60,1
165945,2137,1512,625,1,4
165945,2137,1512,625,12,3
165945,734,508,226,21,4
165945,734,508,226,32,3
165945,1403,1004,399,41,4
165945,1403,1004,399,52,3
165981,2240,892,1348,1,4
165981,2240,892,1348,2,1
165981,1980,792,1188,3,1
165981,377,169,208,4,1
165981,1603,623,980,5,1
165981,260,100,160,11,1
165981,242,95,147,19,1
165981,1361,528,833,20,1
165981,815,366,449,21,4
165981,815,366,449,22,1
165981,786,355,431,23,1
165981,205,97,108,24,1
165981,581,258,323,25,1
165981,29,11,18,31,1
165981,95,37,58,39,1
165981,486,221,265,40,1
165981,1425,526,899,41,4
165981,1425,526,899,42,1
165981,1194,437,757,43,1
165981,172,72,100,44,1
165981,1022,365,657,45,1
165981,231,89,142,51,1
165981,147,58,89,59,1
165981,875,307,568,60,1
166009,69,21,48,1,4
166009,69,21,48,2,1
166009,69,21,48,3,1
166009,42,12,30,4,1
166009,27,9,18,5,1
166009,27,9,18,20,1
166009,69,21,48,21,4
166009,69,21,48,22,1
166009,69,21,48,23,1
166009,42,12,30,24,1
166009,27,9,18,25,1
166009,27,9,18,40,1
166018,1492,646,846,1,4
166018,1492,646,846,2,1
166018,1468,637,831,3,1
166018,381,153,228,4,1
166018,1087,484,603,5,1
166018,24,9,15,11,1
166018,73,34,39,19,1
166018,1014,450,564,20,1
166018,1492,646,846,21,4
166018,1492,646,846,22,1
166018,1468,637,831,23,1
166018,381,153,228,24,1
166018,1087,484,603,25,1
166018,24,9,15,31,1
166018,73,34,39,39,1
166018,1014,450,564,40,1
166027,28297,14478,13819,1,4
166027,10534,5268,5266,2,1
166027,7278,3779,3499,3,1
166027,1658,869,789,4,1
166027,5620,2910,2710,5,1
166027,3256,1489,1767,11,1
166027,17763,9210,8553,12,3
166027,13,6,7,19,1
166027,5607,2904,2703,20,1
166027,20370,10585,9785,21,4
166027,7240,3786,3454,22,1
166027,6912,3595,3317,23,1
166027,1658,869,789,24,1
166027,5254,2726,2528,25,1
166027,328,191,137,31,1
166027,13130,6799,6331,32,3
166027,13,6,7,39,1
166027,5241,2720,2521,40,1
166027,7927,3893,4034,41,4
166027,3294,1482,1812,42,1
166027,366,184,182,43,1
166027,366,184,182,45,1
166027,2928,1298,1630,51,1
166027,4633,2411,2222,52,3
166027,366,184,182,60,1
166045,188,64,124,1,4
166045,4,1,3,2,1
166045,4,1,3,3,1
166045,4,1,3,5,1
166045,184,63,121,12,3
166045,4,1,3,20,1
166045,69,30,39,21,4
166045,2,1,1,22,1
166045,2,1,1,23,1
166045,2,1,1,25,1
166045,67,29,38,32,3
166045,2,1,1,40,1
166045,119,34,85,41,4
166045,2,0,2,42,1
166045,2,0,2,43,1
166045,2,0,2,45,1
166045,117,34,83,52,3
166045,2,0,2,60,1
166054,208,154,54,1,4
166054,92,49,43,2,1
166054,92,49,43,3,1
166054,16,10,6,4,1
166054,76,39,37,5,1
166054,116,105,11,12,3
166054,15,7,8,19,1
166054,61,32,29,20,1
166054,200,148,52,21,4
166054,92,49,43,22,1
166054,92,49,43,23,1
166054,16,10,6,24,1
166054,76,39,37,25,1
166054,108,99,9,32,3
166054,15,7,8,39,1
166054,61,32,29,40,1
166054,8,6,2,41,4
166054,8,6,2,52,3
166063,30,0,30,1,4
166063,30,0,30,2,1
166063,30,0,30,3,1
166063,17,0,17,4,1
166063,13,0,13,5,1
166063,13,0,13,20,1
166063,30,0,30,21,4
166063,30,0,30,22,1
166063,30,0,30,23,1
166063,17,0,17,24,1
166063,13,0,13,25,1
166063,13,0,13,40,1
166124,2912,1449,1463,1,4
166124,2912,1449,1463,2,1
166124,2878,1438,1440,3,1
166124,719,368,351,4,1
166124,2159,1070,1089,5,1
166124,34,11,23,11,1
166124,13,7,6,19,1
166124,2146,1063,1083,20,1
166124,2877,1438,1439,21,4
166124,2877,1438,1439,22,1
166124,2877,1438,1439,23,1
166124,719,368,351,24,1
166124,2158,1070,1088,25,1
166124,13,7,6,39,1
166124,2145,1063,1082,40,1
166124,35,11,24,41,4
166124,35,11,24,42,1
166124,1,0,1,43,1
166124,1,0,1,45,1
166124,34,11,23,51,1
166124,1,0,1,60,1
166133,6740,2673,4067,1,4
166133,6740,2673,4067,2,1
166133,6370,2536,3834,3,1
166133,1542,747,795,4,1
166133,4828,1789,3039,5,1
166133,370,137,233,11,1
166133,485,203,282,19,1
166133,4343,1586,2757,20,1
166133,3272,1495,1777,21,4
166133,3272,1495,1777,22,1
166133,3205,1459,1746,23,1
166133,1066,543,523,24,1
166133,2139,916,1223,25,1
166133,67,36,31,31,1
166133,279,135,144,39,1
166133,1860,781,1079,40,1
166133,3468,1178,2290,41,4
166133,3468,1178,2290,42,1
166133,3165,1077,2088,43,1
166133,476,204,272,44,1
166133,2689,873,1816,45,1
166133,303,101,202,51,1
166133,206,68,138,59,1
166133,2483,805,1678,60,1
166276,71,10,61,1,4
166276,71,10,61,2,1
166276,71,10,61,3,1
166276,71,10,61,5,1
166276,71,10,61,20,1
166276,47,5,42,21,4
166276,47,5,42,22,1
166276,47,5,42,23,1
166276,47,5,42,25,1
166276,47,5,42,40,1
166276,24,5,19,41,4
166276,24,5,19,42,1
166276,24,5,19,43,1
166276,24,5,19,45,1
166276,24,5,19,60,1
166294,46,2,44,1,4
166294,46,2,44,2,1
166294,46,2,44,3,1
166294,23,2,21,4,1
166294,23,0,23,5,1
166294,23,0,23,20,1
166294,16,1,15,21,4
166294,16,1,15,22,1
166294,16,1,15,23,1
166294,12,1,11,24,1
166294,4,0,4,25,1
166294,4,0,4,40,1
166294,30,1,29,41,4
166294,30,1,29,42,1
166294,30,1,29,43,1
166294,11,1,10,44,1
166294,19,0,19,45,1
166294,19,0,19,60,1
166319,44,1,43,1,4
166319,44,1,43,2,1
166319,44,1,43,3,1
166319,26,0,26,4,1
166319,18,1,17,5,1
166319,18,1,17,20,1
166319,25,1,24,21,4
166319,25,1,24,22,1
166319,25,1,24,23,1
166319,18,0,18,24,1
166319,7,1,6,25,1
166319,7,1,6,40,1
166319,19,0,19,41,4
166319,19,0,19,42,1
166319,19,0,19,43,1
166319,8,0,8,44,1
166319,11,0,11,45,1
166319,11,0,11,60,1
166328,102,1,101,1,4
166328,102,1,101,2,1
166328,102,1,101,3,1
166328,27,1,26,4,1
166328,75,0,75,5,1
166328,75,0,75,20,1
166328,46,1,45,21,4
166328,46,1,45,22,1
166328,46,1,45,23,1
166328,16,1,15,24,1
166328,30,0,30,25,1
166328,30,0,30,40,1
166328,56,0,56,41,4
166328,56,0,56,42,1
166328,56,0,56,43,1
166328,11,0,11,44,1
166328,45,0,45,45,1
166328,45,0,45,60,1
166391,2081,726,1355,1,4
166391,1687,608,1079,2,1
166391,1667,602,1065,3,1
166391,485,162,323,4,1
166391,1182,440,742,5,1
166391,20,6,14,11,1
166391,394,118,276,12,3
166391,73,36,37,19,1
166391,1109,404,705,20,1
166391,1767,630,1137,21,4
166391,1649,594,1055,22,1
166391,1649,594,1055,23,1
166391,484,162,322,24,1
166391,1165,432,733,25,1
166391,118,36,82,32,3
166391,71,35,36,39,1
166391,1094,397,697,40,1
166391,314,96,218,41,4
166391,38,14,24,42,1
166391,18,8,10,43,1
166391,1,0,1,44,1
166391,17,8,9,45,1
166391,20,6,14,51,1
166391,276,82,194,52,3
166391,2,1,1,59,1
166391,15,7,8,60,1
166407,302,37,265,1,4
166407,302,37,265,2,1
166407,302,37,265,3,1
166407,3,1,2,4,1
166407,299,36,263,5,1
166407,44,7,37,19,1
166407,255,29,226,20,1
166407,266,30,236,21,4
166407,266,30,236,22,1
166407,266,30,236,23,1
166407,266,30,236,25,1
166407,12,2,10,39,1
166407,254,28,226,40,1
166407,36,7,29,41,4
166407,36,7,29,42,1
166407,36,7,29,43,1
166407,3,1,2,44,1
166407,33,6,27,45,1
166407,32,5,27,59,1
166407,1,1,0,60,1
166452,5195,929,4266,1,4
166452,1948,448,1500,2,1
166452,1785,402,1383,3,1
166452,323,74,249,4,1
166452,1462,328,1134,5,1
166452,163,46,117,11,1
166452,3247,481,2766,12,3
166452,152,30,122,19,1
166452,1310,298,1012,20,1
166452,2554,504,2050,21,4
166452,1460,336,1124,22,1
166452,1457,336,1121,23,1
166452,317,74,243,24,1
166452,1140,262,878,25,1
166452,3,0,3,31,1
166452,1094,168,926,32,3
166452,103,19,84,39,1
166452,1037,243,794,40,1
166452,2641,425,2216,41,4
166452,488,112,376,42,1
166452,328,66,262,43,1
166452,6,0,6,44,1
166452,322,66,256,45,1
166452,160,46,114,51,1
166452,2153,313,1840,52,3
166452,49,11,38,59,1
166452,273,55,218,60,1
166489,265,105,160,1,4
166489,58,25,33,2,1
166489,58,25,33,3,1
166489,12,7,5,4,1
166489,46,18,28,5,1
166489,207,80,127,12,3
166489,6,1,5,19,1
166489,40,17,23,20,1
166489,249,100,149,21,4
166489,55,24,31,22,1
166489,55,24,31,23,1
166489,12,7,5,24,1
166489,43,17,26,25,1
166489,194,76,118,32,3
166489,6,1,5,39,1
166489,37,16,21,40,1
166489,16,5,11,41,4
166489,3,1,2,42,1
166489,3,1,2,43,1
166489,3,1,2,45,1
166489,13,4,9,52,3
166489,3,1,2,60,1
166498,102,7,95,1,4
166498,102,7,95,2,1
166498,102,7,95,3,1
166498,76,4,72,4,1
166498,26,3,23,5,1
166498,26,3,23,20,1
166498,74,4,70,21,4
166498,74,4,70,22,1
166498,74,4,70,23,1
166498,58,3,55,24,1
166498,16,1,15,25,1
166498,16,1,15,40,1
166498,28,3,25,41,4
166498,28,3,25,42,1
166498,28,3,25,43,1
166498,18,1,17,44,1
166498,10,2,8,45,1
166498,10,2,8,60,1
166513,16932,10017,6915,1,4
166513,12734,7777,4957,2,1
166513,11830,7217,4613,3,1
166513,1650,1057,593,4,1
166513,10180,6160,4020,5,1
166513,904,560,344,11,1
166513,4198,2240,1958,12,3
166513,1289,729,560,19,1
166513,8891,5431,3460,20,1
166513,10322,6336,3986,21,4
166513,9034,5581,3453,22,1
166513,8889,5470,3419,23,1
166513,1626,1042,584,24,1
166513,7263,4428,2835,25,1
166513,145,111,34,31,1
166513,1288,755,533,32,3
166513,950,543,407,39,1
166513,6313,3885,2428,40,1
166513,6610,3681,2929,41,4
166513,3700,2196,1504,42,1
166513,2941,1747,1194,43,1
166513,24,15,9,44,1
166513,2917,1732,1185,45,1
166513,759,449,310,51,1
166513,2910,1485,1425,52,3
166513,339,186,153,59,1
166513,2578,1546,1032,60,1
166586,38,2,36,1,4
166586,38,2,36,2,1
166586,38,2,36,3,1
166586,5,1,4,4,1
166586,33,1,32,5,1
166586,33,1,32,20,1
166586,30,2,28,21,4
166586,30,2,28,22,1
166586,30,2,28,23,1
166586,4,1,3,24,1
166586,26,1,25,25,1
166586,26,1,25,40,1
166586,8,0,8,41,4
166586,8,0,8,42,1
166586,8,0,8,43,1
166586,1,0,1,44,1
166586,7,0,7,45,1
166586,7,0,7,60,1
166595,60,6,54,1,4
166595,60,6,54,2,1
166595,60,6,54,3,1
166595,10,3,7,4,1
166595,50,3,47,5,1
166595,50,3,47,20,1
166595,39,6,33,21,4
166595,39,6,33,22,1
166595,39,6,33,23,1
166595,8,3,5,24,1
166595,31,3,28,25,1
166595,31,3,28,40,1
166595,21,0,21,41,4
166595,21,0,21,42,1
166595,21,0,21,43,1
166595,2,0,2,44,1
166595,19,0,19,45,1
166595,19,0,19,60,1
166601,266,73,193,1,4
166601,266,73,193,2,1
166601,173,41,132,3,1
166601,24,3,21,4,1
166601,149,38,111,5,1
166601,93,32,61,11,1
166601,13,4,9,19,1
166601,136,34,102,20,1
166601,130,34,96,21,4
166601,130,34,96,22,1
166601,130,34,96,23,1
166601,20,3,17,24,1
166601,110,31,79,25,1
166601,9,4,5,39,1
166601,101,27,74,40,1
166601,136,39,97,41,4
166601,136,39,97,42,1
166601,43,7,36,43,1
166601,4,0,4,44,1
166601,39,7,32,45,1
166601,93,32,61,51,1
166601,4,0,4,59,1
166601,35,7,28,60,1
166629,28518,14467,14051,1,4
166629,22134,11260,10874,2,1
166629,21672,11067,10605,3,1
166629,4686,2407,2279,4,1
166629,16986,8660,8326,5,1
166629,462,193,269,11,1
166629,6384,3207,3177,12,3
166629,1468,732,736,19,1
166629,15518,7928,7590,20,1
166629,22808,11665,11143,21,4
166629,20505,10597,9908,22,1
166629,20384,10557,9827,23,1
166629,4683,2406,2277,24,1
166629,15701,8151,7550,25,1
166629,121,40,81,31,1
166629,2303,1068,1235,32,3
166629,1181,638,543,39,1
166629,14520,7513,7007,40,1
166629,5710,2802,2908,41,4
166629,1629,663,966,42,1
166629,1288,510,778,43,1
166629,3,1,2,44,1
166629,1285,509,776,45,1
166629,341,153,188,51,1
166629,4081,2139,1942,52,3
166629,287,94,193,59,1
166629,998,415,583,60,1
166638,16277,6664,9613,1,4
166638,12366,5438,6928,2,1
166638,11786,5154,6632,3,1
166638,1413,703,710,4,1
166638,10373,4451,5922,5,1
166638,580,284,296,11,1
166638,3911,1226,2685,12,3
166638,1719,707,1012,19,1
166638,8654,3744,4910,20,1
166638,9999,4329,5670,21,4
166638,8759,3926,4833,22,1
166638,8642,3864,4778,23,1
166638,1313,641,672,24,1
166638,7329,3223,4106,25,1
166638,117,62,55,31,1
166638,1240,403,837,32,3
166638,1244,540,704,39,1
166638,6085,2683,3402,40,1
166638,6278,2335,3943,41,4
166638,3607,1512,2095,42,1
166638,3144,1290,1854,43,1
166638,100,62,38,44,1
166638,3044,1228,1816,45,1
166638,463,222,241,51,1
166638,2671,823,1848,52,3
166638,475,167,308,59,1
166638,2569,1061,1508,60,1
166647,5377,2464,2913,1,4
166647,5377,2464,2913,2,1
166647,4573,2150,2423,3,1
166647,1219,643,576,4,1
166647,3354,1507,1847,5,1
166647,804,314,490,11,1
166647,224,94,130,19,1
166647,3130,1413,1717,20,1
166647,1961,1078,883,21,4
166647,1961,1078,883,22,1
166647,1862,1022,840,23,1
166647,656,378,278,24,1
166647,1206,644,562,25,1
166647,99,56,43,31,1
166647,102,48,54,39,1
166647,1104,596,508,40,1
166647,3416,1386,2030,41,4
166647,3416,1386,2030,42,1
166647,2711,1128,1583,43,1
166647,563,265,298,44,1
166647,2148,863,1285,45,1
166647,705,258,447,51,1
166647,122,46,76,59,1
166647,2026,817,1209,60,1
166656,6548,2203,4345,1,4
166656,3897,1286,2611,2,1
166656,3808,1278,2530,3,1
166656,912,310,602,4,1
166656,2896,968,1928,5,1
166656,89,8,81,11,1
166656,2651,917,1734,12,3
166656,217,56,161,19,1
166656,2679,912,1767,20,1
166656,6042,2111,3931,21,4
166656,3723,1257,2466,22,1
166656,3681,1257,2424,23,1
166656,912,310,602,24,1
166656,2769,947,1822,25,1
166656,42,0,42,31,1
166656,2319,854,1465,32,3
166656,164,51,113,39,1
166656,2605,896,1709,40,1
166656,506,92,414,41,4
166656,174,29,145,42,1
166656,127,21,106,43,1
166656,127,21,106,45,1
166656,47,8,39,51,1
166656,332,63,269,52,3
166656,53,5,48,59,1
166656,74,16,58,60,1
166674,2264,697,1567,1,4
166674,2120,634,1486,2,1
166674,1861,559,1302,3,1
166674,367,97,270,4,1
166674,1494,462,1032,5,1
166674,259,75,184,11,1
166674,144,63,81,12,3
166674,127,41,86,19,1
166674,1367,421,946,20,1
166674,1793,559,1234,21,4
166674,1677,504,1173,22,1
166674,1676,504,1172,23,1
166674,366,97,269,24,1
166674,1310,407,903,25,1
166674,1,0,1,31,1
166674,116,55,61,32,3
166674,121,37,84,39,1
166674,1189,370,819,40,1
166674,471,138,333,41,4
166674,443,130,313,42,1
166674,185,55,130,43,1
166674,1,0,1,44,1
166674,184,55,129,45,1
166674,258,75,183,51,1
166674,28,8,20,52,3
166674,6,4,2,59,1
166674,178,51,127,60,1
166683,11301,7139,4162,1,4
166683,4528,2487,2041,2,1
166683,4510,2475,2035,3,1
166683,1115,609,506,4,1
166683,3395,1866,1529,5,1
166683,18,12,6,11,1
166683,6773,4652,2121,12,3
166683,19,14,5,19,1
166683,3376,1852,1524,20,1
166683,11138,7025,4113,21,4
166683,4499,2470,2029,22,1
166683,4485,2460,2025,23,1
166683,1115,609,506,24,1
166683,3370,1851,1519,25,1
166683,14,10,4,31,1
166683,6639,4555,2084,32,3
166683,19,14,5,39,1
166683,3351,1837,1514,40,1
166683,163,114,49,41,4
166683,29,17,12,42,1
166683,25,15,10,43,1
166683,25,15,10,45,1
166683,4,2,2,51,1
166683,134,97,37,52,3
166683,25,15,10,60,1
166692,1476,1296,180,1,4
166692,1376,1214,162,2,1
166692,1362,1205,157,3,1
166692,332,278,54,4,1
166692,1030,927,103,5,1
166692,14,9,5,11,1
166692,100,82,18,12,3
166692,49,45,4,19,1
166692,981,882,99,20,1
166692,1333,1180,153,21,4
166692,1333,1180,153,22,1
166692,1333,1180,153,23,1
166692,332,278,54,24,1
166692,1001,902,99,25,1
166692,49,45,4,39,1
166692,952,857,95,40,1
166692,143,116,27,41,4
166692,43,34,9,42,1
166692,29,25,4,43,1
166692,29,25,4,45,1
166692,14,9,5,51,1
166692,100,82,18,52,3
166692,29,25,4,60,1
166708,1161,465,696,1,4
166708,1161,465,696,12,3
166708,1056,435,621,21,4
166708,1056,435,621,32,3
166708,105,30,75,41,4
166708,105,30,75,52,3
166717,652,138,514,1,4
166717,652,138,514,12,3
166717,478,105,373,21,4
166717,478,105,373,32,3
166717,174,33,141,41,4
166717,174,33,141,52,3
166805,91,81,10,1,4
166805,91,81,10,2,1
166805,91,81,10,3,1
166805,44,43,1,4,1
166805,47,38,9,5,1
166805,47,38,9,20,1
166805,26,23,3,21,4
166805,26,23,3,22,1
166805,26,23,3,23,1
166805,14,13,1,24,1
166805,12,10,2,25,1
166805,12,10,2,40,1
166805,65,58,7,41,4
166805,65,58,7,42,1
166805,65,58,7,43,1
166805,30,30,0,44,1
166805,35,28,7,45,1
166805,35,28,7,60,1
166823,8272,3581,4691,1,4
166823,8272,3581,4691,2,1
166823,7034,3055,3979,3,1
166823,1860,950,910,4,1
166823,5174,2105,3069,5,1
166823,1238,526,712,11,1
166823,465,170,295,19,1
166823,4709,1935,2774,20,1
166823,3618,1815,1803,21,4
166823,3618,1815,1803,22,1
166823,3471,1724,1747,23,1
166823,1281,695,586,24,1
166823,2190,1029,1161,25,1
166823,147,91,56,31,1
166823,223,97,126,39,1
166823,1967,932,1035,40,1
166823,4654,1766,2888,41,4
166823,4654,1766,2888,42,1
166823,3563,1331,2232,43,1
166823,579,255,324,44,1
166823,2984,1076,1908,45,1
166823,1091,435,656,51,1
166823,242,73,169,59,1
166823,2742,1003,1739,60,1
166850,3067,1478,1589,1,4
166850,2758,1397,1361,2,1
166850,2722,1368,1354,3,1
166850,794,386,408,4,1
166850,1928,982,946,5,1
166850,36,29,7,11,1
166850,309,81,228,12,3
166850,85,45,40,19,1
166850,1843,937,906,20,1
166850,2790,1364,1426,21,4
166850,2604,1306,1298,22,1
166850,2602,1305,1297,23,1
166850,794,386,408,24,1
166850,1808,919,889,25,1
166850,2,1,1,31,1
166850,186,58,128,32,3
166850,83,45,38,39,1
166850,1725,874,851,40,1
166850,277,114,163,41,4
166850,154,91,63,42,1
166850,120,63,57,43,1
166850,120,63,57,45,1
166850,34,28,6,51,1
166850,123,23,100,52,3
166850,2,0,2,59,1
166850,118,63,55,60,1
166869,1096,184,912,1,4
166869,162,22,140,2,1
166869,160,21,139,3,1
166869,160,21,139,5,1
166869,2,1,1,11,1
166869,934,162,772,12,3
166869,160,21,139,20,1
166869,784,124,660,21,4
166869,162,22,140,22,1
166869,160,21,139,23,1
166869,160,21,139,25,1
166869,2,1,1,31,1
166869,622,102,520,32,3
166869,160,21,139,40,1
166869,312,60,252,41,4
166869,312,60,252,52,3
166887,9702,4211,5491,1,4
166887,9702,4211,5491,2,1
166887,8871,3867,5004,3,1
166887,2034,978,1056,4,1
166887,6837,2889,3948,5,1
166887,831,344,487,11,1
166887,745,321,424,19,1
166887,6092,2568,3524,20,1
166887,3619,1746,1873,21,4
166887,3619,1746,1873,22,1
166887,3567,1717,1850,23,1
166887,1118,547,571,24,1
166887,2449,1170,1279,25,1
166887,52,29,23,31,1
166887,304,153,151,39,1
166887,2145,1017,1128,40,1
166887,6083,2465,3618,41,4
166887,6083,2465,3618,42,1
166887,5304,2150,3154,43,1
166887,916,431,485,44,1
166887,4388,1719,2669,45,1
166887,779,315,464,51,1
166887,441,168,273,59,1
166887,3947,1551,2396,60,1
166911,392,106,286,1,4
166911,392,106,286,2,1
166911,378,100,278,3,1
166911,103,22,81,4,1
166911,275,78,197,5,1
166911,14,6,8,11,1
166911,18,7,11,19,1
166911,257,71,186,20,1
166911,379,104,275,21,4
166911,379,104,275,22,1
166911,373,98,275,23,1
166911,102,22,80,24,1
166911,271,76,195,25,1
166911,6,6,0,31,1
166911,18,7,11,39,1
166911,253,69,184,40,1
166911,13,2,11,41,4
166911,13,2,11,42,1
166911,5,2,3,43,1
166911,1,0,1,44,1
166911,4,2,2,45,1
166911,8,0,8,51,1
166911,4,2,2,60,1
166939,2251,12,2239,1,4
166939,2183,2,2181,2,1
166939,2154,0,2154,3,1
166939,513,0,513,4,1
166939,1641,0,1641,5,1
166939,29,2,27,11,1
166939,68,10,58,12,3
166939,58,0,58,19,1
166939,1583,0,1583,20,1
166939,2188,8,2180,21,4
166939,2151,0,2151,22,1
166939,2136,0,2136,23,1
166939,511,0,511,24,1
166939,1625,0,1625,25,1
166939,15,0,15,31,1
166939,37,8,29,32,3
166939,57,0,57,39,1
166939,1568,0,1568,40,1
166939,63,4,59,41,4
166939,32,2,30,42,1
166939,18,0,18,43,1
166939,2,0,2,44,1
166939,16,0,16,45,1
166939,14,2,12,51,1
166939,31,2,29,52,3
166939,1,0,1,59,1
166939,15,0,15,60,1
166948,1288,442,846,1,4
166948,1268,436,832,2,1
166948,1261,433,828,3,1
166948,307,110,197,4,1
166948,954,323,631,5,1
166948,7,3,4,11,1
166948,20,6,14,12,3
166948,116,30,86,19,1
166948,838,293,545,20,1
166948,1176,419,757,21,4
166948,1167,416,751,22,1
166948,1167,416,751,23,1
166948,307,110,197,24,1
166948,860,306,554,25,1
166948,9,3,6,32,3
166948,102,29,73,39,1
166948,758,277,481,40,1
166948,112,23,89,41,4
166948,101,20,81,42,1
166948,94,17,77,43,1
166948,94,17,77,45,1
166948,7,3,4,51,1
166948,11,3,8,52,3
166948,14,1,13,59,1
166948,80,16,64,60,1
166957,4734,1671,3063,1,4
166957,4734,1671,3063,2,1
166957,4222,1470,2752,3,1
166957,915,423,492,4,1
166957,3307,1047,2260,5,1
166957,512,201,311,11,1
166957,321,108,213,19,1
166957,2986,939,2047,20,1
166957,2000,826,1174,21,4
166957,2000,826,1174,22,1
166957,1906,795,1111,23,1
166957,596,289,307,24,1
166957,1310,506,804,25,1
166957,94,31,63,31,1
166957,140,65,75,39,1
166957,1170,441,729,40,1
166957,2734,845,1889,41,4
166957,2734,845,1889,42,1
166957,2316,675,1641,43,1
166957,319,134,185,44,1
166957,1997,541,1456,45,1
166957,418,170,248,51,1
166957,181,43,138,59,1
166957,1816,498,1318,60,1
166975,210,57,153,1,4
166975,210,57,153,2,1
166975,210,57,153,3,1
166975,75,18,57,4,1
166975,135,39,96,5,1
166975,135,39,96,20,1
166975,85,25,60,21,4
166975,85,25,60,22,1
166975,85,25,60,23,1
166975,30,8,22,24,1
166975,55,17,38,25,1
166975,55,17,38,40,1
166975,125,32,93,41,4
166975,125,32,93,42,1
166975,125,32,93,43,1
166975,45,10,35,44,1
166975,80,22,58,45,1
166975,80,22,58,60,1
166984,651,181,470,1,4
166984,484,133,351,2,1
166984,340,98,242,3,1
166984,54,16,38,4,1
166984,286,82,204,5,1
166984,144,35,109,11,1
166984,167,48,119,12,3
166984,32,15,17,19,1
166984,254,67,187,20,1
166984,563,163,400,21,4
166984,404,118,286,22,1
166984,320,91,229,23,1
166984,54,16,38,24,1
166984,266,75,191,25,1
166984,84,27,57,31,1
166984,159,45,114,32,3
166984,29,13,16,39,1
166984,237,62,175,40,1
166984,88,18,70,41,4
166984,80,15,65,42,1
166984,20,7,13,43,1
166984,20,7,13,45,1
166984,60,8,52,51,1
166984,8,3,5,52,3
166984,3,2,1,59,1
166984,17,5,12,60,1
167020,369,44,325,1,4
167020,369,44,325,2,1
167020,369,44,325,3,1
167020,86,9,77,4,1
167020,283,35,248,5,1
167020,283,35,248,20,1
167020,369,44,325,21,4
167020,369,44,325,22,1
167020,369,44,325,23,1
167020,86,9,77,24,1
167020,283,35,248,25,1
167020,283,35,248,40,1
167039,27,2,25,1,4
167039,27,2,25,2,1
167039,27,2,25,3,1
167039,11,1,10,4,1
167039,16,1,15,5,1
167039,16,1,15,20,1
167039,27,2,25,21,4
167039,27,2,25,22,1
167039,27,2,25,23,1
167039,11,1,10,24,1
167039,16,1,15,25,1
167039,16,1,15,40,1
167057,813,430,383,1,4
167057,431,253,178,2,1
167057,410,240,170,3,1
167057,96,56,40,4,1
167057,314,184,130,5,1
167057,21,13,8,11,1
167057,382,177,205,12,3
167057,13,6,7,19,1
167057,301,178,123,20,1
167057,749,393,356,21,4
167057,396,231,165,22,1
167057,393,230,163,23,1
167057,93,54,39,24,1
167057,300,176,124,25,1
167057,3,1,2,31,1
167057,353,162,191,32,3
167057,12,5,7,39,1
167057,288,171,117,40,1
167057,64,37,27,41,4
167057,35,22,13,42,1
167057,17,10,7,43,1
167057,3,2,1,44,1
167057,14,8,6,45,1
167057,18,12,6,51,1
167057,29,15,14,52,3
167057,1,1,0,59,1
167057,13,7,6,60,1
167093,502,137,365,1,4
167093,502,137,365,12,3
167093,498,135,363,21,4
167093,498,135,363,32,3
167093,4,2,2,41,4
167093,4,2,2,52,3
167181,179,42,137,1,4
167181,179,42,137,12,3
167181,132,30,102,21,4
167181,132,30,102,32,3
167181,47,12,35,41,4
167181,47,12,35,52,3
167215,964,408,556,1,4
167215,964,408,556,12,3
167215,676,282,394,21,4
167215,676,282,394,32,3
167215,288,126,162,41,4
167215,288,126,162,52,3
167224,66,20,46,1,4
167224,66,20,46,2,1
167224,66,20,46,3,1
167224,17,5,12,4,1
167224,49,15,34,5,1
167224,49,15,34,20,1
167224,66,20,46,21,4
167224,66,20,46,22,1
167224,66,20,46,23,1
167224,17,5,12,24,1
167224,49,15,34,25,1
167224,49,15,34,40,1
167251,962,426,536,1,4
167251,962,426,536,2,1
167251,961,425,536,3,1
167251,268,121,147,4,1
167251,693,304,389,5,1
167251,1,1,0,11,1
167251,41,21,20,19,1
167251,652,283,369,20,1
167251,851,382,469,21,4
167251,851,382,469,22,1
167251,851,382,469,23,1
167251,267,120,147,24,1
167251,584,262,322,25,1
167251,36,19,17,39,1
167251,548,243,305,40,1
167251,111,44,67,41,4
167251,111,44,67,42,1
167251,110,43,67,43,1
167251,1,1,0,44,1
167251,109,42,67,45,1
167251,1,1,0,51,1
167251,5,2,3,59,1
167251,104,40,64,60,1
167260,1459,854,605,1,4
167260,1281,761,520,2,1
167260,1260,746,514,3,1
167260,380,245,135,4,1
167260,880,501,379,5,1
167260,21,15,6,11,1
167260,178,93,85,12,3
167260,58,25,33,19,1
167260,822,476,346,20,1
167260,1138,705,433,21,4
167260,1100,682,418,22,1
167260,1099,681,418,23,1
167260,379,244,135,24,1
167260,720,437,283,25,1
167260,1,1,0,31,1
167260,38,23,15,32,3
167260,49,22,27,39,1
167260,671,415,256,40,1
167260,321,149,172,41,4
167260,181,79,102,42,1
167260,161,65,96,43,1
167260,1,1,0,44,1
167260,160,64,96,45,1
167260,20,14,6,51,1
167260,140,70,70,52,3
167260,9,3,6,59,1
167260,151,61,90,60,1
167288,1716,684,1032,1,4
167288,1538,612,926,2,1
167288,1483,587,896,3,1
167288,275,92,183,4,1
167288,1208,495,713,5,1
167288,55,25,30,11,1
167288,178,72,106,12,3
167288,128,49,79,19,1
167288,1080,446,634,20,1
167288,1374,551,823,21,4
167288,1353,546,807,22,1
167288,1345,544,801,23,1
167288,271,91,180,24,1
167288,1074,453,621,25,1
167288,8,2,6,31,1
167288,21,5,16,32,3
167288,111,47,64,39,1
167288,963,406,557,40,1
167288,342,133,209,41,4
167288,185,66,119,42,1
167288,138,43,95,43,1
167288,4,1,3,44,1
167288,134,42,92,45,1
167288,47,23,24,51,1
167288,157,67,90,52,3
167288,17,2,15,59,1
167288,117,40,77,60,1
167297,161,110,51,1,4
167297,161,110,51,2,1
167297,161,110,51,3,1
167297,15,12,3,4,1
167297,146,98,48,5,1
167297,146,98,48,20,1
167297,161,110,51,21,4
167297,161,110,51,22,1
167297,161,110,51,23,1
167297,15,12,3,24,1
167297,146,98,48,25,1
167297,146,98,48,40,1
167312,7750,3071,4679,1,4
167312,7750,3071,4679,2,1
167312,7053,2816,4237,3,1
167312,1469,668,801,4,1
167312,5584,2148,3436,5,1
167312,697,255,442,11,1
167312,635,225,410,19,1
167312,4949,1923,3026,20,1
167312,3018,1383,1635,21,4
167312,3018,1383,1635,22,1
167312,2973,1355,1618,23,1
167312,936,439,497,24,1
167312,2037,916,1121,25,1
167312,45,28,17,31,1
167312,292,126,166,39,1
167312,1745,790,955,40,1
167312,4732,1688,3044,41,4
167312,4732,1688,3044,42,1
167312,4080,1461,2619,43,1
167312,533,229,304,44,1
167312,3547,1232,2315,45,1
167312,652,227,425,51,1
167312,343,99,244,59,1
167312,3204,1133,2071,60,1
167321,779,508,271,1,4
167321,779,508,271,2,1
167321,779,508,271,3,1
167321,136,93,43,4,1
167321,643,415,228,5,1
167321,78,53,25,19,1
167321,565,362,203,20,1
167321,712,461,251,21,4
167321,712,461,251,22,1
167321,712,461,251,23,1
167321,135,92,43,24,1
167321,577,369,208,25,1
167321,75,51,24,39,1
167321,502,318,184,40,1
167321,67,47,20,41,4
167321,67,47,20,42,1
167321,67,47,20,43,1
167321,1,1,0,44,1
167321,66,46,20,45,1
167321,3,2,1,59,1
167321,63,44,19,60,1
167358,20053,10092,9961,1,4
167358,13223,6427,6796,2,1
167358,13204,6418,6786,3,1
167358,2891,1346,1545,4,1
167358,10313,5072,5241,5,1
167358,19,9,10,11,1
167358,6830,3665,3165,12,3
167358,656,297,359,19,1
167358,9657,4775,4882,20,1
167358,17957,8901,9056,21,4
167358,13204,6418,6786,22,1
167358,13204,6418,6786,23,1
167358,2891,1346,1545,24,1
167358,10313,5072,5241,25,1
167358,4753,2483,2270,32,3
167358,656,297,359,39,1
167358,9657,4775,4882,40,1
167358,2096,1191,905,41,4
167358,19,9,10,42,1
167358,19,9,10,51,1
167358,2077,1182,895,52,3
167376,7352,2817,4535,1,4
167376,7352,2817,4535,2,1
167376,6746,2597,4149,3,1
167376,1518,705,813,4,1
167376,5228,1892,3336,5,1
167376,606,220,386,11,1
167376,426,161,265,19,1
167376,4802,1731,3071,20,1
167376,2438,1118,1320,21,4
167376,2438,1118,1320,22,1
167376,2418,1108,1310,23,1
167376,827,396,431,24,1
167376,1591,712,879,25,1
167376,20,10,10,31,1
167376,156,66,90,39,1
167376,1435,646,789,40,1
167376,4914,1699,3215,41,4
167376,4914,1699,3215,42,1
167376,4328,1489,2839,43,1
167376,691,309,382,44,1
167376,3637,1180,2457,45,1
167376,586,210,376,51,1
167376,270,95,175,59,1
167376,3367,1085,2282,60,1
167394,1678,382,1296,1,4
167394,1347,320,1027,2,1
167394,1308,310,998,3,1
167394,192,52,140,4,1
167394,1116,258,858,5,1
167394,39,10,29,11,1
167394,331,62,269,12,3
167394,239,65,174,19,1
167394,877,193,684,20,1
167394,1021,266,755,21,4
167394,1006,263,743,22,1
167394,1006,263,743,23,1
167394,187,51,136,24,1
167394,819,212,607,25,1
167394,15,3,12,32,3
167394,154,44,110,39,1
167394,665,168,497,40,1
167394,657,116,541,41,4
167394,341,57,284,42,1
167394,302,47,255,43,1
167394,5,1,4,44,1
167394,297,46,251,45,1
167394,39,10,29,51,1
167394,316,59,257,52,3
167394,85,21,64,59,1
167394,212,25,187,60,1
167455,346,55,291,1,4
167455,313,47,266,2,1
167455,221,3,218,3,1
167455,53,1,52,4,1
167455,168,2,166,5,1
167455,92,44,48,11,1
167455,33,8,25,12,3
167455,13,0,13,19,1
167455,155,2,153,20,1
167455,338,55,283,21,4
167455,305,47,258,22,1
167455,213,3,210,23,1
167455,52,1,51,24,1
167455,161,2,159,25,1
167455,92,44,48,31,1
167455,33,8,25,32,3
167455,12,0,12,39,1
167455,149,2,147,40,1
167455,8,0,8,41,4
167455,8,0,8,42,1
167455,8,0,8,43,1
167455,1,0,1,44,1
167455,7,0,7,45,1
167455,1,0,1,59,1
167455,6,0,6,60,1
167464,57,57,0,1,4
167464,57,57,0,12,3
167464,57,57,0,21,4
167464,57,57,0,32,3
167525,4576,1474,3102,1,4
167525,4576,1474,3102,2,1
167525,4025,1303,2722,3,1
167525,600,240,360,4,1
167525,3425,1063,2362,5,1
167525,551,171,380,11,1
167525,884,282,602,19,1
167525,2541,781,1760,20,1
167525,1718,689,1029,21,4
167525,1718,689,1029,22,1
167525,1684,668,1016,23,1
167525,366,148,218,24,1
167525,1318,520,798,25,1
167525,34,21,13,31,1
167525,365,138,227,39,1
167525,953,382,571,40,1
167525,2858,785,2073,41,4
167525,2858,785,2073,42,1
167525,2341,635,1706,43,1
167525,234,92,142,44,1
167525,2107,543,1564,45,1
167525,517,150,367,51,1
167525,519,144,375,59,1
167525,1588,399,1189,60,1
167534,8582,3672,4910,1,4
167534,8582,3672,4910,2,1
167534,7647,3247,4400,3,1
167534,1843,947,896,4,1
167534,5804,2300,3504,5,1
167534,935,425,510,11,1
167534,520,207,313,19,1
167534,5284,2093,3191,20,1
167534,3440,1687,1753,21,4
167534,3440,1687,1753,22,1
167534,3283,1597,1686,23,1
167534,1007,555,452,24,1
167534,2276,1042,1234,25,1
167534,157,90,67,31,1
167534,243,122,121,39,1
167534,2033,920,1113,40,1
167534,5142,1985,3157,41,4
167534,5142,1985,3157,42,1
167534,4364,1650,2714,43,1
167534,836,392,444,44,1
167534,3528,1258,2270,45,1
167534,778,335,443,51,1
167534,277,85,192,59,1
167534,3251,1173,2078,60,1
167598,2069,388,1681,1,4
167598,1188,280,908,2,1
167598,1188,280,908,3,1
167598,266,54,212,4,1
167598,922,226,696,5,1
167598,881,108,773,12,3
167598,58,12,46,19,1
167598,864,214,650,20,1
167598,1225,274,951,21,4
167598,948,240,708,22,1
167598,948,240,708,23,1
167598,266,54,212,24,1
167598,682,186,496,25,1
167598,277,34,243,32,3
167598,58,12,46,39,1
167598,624,174,450,40,1
167598,844,114,730,41,4
167598,240,40,200,42,1
167598,240,40,200,43,1
167598,240,40,200,45,1
167598,604,74,530,52,3
167598,240,40,200,60,1
167631,2437,804,1633,1,4
167631,2437,804,1633,2,1
167631,2216,728,1488,3,1
167631,524,196,328,4,1
167631,1692,532,1160,5,1
167631,221,76,145,11,1
167631,10,6,4,19,1
167631,1682,526,1156,20,1
167631,793,275,518,21,4
167631,793,275,518,22,1
167631,783,270,513,23,1
167631,226,83,143,24,1
167631,557,187,370,25,1
167631,10,5,5,31,1
167631,4,4,0,39,1
167631,553,183,370,40,1
167631,1644,529,1115,41,4
167631,1644,529,1115,42,1
167631,1433,458,975,43,1
167631,298,113,185,44,1
167631,1135,345,790,45,1
167631,211,71,140,51,1
167631,6,2,4,59,1
167631,1129,343,786,60,1
167677,192,140,52,1,4
167677,43,43,0,2,1
167677,35,35,0,3,1
167677,35,35,0,5,1
167677,8,8,0,11,1
167677,149,97,52,12,3
167677,17,17,0,19,1
167677,18,18,0,20,1
167677,117,106,11,21,4
167677,35,35,0,22,1
167677,35,35,0,23,1
167677,35,35,0,25,1
167677,82,71,11,32,3
167677,17,17,0,39,1
167677,18,18,0,40,1
167677,75,34,41,41,4
167677,8,8,0,42,1
167677,8,8,0,51,1
167677,67,26,41,52,3
167729,9301,3437,5864,1,4
167729,7664,3013,4651,2,1
167729,7134,2766,4368,3,1
167729,1087,398,689,4,1
167729,6047,2368,3679,5,1
167729,530,247,283,11,1
167729,1637,424,1213,12,3
167729,782,325,457,19,1
167729,5265,2043,3222,20,1
167729,6194,2396,3798,21,4
167729,5834,2314,3520,22,1
167729,5752,2267,3485,23,1
167729,1074,391,683,24,1
167729,4678,1876,2802,25,1
167729,82,47,35,31,1
167729,360,82,278,32,3
167729,630,277,353,39,1
167729,4048,1599,2449,40,1
167729,3107,1041,2066,41,4
167729,1830,699,1131,42,1
167729,1382,499,883,43,1
167729,13,7,6,44,1
167729,1369,492,877,45,1
167729,448,200,248,51,1
167729,1277,342,935,52,3
167729,152,48,104,59,1
167729,1217,444,773,60,1
167738,699,117,582,1,4
167738,699,117,582,2,1
167738,697,117,580,3,1
167738,648,109,539,4,1
167738,49,8,41,5,1
167738,2,0,2,11,1
167738,49,8,41,20,1
167738,530,87,443,21,4
167738,530,87,443,22,1
167738,528,87,441,23,1
167738,495,83,412,24,1
167738,33,4,29,25,1
167738,2,0,2,31,1
167738,33,4,29,40,1
167738,169,30,139,41,4
167738,169,30,139,42,1
167738,169,30,139,43,1
167738,153,26,127,44,1
167738,16,4,12,45,1
167738,16,4,12,60,1
167783,4655,384,4271,1,4
167783,1732,3,1729,2,1
167783,1710,0,1710,3,1
167783,338,0,338,4,1
167783,1372,0,1372,5,1
167783,22,3,19,11,1
167783,2923,381,2542,12,3
167783,59,0,59,19,1
167783,1313,0,1313,20,1
167783,2335,90,2245,21,4
167783,1577,0,1577,22,1
167783,1575,0,1575,23,1
167783,338,0,338,24,1
167783,1237,0,1237,25,1
167783,2,0,2,31,1
167783,758,90,668,32,3
167783,59,0,59,39,1
167783,1178,0,1178,40,1
167783,2320,294,2026,41,4
167783,155,3,152,42,1
167783,135,0,135,43,1
167783,135,0,135,45,1
167783,20,3,17,51,1
167783,2165,291,1874,52,3
167783,135,0,135,60,1
167792,350,148,202,1,4
167792,350,148,202,2,1
167792,344,145,199,3,1
167792,144,57,87,4,1
167792,200,88,112,5,1
167792,6,3,3,11,1
167792,2,0,2,19,1
167792,198,88,110,20,1
167792,341,142,199,21,4
167792,341,142,199,22,1
167792,341,142,199,23,1
167792,144,57,87,24,1
167792,197,85,112,25,1
167792,2,0,2,39,1
167792,195,85,110,40,1
167792,9,6,3,41,4
167792,9,6,3,42,1
167792,3,3,0,43,1
167792,3,3,0,45,1
167792,6,3,3,51,1
167792,3,3,0,60,1
167835,3033,68,2965,1,4
167835,2606,2,2604,2,1
167835,2606,2,2604,3,1
167835,643,0,643,4,1
167835,1963,2,1961,5,1
167835,427,66,361,12,3
167835,85,0,85,19,1
167835,1878,2,1876,20,1
167835,2937,50,2887,21,4
167835,2585,2,2583,22,1
167835,2585,2,2583,23,1
167835,643,0,643,24,1
167835,1942,2,1940,25,1
167835,352,48,304,32,3
167835,83,0,83,39,1
167835,1859,2,1857,40,1
167835,96,18,78,41,4
167835,21,0,21,42,1
167835,21,0,21,43,1
167835,21,0,21,45,1
167835,75,18,57,52,3
167835,2,0,2,59,1
167835,19,0,19,60,1
167871,112,20,92,1,4
167871,112,20,92,2,1
167871,112,20,92,3,1
167871,56,11,45,4,1
167871,56,9,47,5,1
167871,56,9,47,20,1
167871,86,9,77,21,4
167871,86,9,77,22,1
167871,86,9,77,23,1
167871,39,3,36,24,1
167871,47,6,41,25,1
167871,47,6,41,40,1
167871,26,11,15,41,4
167871,26,11,15,42,1
167871,26,11,15,43,1
167871,17,8,9,44,1
167871,9,3,6,45,1
167871,9,3,6,60,1
167899,3255,1414,1841,1,4
167899,2182,1136,1046,2,1
167899,2157,1122,1035,3,1
167899,510,261,249,4,1
167899,1647,861,786,5,1
167899,25,14,11,11,1
167899,1073,278,795,12,3
167899,69,30,39,19,1
167899,1578,831,747,20,1
167899,3004,1337,1667,21,4
167899,2128,1107,1021,22,1
167899,2126,1105,1021,23,1
167899,510,261,249,24,1
167899,1616,844,772,25,1
167899,2,2,0,31,1
167899,876,230,646,32,3
167899,69,30,39,39,1
167899,1547,814,733,40,1
167899,251,77,174,41,4
167899,54,29,25,42,1
167899,31,17,14,43,1
167899,31,17,14,45,1
167899,23,12,11,51,1
167899,197,48,149,52,3
167899,31,17,14,60,1
167905,6792,2843,3949,1,4
167905,6792,2843,3949,2,1
167905,6281,2632,3649,3,1
167905,1401,672,729,4,1
167905,4880,1960,2920,5,1
167905,511,211,300,11,1
167905,537,200,337,19,1
167905,4343,1760,2583,20,1
167905,3210,1484,1726,21,4
167905,3210,1484,1726,22,1
167905,3148,1462,1686,23,1
167905,947,474,473,24,1
167905,2201,988,1213,25,1
167905,62,22,40,31,1
167905,257,104,153,39,1
167905,1944,884,1060,40,1
167905,3582,1359,2223,41,4
167905,3582,1359,2223,42,1
167905,3133,1170,1963,43,1
167905,454,198,256,44,1
167905,2679,972,1707,45,1
167905,449,189,260,51,1
167905,280,96,184,59,1
167905,2399,876,1523,60,1
167987,9053,4638,4415,1,4
167987,7437,3885,3552,2,1
167987,7202,3753,3449,3,1
167987,1519,829,690,4,1
167987,5683,2924,2759,5,1
167987,235,132,103,11,1
167987,1616,753,863,12,3
167987,590,291,299,19,1
167987,5093,2633,2460,20,1
167987,7060,3806,3254,21,4
167987,6373,3430,2943,22,1
167987,6331,3402,2929,23,1
167987,1498,816,682,24,1
167987,4833,2586,2247,25,1
167987,42,28,14,31,1
167987,687,376,311,32,3
167987,414,230,184,39,1
167987,4419,2356,2063,40,1
167987,1993,832,1161,41,4
167987,1064,455,609,42,1
167987,871,351,520,43,1
167987,21,13,8,44,1
167987,850,338,512,45,1
167987,193,104,89,51,1
167987,929,377,552,52,3
167987,176,61,115,59,1
167987,674,277,397,60,1
167996,2481,949,1532,1,4
167996,2481,949,1532,2,1
167996,2473,946,1527,3,1
167996,610,248,362,4,1
167996,1863,698,1165,5,1
167996,8,3,5,11,1
167996,31,14,17,19,1
167996,1832,684,1148,20,1
167996,2458,938,1520,21,4
167996,2458,938,1520,22,1
167996,2458,938,1520,23,1
167996,610,248,362,24,1
167996,1848,690,1158,25,1
167996,31,14,17,39,1
167996,1817,676,1141,40,1
167996,23,11,12,41,4
167996,23,11,12,42,1
167996,15,8,7,43,1
167996,15,8,7,45,1
167996,8,3,5,51,1
167996,15,8,7,60,1
168005,8675,3854,4821,1,4
168005,5658,2550,3108,2,1
168005,5535,2494,3041,3,1
168005,1165,476,689,4,1
168005,4370,2018,2352,5,1
168005,123,56,67,11,1
168005,3017,1304,1713,12,3
168005,382,195,187,19,1
168005,3988,1823,2165,20,1
168005,6815,3008,3807,21,4
168005,5236,2336,2900,22,1
168005,5230,2332,2898,23,1
168005,1159,472,687,24,1
168005,4071,1860,2211,25,1
168005,6,4,2,31,1
168005,1579,672,907,32,3
168005,365,188,177,39,1
168005,3706,1672,2034,40,1
168005,1860,846,1014,41,4
168005,422,214,208,42,1
168005,305,162,143,43,1
168005,6,4,2,44,1
168005,299,158,141,45,1
168005,117,52,65,51,1
168005,1438,632,806,52,3
168005,17,7,10,59,1
168005,282,151,131,60,1
168032,37,2,35,1,4
168032,37,2,35,2,1
168032,37,2,35,3,1
168032,16,2,14,4,1
168032,21,0,21,5,1
168032,21,0,21,20,1
168032,37,2,35,21,4
168032,37,2,35,22,1
168032,37,2,35,23,1
168032,16,2,14,24,1
168032,21,0,21,25,1
168032,21,0,21,40,1
168148,10872,4945,5927,1,4
168148,5180,2556,2624,2,1
168148,5146,2545,2601,3,1
168148,1307,650,657,4,1
168148,3839,1895,1944,5,1
168148,34,11,23,11,1
168148,5692,2389,3303,12,3
168148,56,25,31,19,1
168148,3783,1870,1913,20,1
168148,10051,4612,5439,21,4
168148,5138,2537,2601,22,1
168148,5118,2531,2587,23,1
168148,1307,650,657,24,1
168148,3811,1881,1930,25,1
168148,20,6,14,31,1
168148,4913,2075,2838,32,3
168148,55,25,30,39,1
168148,3756,1856,1900,40,1
168148,821,333,488,41,4
168148,42,19,23,42,1
168148,28,14,14,43,1
168148,28,14,14,45,1
168148,14,5,9,51,1
168148,779,314,465,52,3
168148,1,0,1,59,1
168148,27,14,13,60,1
168218,2474,50,2424,1,4
168218,2474,50,2424,2,1
168218,2347,0,2347,3,1
168218,590,0,590,4,1
168218,1757,0,1757,5,1
168218,127,50,77,11,1
168218,20,0,20,19,1
168218,1737,0,1737,20,1
168218,2344,0,2344,21,4
168218,2344,0,2344,22,1
168218,2334,0,2334,23,1
168218,590,0,590,24,1
168218,1744,0,1744,25,1
168218,10,0,10,31,1
168218,18,0,18,39,1
168218,1726,0,1726,40,1
168218,130,50,80,41,4
168218,130,50,80,42,1
168218,13,0,13,43,1
168218,13,0,13,45,1
168218,117,50,67,51,1
168218,2,0,2,59,1
168218,11,0,11,60,1
168227,4179,3395,784,1,4
168227,4012,3280,732,2,1
168227,3975,3249,726,3,1
168227,900,728,172,4,1
168227,3075,2521,554,5,1
168227,37,31,6,11,1
168227,167,115,52,12,3
168227,239,188,51,19,1
168227,2836,2333,503,20,1
168227,3724,3020,704,21,4
168227,3634,2961,673,22,1
168227,3630,2957,673,23,1
168227,877,709,168,24,1
168227,2753,2248,505,25,1
168227,4,4,0,31,1
168227,90,59,31,32,3
168227,185,151,34,39,1
168227,2568,2097,471,40,1
168227,455,375,80,41,4
168227,378,319,59,42,1
168227,345,292,53,43,1
168227,23,19,4,44,1
168227,322,273,49,45,1
168227,33,27,6,51,1
168227,77,56,21,52,3
168227,54,37,17,59,1
168227,268,236,32,60,1
168254,3800,2113,1687,1,4
168254,2667,1610,1057,2,1
168254,2648,1605,1043,3,1
168254,691,423,268,4,1
168254,1957,1182,775,5,1
168254,19,5,14,11,1
168254,1133,503,630,12,3
168254,88,55,33,19,1
168254,1869,1127,742,20,1
168254,2955,1724,1231,21,4
168254,2498,1514,984,22,1
168254,2498,1514,984,23,1
168254,689,422,267,24,1
168254,1809,1092,717,25,1
168254,457,210,247,32,3
168254,88,55,33,39,1
168254,1721,1037,684,40,1
168254,845,389,456,41,4
168254,169,96,73,42,1
168254,150,91,59,43,1
168254,2,1,1,44,1
168254,148,90,58,45,1
168254,19,5,14,51,1
168254,676,293,383,52,3
168254,148,90,58,60,1
168263,6371,2979,3392,1,4
168263,5692,2760,2932,2,1
168263,5524,2661,2863,3,1
168263,1287,607,680,4,1
168263,4237,2054,2183,5,1
168263,168,99,69,11,1
168263,679,219,460,12,3
168263,450,239,211,19,1
168263,3787,1815,1972,20,1
168263,5220,2467,2753,21,4
168263,4999,2407,2592,22,1
168263,4972,2385,2587,23,1
168263,1285,606,679,24,1
168263,3687,1779,1908,25,1
168263,27,22,5,31,1
168263,221,60,161,32,3
168263,379,205,174,39,1
168263,3308,1574,1734,40,1
168263,1151,512,639,41,4
168263,693,353,340,42,1
168263,552,276,276,43,1
168263,2,1,1,44,1
168263,550,275,275,45,1
168263,141,77,64,51,1
168263,458,159,299,52,3
168263,71,34,37,59,1
168263,479,241,238,60,1
168281,1654,574,1080,1,4
168281,1654,574,1080,2,1
168281,1640,568,1072,3,1
168281,458,158,300,4,1
168281,1182,410,772,5,1
168281,14,6,8,11,1
168281,14,4,10,19,1
168281,1168,406,762,20,1
168281,1645,572,1073,21,4
168281,1645,572,1073,22,1
168281,1638,568,1070,23,1
168281,458,158,300,24,1
168281,1180,410,770,25,1
168281,7,4,3,31,1
168281,14,4,10,39,1
168281,1166,406,760,40,1
168281,9,2,7,41,4
168281,9,2,7,42,1
168281,2,0,2,43,1
168281,2,0,2,45,1
168281,7,2,5,51,1
168281,2,0,2,60,1
168290,1378,155,1223,1,4
168290,880,105,775,2,1
168290,839,97,742,3,1
168290,215,31,184,4,1
168290,624,66,558,5,1
168290,41,8,33,11,1
168290,498,50,448,12,3
168290,42,13,29,19,1
168290,582,53,529,20,1
168290,1065,124,941,21,4
168290,809,96,713,22,1
168290,809,96,713,23,1
168290,215,31,184,24,1
168290,594,65,529,25,1
168290,256,28,228,32,3
168290,39,12,27,39,1
168290,555,53,502,40,1
168290,313,31,282,41,4
168290,71,9,62,42,1
168290,30,1,29,43,1
168290,30,1,29,45,1
168290,41,8,33,51,1
168290,242,22,220,52,3
168290,3,1,2,59,1
168290,27,0,27,60,1
168342,2150,1042,1108,1,4
168342,2096,1014,1082,2,1
168342,2051,997,1054,3,1
168342,544,273,271,4,1
168342,1507,724,783,5,1
168342,45,17,28,11,1
168342,54,28,26,12,3
168342,3,1,2,19,1
168342,1504,723,781,20,1
168342,2118,1028,1090,21,4
168342,2064,1000,1064,22,1
168342,2051,997,1054,23,1
168342,544,273,271,24,1
168342,1507,724,783,25,1
168342,13,3,10,31,1
168342,54,28,26,32,3
168342,3,1,2,39,1
168342,1504,723,781,40,1
168342,32,14,18,41,4
168342,32,14,18,42,1
168342,32,14,18,51,1
168421,6296,4359,1937,1,4
168421,4134,2784,1350,2,1
168421,4012,2706,1306,3,1
168421,1103,737,366,4,1
168421,2909,1969,940,5,1
168421,122,78,44,11,1
168421,2162,1575,587,12,3
168421,44,26,18,19,1
168421,2865,1943,922,20,1
168421,4719,3163,1556,21,4
168421,3959,2656,1303,22,1
168421,3893,2613,1280,23,1
168421,1103,737,366,24,1
168421,2790,1876,914,25,1
168421,66,43,23,31,1
168421,760,507,253,32,3
168421,44,26,18,39,1
168421,2746,1850,896,40,1
168421,1577,1196,381,41,4
168421,175,128,47,42,1
168421,119,93,26,43,1
168421,119,93,26,45,1
168421,56,35,21,51,1
168421,1402,1068,334,52,3
168421,119,93,26,60,1
168430,6447,2452,3995,1,4
168430,5556,2234,3322,2,1
168430,5033,2032,3001,3,1
168430,780,318,462,4,1
168430,4253,1714,2539,5,1
168430,523,202,321,11,1
168430,891,218,673,12,3
168430,606,270,336,19,1
168430,3647,1444,2203,20,1
168430,4268,1695,2573,21,4
168430,4115,1675,2440,22,1
168430,4094,1665,2429,23,1
168430,775,315,460,24,1
168430,3319,1350,1969,25,1
168430,21,10,11,31,1
168430,153,20,133,32,3
168430,461,221,240,39,1
168430,2858,1129,1729,40,1
168430,2179,757,1422,41,4
168430,1441,559,882,42,1
168430,939,367,572,43,1
168430,5,3,2,44,1
168430,934,364,570,45,1
168430,502,192,310,51,1
168430,738,198,540,52,3
168430,145,49,96,59,1
168430,789,315,474,60,1
168528,1658,853,805,1,4
168528,1649,847,802,2,1
168528,1616,835,781,3,1
168528,467,253,214,4,1
168528,1149,582,567,5,1
168528,33,12,21,11,1
168528,9,6,3,12,3
168528,188,116,72,19,1
168528,961,466,495,20,1
168528,1591,815,776,21,4
168528,1582,809,773,22,1
168528,1582,809,773,23,1
168528,458,246,212,24,1
168528,1124,563,561,25,1
168528,9,6,3,32,3
168528,182,113,69,39,1
168528,942,450,492,40,1
168528,67,38,29,41,4
168528,67,38,29,42,1
168528,34,26,8,43,1
168528,9,7,2,44,1
168528,25,19,6,45,1
168528,33,12,21,51,1
168528,6,3,3,59,1
168528,19,16,3,60,1
168546,1307,664,643,1,4
168546,1307,664,643,2,1
168546,1284,652,632,3,1
168546,346,164,182,4,1
168546,938,488,450,5,1
168546,23,12,11,11,1
168546,27,14,13,19,1
168546,911,474,437,20,1
168546,1272,644,628,21,4
168546,1272,644,628,22,1
168546,1268,643,625,23,1
168546,346,164,182,24,1
168546,922,479,443,25,1
168546,4,1,3,31,1
168546,27,14,13,39,1
168546,895,465,430,40,1
168546,35,20,15,41,4
168546,35,20,15,42,1
168546,16,9,7,43,1
168546,16,9,7,45,1
168546,19,11,8,51,1
168546,16,9,7,60,1
168555,35,1,34,1,4
168555,35,1,34,2,1
168555,35,1,34,3,1
168555,9,0,9,4,1
168555,26,1,25,5,1
168555,26,1,25,20,1
168555,33,0,33,21,4
168555,33,0,33,22,1
168555,33,0,33,23,1
168555,9,0,9,24,1
168555,24,0,24,25,1
168555,24,0,24,40,1
168555,2,1,1,41,4
168555,2,1,1,42,1
168555,2,1,1,43,1
168555,2,1,1,45,1
168555,2,1,1,60,1
168573,406,395,11,1,4
168573,406,395,11,2,1
168573,406,395,11,3,1
168573,128,125,3,4,1
168573,278,270,8,5,1
168573,278,270,8,20,1
168573,406,395,11,21,4
168573,406,395,11,22,1
168573,406,395,11,23,1
168573,128,125,3,24,1
168573,278,270,8,25,1
168573,278,270,8,40,1
168591,1419,640,779,1,4
168591,1419,640,779,2,1
168591,1385,631,754,3,1
168591,378,174,204,4,1
168591,1007,457,550,5,1
168591,34,9,25,11,1
168591,37,25,12,19,1
168591,970,432,538,20,1
168591,1378,623,755,21,4
168591,1378,623,755,22,1
168591,1371,622,749,23,1
168591,378,174,204,24,1
168591,993,448,545,25,1
168591,7,1,6,31,1
168591,37,25,12,39,1
168591,956,423,533,40,1
168591,41,17,24,41,4
168591,41,17,24,42,1
168591,14,9,5,43,1
168591,14,9,5,45,1
168591,27,8,19,51,1
168591,14,9,5,60,1
168607,1712,770,942,1,4
168607,1712,770,942,2,1
168607,1418,663,755,3,1
168607,414,221,193,4,1
168607,1004,442,562,5,1
168607,294,107,187,11,1
168607,57,28,29,19,1
168607,947,414,533,20,1
168607,870,450,420,21,4
168607,870,450,420,22,1
168607,864,446,418,23,1
168607,316,177,139,24,1
168607,548,269,279,25,1
168607,6,4,2,31,1
168607,40,24,16,39,1
168607,508,245,263,40,1
168607,842,320,522,41,4
168607,842,320,522,42,1
168607,554,217,337,43,1
168607,98,44,54,44,1
168607,456,173,283,45,1
168607,288,103,185,51,1
168607,17,4,13,59,1
168607,439,169,270,60,1
168740,3516,1846,1670,1,4
168740,1905,831,1074,2,1
168740,1765,762,1003,3,1
168740,321,129,192,4,1
168740,1444,633,811,5,1
168740,140,69,71,11,1
168740,1611,1015,596,12,3
168740,159,69,90,19,1
168740,1285,564,721,20,1
168740,2324,1139,1185,21,4
168740,1618,698,920,22,1
168740,1612,697,915,23,1
168740,307,125,182,24,1
168740,1305,572,733,25,1
168740,6,1,5,31,1
168740,706,441,265,32,3
168740,132,57,75,39,1
168740,1173,515,658,40,1
168740,1192,707,485,41,4
168740,287,133,154,42,1
168740,153,65,88,43,1
168740,14,4,10,44,1
168740,139,61,78,45,1
168740,134,68,66,51,1
168740,905,574,331,52,3
168740,27,12,15,59,1
168740,112,49,63,60,1
168786,2001,751,1250,1,4
168786,1863,713,1150,2,1
168786,1843,702,1141,3,1
168786,391,139,252,4,1
168786,1452,563,889,5,1
168786,20,11,9,11,1
168786,138,38,100,12,3
168786,93,38,55,19,1
168786,1359,525,834,20,1
168786,1649,628,1021,21,4
168786,1634,625,1009,22,1
168786,1634,625,1009,23,1
168786,390,139,251,24,1
168786,1244,486,758,25,1
168786,15,3,12,32,3
168786,72,30,42,39,1
168786,1172,456,716,40,1
168786,352,123,229,41,4
168786,229,88,141,42,1
168786,209,77,132,43,1
168786,1,0,1,44,1
168786,208,77,131,45,1
168786,20,11,9,51,1
168786,123,35,88,52,3
168786,21,8,13,59,1
168786,187,69,118,60,1
168838,2828,1185,1643,1,4
168838,2815,1181,1634,2,1
168838,2726,1116,1610,3,1
168838,622,324,298,4,1
168838,2104,792,1312,5,1
168838,89,65,24,11,1
168838,13,4,9,12,3
168838,152,54,98,19,1
168838,1952,738,1214,20,1
168838,1713,711,1002,21,4
168838,1711,710,1001,22,1
168838,1710,710,1000,23,1
168838,549,287,262,24,1
168838,1161,423,738,25,1
168838,1,0,1,31,1
168838,2,1,1,32,3
168838,109,39,70,39,1
168838,1052,384,668,40,1
168838,1115,474,641,41,4
168838,1104,471,633,42,1
168838,1016,406,610,43,1
168838,73,37,36,44,1
168838,943,369,574,45,1
168838,88,65,23,51,1
168838,11,3,8,52,3
168838,43,15,28,59,1
168838,900,354,546,60,1
168847,4977,1748,3229,1,4
168847,4948,1730,3218,2,1
168847,4886,1702,3184,3,1
168847,847,366,481,4,1
168847,4039,1336,2703,5,1
168847,62,28,34,11,1
168847,29,18,11,12,3
168847,457,135,322,19,1
168847,3582,1201,2381,20,1
168847,2746,1040,1706,21,4
168847,2739,1036,1703,22,1
168847,2733,1033,1700,23,1
168847,672,300,372,24,1
168847,2061,733,1328,25,1
168847,6,3,3,31,1
168847,7,4,3,32,3
168847,260,88,172,39,1
168847,1801,645,1156,40,1
168847,2231,708,1523,41,4
168847,2209,694,1515,42,1
168847,2153,669,1484,43,1
168847,175,66,109,44,1
168847,1978,603,1375,45,1
168847,56,25,31,51,1
168847,22,14,8,52,3
168847,197,47,150,59,1
168847,1781,556,1225,60,1
168883,2305,856,1449,1,4
168883,2305,856,1449,2,1
168883,2024,766,1258,3,1
168883,374,173,201,4,1
168883,1650,593,1057,5,1
168883,281,90,191,11,1
168883,393,148,245,19,1
168883,1257,445,812,20,1
168883,1149,492,657,21,4
168883,1149,492,657,22,1
168883,1145,490,655,23,1
168883,304,138,166,24,1
168883,841,352,489,25,1
168883,4,2,2,31,1
168883,185,91,94,39,1
168883,656,261,395,40,1
168883,1156,364,792,41,4
168883,1156,364,792,42,1
168883,879,276,603,43,1
168883,70,35,35,44,1
168883,809,241,568,45,1
168883,277,88,189,51,1
168883,208,57,151,59,1
168883,601,184,417,60,1
168892,41,0,41,1,4
168892,41,0,41,2,1
168892,41,0,41,3,1
168892,19,0,19,4,1
168892,22,0,22,5,1
168892,22,0,22,20,1
168892,18,0,18,21,4
168892,18,0,18,22,1
168892,18,0,18,23,1
168892,8,0,8,24,1
168892,10,0,10,25,1
168892,10,0,10,40,1
168892,23,0,23,41,4
168892,23,0,23,42,1
168892,23,0,23,43,1
168892,11,0,11,44,1
168892,12,0,12,45,1
168892,12,0,12,60,1
169071,39,1,38,1,4
169071,39,1,38,2,1
169071,39,1,38,3,1
169071,32,1,31,4,1
169071,7,0,7,5,1
169071,7,0,7,20,1
169071,19,1,18,21,4
169071,19,1,18,22,1
169071,19,1,18,23,1
169071,17,1,16,24,1
169071,2,0,2,25,1
169071,2,0,2,40,1
169071,20,0,20,41,4
169071,20,0,20,42,1
169071,20,0,20,43,1
169071,15,0,15,44,1
169071,5,0,5,45,1
169071,5,0,5,60,1
169080,4034,1809,2225,1,4
169080,3959,1787,2172,2,1
169080,3895,1761,2134,3,1
169080,1006,460,546,4,1
169080,2889,1301,1588,5,1
169080,64,26,38,11,1
169080,75,22,53,12,3
169080,101,40,61,19,1
169080,2788,1261,1527,20,1
169080,3849,1719,2130,21,4
169080,3814,1716,2098,22,1
169080,3807,1713,2094,23,1
169080,1006,460,546,24,1
169080,2801,1253,1548,25,1
169080,7,3,4,31,1
169080,35,3,32,32,3
169080,101,40,61,39,1
169080,2700,1213,1487,40,1
169080,185,90,95,41,4
169080,145,71,74,42,1
169080,88,48,40,43,1
169080,88,48,40,45,1
169080,57,23,34,51,1
169080,40,19,21,52,3
169080,88,48,40,60,1
169099,306,245,61,1,4
169099,306,245,61,12,3
169099,241,197,44,21,4
169099,241,197,44,32,3
169099,65,48,17,41,4
169099,65,48,17,52,3
169187,241,41,200,1,4
169187,241,41,200,2,1
169187,241,41,200,3,1
169187,28,1,27,4,1
169187,213,40,173,5,1
169187,213,40,173,20,1
169187,112,24,88,21,4
169187,112,24,88,22,1
169187,112,24,88,23,1
169187,20,1,19,24,1
169187,92,23,69,25,1
169187,92,23,69,40,1
169187,129,17,112,41,4
169187,129,17,112,42,1
169187,129,17,112,43,1
169187,8,0,8,44,1
169187,121,17,104,45,1
169187,121,17,104,60,1
169220,161,39,122,1,4
169220,161,39,122,12,3
169220,86,16,70,21,4
169220,86,16,70,32,3
169220,75,23,52,41,4
169220,75,23,52,52,3
169248,26841,11501,15340,1,4
169248,20534,8999,11535,2,1
169248,20070,8821,11249,3,1
169248,3012,1332,1680,4,1
169248,17058,7489,9569,5,1
169248,464,178,286,11,1
169248,6307,2502,3805,12,3
169248,1448,671,777,19,1
169248,15610,6818,8792,20,1
169248,19653,8711,10942,21,4
169248,17880,7911,9969,22,1
169248,17606,7815,9791,23,1
169248,2964,1308,1656,24,1
169248,14642,6507,8135,25,1
169248,274,96,178,31,1
169248,1773,800,973,32,3
169248,1191,594,597,39,1
169248,13451,5913,7538,40,1
169248,7188,2790,4398,41,4
169248,2654,1088,1566,42,1
169248,2464,1006,1458,43,1
169248,48,24,24,44,1
169248,2416,982,1434,45,1
169248,190,82,108,51,1
169248,4534,1702,2832,52,3
169248,257,77,180,59,1
169248,2159,905,1254,60,1
169275,9683,4039,5644,1,4
169275,9683,4039,5644,2,1
169275,8349,3472,4877,3,1
169275,741,393,348,4,1
169275,7608,3079,4529,5,1
169275,1334,567,767,11,1
169275,266,117,149,19,1
169275,7342,2962,4380,20,1
169275,2903,1274,1629,21,4
169275,2903,1274,1629,22,1
169275,2637,1157,1480,23,1
169275,301,153,148,24,1
169275,2336,1004,1332,25,1
169275,266,117,149,31,1
169275,93,40,53,39,1
169275,2243,964,1279,40,1
169275,6780,2765,4015,41,4
169275,6780,2765,4015,42,1
169275,5712,2315,3397,43,1
169275,440,240,200,44,1
169275,5272,2075,3197,45,1
169275,1068,450,618,51,1
169275,173,77,96,59,1
169275,5099,1998,3101,60,1
169284,365,31,334,1,4
169284,365,31,334,2,1
169284,365,31,334,3,1
169284,106,12,94,4,1
169284,259,19,240,5,1
169284,259,19,240,20,1
169284,295,26,269,21,4
169284,295,26,269,22,1
169284,295,26,269,23,1
169284,92,9,83,24,1
169284,203,17,186,25,1
169284,203,17,186,40,1
169284,70,5,65,41,4
169284,70,5,65,42,1
169284,70,5,65,43,1
169284,14,3,11,44,1
169284,56,2,54,45,1
169284,56,2,54,60,1
169327,546,217,329,1,4
169327,457,191,266,2,1
169327,450,189,261,3,1
169327,48,26,22,4,1
169327,402,163,239,5,1
169327,7,2,5,11,1
169327,89,26,63,12,3
169327,68,30,38,19,1
169327,334,133,201,20,1
169327,333,141,192,21,4
169327,259,121,138,22,1
169327,258,121,137,23,1
169327,43,23,20,24,1
169327,215,98,117,25,1
169327,1,0,1,31,1
169327,74,20,54,32,3
169327,60,25,35,39,1
169327,155,73,82,40,1
169327,213,76,137,41,4
169327,198,70,128,42,1
169327,192,68,124,43,1
169327,5,3,2,44,1
169327,187,65,122,45,1
169327,6,2,4,51,1
169327,15,6,9,52,3
169327,8,5,3,59,1
169327,179,60,119,60,1
169363,740,362,378,1,4
169363,584,313,271,2,1
169363,529,286,243,3,1
169363,188,107,81,4,1
169363,341,179,162,5,1
169363,55,27,28,11,1
169363,156,49,107,12,3
169363,44,27,17,19,1
169363,297,152,145,20,1
169363,532,284,248,21,4
169363,506,277,229,22,1
169363,505,276,229,23,1
169363,184,105,79,24,1
169363,321,171,150,25,1
169363,1,1,0,31,1
169363,26,7,19,32,3
169363,36,24,12,39,1
169363,285,147,138,40,1
169363,208,78,130,41,4
169363,78,36,42,42,1
169363,24,10,14,43,1
169363,4,2,2,44,1
169363,20,8,12,45,1
169363,54,26,28,51,1
169363,130,42,88,52,3
169363,8,3,5,59,1
169363,12,5,7,60,1
169424,149,61,88,1,4
169424,149,61,88,12,3
169424,149,61,88,21,4
169424,149,61,88,32,3
169442,1423,739,684,1,4
169442,1363,701,662,2,1
169442,1352,694,658,3,1
169442,241,118,123,4,1
169442,1111,576,535,5,1
169442,11,7,4,11,1
169442,60,38,22,12,3
169442,147,82,65,19,1
169442,964,494,470,20,1
169442,1138,605,533,21,4
169442,1082,568,514,22,1
169442,1079,566,513,23,1
169442,218,109,109,24,1
169442,861,457,404,25,1
169442,3,2,1,31,1
169442,56,37,19,32,3
169442,111,59,52,39,1
169442,750,398,352,40,1
169442,285,134,151,41,4
169442,281,133,148,42,1
169442,273,128,145,43,1
169442,23,9,14,44,1
169442,250,119,131,45,1
169442,8,5,3,51,1
169442,4,1,3,52,3
169442,36,23,13,59,1
169442,214,96,118,60,1
169479,9591,3704,5887,1,4
169479,7356,2763,4593,2,1
169479,7119,2675,4444,3,1
169479,589,298,291,4,1
169479,6530,2377,4153,5,1
169479,237,88,149,11,1
169479,2235,941,1294,12,3
169479,842,317,525,19,1
169479,5688,2060,3628,20,1
169479,2676,1325,1351,21,4
169479,2580,1289,1291,22,1
169479,2578,1288,1290,23,1
169479,451,243,208,24,1
169479,2127,1045,1082,25,1
169479,2,1,1,31,1
169479,96,36,60,32,3
169479,352,168,184,39,1
169479,1775,877,898,40,1
169479,6915,2379,4536,41,4
169479,4776,1474,3302,42,1
169479,4541,1387,3154,43,1
169479,138,55,83,44,1
169479,4403,1332,3071,45,1
169479,235,87,148,51,1
169479,2139,905,1234,52,3
169479,490,149,341,59,1
169479,3913,1183,2730,60,1
169503,225,10,215,1,4
169503,225,10,215,2,1
169503,225,10,215,3,1
169503,20,0,20,4,1
169503,205,10,195,5,1
169503,205,10,195,20,1
169503,225,10,215,21,4
169503,225,10,215,22,1
169503,225,10,215,23,1
169503,20,0,20,24,1
169503,205,10,195,25,1
169503,205,10,195,40,1
169521,10272,4638,5634,1,4
169521,10272,4638,5634,2,1
169521,8664,3826,4838,3,1
169521,1497,772,725,4,1
169521,7167,3054,4113,5,1
169521,1608,812,796,11,1
169521,353,164,189,19,1
169521,6814,2890,3924,20,1
169521,3880,1829,2051,21,4
169521,3880,1829,2051,22,1
169521,3489,1629,1860,23,1
169521,891,436,455,24,1
169521,2598,1193,1405,25,1
169521,391,200,191,31,1
169521,157,73,84,39,1
169521,2441,1120,1321,40,1
169521,6392,2809,3583,41,4
169521,6392,2809,3583,42,1
169521,5175,2197,2978,43,1
169521,606,336,270,44,1
169521,4569,1861,2708,45,1
169521,1217,612,605,51,1
169521,196,91,105,59,1
169521,4373,1770,2603,60,1
169576,76,4,72,1,4
169576,76,4,72,2,1
169576,76,4,72,3,1
169576,18,2,16,4,1
169576,58,2,56,5,1
169576,58,2,56,20,1
169576,66,4,62,21,4
169576,66,4,62,22,1
169576,66,4,62,23,1
169576,14,2,12,24,1
169576,52,2,50,25,1
169576,52,2,50,40,1
169576,10,0,10,41,4
169576,10,0,10,42,1
169576,10,0,10,43,1
169576,4,0,4,44,1
169576,6,0,6,45,1
169576,6,0,6,60,1
169628,998,565,433,1,4
169628,998,565,433,12,3
169628,823,468,355,21,4
169628,823,468,355,32,3
169628,175,97,78,41,4
169628,175,97,78,52,3
169655,498,465,33,1,4
169655,498,465,33,2,1
169655,469,438,31,3,1
169655,245,231,14,4,1
169655,224,207,17,5,1
169655,29,27,2,11,1
169655,67,61,6,19,1
169655,157,146,11,20,1
169655,450,419,31,21,4
169655,450,419,31,22,1
169655,450,419,31,23,1
169655,242,228,14,24,1
169655,208,191,17,25,1
169655,67,61,6,39,1
169655,141,130,11,40,1
169655,48,46,2,41,4
169655,48,46,2,42,1
169655,19,19,0,43,1
169655,3,3,0,44,1
169655,16,16,0,45,1
169655,29,27,2,51,1
169655,16,16,0,60,1
169716,5112,2093,3019,1,4
169716,2888,1016,1872,2,1
169716,2871,1008,1863,3,1
169716,493,197,296,4,1
169716,2378,811,1567,5,1
169716,17,8,9,11,1
169716,2224,1077,1147,12,3
169716,201,65,136,19,1
169716,2177,746,1431,20,1
169716,3716,1630,2086,21,4
169716,2196,833,1363,22,1
169716,2196,833,1363,23,1
169716,491,197,294,24,1
169716,1705,636,1069,25,1
169716,1520,797,723,32,3
169716,76,40,36,39,1
169716,1629,596,1033,40,1
169716,1396,463,933,41,4
169716,692,183,509,42,1
169716,675,175,500,43,1
169716,2,0,2,44,1
169716,673,175,498,45,1
169716,17,8,9,51,1
169716,704,280,424,52,3
169716,125,25,100,59,1
169716,548,150,398,60,1
169734,203,18,185,1,4
169734,203,18,185,2,1
169734,203,18,185,3,1
169734,76,6,70,4,1
169734,127,12,115,5,1
169734,127,12,115,20,1
169734,203,18,185,21,4
169734,203,18,185,22,1
169734,203,18,185,23,1
169734,76,6,70,24,1
169734,127,12,115,25,1
169734,127,12,115,40,1
169761,145,8,137,1,4
169761,145,8,137,2,1
169761,145,8,137,3,1
169761,69,3,66,4,1
169761,76,5,71,5,1
169761,76,5,71,20,1
169761,145,8,137,21,4
169761,145,8,137,22,1
169761,145,8,137,23,1
169761,69,3,66,24,1
169761,76,5,71,25,1
169761,76,5,71,40,1
169798,23447,9557,13890,1,4
169798,19189,8047,11142,2,1
169798,18543,7808,10735,3,1
169798,2885,1173,1712,4,1
169798,15658,6635,9023,5,1
169798,646,239,407,11,1
169798,4258,1510,2748,12,3
169798,1965,888,1077,19,1
169798,13693,5747,7946,20,1
169798,14493,6068,8425,21,4
169798,13542,5727,7815,22,1
169798,13372,5645,7727,23,1
169798,2848,1161,1687,24,1
169798,10524,4484,6040,25,1
169798,170,82,88,31,1
169798,951,341,610,32,3
169798,1341,643,698,39,1
169798,9183,3841,5342,40,1
169798,8954,3489,5465,41,4
169798,5647,2320,3327,42,1
169798,5171,2163,3008,43,1
169798,37,12,25,44,1
169798,5134,2151,2983,45,1
169798,476,157,319,51,1
169798,3307,1169,2138,52,3
169798,624,245,379,59,1
169798,4510,1906,2604,60,1
169910,14707,7017,7690,1,4
169910,13477,6486,6991,2,1
169910,12646,6227,6419,3,1
169910,2035,987,1048,4,1
169910,10611,5240,5371,5,1
169910,831,259,572,11,1
169910,1230,531,699,12,3
169910,1556,793,763,19,1
169910,9055,4447,4608,20,1
169910,10066,5119,4947,21,4
169910,9255,4751,4504,22,1
169910,9169,4682,4487,23,1
169910,1982,958,1024,24,1
169910,7187,3724,3463,25,1
169910,86,69,17,31,1
169910,811,368,443,32,3
169910,890,510,380,39,1
169910,6297,3214,3083,40,1
169910,4641,1898,2743,41,4
169910,4222,1735,2487,42,1
169910,3477,1545,1932,43,1
169910,53,29,24,44,1
169910,3424,1516,1908,45,1
169910,745,190,555,51,1
169910,419,163,256,52,3
169910,666,283,383,59,1
169910,2758,1233,1525,60,1
169947,56,52,4,1,4
169947,56,52,4,2,1
169947,56,52,4,3,1
169947,17,16,1,4,1
169947,39,36,3,5,1
169947,39,36,3,20,1
169947,56,52,4,21,4
169947,56,52,4,22,1
169947,56,52,4,23,1
169947,17,16,1,24,1
169947,39,36,3,25,1
169947,39,36,3,40,1
169974,1221,471,750,1,4
169974,1221,471,750,2,1
169974,709,284,425,3,1
169974,173,93,80,4,1
169974,536,191,345,5,1
169974,512,187,325,11,1
169974,43,23,20,19,1
169974,493,168,325,20,1
169974,531,210,321,21,4
169974,531,210,321,22,1
169974,446,185,261,23,1
169974,135,73,62,24,1
169974,311,112,199,25,1
169974,85,25,60,31,1
169974,31,15,16,39,1
169974,280,97,183,40,1
169974,690,261,429,41,4
169974,690,261,429,42,1
169974,263,99,164,43,1
169974,38,20,18,44,1
169974,225,79,146,45,1
169974,427,162,265,51,1
169974,12,8,4,59,1
169974,213,71,142,60,1
169983,1985,1602,383,1,4
169983,1684,1377,307,2,1
169983,1640,1339,301,3,1
169983,376,308,68,4,1
169983,1264,1031,233,5,1
169983,44,38,6,11,1
169983,301,225,76,12,3
169983,34,29,5,19,1
169983,1230,1002,228,20,1
169983,1612,1317,295,21,4
169983,1590,1300,290,22,1
169983,1580,1291,289,23,1
169983,375,307,68,24,1
169983,1205,984,221,25,1
169983,10,9,1,31,1
169983,22,17,5,32,3
169983,34,29,5,39,1
169983,1171,955,216,40,1
169983,373,285,88,41,4
169983,94,77,17,42,1
169983,60,48,12,43,1
169983,1,1,0,44,1
169983,59,47,12,45,1
169983,34,29,5,51,1
169983,279,208,71,52,3
169983,59,47,12,60,1
169992,1099,420,679,1,4
169992,1099,420,679,2,1
169992,948,361,587,3,1
169992,293,131,162,4,1
169992,655,230,425,5,1
169992,151,59,92,11,1
169992,93,40,53,19,1
169992,562,190,372,20,1
169992,647,291,356,21,4
169992,647,291,356,22,1
169992,641,287,354,23,1
169992,262,124,138,24,1
169992,379,163,216,25,1
169992,6,4,2,31,1
169992,67,32,35,39,1
169992,312,131,181,40,1
169992,452,129,323,41,4
169992,452,129,323,42,1
169992,307,74,233,43,1
169992,31,7,24,44,1
169992,276,67,209,45,1
169992,145,55,90,51,1
169992,26,8,18,59,1
169992,250,59,191,60,1
170000,579,275,304,1,4
170000,579,275,304,2,1
170000,576,273,303,3,1
170000,141,62,79,4,1
170000,435,211,224,5,1
170000,3,2,1,11,1
170000,103,52,51,19,1
170000,332,159,173,20,1
170000,438,219,219,21,4
170000,438,219,219,22,1
170000,438,219,219,23,1
170000,116,55,61,24,1
170000,322,164,158,25,1
170000,73,35,38,39,1
170000,249,129,120,40,1
170000,141,56,85,41,4
170000,141,56,85,42,1
170000,138,54,84,43,1
170000,25,7,18,44,1
170000,113,47,66,45,1
170000,3,2,1,51,1
170000,30,17,13,59,1
170000,83,30,53,60,1
170037,2809,1197,1612,1,4
170037,2200,902,1298,2,1
170037,2100,850,1250,3,1
170037,373,159,214,4,1
170037,1727,691,1036,5,1
170037,100,52,48,11,1
170037,609,295,314,12,3
170037,51,23,28,19,1
170037,1676,668,1008,20,1
170037,1909,794,1115,21,4
170037,1610,661,949,22,1
170037,1604,658,946,23,1
170037,356,151,205,24,1
170037,1248,507,741,25,1
170037,6,3,3,31,1
170037,299,133,166,32,3
170037,32,15,17,39,1
170037,1216,492,724,40,1
170037,900,403,497,41,4
170037,590,241,349,42,1
170037,496,192,304,43,1
170037,17,8,9,44,1
170037,479,184,295,45,1
170037,94,49,45,51,1
170037,310,162,148,52,3
170037,19,8,11,59,1
170037,460,176,284,60,1
170046,576,71,505,1,4
170046,576,71,505,2,1
170046,576,71,505,3,1
170046,78,16,62,4,1
170046,498,55,443,5,1
170046,498,55,443,20,1
170046,576,71,505,21,4
170046,576,71,505,22,1
170046,576,71,505,23,1
170046,78,16,62,24,1
170046,498,55,443,25,1
170046,498,55,443,40,1
170055,16590,7963,8627,1,4
170055,16590,7963,8627,2,1
170055,15635,7550,8085,3,1
170055,3529,1918,1611,4,1
170055,12106,5632,6474,5,1
170055,955,413,542,11,1
170055,1015,448,567,19,1
170055,11091,5184,5907,20,1
170055,5669,2957,2712,21,4
170055,5669,2957,2712,22,1
170055,5609,2925,2684,23,1
170055,1893,1035,858,24,1
170055,3716,1890,1826,25,1
170055,60,32,28,31,1
170055,423,212,211,39,1
170055,3293,1678,1615,40,1
170055,10921,5006,5915,41,4
170055,10921,5006,5915,42,1
170055,10026,4625,5401,43,1
170055,1636,883,753,44,1
170055,8390,3742,4648,45,1
170055,895,381,514,51,1
170055,592,236,356,59,1
170055,7798,3506,4292,60,1
170082,24477,9981,14496,1,4
170082,21235,8931,12304,2,1
170082,21137,8883,12254,3,1
170082,4078,1615,2463,4,1
170082,17059,7268,9791,5,1
170082,98,48,50,11,1
170082,3242,1050,2192,12,3
170082,1707,767,940,19,1
170082,15352,6501,8851,20,1
170082,19853,8088,11765,21,4
170082,18686,7730,10956,22,1
170082,18685,7729,10956,23,1
170082,4063,1604,2459,24,1
170082,14622,6125,8497,25,1
170082,1,1,0,31,1
170082,1167,358,809,32,3
170082,1472,670,802,39,1
170082,13150,5455,7695,40,1
170082,4624,1893,2731,41,4
170082,2549,1201,1348,42,1
170082,2452,1154,1298,43,1
170082,15,11,4,44,1
170082,2437,1143,1294,45,1
170082,97,47,50,51,1
170082,2075,692,1383,52,3
170082,235,97,138,59,1
170082,2202,1046,1156,60,1
170091,194,120,74,1,4
170091,194,120,74,2,1
170091,194,120,74,3,1
170091,51,30,21,4,1
170091,143,90,53,5,1
170091,25,16,9,19,1
170091,118,74,44,20,1
170091,143,89,54,21,4
170091,143,89,54,22,1
170091,143,89,54,23,1
170091,39,25,14,24,1
170091,104,64,40,25,1
170091,20,14,6,39,1
170091,84,50,34,40,1
170091,51,31,20,41,4
170091,51,31,20,42,1
170091,51,31,20,43,1
170091,12,5,7,44,1
170091,39,26,13,45,1
170091,5,2,3,59,1
170091,34,24,10,60,1
170240,13836,6125,7711,1,4
170240,13836,6125,7711,2,1
170240,12421,5485,6936,3,1
170240,2633,1254,1379,4,1
170240,9788,4231,5557,5,1
170240,1415,640,775,11,1
170240,509,186,323,19,1
170240,9279,4045,5234,20,1
170240,5011,2350,2661,21,4
170240,5011,2350,2661,22,1
170240,4883,2292,2591,23,1
170240,1564,747,817,24,1
170240,3319,1545,1774,25,1
170240,128,58,70,31,1
170240,186,66,120,39,1
170240,3133,1479,1654,40,1
170240,8825,3775,5050,41,4
170240,8825,3775,5050,42,1
170240,7538,3193,4345,43,1
170240,1069,507,562,44,1
170240,6469,2686,3783,45,1
170240,1287,582,705,51,1
170240,323,120,203,59,1
170240,6146,2566,3580,60,1
170301,3388,1344,2044,1,4
170301,3388,1344,2044,2,1
170301,3296,1308,1988,3,1
170301,822,311,511,4,1
170301,2474,997,1477,5,1
170301,92,36,56,11,1
170301,50,21,29,19,1
170301,2424,976,1448,20,1
170301,3235,1288,1947,21,4
170301,3235,1288,1947,22,1
170301,3214,1280,1934,23,1
170301,822,311,511,24,1
170301,2392,969,1423,25,1
170301,21,8,13,31,1
170301,50,21,29,39,1
170301,2342,948,1394,40,1
170301,153,56,97,41,4
170301,153,56,97,42,1
170301,82,28,54,43,1
170301,82,28,54,45,1
170301,71,28,43,51,1
170301,82,28,54,60,1
170417,343,272,71,1,4
170417,343,272,71,2,1
170417,343,272,71,3,1
170417,56,42,14,4,1
170417,287,230,57,5,1
170417,9,7,2,19,1
170417,278,223,55,20,1
170417,270,218,52,21,4
170417,270,218,52,22,1
170417,270,218,52,23,1
170417,51,39,12,24,1
170417,219,179,40,25,1
170417,8,6,2,39,1
170417,211,173,38,40,1
170417,73,54,19,41,4
170417,73,54,19,42,1
170417,73,54,19,43,1
170417,5,3,2,44,1
170417,68,51,17,45,1
170417,1,1,0,59,1
170417,67,50,17,60,1
170444,5665,2139,3526,1,4
170444,5665,2139,3526,2,1
170444,5180,1953,3227,3,1
170444,1219,577,642,4,1
170444,3961,1376,2585,5,1
170444,485,186,299,11,1
170444,310,101,209,19,1
170444,3651,1275,2376,20,1
170444,2389,959,1430,21,4
170444,2389,959,1430,22,1
170444,2370,953,1417,23,1
170444,830,384,446,24,1
170444,1540,569,971,25,1
170444,19,6,13,31,1
170444,171,65,106,39,1
170444,1369,504,865,40,1
170444,3276,1180,2096,41,4
170444,3276,1180,2096,42,1
170444,2810,1000,1810,43,1
170444,389,193,196,44,1
170444,2421,807,1614,45,1
170444,466,180,286,51,1
170444,139,36,103,59,1
170444,2282,771,1511,60,1
170514,84,2,82,1,4
170514,84,2,82,2,1
170514,84,2,82,3,1
170514,15,1,14,4,1
170514,69,1,68,5,1
170514,69,1,68,20,1
170514,3,0,3,21,4
170514,3,0,3,22,1
170514,3,0,3,23,1
170514,1,0,1,24,1
170514,2,0,2,25,1
170514,2,0,2,40,1
170514,81,2,79,41,4
170514,81,2,79,42,1
170514,81,2,79,43,1
170514,14,1,13,44,1
170514,67,1,66,45,1
170514,67,1,66,60,1
170532,1458,635,823,1,4
170532,1458,635,823,2,1
170532,1427,625,802,3,1
170532,453,215,238,4,1
170532,974,410,564,5,1
170532,31,10,21,11,1
170532,22,12,10,19,1
170532,952,398,554,20,1
170532,1446,631,815,21,4
170532,1446,631,815,22,1
170532,1419,622,797,23,1
170532,453,215,238,24,1
170532,966,407,559,25,1
170532,27,9,18,31,1
170532,22,12,10,39,1
170532,944,395,549,40,1
170532,12,4,8,41,4
170532,12,4,8,42,1
170532,8,3,5,43,1
170532,8,3,5,45,1
170532,4,1,3,51,1
170532,8,3,5,60,1
170541,10192,4971,5221,1,4
170541,10192,4971,5221,2,1
170541,9139,4467,4672,3,1
170541,1835,940,895,4,1
170541,7304,3527,3777,5,1
170541,1053,504,549,11,1
170541,882,474,408,19,1
170541,6422,3053,3369,20,1
170541,3888,1992,1896,21,4
170541,3888,1992,1896,22,1
170541,3759,1909,1850,23,1
170541,1040,523,517,24,1
170541,2719,1386,1333,25,1
170541,129,83,46,31,1
170541,420,246,174,39,1
170541,2299,1140,1159,40,1
170541,6304,2979,3325,41,4
170541,6304,2979,3325,42,1
170541,5380,2558,2822,43,1
170541,795,417,378,44,1
170541,4585,2141,2444,45,1
170541,924,421,503,51,1
170541,462,228,234,59,1
170541,4123,1913,2210,60,1
170550,6123,2095,4028,1,4
170550,6123,2095,4028,2,1
170550,4986,1714,3272,3,1
170550,573,261,312,4,1
170550,4413,1453,2960,5,1
170550,1137,381,756,11,1
170550,286,107,179,19,1
170550,4127,1346,2781,20,1
170550,1744,699,1045,21,4
170550,1744,699,1045,22,1
170550,1696,681,1015,23,1
170550,297,144,153,24,1
170550,1399,537,862,25,1
170550,48,18,30,31,1
170550,102,47,55,39,1
170550,1297,490,807,40,1
170550,4379,1396,2983,41,4
170550,4379,1396,2983,42,1
170550,3290,1033,2257,43,1
170550,276,117,159,44,1
170550,3014,916,2098,45,1
170550,1089,363,726,51,1
170550,184,60,124,59,1
170550,2830,856,1974,60,1
170587,1805,665,1140,1,4
170587,1805,665,1140,2,1
170587,1547,512,1035,3,1
170587,271,113,158,4,1
170587,1276,399,877,5,1
170587,258,153,105,11,1
170587,116,39,77,19,1
170587,1160,360,800,20,1
170587,694,251,443,21,4
170587,694,251,443,22,1
170587,693,251,442,23,1
170587,148,60,88,24,1
170587,545,191,354,25,1
170587,1,0,1,31,1
170587,50,23,27,39,1
170587,495,168,327,40,1
170587,1111,414,697,41,4
170587,1111,414,697,42,1
170587,854,261,593,43,1
170587,123,53,70,44,1
170587,731,208,523,45,1
170587,257,153,104,51,1
170587,66,16,50,59,1
170587,665,192,473,60,1
170611,117,2,115,1,4
170611,117,2,115,2,1
170611,117,2,115,3,1
170611,98,2,96,4,1
170611,19,0,19,5,1
170611,19,0,19,20,1
170611,88,2,86,21,4
170611,88,2,86,22,1
170611,88,2,86,23,1
170611,74,2,72,24,1
170611,14,0,14,25,1
170611,14,0,14,40,1
170611,29,0,29,41,4
170611,29,0,29,42,1
170611,29,0,29,43,1
170611,24,0,24,44,1
170611,5,0,5,45,1
170611,5,0,5,60,1
170620,4230,1660,2570,1,4
170620,4230,1660,2570,2,1
170620,3252,1214,2038,3,1
170620,735,322,413,4,1
170620,2517,892,1625,5,1
170620,978,446,532,11,1
170620,213,86,127,19,1
170620,2304,806,1498,20,1
170620,1302,540,762,21,4
170620,1302,540,762,22,1
170620,1254,514,740,23,1
170620,392,185,207,24,1
170620,862,329,533,25,1
170620,48,26,22,31,1
170620,76,38,38,39,1
170620,786,291,495,40,1
170620,2928,1120,1808,41,4
170620,2928,1120,1808,42,1
170620,1998,700,1298,43,1
170620,343,137,206,44,1
170620,1655,563,1092,45,1
170620,930,420,510,51,1
170620,137,48,89,59,1
170620,1518,515,1003,60,1
170639,2435,1209,1226,1,4
170639,2429,1208,1221,2,1
170639,2299,1154,1145,3,1
170639,409,202,207,4,1
170639,1890,952,938,5,1
170639,130,54,76,11,1
170639,6,1,5,12,3
170639,220,119,101,19,1
170639,1670,833,837,20,1
170639,1967,1009,958,21,4
170639,1967,1009,958,22,1
170639,1964,1006,958,23,1
170639,398,195,203,24,1
170639,1566,811,755,25,1
170639,3,3,0,31,1
170639,166,100,66,39,1
170639,1400,711,689,40,1
170639,468,200,268,41,4
170639,462,199,263,42,1
170639,335,148,187,43,1
170639,11,7,4,44,1
170639,324,141,183,45,1
170639,127,51,76,51,1
170639,6,1,5,52,3
170639,54,19,35,59,1
170639,270,122,148,60,1
170657,17562,7970,9592,1,4
170657,17562,7970,9592,2,1
170657,13947,6341,7606,3,1
170657,3386,1686,1700,4,1
170657,10561,4655,5906,5,1
170657,3615,1629,1986,11,1
170657,10561,4655,5906,20,1
170657,6587,3169,3418,21,4
170657,6587,3169,3418,22,1
170657,5331,2576,2755,23,1
170657,1787,910,877,24,1
170657,3544,1666,1878,25,1
170657,1256,593,663,31,1
170657,3544,1666,1878,40,1
170657,10975,4801,6174,41,4
170657,10975,4801,6174,42,1
170657,8616,3765,4851,43,1
170657,1599,776,823,44,1
170657,7017,2989,4028,45,1
170657,2359,1036,1323,51,1
170657,7017,2989,4028,60,1
170675,4002,2951,1051,1,4
170675,3033,2290,743,2,1
170675,3033,2290,743,3,1
170675,365,255,110,4,1
170675,2668,2035,633,5,1
170675,969,661,308,12,3
170675,1069,768,301,19,1
170675,1599,1267,332,20,1
170675,1571,1122,449,21,4
170675,1536,1097,439,22,1
170675,1536,1097,439,23,1
170675,353,247,106,24,1
170675,1183,850,333,25,1
170675,35,25,10,32,3
170675,715,516,199,39,1
170675,468,334,134,40,1
170675,2431,1829,602,41,4
170675,1497,1193,304,42,1
170675,1497,1193,304,43,1
170675,12,8,4,44,1
170675,1485,1185,300,45,1
170675,934,636,298,52,3
170675,354,252,102,59,1
170675,1131,933,198,60,1
170736,82,3,79,1,4
170736,82,3,79,2,1
170736,82,3,79,3,1
170736,50,2,48,4,1
170736,32,1,31,5,1
170736,32,1,31,20,1
170736,82,3,79,21,4
170736,82,3,79,22,1
170736,82,3,79,23,1
170736,50,2,48,24,1
170736,32,1,31,25,1
170736,32,1,31,40,1
170790,23446,11039,12407,1,4
170790,23446,11039,12407,2,1
170790,13619,6898,6721,3,1
170790,1475,806,669,4,1
170790,12144,6092,6052,5,1
170790,9827,4141,5686,11,1
170790,397,202,195,19,1
170790,11747,5890,5857,20,1
170790,7508,3665,3843,21,4
170790,7508,3665,3843,22,1
170790,4440,2283,2157,23,1
170790,681,383,298,24,1
170790,3759,1900,1859,25,1
170790,3068,1382,1686,31,1
170790,195,117,78,39,1
170790,3564,1783,1781,40,1
170790,15938,7374,8564,41,4
170790,15938,7374,8564,42,1
170790,9179,4615,4564,43,1
170790,794,423,371,44,1
170790,8385,4192,4193,45,1
170790,6759,2759,4000,51,1
170790,202,85,117,59,1
170790,8183,4107,4076,60,1
170806,4399,1329,3070,1,4
170806,3352,1098,2254,2,1
170806,3080,974,2106,3,1
170806,205,77,128,4,1
170806,2875,897,1978,5,1
170806,272,124,148,11,1
170806,1047,231,816,12,3
170806,654,247,407,19,1
170806,2221,650,1571,20,1
170806,1774,537,1237,21,4
170806,1678,504,1174,22,1
170806,1620,487,1133,23,1
170806,198,75,123,24,1
170806,1422,412,1010,25,1
170806,58,17,41,31,1
170806,96,33,63,32,3
170806,266,87,179,39,1
170806,1156,325,831,40,1
170806,2625,792,1833,41,4
170806,1674,594,1080,42,1
170806,1460,487,973,43,1
170806,7,2,5,44,1
170806,1453,485,968,45,1
170806,214,107,107,51,1
170806,951,198,753,52,3
170806,388,160,228,59,1
170806,1065,325,740,60,1
170842,1960,473,1487,1,4
170842,1041,260,781,2,1
170842,1041,260,781,3,1
170842,182,48,134,4,1
170842,859,212,647,5,1
170842,919,213,706,12,3
170842,182,32,150,19,1
170842,677,180,497,20,1
170842,816,211,605,21,4
170842,801,207,594,22,1
170842,801,207,594,23,1
170842,170,45,125,24,1
170842,631,162,469,25,1
170842,15,4,11,32,3
170842,142,25,117,39,1
170842,489,137,352,40,1
170842,1144,262,882,41,4
170842,240,53,187,42,1
170842,240,53,187,43,1
170842,12,3,9,44,1
170842,228,50,178,45,1
170842,904,209,695,52,3
170842,40,7,33,59,1
170842,188,43,145,60,1
170967,1129,451,678,1,4
170967,1117,442,675,2,1
170967,960,395,565,3,1
170967,162,80,82,4,1
170967,798,315,483,5,1
170967,157,47,110,11,1
170967,12,9,3,12,3
170967,166,63,103,19,1
170967,632,252,380,20,1
170967,723,326,397,21,4
170967,712,317,395,22,1
170967,712,317,395,23,1
170967,150,78,72,24,1
170967,562,239,323,25,1
170967,11,9,2,32,3
170967,108,46,62,39,1
170967,454,193,261,40,1
170967,406,125,281,41,4
170967,405,125,280,42,1
170967,248,78,170,43,1
170967,12,2,10,44,1
170967,236,76,160,45,1
170967,157,47,110,51,1
170967,1,0,1,52,3
170967,58,17,41,59,1
170967,178,59,119,60,1
170976,43710,22830,20880,1,4
170976,28283,14407,13876,2,1
170976,28077,14301,13776,3,1
170976,6200,3016,3184,4,1
170976,21877,11285,10592,5,1
170976,206,106,100,11,1
170976,15427,8423,7004,12,3
170976,966,562,404,19,1
170976,20911,10723,10188,20,1
170976,41152,21293,19859,21,4
170976,27316,13853,13463,22,1
170976,27228,13814,13414,23,1
170976,6176,3005,3171,24,1
170976,21052,10809,10243,25,1
170976,88,39,49,31,1
170976,13836,7440,6396,32,3
170976,945,554,391,39,1
170976,20107,10255,9852,40,1
170976,2558,1537,1021,41,4
170976,967,554,413,42,1
170976,849,487,362,43,1
170976,24,11,13,44,1
170976,825,476,349,45,1
170976,118,67,51,51,1
170976,1591,983,608,52,3
170976,21,8,13,59,1
170976,804,468,336,60,1
171012,163,152,11,1,4
171012,163,152,11,2,1
171012,163,152,11,3,1
171012,30,29,1,4,1
171012,133,123,10,5,1
171012,133,123,10,20,1
171012,163,152,11,21,4
171012,163,152,11,22,1
171012,163,152,11,23,1
171012,30,29,1,24,1
171012,133,123,10,25,1
171012,133,123,10,40,1
171100,49317,23884,25433,1,4
171100,37985,18922,19063,2,1
171100,37622,18752,18870,3,1
171100,8061,3918,4143,4,1
171100,29561,14834,14727,5,1
171100,363,170,193,11,1
171100,11332,4962,6370,12,3
171100,1513,784,729,19,1
171100,28048,14050,13998,20,1
171100,43276,21184,22092,21,4
171100,34838,17237,17601,22,1
171100,34576,17111,17465,23,1
171100,7924,3848,4076,24,1
171100,26652,13263,13389,25,1
171100,262,126,136,31,1
171100,8438,3947,4491,32,3
171100,1401,731,670,39,1
171100,25251,12532,12719,40,1
171100,6041,2700,3341,41,4
171100,3147,1685,1462,42,1
171100,3046,1641,1405,43,1
171100,137,70,67,44,1
171100,2909,1571,1338,45,1
171100,101,44,57,51,1
171100,2894,1015,1879,52,3
171100,112,53,59,59,1
171100,2797,1518,1279,60,1
171128,6975,5164,1811,1,4
171128,5617,4198,1419,2,1
171128,5536,4149,1387,3,1
171128,1253,944,309,4,1
171128,4283,3205,1078,5,1
171128,81,49,32,11,1
171128,1358,966,392,12,3
171128,195,132,63,19,1
171128,4088,3073,1015,20,1
171128,6158,4560,1598,21,4
171128,5198,3882,1316,22,1
171128,5197,3881,1316,23,1
171128,1252,943,309,24,1
171128,3945,2938,1007,25,1
171128,1,1,0,31,1
171128,960,678,282,32,3
171128,189,130,59,39,1
171128,3756,2808,948,40,1
171128,817,604,213,41,4
171128,419,316,103,42,1
171128,339,268,71,43,1
171128,1,1,0,44,1
171128,338,267,71,45,1
171128,80,48,32,51,1
171128,398,288,110,52,3
171128,6,2,4,59,1
171128,332,265,67,60,1
171137,8748,4554,4194,1,4
171137,7144,3584,3560,2,1
171137,6793,3405,3388,3,1
171137,954,524,430,4,1
171137,5839,2881,2958,5,1
171137,351,179,172,11,1
171137,1604,970,634,12,3
171137,727,352,375,19,1
171137,5112,2529,2583,20,1
171137,5225,2728,2497,21,4
171137,4814,2467,2347,22,1
171137,4717,2405,2312,23,1
171137,908,502,406,24,1
171137,3809,1903,1906,25,1
171137,97,62,35,31,1
171137,411,261,150,32,3
171137,453,239,214,39,1
171137,3356,1664,1692,40,1
171137,3523,1826,1697,41,4
171137,2330,1117,1213,42,1
171137,2076,1000,1076,43,1
171137,46,22,24,44,1
171137,2030,978,1052,45,1
171137,254,117,137,51,1
171137,1193,709,484,52,3
171137,274,113,161,59,1
171137,1756,865,891,60,1
171146,8555,3405,5150,1,4
171146,7143,2849,4294,2,1
171146,6746,2692,4054,3,1
171146,724,341,383,4,1
171146,6022,2351,3671,5,1
171146,397,157,240,11,1
171146,1412,556,856,12,3
171146,810,279,531,19,1
171146,5212,2072,3140,20,1
171146,4943,2111,2832,21,4
171146,4490,1960,2530,22,1
171146,4467,1948,2519,23,1
171146,665,309,356,24,1
171146,3802,1639,2163,25,1
171146,23,12,11,31,1
171146,453,151,302,32,3
171146,458,184,274,39,1
171146,3344,1455,1889,40,1
171146,3612,1294,2318,41,4
171146,2653,889,1764,42,1
171146,2279,744,1535,43,1
171146,59,32,27,44,1
171146,2220,712,1508,45,1
171146,374,145,229,51,1
171146,959,405,554,52,3
171146,352,95,257,59,1
171146,1868,617,1251,60,1
171155,4552,1863,2689,1,4
171155,4552,1863,2689,2,1
171155,3098,1429,1669,3,1
171155,756,381,375,4,1
171155,2342,1048,1294,5,1
171155,1454,434,1020,11,1
171155,913,475,438,19,1
171155,1429,573,856,20,1
171155,1672,832,840,21,4
171155,1672,832,840,22,1
171155,1445,779,666,23,1
171155,432,237,195,24,1
171155,1013,542,471,25,1
171155,227,53,174,31,1
171155,479,290,189,39,1
171155,534,252,282,40,1
171155,2880,1031,1849,41,4
171155,2880,1031,1849,42,1
171155,1653,650,1003,43,1
171155,324,144,180,44,1
171155,1329,506,823,45,1
171155,1227,381,846,51,1
171155,434,185,249,59,1
171155,895,321,574,60,1
171225,3777,1617,2160,1,4
171225,3777,1617,2160,2,1
171225,2285,1002,1283,3,1
171225,579,267,312,4,1
171225,1706,735,971,5,1
171225,1492,615,877,11,1
171225,104,45,59,19,1
171225,1602,690,912,20,1
171225,1313,605,708,21,4
171225,1313,605,708,22,1
171225,833,390,443,23,1
171225,258,124,134,24,1
171225,575,266,309,25,1
171225,480,215,265,31,1
171225,57,29,28,39,1
171225,518,237,281,40,1
171225,2464,1012,1452,41,4
171225,2464,1012,1452,42,1
171225,1452,612,840,43,1
171225,321,143,178,44,1
171225,1131,469,662,45,1
171225,1012,400,612,51,1
171225,47,16,31,59,1
171225,1084,453,631,60,1
171234,1944,679,1265,1,4
171234,1944,679,1265,2,1
171234,1643,546,1097,3,1
171234,189,83,106,4,1
171234,1454,463,991,5,1
171234,301,133,168,11,1
171234,344,91,253,19,1
171234,1110,372,738,20,1
171234,654,227,427,21,4
171234,654,227,427,22,1
171234,649,225,424,23,1
171234,96,40,56,24,1
171234,553,185,368,25,1
171234,5,2,3,31,1
171234,124,37,87,39,1
171234,429,148,281,40,1
171234,1290,452,838,41,4
171234,1290,452,838,42,1
171234,994,321,673,43,1
171234,93,43,50,44,1
171234,901,278,623,45,1
171234,296,131,165,51,1
171234,220,54,166,59,1
171234,681,224,457,60,1
171261,117,12,105,1,4
171261,117,12,105,2,1
171261,117,12,105,3,1
171261,38,9,29,4,1
171261,79,3,76,5,1
171261,79,3,76,20,1
171261,73,6,67,21,4
171261,73,6,67,22,1
171261,73,6,67,23,1
171261,21,6,15,24,1
171261,52,0,52,25,1
171261,52,0,52,40,1
171261,44,6,38,41,4
171261,44,6,38,42,1
171261,44,6,38,43,1
171261,17,3,14,44,1
171261,27,3,24,45,1
171261,27,3,24,60,1
171298,4021,1202,2819,1,4
171298,4005,1197,2808,2,1
171298,3988,1191,2797,3,1
171298,757,259,498,4,1
171298,3231,932,2299,5,1
171298,17,6,11,11,1
171298,16,5,11,12,3
171298,383,109,274,19,1
171298,2848,823,2025,20,1
171298,2592,838,1754,21,4
171298,2585,835,1750,22,1
171298,2584,834,1750,23,1
171298,660,233,427,24,1
171298,1924,601,1323,25,1
171298,1,1,0,31,1
171298,7,3,4,32,3
171298,266,75,191,39,1
171298,1658,526,1132,40,1
171298,1429,364,1065,41,4
171298,1420,362,1058,42,1
171298,1404,357,1047,43,1
171298,97,26,71,44,1
171298,1307,331,976,45,1
171298,16,5,11,51,1
171298,9,2,7,52,3
171298,117,34,83,59,1
171298,1190,297,893,60,1
171304,4879,2186,2693,1,4
171304,4879,2186,2693,2,1
171304,3798,1745,2053,3,1
171304,865,472,393,4,1
171304,2933,1273,1660,5,1
171304,1081,441,640,11,1
171304,248,121,127,19,1
171304,2685,1152,1533,20,1
171304,1705,833,872,21,4
171304,1705,833,872,22,1
171304,1491,731,760,23,1
171304,491,276,215,24,1
171304,1000,455,545,25,1
171304,214,102,112,31,1
171304,106,59,47,39,1
171304,894,396,498,40,1
171304,3174,1353,1821,41,4
171304,3174,1353,1821,42,1
171304,2307,1014,1293,43,1
171304,374,196,178,44,1
171304,1933,818,1115,45,1
171304,867,339,528,51,1
171304,142,62,80,59,1
171304,1791,756,1035,60,1
171313,459,64,395,1,4
171313,459,64,395,2,1
171313,459,64,395,3,1
171313,79,8,71,4,1
171313,380,56,324,5,1
171313,380,56,324,20,1
171313,459,64,395,21,4
171313,459,64,395,22,1
171313,459,64,395,23,1
171313,79,8,71,24,1
171313,380,56,324,25,1
171313,380,56,324,40,1
171322,1003,242,761,1,4
171322,1003,242,761,2,1
171322,1003,242,761,3,1
171322,91,32,59,4,1
171322,912,210,702,5,1
171322,912,210,702,20,1
171322,1003,242,761,21,4
171322,1003,242,761,22,1
171322,1003,242,761,23,1
171322,91,32,59,24,1
171322,912,210,702,25,1
171322,912,210,702,40,1
171395,2790,999,1791,1,4
171395,2790,999,1791,2,1
171395,2466,843,1623,3,1
171395,749,283,466,4,1
171395,1717,560,1157,5,1
171395,324,156,168,11,1
171395,102,43,59,19,1
171395,1615,517,1098,20,1
171395,899,356,543,21,4
171395,899,356,543,22,1
171395,887,350,537,23,1
171395,254,111,143,24,1
171395,633,239,394,25,1
171395,12,6,6,31,1
171395,42,25,17,39,1
171395,591,214,377,40,1
171395,1891,643,1248,41,4
171395,1891,643,1248,42,1
171395,1579,493,1086,43,1
171395,495,172,323,44,1
171395,1084,321,763,45,1
171395,312,150,162,51,1
171395,60,18,42,59,1
171395,1024,303,721,60,1
171456,8918,4038,4880,1,4
171456,8221,3780,4441,2,1
171456,7959,3705,4254,3,1
171456,1665,757,908,4,1
171456,6294,2948,3346,5,1
171456,262,75,187,11,1
171456,697,258,439,12,3
171456,502,268,234,19,1
171456,5792,2680,3112,20,1
171456,7537,3490,4047,21,4
171456,7347,3402,3945,22,1
171456,7334,3395,3939,23,1
171456,1642,742,900,24,1
171456,5692,2653,3039,25,1
171456,13,7,6,31,1
171456,190,88,102,32,3
171456,482,260,222,39,1
171456,5210,2393,2817,40,1
171456,1381,548,833,41,4
171456,874,378,496,42,1
171456,625,310,315,43,1
171456,23,15,8,44,1
171456,602,295,307,45,1
171456,249,68,181,51,1
171456,507,170,337,52,3
171456,20,8,12,59,1
171456,582,287,295,60,1
171465,41,2,39,1,4
171465,41,2,39,2,1
171465,41,2,39,3,1
171465,10,0,10,4,1
171465,31,2,29,5,1
171465,31,2,29,20,1
171465,41,2,39,21,4
171465,41,2,39,22,1
171465,41,2,39,23,1
171465,10,0,10,24,1
171465,31,2,29,25,1
171465,31,2,29,40,1
171483,4724,2158,2566,1,4
171483,4724,2158,2566,2,1
171483,4241,1968,2273,3,1
171483,898,430,468,4,1
171483,3343,1538,1805,5,1
171483,483,190,293,11,1
171483,316,171,145,19,1
171483,3027,1367,1660,20,1
171483,1951,1000,951,21,4
171483,1951,1000,951,22,1
171483,1903,977,926,23,1
171483,572,285,287,24,1
171483,1331,692,639,25,1
171483,48,23,25,31,1
171483,195,120,75,39,1
171483,1136,572,564,40,1
171483,2773,1158,1615,41,4
171483,2773,1158,1615,42,1
171483,2338,991,1347,43,1
171483,326,145,181,44,1
171483,2012,846,1166,45,1
171483,435,167,268,51,1
171483,121,51,70,59,1
171483,1891,795,1096,60,1
171492,3194,1797,1397,1,4
171492,2964,1675,1289,2,1
171492,2920,1639,1281,3,1
171492,299,182,117,4,1
171492,2621,1457,1164,5,1
171492,44,36,8,11,1
171492,230,122,108,12,3
171492,603,317,286,19,1
171492,2018,1140,878,20,1
171492,1934,1141,793,21,4
171492,1859,1095,764,22,1
171492,1853,1090,763,23,1
171492,298,181,117,24,1
171492,1555,909,646,25,1
171492,6,5,1,31,1
171492,75,46,29,32,3
171492,276,149,127,39,1
171492,1279,760,519,40,1
171492,1260,656,604,41,4
171492,1105,580,525,42,1
171492,1067,549,518,43,1
171492,1,1,0,44,1
171492,1066,548,518,45,1
171492,38,31,7,51,1
171492,155,76,79,52,3
171492,327,168,159,59,1
171492,739,380,359,60,1
171535,26405,11338,15067,1,4
171535,26405,11338,15067,2,1
171535,15304,6165,9139,3,1
171535,2412,1095,1317,4,1
171535,12892,5070,7822,5,1
171535,11101,5173,5928,11,1
171535,1125,383,742,19,1
171535,11767,4687,7080,20,1
171535,8058,3864,4194,21,4
171535,8058,3864,4194,22,1
171535,4766,2184,2582,23,1
171535,1179,544,635,24,1
171535,3587,1640,1947,25,1
171535,3292,1680,1612,31,1
171535,481,194,287,39,1
171535,3106,1446,1660,40,1
171535,18347,7474,10873,41,4
171535,18347,7474,10873,42,1
171535,10538,3981,6557,43,1
171535,1233,551,682,44,1
171535,9305,3430,5875,45,1
171535,7809,3493,4316,51,1
171535,644,189,455,59,1
171535,8661,3241,5420,60,1
171571,20169,8232,11937,1,4
171571,16594,6820,9774,2,1
171571,16113,6606,9507,3,1
171571,2569,1124,1445,4,1
171571,13544,5482,8062,5,1
171571,481,214,267,11,1
171571,3575,1412,2163,12,3
171571,1900,800,1100,19,1
171571,11644,4682,6962,20,1
171571,13863,5582,8281,21,4
171571,12252,4959,7293,22,1
171571,12202,4939,7263,23,1
171571,2453,1064,1389,24,1
171571,9749,3875,5874,25,1
171571,50,20,30,31,1
171571,1611,623,988,32,3
171571,1350,567,783,39,1
171571,8399,3308,5091,40,1
171571,6306,2650,3656,41,4
171571,4342,1861,2481,42,1
171571,3911,1667,2244,43,1
171571,116,60,56,44,1
171571,3795,1607,2188,45,1
171571,431,194,237,51,1
171571,1964,789,1175,52,3
171571,550,233,317,59,1
171571,3245,1374,1871,60,1
171599,1133,649,484,1,4
171599,1119,641,478,2,1
171599,1016,594,422,3,1
171599,279,180,99,4,1
171599,737,414,323,5,1
171599,103,47,56,11,1
171599,14,8,6,12,3
171599,71,43,28,19,1
171599,666,371,295,20,1
171599,982,571,411,21,4
171599,982,571,411,22,1
171599,969,565,404,23,1
171599,278,179,99,24,1
171599,691,386,305,25,1
171599,13,6,7,31,1
171599,68,41,27,39,1
171599,623,345,278,40,1
171599,151,78,73,41,4
171599,137,70,67,42,1
171599,47,29,18,43,1
171599,1,1,0,44,1
171599,46,28,18,45,1
171599,90,41,49,51,1
171599,14,8,6,52,3
171599,3,2,1,59,1
171599,43,26,17,60,1
171775,82,3,79,1,4
171775,82,3,79,2,1
171775,82,3,79,3,1
171775,17,0,17,4,1
171775,65,3,62,5,1
171775,65,3,62,20,1
171775,54,3,51,21,4
171775,54,3,51,22,1
171775,54,3,51,23,1
171775,14,0,14,24,1
171775,40,3,37,25,1
171775,40,3,37,40,1
171775,28,0,28,41,4
171775,28,0,28,42,1
171775,28,0,28,43,1
171775,3,0,3,44,1
171775,25,0,25,45,1
171775,25,0,25,60,1
171881,291,140,151,1,4
171881,288,139,149,2,1
171881,283,135,148,3,1
171881,38,16,22,4,1
171881,245,119,126,5,1
171881,5,4,1,11,1
171881,3,1,2,12,3
171881,42,20,22,19,1
171881,203,99,104,20,1
171881,248,122,126,21,4
171881,247,122,125,22,1
171881,247,122,125,23,1
171881,37,16,21,24,1
171881,210,106,104,25,1
171881,1,0,1,32,3
171881,35,19,16,39,1
171881,175,87,88,40,1
171881,43,18,25,41,4
171881,41,17,24,42,1
171881,36,13,23,43,1
171881,1,0,1,44,1
171881,35,13,22,45,1
171881,5,4,1,51,1
171881,2,1,1,52,3
171881,7,1,6,59,1
171881,28,12,16,60,1
171988,151,11,140,1,4
171988,151,11,140,2,1
171988,151,11,140,3,1
171988,48,5,43,4,1
171988,103,6,97,5,1
171988,103,6,97,20,1
171988,151,11,140,21,4
171988,151,11,140,22,1
171988,151,11,140,23,1
171988,48,5,43,24,1
171988,103,6,97,25,1
171988,103,6,97,40,1
171997,270,17,253,1,4
171997,270,17,253,2,1
171997,270,17,253,3,1
171997,72,4,68,4,1
171997,198,13,185,5,1
171997,198,13,185,20,1
171997,270,17,253,21,4
171997,270,17,253,22,1
171997,270,17,253,23,1
171997,72,4,68,24,1
171997,198,13,185,25,1
171997,198,13,185,40,1
172015,307,21,286,1,4
172015,307,21,286,2,1
172015,307,21,286,3,1
172015,83,10,73,4,1
172015,224,11,213,5,1
172015,224,11,213,20,1
172015,307,21,286,21,4
172015,307,21,286,22,1
172015,307,21,286,23,1
172015,83,10,73,24,1
172015,224,11,213,25,1
172015,224,11,213,40,1
172033,436,278,158,1,4
172033,264,153,111,2,1
172033,154,108,46,3,1
172033,1,1,0,4,1
172033,153,107,46,5,1
172033,110,45,65,11,1
172033,172,125,47,12,3
172033,22,19,3,19,1
172033,131,88,43,20,1
172033,130,123,7,21,4
172033,54,50,4,22,1
172033,54,50,4,23,1
172033,1,1,0,24,1
172033,53,49,4,25,1
172033,76,73,3,32,3
172033,12,12,0,39,1
172033,41,37,4,40,1
172033,306,155,151,41,4
172033,210,103,107,42,1
172033,100,58,42,43,1
172033,100,58,42,45,1
172033,110,45,65,51,1
172033,96,52,44,52,3
172033,10,7,3,59,1
172033,90,51,39,60,1
172051,10240,4239,6001,1,4
172051,9163,3931,5232,2,1
172051,8687,3731,4956,3,1
172051,1593,648,945,4,1
172051,7094,3083,4011,5,1
172051,476,200,276,11,1
172051,1077,308,769,12,3
172051,640,281,359,19,1
172051,6454,2802,3652,20,1
172051,7899,3350,4549,21,4
172051,7628,3260,4368,22,1
172051,7408,3132,4276,23,1
172051,1582,640,942,24,1
172051,5826,2492,3334,25,1
172051,220,128,92,31,1
172051,271,90,181,32,3
172051,510,230,280,39,1
172051,5316,2262,3054,40,1
172051,2341,889,1452,41,4
172051,1535,671,864,42,1
172051,1279,599,680,43,1
172051,11,8,3,44,1
172051,1268,591,677,45,1
172051,256,72,184,51,1
172051,806,218,588,52,3
172051,130,51,79,59,1
172051,1138,540,598,60,1
172200,12385,5595,6790,1,4
172200,12385,5595,6790,2,1
172200,9535,4274,5261,3,1
172200,1878,953,925,4,1
172200,7657,3321,4336,5,1
172200,2850,1321,1529,11,1
172200,2853,1138,1715,19,1
172200,4804,2183,2621,20,1
172200,4386,2089,2297,21,4
172200,4386,2089,2297,22,1
172200,3527,1686,1841,23,1
172200,1074,530,544,24,1
172200,2453,1156,1297,25,1
172200,859,403,456,31,1
172200,828,373,455,39,1
172200,1625,783,842,40,1
172200,7999,3506,4493,41,4
172200,7999,3506,4493,42,1
172200,6008,2588,3420,43,1
172200,804,423,381,44,1
172200,5204,2165,3039,45,1
172200,1991,918,1073,51,1
172200,2025,765,1260,59,1
172200,3179,1400,1779,60,1
172264,2684,1127,1557,1,4
172264,2424,1053,1371,2,1
172264,2325,1007,1318,3,1
172264,301,162,139,4,1
172264,2024,845,1179,5,1
172264,99,46,53,11,1
172264,260,74,186,12,3
172264,471,188,283,19,1
172264,1553,657,896,20,1
172264,1246,592,654,21,4
172264,1237,590,647,22,1
172264,1237,590,647,23,1
172264,300,161,139,24,1
172264,937,429,508,25,1
172264,9,2,7,32,3
172264,204,76,128,39,1
172264,733,353,380,40,1
172264,1438,535,903,41,4
172264,1187,463,724,42,1
172264,1088,417,671,43,1
172264,1,1,0,44,1
172264,1087,416,671,45,1
172264,99,46,53,51,1
172264,251,72,179,52,3
172264,267,112,155,59,1
172264,820,304,516,60,1
172291,4324,1771,2553,1,4
172291,4324,1771,2553,2,1
172291,3588,1480,2108,3,1
172291,757,354,403,4,1
172291,2831,1126,1705,5,1
172291,736,291,445,11,1
172291,163,58,105,19,1
172291,2668,1068,1600,20,1
172291,1763,760,1003,21,4
172291,1763,760,1003,22,1
172291,1712,740,972,23,1
172291,525,242,283,24,1
172291,1187,498,689,25,1
172291,51,20,31,31,1
172291,69,29,40,39,1
172291,1118,469,649,40,1
172291,2561,1011,1550,41,4
172291,2561,1011,1550,42,1
172291,1876,740,1136,43,1
172291,232,112,120,44,1
172291,1644,628,1016,45,1
172291,685,271,414,51,1
172291,94,29,65,59,1
172291,1550,599,951,60,1
172307,2802,1156,1646,1,4
172307,2802,1156,1646,2,1
172307,2419,1001,1418,3,1
172307,765,355,410,4,1
172307,1654,646,1008,5,1
172307,383,155,228,11,1
172307,209,86,123,19,1
172307,1445,560,885,20,1
172307,1410,638,772,21,4
172307,1410,638,772,22,1
172307,1402,636,766,23,1
172307,615,281,334,24,1
172307,787,355,432,25,1
172307,8,2,6,31,1
172307,111,55,56,39,1
172307,676,300,376,40,1
172307,1392,518,874,41,4
172307,1392,518,874,42,1
172307,1017,365,652,43,1
172307,150,74,76,44,1
172307,867,291,576,45,1
172307,375,153,222,51,1
172307,98,31,67,59,1
172307,769,260,509,60,1
172325,597,384,213,1,4
172325,597,384,213,2,1
172325,597,384,213,3,1
172325,180,123,57,4,1
172325,417,261,156,5,1
172325,417,261,156,20,1
172325,597,384,213,41,4
172325,597,384,213,42,1
172325,597,384,213,43,1
172325,180,123,57,44,1
172325,417,261,156,45,1
172325,417,261,156,60,1
172334,3962,1152,2810,1,4
172334,2968,919,2049,2,1
172334,2860,873,1987,3,1
172334,369,125,244,4,1
172334,2491,748,1743,5,1
172334,108,46,62,11,1
172334,994,233,761,12,3
172334,481,120,361,19,1
172334,2010,628,1382,20,1
172334,2498,824,1674,21,4
172334,2006,693,1313,22,1
172334,2006,693,1313,23,1
172334,367,124,243,24,1
172334,1639,569,1070,25,1
172334,492,131,361,32,3
172334,119,44,75,39,1
172334,1520,525,995,40,1
172334,1464,328,1136,41,4
172334,962,226,736,42,1
172334,854,180,674,43,1
172334,2,1,1,44,1
172334,852,179,673,45,1
172334,108,46,62,51,1
172334,502,102,400,52,3
172334,362,76,286,59,1
172334,490,103,387,60,1
172422,200,150,50,1,4
172422,200,150,50,2,1
172422,200,150,50,3,1
172422,129,89,40,4,1
172422,71,61,10,5,1
172422,71,61,10,20,1
172422,200,150,50,21,4
172422,200,150,50,22,1
172422,200,150,50,23,1
172422,129,89,40,24,1
172422,71,61,10,25,1
172422,71,61,10,40,1
172440,525,225,300,1,4
172440,525,225,300,2,1
172440,498,218,280,3,1
172440,107,59,48,4,1
172440,391,159,232,5,1
172440,27,7,20,11,1
172440,59,21,38,19,1
172440,332,138,194,20,1
172440,464,212,252,21,4
172440,464,212,252,22,1
172440,463,212,251,23,1
172440,105,59,46,24,1
172440,358,153,205,25,1
172440,1,0,1,31,1
172440,57,21,36,39,1
172440,301,132,169,40,1
172440,61,13,48,41,4
172440,61,13,48,42,1
172440,35,6,29,43,1
172440,2,0,2,44,1
172440,33,6,27,45,1
172440,26,7,19,51,1
172440,2,0,2,59,1
172440,31,6,25,60,1
172477,2477,1201,1276,1,4
172477,2477,1201,1276,12,3
172477,443,235,208,21,4
172477,443,235,208,32,3
172477,2034,966,1068,41,4
172477,2034,966,1068,52,3
172495,111,3,108,1,4
172495,111,3,108,2,1
172495,111,3,108,3,1
172495,31,0,31,4,1
172495,80,3,77,5,1
172495,80,3,77,20,1
172495,18,1,17,21,4
172495,18,1,17,22,1
172495,18,1,17,23,1
172495,12,0,12,24,1
172495,6,1,5,25,1
172495,6,1,5,40,1
172495,93,2,91,41,4
172495,93,2,91,42,1
172495,93,2,91,43,1
172495,19,0,19,44,1
172495,74,2,72,45,1
172495,74,2,72,60,1
172608,2864,1410,1454,1,4
172608,994,518,476,2,1
172608,967,505,462,3,1
172608,967,505,462,5,1
172608,27,13,14,11,1
172608,1870,892,978,12,3
172608,235,115,120,19,1
172608,732,390,342,20,1
172608,204,110,94,21,4
172608,110,60,50,22,1
172608,109,59,50,23,1
172608,109,59,50,25,1
172608,1,1,0,31,1
172608,94,50,44,32,3
172608,42,26,16,39,1
172608,67,33,34,40,1
172608,2660,1300,1360,41,4
172608,884,458,426,42,1
172608,858,446,412,43,1
172608,858,446,412,45,1
172608,26,12,14,51,1
172608,1776,842,934,52,3
172608,193,89,104,59,1
172608,665,357,308,60,1
172617,12327,5894,6433,1,4
172617,12327,5894,6433,2,1
172617,10172,4854,5318,3,1
172617,1721,905,816,4,1
172617,8451,3949,4502,5,1
172617,2155,1040,1115,11,1
172617,771,383,388,19,1
172617,7680,3566,4114,20,1
172617,3758,1887,1871,21,4
172617,3758,1887,1871,22,1
172617,3291,1629,1662,23,1
172617,777,410,367,24,1
172617,2514,1219,1295,25,1
172617,467,258,209,31,1
172617,348,182,166,39,1
172617,2166,1037,1129,40,1
172617,8569,4007,4562,41,4
172617,8569,4007,4562,42,1
172617,6881,3225,3656,43,1
172617,944,495,449,44,1
172617,5937,2730,3207,45,1
172617,1688,782,906,51,1
172617,423,201,222,59,1
172617,5514,2529,2985,60,1
172635,18119,6067,12052,1,4
172635,18119,6067,12052,2,1
172635,13713,4726,8987,3,1
172635,3613,1424,2189,4,1
172635,10100,3302,6798,5,1
172635,4406,1341,3065,11,1
172635,2588,766,1822,19,1
172635,7512,2536,4976,20,1
172635,3862,1585,2277,21,4
172635,3862,1585,2277,22,1
172635,3810,1564,2246,23,1
172635,1225,539,686,24,1
172635,2585,1025,1560,25,1
172635,52,21,31,31,1
172635,711,248,463,39,1
172635,1874,777,1097,40,1
172635,14257,4482,9775,41,4
172635,14257,4482,9775,42,1
172635,9903,3162,6741,43,1
172635,2388,885,1503,44,1
172635,7515,2277,5238,45,1
172635,4354,1320,3034,51,1
172635,1877,518,1359,59,1
172635,5638,1759,3879,60,1
172644,27897,12133,15764,1,4
172644,18602,8236,10366,2,1
172644,17789,7915,9874,3,1
172644,2167,971,1196,4,1
172644,15622,6944,8678,5,1
172644,813,321,492,11,1
172644,9295,3897,5398,12,3
172644,1883,798,1085,19,1
172644,13739,6146,7593,20,1
172644,18096,8000,10096,21,4
172644,12221,5393,6828,22,1
172644,12129,5363,6766,23,1
172644,2075,924,1151,24,1
172644,10054,4439,5615,25,1
172644,92,30,62,31,1
172644,5875,2607,3268,32,3
172644,1221,510,711,39,1
172644,8833,3929,4904,40,1
172644,9801,4133,5668,41,4
172644,6381,2843,3538,42,1
172644,5660,2552,3108,43,1
172644,92,47,45,44,1
172644,5568,2505,3063,45,1
172644,721,291,430,51,1
172644,3420,1290,2130,52,3
172644,662,288,374,59,1
172644,4906,2217,2689,60,1
172671,1487,624,863,1,4
172671,1487,624,863,2,1
172671,1167,498,669,3,1
172671,242,117,125,4,1
172671,925,381,544,5,1
172671,320,126,194,11,1
172671,62,23,39,19,1
172671,863,358,505,20,1
172671,513,242,271,21,4
172671,513,242,271,22,1
172671,474,226,248,23,1
172671,155,74,81,24,1
172671,319,152,167,25,1
172671,39,16,23,31,1
172671,28,10,18,39,1
172671,291,142,149,40,1
172671,974,382,592,41,4
172671,974,382,592,42,1
172671,693,272,421,43,1
172671,87,43,44,44,1
172671,606,229,377,45,1
172671,281,110,171,51,1
172671,34,13,21,59,1
172671,572,216,356,60,1
172699,24294,11741,12553,1,4
172699,19198,9576,9622,2,1
172699,18755,9336,9419,3,1
172699,3190,1549,1641,4,1
172699,15565,7787,7778,5,1
172699,443,240,203,11,1
172699,5096,2165,2931,12,3
172699,1641,812,829,19,1
172699,13924,6975,6949,20,1
172699,17042,8364,8678,21,4
172699,15879,7927,7952,22,1
172699,15820,7899,7921,23,1
172699,3158,1539,1619,24,1
172699,12662,6360,6302,25,1
172699,59,28,31,31,1
172699,1163,437,726,32,3
172699,1311,675,636,39,1
172699,11351,5685,5666,40,1
172699,7252,3377,3875,41,4
172699,3319,1649,1670,42,1
172699,2935,1437,1498,43,1
172699,32,10,22,44,1
172699,2903,1427,1476,45,1
172699,384,212,172,51,1
172699,3933,1728,2205,52,3
172699,330,137,193,59,1
172699,2573,1290,1283,60,1
172705,275,182,93,1,4
172705,275,182,93,12,3
172705,187,132,55,21,4
172705,187,132,55,32,3
172705,88,50,38,41,4
172705,88,50,38,52,3
172802,45,3,42,1,4
172802,45,3,42,2,1
172802,45,3,42,3,1
172802,14,0,14,4,1
172802,31,3,28,5,1
172802,31,3,28,20,1
172802,15,3,12,21,4
172802,15,3,12,22,1
172802,15,3,12,23,1
172802,1,0,1,24,1
172802,14,3,11,25,1
172802,14,3,11,40,1
172802,30,0,30,41,4
172802,30,0,30,42,1
172802,30,0,30,43,1
172802,13,0,13,44,1
172802,17,0,17,45,1
172802,17,0,17,60,1
172866,149,118,31,1,4
172866,149,118,31,2,1
172866,140,111,29,3,1
172866,9,8,1,4,1
172866,131,103,28,5,1
172866,9,7,2,11,1
172866,17,16,1,19,1
172866,114,87,27,20,1
172866,108,90,18,21,4
172866,108,90,18,22,1
172866,100,84,16,23,1
172866,9,8,1,24,1
172866,91,76,15,25,1
172866,8,6,2,31,1
172866,17,16,1,39,1
172866,74,60,14,40,1
172866,41,28,13,41,4
172866,41,28,13,42,1
172866,40,27,13,43,1
172866,40,27,13,45,1
172866,1,1,0,51,1
172866,40,27,13,60,1
172918,2845,1489,1356,1,4
172918,2845,1489,1356,2,1
172918,1782,1004,778,3,1
172918,555,376,179,4,1
172918,1227,628,599,5,1
172918,1063,485,578,11,1
172918,197,98,99,19,1
172918,1030,530,500,20,1
172918,1474,901,573,21,4
172918,1474,901,573,22,1
172918,1373,861,512,23,1
172918,508,366,142,24,1
172918,865,495,370,25,1
172918,101,40,61,31,1
172918,150,88,62,39,1
172918,715,407,308,40,1
172918,1371,588,783,41,4
172918,1371,588,783,42,1
172918,409,143,266,43,1
172918,47,10,37,44,1
172918,362,133,229,45,1
172918,962,445,517,51,1
172918,47,10,37,59,1
172918,315,123,192,60,1
172927,136,66,70,1,4
172927,136,66,70,2,1
172927,136,66,70,3,1
172927,13,13,0,4,1
172927,123,53,70,5,1
172927,123,53,70,20,1
172927,135,66,69,21,4
172927,135,66,69,22,1
172927,135,66,69,23,1
172927,13,13,0,24,1
172927,122,53,69,25,1
172927,122,53,69,40,1
172927,1,0,1,41,4
172927,1,0,1,42,1
172927,1,0,1,43,1
172927,1,0,1,45,1
172927,1,0,1,60,1
172954,2249,902,1347,1,4
172954,2249,902,1347,2,1
172954,1992,832,1160,3,1
172954,308,193,115,4,1
172954,1684,639,1045,5,1
172954,257,70,187,11,1
172954,431,176,255,19,1
172954,1253,463,790,20,1
172954,1021,545,476,21,4
172954,1021,545,476,22,1
172954,1013,540,473,23,1
172954,214,154,60,24,1
172954,799,386,413,25,1
172954,8,5,3,31,1
172954,205,112,93,39,1
172954,594,274,320,40,1
172954,1228,357,871,41,4
172954,1228,357,871,42,1
172954,979,292,687,43,1
172954,94,39,55,44,1
172954,885,253,632,45,1
172954,249,65,184,51,1
172954,226,64,162,59,1
172954,659,189,470,60,1
172963,9320,3629,5691,1,4
172963,9320,3629,5691,2,1
172963,6585,2557,4028,3,1
172963,1292,617,675,4,1
172963,5293,1940,3353,5,1
172963,2735,1072,1663,11,1
172963,852,340,512,19,1
172963,4441,1600,2841,20,1
172963,3161,1368,1793,21,4
172963,3161,1368,1793,22,1
172963,2445,1109,1336,23,1
172963,783,380,403,24,1
172963,1662,729,933,25,1
172963,716,259,457,31,1
172963,376,178,198,39,1
172963,1286,551,735,40,1
172963,6159,2261,3898,41,4
172963,6159,2261,3898,42,1
172963,4140,1448,2692,43,1
172963,509,237,272,44,1
172963,3631,1211,2420,45,1
172963,2019,813,1206,51,1
172963,476,162,314,59,1
172963,3155,1049,2106,60,1
173045,3554,1484,2070,1,4
173045,2716,1232,1484,2,1
173045,2661,1209,1452,3,1
173045,466,223,243,4,1
173045,2195,986,1209,5,1
173045,55,23,32,11,1
173045,838,252,586,12,3
173045,298,130,168,19,1
173045,1897,856,1041,20,1
173045,2567,1164,1403,21,4
173045,2038,999,1039,22,1
173045,2029,996,1033,23,1
173045,463,223,240,24,1
173045,1566,773,793,25,1
173045,9,3,6,31,1
173045,529,165,364,32,3
173045,192,100,92,39,1
173045,1374,673,701,40,1
173045,987,320,667,41,4
173045,678,233,445,42,1
173045,632,213,419,43,1
173045,3,0,3,44,1
173045,629,213,416,45,1
173045,46,20,26,51,1
173045,309,87,222,52,3
173045,106,30,76,59,1
173045,523,183,340,60,1
173063,3308,1503,1805,1,4
173063,3308,1503,1805,2,1
173063,2509,1173,1336,3,1
173063,488,288,200,4,1
173063,2021,885,1136,5,1
173063,799,330,469,11,1
173063,215,88,127,19,1
173063,1806,797,1009,20,1
173063,1334,664,670,21,4
173063,1334,664,670,22,1
173063,1184,606,578,23,1
173063,372,227,145,24,1
173063,812,379,433,25,1
173063,150,58,92,31,1
173063,122,60,62,39,1
173063,690,319,371,40,1
173063,1974,839,1135,41,4
173063,1974,839,1135,42,1
173063,1325,567,758,43,1
173063,116,61,55,44,1
173063,1209,506,703,45,1
173063,649,272,377,51,1
173063,93,28,65,59,1
173063,1116,478,638,60,1
173115,1216,372,844,1,4
173115,1216,372,844,2,1
173115,795,260,535,3,1
173115,123,65,58,4,1
173115,672,195,477,5,1
173115,421,112,309,11,1
173115,158,44,114,19,1
173115,514,151,363,20,1
173115,430,191,239,21,4
173115,430,191,239,22,1
173115,415,184,231,23,1
173115,77,53,24,24,1
173115,338,131,207,25,1
173115,15,7,8,31,1
173115,72,26,46,39,1
173115,266,105,161,40,1
173115,786,181,605,41,4
173115,786,181,605,42,1
173115,380,76,304,43,1
173115,46,12,34,44,1
173115,334,64,270,45,1
173115,406,105,301,51,1
173115,86,18,68,59,1
173115,248,46,202,60,1
173124,4963,2167,2796,1,4
173124,4727,2092,2635,2,1
173124,4397,1969,2428,3,1
173124,828,407,421,4,1
173124,3569,1562,2007,5,1
173124,330,123,207,11,1
173124,236,75,161,12,3
173124,585,232,353,19,1
173124,2984,1330,1654,20,1
173124,3551,1694,1857,21,4
173124,3518,1681,1837,22,1
173124,3490,1672,1818,23,1
173124,816,401,415,24,1
173124,2674,1271,1403,25,1
173124,28,9,19,31,1
173124,33,13,20,32,3
173124,360,172,188,39,1
173124,2314,1099,1215,40,1
173124,1412,473,939,41,4
173124,1209,411,798,42,1
173124,907,297,610,43,1
173124,12,6,6,44,1
173124,895,291,604,45,1
173124,302,114,188,51,1
173124,203,62,141,52,3
173124,225,60,165,59,1
173124,670,231,439,60,1
173142,579,283,296,1,4
173142,579,283,296,2,1
173142,552,270,282,3,1
173142,147,67,80,4,1
173142,405,203,202,5,1
173142,27,13,14,11,1
173142,37,26,11,19,1
173142,368,177,191,20,1
173142,552,269,283,21,4
173142,552,269,283,22,1
173142,538,264,274,23,1
173142,146,66,80,24,1
173142,392,198,194,25,1
173142,14,5,9,31,1
173142,34,26,8,39,1
173142,358,172,186,40,1
173142,27,14,13,41,4
173142,27,14,13,42,1
173142,14,6,8,43,1
173142,1,1,0,44,1
173142,13,5,8,45,1
173142,13,8,5,51,1
173142,3,0,3,59,1
173142,10,5,5,60,1
173160,4340,1590,2750,1,4
173160,3280,1211,2069,2,1
173160,3178,1174,2004,3,1
173160,612,228,384,4,1
173160,2566,946,1620,5,1
173160,102,37,65,11,1
173160,1060,379,681,12,3
173160,236,79,157,19,1
173160,2330,867,1463,20,1
173160,2942,1117,1825,21,4
173160,2614,1001,1613,22,1
173160,2535,977,1558,23,1
173160,610,226,384,24,1
173160,1925,751,1174,25,1
173160,79,24,55,31,1
173160,328,116,212,32,3
173160,98,45,53,39,1
173160,1827,706,1121,40,1
173160,1398,473,925,41,4
173160,666,210,456,42,1
173160,643,197,446,43,1
173160,2,2,0,44,1
173160,641,195,446,45,1
173160,23,13,10,51,1
173160,732,263,469,52,3
173160,138,34,104,59,1
173160,503,161,342,60,1
173179,512,315,197,1,4
173179,512,315,197,12,3
173179,74,41,33,21,4
173179,74,41,33,32,3
173179,438,274,164,41,4
173179,438,274,164,52,3
173203,4350,1887,2463,1,4
173203,4350,1887,2463,2,1
173203,2601,1233,1368,3,1
173203,680,404,276,4,1
173203,1921,829,1092,5,1
173203,1749,654,1095,11,1
173203,275,132,143,19,1
173203,1646,697,949,20,1
173203,2179,1056,1123,21,4
173203,2179,1056,1123,22,1
173203,1732,907,825,23,1
173203,557,357,200,24,1
173203,1175,550,625,25,1
173203,447,149,298,31,1
173203,207,111,96,39,1
173203,968,439,529,40,1
173203,2171,831,1340,41,4
173203,2171,831,1340,42,1
173203,869,326,543,43,1
173203,123,47,76,44,1
173203,746,279,467,45,1
173203,1302,505,797,51,1
173203,68,21,47,59,1
173203,678,258,420,60,1
173258,2045,960,1085,1,4
173258,2045,960,1085,2,1
173258,2023,953,1070,3,1
173258,527,259,268,4,1
173258,1496,694,802,5,1
173258,22,7,15,11,1
173258,2,1,1,19,1
173258,1494,693,801,20,1
173258,2025,955,1070,21,4
173258,2025,955,1070,22,1
173258,2023,953,1070,23,1
173258,527,259,268,24,1
173258,1496,694,802,25,1
173258,2,2,0,31,1
173258,2,1,1,39,1
173258,1494,693,801,40,1
173258,20,5,15,41,4
173258,20,5,15,42,1
173258,20,5,15,51,1
173300,2558,972,1586,1,4
173300,2531,968,1563,2,1
173300,2464,951,1513,3,1
173300,684,277,407,4,1
173300,1780,674,1106,5,1
173300,67,17,50,11,1
173300,27,4,23,12,3
173300,42,25,17,19,1
173300,1738,649,1089,20,1
173300,2488,952,1536,21,4
173300,2488,952,1536,22,1
173300,2447,941,1506,23,1
173300,684,277,407,24,1
173300,1763,664,1099,25,1
173300,41,11,30,31,1
173300,42,25,17,39,1
173300,1721,639,1082,40,1
173300,70,20,50,41,4
173300,43,16,27,42,1
173300,17,10,7,43,1
173300,17,10,7,45,1
173300,26,6,20,51,1
173300,27,4,23,52,3
173300,17,10,7,60,1
173328,3661,1372,2289,1,4
173328,2206,932,1274,2,1
173328,1927,827,1100,3,1
173328,294,160,134,4,1
173328,1633,667,966,5,1
173328,279,105,174,11,1
173328,1455,440,1015,12,3
173328,550,219,331,19,1
173328,1083,448,635,20,1
173328,2494,940,1554,21,4
173328,1216,554,662,22,1
173328,1157,536,621,23,1
173328,282,153,129,24,1
173328,875,383,492,25,1
173328,59,18,41,31,1
173328,1278,386,892,32,3
173328,220,99,121,39,1
173328,655,284,371,40,1
173328,1167,432,735,41,4
173328,990,378,612,42,1
173328,770,291,479,43,1
173328,12,7,5,44,1
173328,758,284,474,45,1
173328,220,87,133,51,1
173328,177,54,123,52,3
173328,330,120,210,59,1
173328,428,164,264,60,1
173416,3128,1799,1329,1,4
173416,3128,1799,1329,2,1
173416,2641,1436,1205,3,1
173416,440,312,128,4,1
173416,2201,1124,1077,5,1
173416,487,363,124,11,1
173416,505,282,223,19,1
173416,1696,842,854,20,1
173416,1496,941,555,21,4
173416,1496,941,555,22,1
173416,1477,929,548,23,1
173416,325,246,79,24,1
173416,1152,683,469,25,1
173416,19,12,7,31,1
173416,322,197,125,39,1
173416,830,486,344,40,1
173416,1632,858,774,41,4
173416,1632,858,774,42,1
173416,1164,507,657,43,1
173416,115,66,49,44,1
173416,1049,441,608,45,1
173416,468,351,117,51,1
173416,183,85,98,59,1
173416,866,356,510,60,1
173452,824,418,406,1,4
173452,763,380,383,2,1
173452,729,361,368,3,1
173452,164,79,85,4,1
173452,565,282,283,5,1
173452,34,19,15,11,1
173452,61,38,23,12,3
173452,32,16,16,19,1
173452,533,266,267,20,1
173452,710,348,362,21,4
173452,702,347,355,22,1
173452,702,347,355,23,1
173452,164,79,85,24,1
173452,538,268,270,25,1
173452,8,1,7,32,3
173452,29,16,13,39,1
173452,509,252,257,40,1
173452,114,70,44,41,4
173452,61,33,28,42,1
173452,27,14,13,43,1
173452,27,14,13,45,1
173452,34,19,15,51,1
173452,53,37,16,52,3
173452,3,0,3,59,1
173452,24,14,10,60,1
173461,5394,2337,3057,1,4
173461,5394,2337,3057,2,1
173461,3990,1723,2267,3,1
173461,706,386,320,4,1
173461,3284,1337,1947,5,1
173461,1404,614,790,11,1
173461,518,252,266,19,1
173461,2766,1085,1681,20,1
173461,2140,1098,1042,21,4
173461,2140,1098,1042,22,1
173461,2026,1043,983,23,1
173461,442,258,184,24,1
173461,1584,785,799,25,1
173461,114,55,59,31,1
173461,277,166,111,39,1
173461,1307,619,688,40,1
173461,3254,1239,2015,41,4
173461,3254,1239,2015,42,1
173461,1964,680,1284,43,1
173461,264,128,136,44,1
173461,1700,552,1148,45,1
173461,1290,559,731,51,1
173461,241,86,155,59,1
173461,1459,466,993,60,1
173470,33,2,31,1,4
173470,33,2,31,2,1
173470,33,2,31,3,1
173470,10,0,10,4,1
173470,23,2,21,5,1
173470,23,2,21,20,1
173470,33,2,31,21,4
173470,33,2,31,22,1
173470,33,2,31,23,1
173470,10,0,10,24,1
173470,23,2,21,25,1
173470,23,2,21,40,1
173489,201,27,174,1,4
173489,201,27,174,2,1
173489,201,27,174,3,1
173489,12,1,11,4,1
173489,189,26,163,5,1
173489,30,1,29,19,1
173489,159,25,134,20,1
173489,111,17,94,21,4
173489,111,17,94,22,1
173489,111,17,94,23,1
173489,6,1,5,24,1
173489,105,16,89,25,1
173489,20,1,19,39,1
173489,85,15,70,40,1
173489,90,10,80,41,4
173489,90,10,80,42,1
173489,90,10,80,43,1
173489,6,0,6,44,1
173489,84,10,74,45,1
173489,10,0,10,59,1
173489,74,10,64,60,1
173559,6464,2635,3829,1,4
173559,6464,2635,3829,2,1
173559,4960,2057,2903,3,1
173559,1013,546,467,4,1
173559,3947,1511,2436,5,1
173559,1504,578,926,11,1
173559,690,290,400,19,1
173559,3257,1221,2036,20,1
173559,3134,1517,1617,21,4
173559,3134,1517,1617,22,1
173559,2987,1465,1522,23,1
173559,808,470,338,24,1
173559,2179,995,1184,25,1
173559,147,52,95,31,1
173559,453,222,231,39,1
173559,1726,773,953,40,1
173559,3330,1118,2212,41,4
173559,3330,1118,2212,42,1
173559,1973,592,1381,43,1
173559,205,76,129,44,1
173559,1768,516,1252,45,1
173559,1357,526,831,51,1
173559,237,68,169,59,1
173559,1531,448,1083,60,1
173629,983,325,658,1,4
173629,898,300,598,2,1
173629,845,279,566,3,1
173629,70,28,42,4,1
173629,775,251,524,5,1
173629,53,21,32,11,1
173629,85,25,60,12,3
173629,195,65,130,19,1
173629,580,186,394,20,1
173629,635,223,412,21,4
173629,591,208,383,22,1
173629,579,204,375,23,1
173629,65,26,39,24,1
173629,514,178,336,25,1
173629,12,4,8,31,1
173629,44,15,29,32,3
173629,169,56,113,39,1
173629,345,122,223,40,1
173629,348,102,246,41,4
173629,307,92,215,42,1
173629,266,75,191,43,1
173629,5,2,3,44,1
173629,261,73,188,45,1
173629,41,17,24,51,1
173629,41,10,31,52,3
173629,26,9,17,59,1
173629,235,64,171,60,1
173638,3231,1329,1902,1,4
173638,3231,1329,1902,2,1
173638,2165,858,1307,3,1
173638,358,190,168,4,1
173638,1807,668,1139,5,1
173638,1066,471,595,11,1
173638,241,89,152,19,1
173638,1566,579,987,20,1
173638,1315,541,774,21,4
173638,1315,541,774,22,1
173638,1220,505,715,23,1
173638,287,167,120,24,1
173638,933,338,595,25,1
173638,95,36,59,31,1
173638,152,73,79,39,1
173638,781,265,516,40,1
173638,1916,788,1128,41,4
173638,1916,788,1128,42,1
173638,945,353,592,43,1
173638,71,23,48,44,1
173638,874,330,544,45,1
173638,971,435,536,51,1
173638,89,16,73,59,1
173638,785,314,471,60,1
173647,2449,1135,1314,1,4
173647,2449,1135,1314,2,1
173647,2439,1131,1308,3,1
173647,610,296,314,4,1
173647,1829,835,994,5,1
173647,10,4,6,11,1
173647,121,67,54,19,1
173647,1708,768,940,20,1
173647,2423,1117,1306,21,4
173647,2423,1117,1306,22,1
173647,2417,1116,1301,23,1
173647,610,296,314,24,1
173647,1807,820,987,25,1
173647,6,1,5,31,1
173647,121,67,54,39,1
173647,1686,753,933,40,1
173647,26,18,8,41,4
173647,26,18,8,42,1
173647,22,15,7,43,1
173647,22,15,7,45,1
173647,4,3,1,51,1
173647,22,15,7,60,1
173665,4581,1750,2831,1,4
173665,2164,904,1260,2,1
173665,2108,892,1216,3,1
173665,536,218,318,4,1
173665,1572,674,898,5,1
173665,56,12,44,11,1
173665,2417,846,1571,12,3
173665,142,73,69,19,1
173665,1430,601,829,20,1
173665,2647,1113,1534,21,4
173665,2087,867,1220,22,1
173665,2064,862,1202,23,1
173665,536,218,318,24,1
173665,1528,644,884,25,1
173665,23,5,18,31,1
173665,560,246,314,32,3
173665,135,68,67,39,1
173665,1393,576,817,40,1
173665,1934,637,1297,41,4
173665,77,37,40,42,1
173665,44,30,14,43,1
173665,44,30,14,45,1
173665,33,7,26,51,1
173665,1857,600,1257,52,3
173665,7,5,2,59,1
173665,37,25,12,60,1
173683,90,35,55,1,4
173683,90,35,55,12,3
173683,58,21,37,21,4
173683,58,21,37,32,3
173683,32,14,18,41,4
173683,32,14,18,52,3
173708,6402,3758,2644,1,4
173708,6402,3758,2644,2,1
173708,5750,3350,2400,3,1
173708,715,490,225,4,1
173708,5035,2860,2175,5,1
173708,652,408,244,11,1
173708,992,592,400,19,1
173708,4043,2268,1775,20,1
173708,2278,1567,711,21,4
173708,2278,1567,711,22,1
173708,2173,1500,673,23,1
173708,374,277,97,24,1
173708,1799,1223,576,25,1
173708,105,67,38,31,1
173708,467,332,135,39,1
173708,1332,891,441,40,1
173708,4124,2191,1933,41,4
173708,4124,2191,1933,42,1
173708,3577,1850,1727,43,1
173708,341,213,128,44,1
173708,3236,1637,1599,45,1
173708,547,341,206,51,1
173708,525,260,265,59,1
173708,2711,1377,1334,60,1
173726,37,1,36,1,4
173726,37,1,36,2,1
173726,37,1,36,3,1
173726,8,0,8,4,1
173726,29,1,28,5,1
173726,29,1,28,20,1
173726,37,1,36,21,4
173726,37,1,36,22,1
173726,37,1,36,23,1
173726,8,0,8,24,1
173726,29,1,28,25,1
173726,29,1,28,40,1
173735,1376,587,789,1,4
173735,1376,587,789,2,1
173735,1186,536,650,3,1
173735,257,155,102,4,1
173735,929,381,548,5,1
173735,190,51,139,11,1
173735,256,108,148,19,1
173735,673,273,400,20,1
173735,845,469,376,21,4
173735,845,469,376,22,1
173735,798,454,344,23,1
173735,239,152,87,24,1
173735,559,302,257,25,1
173735,47,15,32,31,1
173735,173,89,84,39,1
173735,386,213,173,40,1
173735,531,118,413,41,4
173735,531,118,413,42,1
173735,388,82,306,43,1
173735,18,3,15,44,1
173735,370,79,291,45,1
173735,143,36,107,51,1
173735,83,19,64,59,1
173735,287,60,227,60,1
173744,489,32,457,1,4
173744,489,32,457,2,1
173744,489,32,457,3,1
173744,213,9,204,4,1
173744,276,23,253,5,1
173744,276,23,253,20,1
173744,489,32,457,21,4
173744,489,32,457,22,1
173744,489,32,457,23,1
173744,213,9,204,24,1
173744,276,23,253,25,1
173744,276,23,253,40,1
173799,5944,2432,3512,1,4
173799,5944,2432,3512,2,1
173799,4915,2004,2911,3,1
173799,787,390,397,4,1
173799,4128,1614,2514,5,1
173799,1029,428,601,11,1
173799,760,300,460,19,1
173799,3368,1314,2054,20,1
173799,2104,985,1119,21,4
173799,2104,985,1119,22,1
173799,1928,920,1008,23,1
173799,468,233,235,24,1
173799,1460,687,773,25,1
173799,176,65,111,31,1
173799,332,155,177,39,1
173799,1128,532,596,40,1
173799,3840,1447,2393,41,4
173799,3840,1447,2393,42,1
173799,2987,1084,1903,43,1
173799,319,157,162,44,1
173799,2668,927,1741,45,1
173799,853,363,490,51,1
173799,428,145,283,59,1
173799,2240,782,1458,60,1
173805,1248,673,575,1,4
173805,1248,673,575,2,1
173805,1076,581,495,3,1
173805,257,155,102,4,1
173805,819,426,393,5,1
173805,172,92,80,11,1
173805,168,98,70,19,1
173805,651,328,323,20,1
173805,886,490,396,21,4
173805,886,490,396,22,1
173805,818,463,355,23,1
173805,232,150,82,24,1
173805,586,313,273,25,1
173805,68,27,41,31,1
173805,136,85,51,39,1
173805,450,228,222,40,1
173805,362,183,179,41,4
173805,362,183,179,42,1
173805,258,118,140,43,1
173805,25,5,20,44,1
173805,233,113,120,45,1
173805,104,65,39,51,1
173805,32,13,19,59,1
173805,201,100,101,60,1
173887,1161,486,675,1,4
173887,1161,486,675,2,1
173887,1161,486,675,3,1
173887,205,96,109,4,1
173887,956,390,566,5,1
173887,173,50,123,19,1
173887,783,340,443,20,1
173887,883,360,523,21,4
173887,883,360,523,22,1
173887,883,360,523,23,1
173887,168,78,90,24,1
173887,715,282,433,25,1
173887,131,38,93,39,1
173887,584,244,340,40,1
173887,278,126,152,41,4
173887,278,126,152,42,1
173887,278,126,152,43,1
173887,37,18,19,44,1
173887,241,108,133,45,1
173887,42,12,30,59,1
173887,199,96,103,60,1
173896,705,372,333,1,4
173896,705,372,333,12,3
173896,401,218,183,21,4
173896,401,218,183,32,3
173896,304,154,150,41,4
173896,304,154,150,52,3
173902,2039,802,1237,1,4
173902,2039,802,1237,2,1
173902,2029,799,1230,3,1
173902,555,227,328,4,1
173902,1474,572,902,5,1
173902,10,3,7,11,1
173902,13,5,8,19,1
173902,1461,567,894,20,1
173902,2011,791,1220,21,4
173902,2011,791,1220,22,1
173902,2010,791,1219,23,1
173902,555,227,328,24,1
173902,1455,564,891,25,1
173902,1,0,1,31,1
173902,13,5,8,39,1
173902,1442,559,883,40,1
173902,28,11,17,41,4
173902,28,11,17,42,1
173902,19,8,11,43,1
173902,19,8,11,45,1
173902,9,3,6,51,1
173902,19,8,11,60,1
173911,3410,1413,1997,1,4
173911,3410,1413,1997,2,1
173911,2966,1213,1753,3,1
173911,513,268,245,4,1
173911,2453,945,1508,5,1
173911,444,200,244,11,1
173911,381,168,213,19,1
173911,2072,777,1295,20,1
173911,1687,833,854,21,4
173911,1687,833,854,22,1
173911,1643,813,830,23,1
173911,404,225,179,24,1
173911,1239,588,651,25,1
173911,44,20,24,31,1
173911,263,133,130,39,1
173911,976,455,521,40,1
173911,1723,580,1143,41,4
173911,1723,580,1143,42,1
173911,1323,400,923,43,1
173911,109,43,66,44,1
173911,1214,357,857,45,1
173911,400,180,220,51,1
173911,118,35,83,59,1
173911,1096,322,774,60,1
173920,15426,7210,8216,1,4
173920,13467,6478,6989,2,1
173920,12542,6115,6427,3,1
173920,2452,1098,1354,4,1
173920,10090,5017,5073,5,1
173920,925,363,562,11,1
173920,1959,732,1227,12,3
173920,1091,531,560,19,1
173920,8999,4486,4513,20,1
173920,12097,5943,6154,21,4
173920,11419,5681,5738,22,1
173920,11266,5616,5650,23,1
173920,2436,1089,1347,24,1
173920,8830,4527,4303,25,1
173920,153,65,88,31,1
173920,678,262,416,32,3
173920,937,485,452,39,1
173920,7893,4042,3851,40,1
173920,3329,1267,2062,41,4
173920,2048,797,1251,42,1
173920,1276,499,777,43,1
173920,16,9,7,44,1
173920,1260,490,770,45,1
173920,772,298,474,51,1
173920,1281,470,811,52,3
173920,154,46,108,59,1
173920,1106,444,662,60,1
173939,137,1,136,1,4
173939,137,1,136,2,1
173939,137,1,136,3,1
173939,53,1,52,4,1
173939,84,0,84,5,1
173939,84,0,84,20,1
173939,102,1,101,21,4
173939,102,1,101,22,1
173939,102,1,101,23,1
173939,43,1,42,24,1
173939,59,0,59,25,1
173939,59,0,59,40,1
173939,35,0,35,41,4
173939,35,0,35,42,1
173939,35,0,35,43,1
173939,10,0,10,44,1
173939,25,0,25,45,1
173939,25,0,25,60,1
173957,195,100,95,1,4
173957,195,100,95,12,3
173957,195,100,95,21,4
173957,195,100,95,32,3
173966,335,89,246,1,4
173966,131,27,104,2,1
173966,131,27,104,3,1
173966,131,27,104,5,1
173966,204,62,142,12,3
173966,131,27,104,20,1
173966,335,89,246,21,4
173966,131,27,104,22,1
173966,131,27,104,23,1
173966,131,27,104,25,1
173966,204,62,142,32,3
173966,131,27,104,40,1
173984,1626,317,1309,1,4
173984,1122,191,931,2,1
173984,1113,190,923,3,1
173984,100,15,85,4,1
173984,1013,175,838,5,1
173984,9,1,8,11,1
173984,504,126,378,12,3
173984,232,46,186,19,1
173984,781,129,652,20,1
173984,318,56,262,21,4
173984,235,37,198,22,1
173984,234,37,197,23,1
173984,27,3,24,24,1
173984,207,34,173,25,1
173984,1,0,1,31,1
173984,83,19,64,32,3
173984,37,9,28,39,1
173984,170,25,145,40,1
173984,1308,261,1047,41,4
173984,887,154,733,42,1
173984,879,153,726,43,1
173984,73,12,61,44,1
173984,806,141,665,45,1
173984,8,1,7,51,1
173984,421,107,314,52,3
173984,195,37,158,59,1
173984,611,104,507,60,1
173993,1425,807,618,1,4
173993,1425,807,618,2,1
173993,986,542,444,3,1
173993,227,152,75,4,1
173993,759,390,369,5,1
173993,439,265,174,11,1
173993,158,86,72,19,1
173993,601,304,297,20,1
173993,841,504,337,21,4
173993,841,504,337,22,1
173993,783,477,306,23,1
173993,206,145,61,24,1
173993,577,332,245,25,1
173993,58,27,31,31,1
173993,129,79,50,39,1
173993,448,253,195,40,1
173993,584,303,281,41,4
173993,584,303,281,42,1
173993,203,65,138,43,1
173993,21,7,14,44,1
173993,182,58,124,45,1
173993,381,238,143,51,1
173993,29,7,22,59,1
173993,153,51,102,60,1
174020,8510,3731,4779,1,4
174020,7647,3388,4259,2,1
174020,7322,3248,4074,3,1
174020,100,53,47,4,1
174020,7222,3195,4027,5,1
174020,325,140,185,11,1
174020,863,343,520,12,3
174020,1811,842,969,19,1
174020,5411,2353,3058,20,1
174020,3033,1374,1659,21,4
174020,2852,1326,1526,22,1
174020,2825,1305,1520,23,1
174020,64,40,24,24,1
174020,2761,1265,1496,25,1
174020,27,21,6,31,1
174020,181,48,133,32,3
174020,759,352,407,39,1
174020,2002,913,1089,40,1
174020,5477,2357,3120,41,4
174020,4795,2062,2733,42,1
174020,4497,1943,2554,43,1
174020,36,13,23,44,1
174020,4461,1930,2531,45,1
174020,298,119,179,51,1
174020,682,295,387,52,3
174020,1052,490,562,59,1
174020,3409,1440,1969,60,1
174066,51526,25050,26476,1,4
174066,34449,16791,17658,2,1
174066,30271,14856,15415,3,1
174066,5544,2629,2915,4,1
174066,24727,12227,12500,5,1
174066,4178,1935,2243,11,1
174066,17077,8259,8818,12,3
174066,2525,1237,1288,19,1
174066,22202,10990,11212,20,1
174066,38767,18721,20046,21,4
174066,28940,14135,14805,22,1
174066,27866,13616,14250,23,1
174066,5538,2627,2911,24,1
174066,22328,10989,11339,25,1
174066,1074,519,555,31,1
174066,9827,4586,5241,32,3
174066,2380,1172,1208,39,1
174066,19948,9817,10131,40,1
174066,12759,6329,6430,41,4
174066,5509,2656,2853,42,1
174066,2405,1240,1165,43,1
174066,6,2,4,44,1
174066,2399,1238,1161,45,1
174066,3104,1416,1688,51,1
174066,7250,3673,3577,52,3
174066,145,65,80,59,1
174066,2254,1173,1081,60,1
174075,2839,1343,1496,1,4
174075,2839,1343,1496,2,1
174075,1813,916,897,3,1
174075,213,108,105,4,1
174075,1600,808,792,5,1
174075,1026,427,599,11,1
174075,242,118,124,19,1
174075,1358,690,668,20,1
174075,1305,656,649,21,4
174075,1305,656,649,22,1
174075,1236,628,608,23,1
174075,200,102,98,24,1
174075,1036,526,510,25,1
174075,69,28,41,31,1
174075,137,64,73,39,1
174075,899,462,437,40,1
174075,1534,687,847,41,4
174075,1534,687,847,42,1
174075,577,288,289,43,1
174075,13,6,7,44,1
174075,564,282,282,45,1
174075,957,399,558,51,1
174075,105,54,51,59,1
174075,459,228,231,60,1
174118,235,76,159,1,4
174118,235,76,159,2,1
174118,235,76,159,3,1
174118,126,38,88,4,1
174118,109,38,71,5,1
174118,55,15,40,19,1
174118,54,23,31,20,1
174118,235,76,159,21,4
174118,235,76,159,22,1
174118,235,76,159,23,1
174118,126,38,88,24,1
174118,109,38,71,25,1
174118,55,15,40,39,1
174118,54,23,31,40,1
174127,791,283,508,1,4
174127,688,246,442,2,1
174127,683,244,439,3,1
174127,116,34,82,4,1
174127,567,210,357,5,1
174127,5,2,3,11,1
174127,103,37,66,12,3
174127,102,39,63,19,1
174127,465,171,294,20,1
174127,698,247,451,21,4
174127,665,236,429,22,1
174127,665,236,429,23,1
174127,115,34,81,24,1
174127,550,202,348,25,1
174127,33,11,22,32,3
174127,102,39,63,39,1
174127,448,163,285,40,1
174127,93,36,57,41,4
174127,23,10,13,42,1
174127,18,8,10,43,1
174127,1,0,1,44,1
174127,17,8,9,45,1
174127,5,2,3,51,1
174127,70,26,44,52,3
174127,17,8,9,60,1
174136,9691,4500,5191,1,4
174136,9691,4500,5191,2,1
174136,8938,4174,4764,3,1
174136,1269,642,627,4,1
174136,7669,3532,4137,5,1
174136,753,326,427,11,1
174136,1382,668,714,19,1
174136,6287,2864,3423,20,1
174136,3409,1824,1585,21,4
174136,3409,1824,1585,22,1
174136,3329,1787,1542,23,1
174136,662,352,310,24,1
174136,2667,1435,1232,25,1
174136,80,37,43,31,1
174136,634,345,289,39,1
174136,2033,1090,943,40,1
174136,6282,2676,3606,41,4
174136,6282,2676,3606,42,1
174136,5609,2387,3222,43,1
174136,607,290,317,44,1
174136,5002,2097,2905,45,1
174136,673,289,384,51,1
174136,748,323,425,59,1
174136,4254,1774,2480,60,1
174154,262,23,239,1,4
174154,262,23,239,2,1
174154,262,23,239,3,1
174154,9,1,8,4,1
174154,253,22,231,5,1
174154,15,1,14,19,1
174154,238,21,217,20,1
174154,128,14,114,21,4
174154,128,14,114,22,1
174154,128,14,114,23,1
174154,6,1,5,24,1
174154,122,13,109,25,1
174154,6,0,6,39,1
174154,116,13,103,40,1
174154,134,9,125,41,4
174154,134,9,125,42,1
174154,134,9,125,43,1
174154,3,0,3,44,1
174154,131,9,122,45,1
174154,9,1,8,59,1
174154,122,8,114,60,1
174190,138,2,136,1,4
174190,138,2,136,2,1
174190,138,2,136,3,1
174190,34,0,34,4,1
174190,104,2,102,5,1
174190,104,2,102,20,1
174190,138,2,136,21,4
174190,138,2,136,22,1
174190,138,2,136,23,1
174190,34,0,34,24,1
174190,104,2,102,25,1
174190,104,2,102,40,1
174206,101,46,55,1,4
174206,101,46,55,2,1
174206,97,45,52,3,1
174206,13,10,3,4,1
174206,84,35,49,5,1
174206,4,1,3,11,1
174206,13,9,4,19,1
174206,71,26,45,20,1
174206,88,41,47,21,4
174206,88,41,47,22,1
174206,87,41,46,23,1
174206,11,8,3,24,1
174206,76,33,43,25,1
174206,1,0,1,31,1
174206,13,9,4,39,1
174206,63,24,39,40,1
174206,13,5,8,41,4
174206,13,5,8,42,1
174206,10,4,6,43,1
174206,2,2,0,44,1
174206,8,2,6,45,1
174206,3,1,2,51,1
174206,8,2,6,60,1
174233,11241,5905,5336,1,4
174233,10079,5393,4686,2,1
174233,9239,5059,4180,3,1
174233,2054,1079,975,4,1
174233,7185,3980,3205,5,1
174233,840,334,506,11,1
174233,1162,512,650,12,3
174233,570,307,263,19,1
174233,6615,3673,2942,20,1
174233,9658,5179,4479,21,4
174233,8989,4877,4112,22,1
174233,8890,4844,4046,23,1
174233,2050,1077,973,24,1
174233,6840,3767,3073,25,1
174233,99,33,66,31,1
174233,669,302,367,32,3
174233,550,298,252,39,1
174233,6290,3469,2821,40,1
174233,1583,726,857,41,4
174233,1090,516,574,42,1
174233,349,215,134,43,1
174233,4,2,2,44,1
174233,345,213,132,45,1
174233,741,301,440,51,1
174233,493,210,283,52,3
174233,20,9,11,59,1
174233,325,204,121,60,1
174251,1946,873,1073,1,4
174251,1946,873,1073,2,1
174251,1846,840,1006,3,1
174251,469,188,281,4,1
174251,1377,652,725,5,1
174251,100,33,67,11,1
174251,100,64,36,19,1
174251,1277,588,689,20,1
174251,1815,823,992,21,4
174251,1815,823,992,22,1
174251,1794,816,978,23,1
174251,468,188,280,24,1
174251,1326,628,698,25,1
174251,21,7,14,31,1
174251,98,64,34,39,1
174251,1228,564,664,40,1
174251,131,50,81,41,4
174251,131,50,81,42,1
174251,52,24,28,43,1
174251,1,0,1,44,1
174251,51,24,27,45,1
174251,79,26,53,51,1
174251,2,0,2,59,1
174251,49,24,25,60,1
174279,1037,341,696,1,4
174279,947,303,644,2,1
174279,896,282,614,3,1
174279,44,22,22,4,1
174279,852,260,592,5,1
174279,51,21,30,11,1
174279,90,38,52,12,3
174279,186,59,127,19,1
174279,666,201,465,20,1
174279,625,210,415,21,4
174279,578,190,388,22,1
174279,570,185,385,23,1
174279,41,21,20,24,1
174279,529,164,365,25,1
174279,8,5,3,31,1
174279,47,20,27,32,3
174279,160,50,110,39,1
174279,369,114,255,40,1
174279,412,131,281,41,4
174279,369,113,256,42,1
174279,326,97,229,43,1
174279,3,1,2,44,1
174279,323,96,227,45,1
174279,43,16,27,51,1
174279,43,18,25,52,3
174279,26,9,17,59,1
174279,297,87,210,60,1
174321,125,2,123,1,4
174321,125,2,123,2,1
174321,125,2,123,3,1
174321,44,1,43,4,1
174321,81,1,80,5,1
174321,81,1,80,20,1
174321,125,2,123,21,4
174321,125,2,123,22,1
174321,125,2,123,23,1
174321,44,1,43,24,1
174321,81,1,80,25,1
174321,81,1,80,40,1
174358,6634,2606,4028,1,4
174358,6163,2487,3676,2,1
174358,5912,2397,3515,3,1
174358,987,360,627,4,1
174358,4925,2037,2888,5,1
174358,251,90,161,11,1
174358,471,119,352,12,3
174358,629,284,345,19,1
174358,4296,1753,2543,20,1
174358,5260,2116,3144,21,4
174358,5109,2083,3026,22,1
174358,5042,2061,2981,23,1
174358,944,344,600,24,1
174358,4098,1717,2381,25,1
174358,67,22,45,31,1
174358,151,33,118,32,3
174358,487,230,257,39,1
174358,3611,1487,2124,40,1
174358,1374,490,884,41,4
174358,1054,404,650,42,1
174358,870,336,534,43,1
174358,43,16,27,44,1
174358,827,320,507,45,1
174358,184,68,116,51,1
174358,320,86,234,52,3
174358,142,54,88,59,1
174358,685,266,419,60,1
174376,7562,3198,4364,1,4
174376,7562,3198,4364,2,1
174376,6670,2832,3838,3,1
174376,915,455,460,4,1
174376,5755,2377,3378,5,1
174376,892,366,526,11,1
174376,1057,416,641,19,1
174376,4698,1961,2737,20,1
174376,2125,1080,1045,21,4
174376,2125,1080,1045,22,1
174376,1870,962,908,23,1
174376,417,232,185,24,1
174376,1453,730,723,25,1
174376,255,118,137,31,1
174376,351,169,182,39,1
174376,1102,561,541,40,1
174376,5437,2118,3319,41,4
174376,5437,2118,3319,42,1
174376,4800,1870,2930,43,1
174376,498,223,275,44,1
174376,4302,1647,2655,45,1
174376,637,248,389,51,1
174376,706,247,459,59,1
174376,3596,1400,2196,60,1
174385,371,131,240,1,4
174385,371,131,240,2,1
174385,369,130,239,3,1
174385,29,18,11,4,1
174385,340,112,228,5,1
174385,2,1,1,11,1
174385,59,23,36,19,1
174385,281,89,192,20,1
174385,22,10,12,21,4
174385,22,10,12,22,1
174385,21,9,12,23,1
174385,21,9,12,25,1
174385,1,1,0,31,1
174385,3,1,2,39,1
174385,18,8,10,40,1
174385,349,121,228,41,4
174385,349,121,228,42,1
174385,348,121,227,43,1
174385,29,18,11,44,1
174385,319,103,216,45,1
174385,1,0,1,51,1
174385,56,22,34,59,1
174385,263,81,182,60,1
174394,237,132,105,1,4
174394,237,132,105,2,1
174394,237,132,105,3,1
174394,20,8,12,4,1
174394,217,124,93,5,1
174394,14,6,8,19,1
174394,203,118,85,20,1
174394,123,68,55,21,4
174394,123,68,55,22,1
174394,123,68,55,23,1
174394,15,6,9,24,1
174394,108,62,46,25,1
174394,8,3,5,39,1
174394,100,59,41,40,1
174394,114,64,50,41,4
174394,114,64,50,42,1
174394,114,64,50,43,1
174394,5,2,3,44,1
174394,109,62,47,45,1
174394,6,3,3,59,1
174394,103,59,44,60,1
174428,9508,4300,5208,1,4
174428,9508,4300,5208,2,1
174428,7751,3567,4184,3,1
174428,1373,694,679,4,1
174428,6378,2873,3505,5,1
174428,1757,733,1024,11,1
174428,1170,534,636,19,1
174428,5208,2339,2869,20,1
174428,3998,2005,1993,21,4
174428,3998,2005,1993,22,1
174428,3410,1735,1675,23,1
174428,859,441,418,24,1
174428,2551,1294,1257,25,1
174428,588,270,318,31,1
174428,647,338,309,39,1
174428,1904,956,948,40,1
174428,5510,2295,3215,41,4
174428,5510,2295,3215,42,1
174428,4341,1832,2509,43,1
174428,514,253,261,44,1
174428,3827,1579,2248,45,1
174428,1169,463,706,51,1
174428,523,196,327,59,1
174428,3304,1383,1921,60,1
174437,1305,597,708,1,4
174437,1301,596,705,2,1
174437,1106,521,585,3,1
174437,246,103,143,4,1
174437,860,418,442,5,1
174437,195,75,120,11,1
174437,4,1,3,12,3
174437,95,50,45,19,1
174437,765,368,397,20,1
174437,1088,507,581,21,4
174437,1088,507,581,22,1
174437,1049,494,555,23,1
174437,246,103,143,24,1
174437,803,391,412,25,1
174437,39,13,26,31,1
174437,90,47,43,39,1
174437,713,344,369,40,1
174437,217,90,127,41,4
174437,213,89,124,42,1
174437,57,27,30,43,1
174437,57,27,30,45,1
174437,156,62,94,51,1
174437,4,1,3,52,3
174437,5,3,2,59,1
174437,52,24,28,60,1
174473,3792,1654,2138,1,4
174473,3792,1654,2138,2,1
174473,2862,1319,1543,3,1
174473,532,299,233,4,1
174473,2330,1020,1310,5,1
174473,930,335,595,11,1
174473,394,179,215,19,1
174473,1936,841,1095,20,1
174473,1713,825,888,21,4
174473,1713,825,888,22,1
174473,1572,762,810,23,1
174473,422,249,173,24,1
174473,1150,513,637,25,1
174473,141,63,78,31,1
174473,253,134,119,39,1
174473,897,379,518,40,1
174473,2079,829,1250,41,4
174473,2079,829,1250,42,1
174473,1290,557,733,43,1
174473,110,50,60,44,1
174473,1180,507,673,45,1
174473,789,272,517,51,1
174473,141,45,96,59,1
174473,1039,462,577,60,1
174491,3352,1380,1972,1,4
174491,3149,1255,1894,2,1
174491,2038,821,1217,3,1
174491,468,182,286,4,1
174491,1570,639,931,5,1
174491,1111,434,677,11,1
174491,203,125,78,12,3
174491,139,58,81,19,1
174491,1431,581,850,20,1
174491,1986,812,1174,21,4
174491,1958,793,1165,22,1
174491,1758,706,1052,23,1
174491,464,181,283,24,1
174491,1294,525,769,25,1
174491,200,87,113,31,1
174491,28,19,9,32,3
174491,116,50,66,39,1
174491,1178,475,703,40,1
174491,1366,568,798,41,4
174491,1191,462,729,42,1
174491,280,115,165,43,1
174491,4,1,3,44,1
174491,276,114,162,45,1
174491,911,347,564,51,1
174491,175,106,69,52,3
174491,23,8,15,59,1
174491,253,106,147,60,1
174507,904,430,474,1,4
174507,113,47,66,2,1
174507,113,47,66,3,1
174507,10,5,5,4,1
174507,103,42,61,5,1
174507,791,383,408,12,3
174507,89,36,53,19,1
174507,14,6,8,20,1
174507,783,381,402,21,4
174507,50,24,26,22,1
174507,50,24,26,23,1
174507,9,4,5,24,1
174507,41,20,21,25,1
174507,733,357,376,32,3
174507,39,18,21,39,1
174507,2,2,0,40,1
174507,121,49,72,41,4
174507,63,23,40,42,1
174507,63,23,40,43,1
174507,1,1,0,44,1
174507,62,22,40,45,1
174507,58,26,32,52,3
174507,50,18,32,59,1
174507,12,4,8,60,1
174525,143,71,72,1,4
174525,143,71,72,2,1
174525,126,64,62,3,1
174525,29,15,14,4,1
174525,97,49,48,5,1
174525,17,7,10,11,1
174525,21,13,8,19,1
174525,76,36,40,20,1
174525,122,61,61,21,4
174525,122,61,61,22,1
174525,117,59,58,23,1
174525,28,14,14,24,1
174525,89,45,44,25,1
174525,5,2,3,31,1
174525,19,12,7,39,1
174525,70,33,37,40,1
174525,21,10,11,41,4
174525,21,10,11,42,1
174525,9,5,4,43,1
174525,1,1,0,44,1
174525,8,4,4,45,1
174525,12,5,7,51,1
174525,2,1,1,59,1
174525,6,3,3,60,1
174534,112,3,109,1,4
174534,112,3,109,2,1
174534,112,3,109,3,1
174534,43,0,43,4,1
174534,69,3,66,5,1
174534,69,3,66,20,1
174534,90,2,88,21,4
174534,90,2,88,22,1
174534,90,2,88,23,1
174534,35,0,35,24,1
174534,55,2,53,25,1
174534,55,2,53,40,1
174534,22,1,21,41,4
174534,22,1,21,42,1
174534,22,1,21,43,1
174534,8,0,8,44,1
174534,14,1,13,45,1
174534,14,1,13,60,1
174570,1098,296,802,1,4
174570,1098,296,802,2,1
174570,751,237,514,3,1
174570,118,53,65,4,1
174570,633,184,449,5,1
174570,347,59,288,11,1
174570,116,27,89,19,1
174570,517,157,360,20,1
174570,345,118,227,21,4
174570,345,118,227,22,1
174570,327,108,219,23,1
174570,46,26,20,24,1
174570,281,82,199,25,1
174570,18,10,8,31,1
174570,47,11,36,39,1
174570,234,71,163,40,1
174570,753,178,575,41,4
174570,753,178,575,42,1
174570,424,129,295,43,1
174570,72,27,45,44,1
174570,352,102,250,45,1
174570,329,49,280,51,1
174570,69,16,53,59,1
174570,283,86,197,60,1
174604,315,125,190,1,4
174604,315,125,190,2,1
174604,204,85,119,3,1
174604,66,29,37,4,1
174604,138,56,82,5,1
174604,111,40,71,11,1
174604,30,18,12,19,1
174604,108,38,70,20,1
174604,240,91,149,21,4
174604,240,91,149,22,1
174604,163,71,92,23,1
174604,60,26,34,24,1
174604,103,45,58,25,1
174604,77,20,57,31,1
174604,23,13,10,39,1
174604,80,32,48,40,1
174604,75,34,41,41,4
174604,75,34,41,42,1
174604,41,14,27,43,1
174604,6,3,3,44,1
174604,35,11,24,45,1
174604,34,20,14,51,1
174604,7,5,2,59,1
174604,28,6,22,60,1
174738,6057,2322,3735,1,4
174738,6057,2322,3735,2,1
174738,5291,2029,3262,3,1
174738,1051,496,555,4,1
174738,4240,1533,2707,5,1
174738,766,293,473,11,1
174738,592,229,363,19,1
174738,3648,1304,2344,20,1
174738,2728,1285,1443,21,4
174738,2728,1285,1443,22,1
174738,2500,1192,1308,23,1
174738,768,391,377,24,1
174738,1732,801,931,25,1
174738,228,93,135,31,1
174738,311,147,164,39,1
174738,1421,654,767,40,1
174738,3329,1037,2292,41,4
174738,3329,1037,2292,42,1
174738,2791,837,1954,43,1
174738,283,105,178,44,1
174738,2508,732,1776,45,1
174738,538,200,338,51,1
174738,281,82,199,59,1
174738,2227,650,1577,60,1
174747,2051,0,2051,1,4
174747,2051,0,2051,2,1
174747,2051,0,2051,3,1
174747,543,0,543,4,1
174747,1508,0,1508,5,1
174747,38,0,38,19,1
174747,1470,0,1470,20,1
174747,2015,0,2015,21,4
174747,2015,0,2015,22,1
174747,2015,0,2015,23,1
174747,538,0,538,24,1
174747,1477,0,1477,25,1
174747,38,0,38,39,1
174747,1439,0,1439,40,1
174747,36,0,36,41,4
174747,36,0,36,42,1
174747,36,0,36,43,1
174747,5,0,5,44,1
174747,31,0,31,45,1
174747,31,0,31,60,1
174756,4946,2318,2628,1,4
174756,4946,2318,2628,2,1
174756,4422,2013,2409,3,1
174756,976,544,432,4,1
174756,3446,1469,1977,5,1
174756,524,305,219,11,1
174756,687,329,358,19,1
174756,2759,1140,1619,20,1
174756,2286,1183,1103,21,4
174756,2286,1183,1103,22,1
174756,2206,1153,1053,23,1
174756,524,337,187,24,1
174756,1682,816,866,25,1
174756,80,30,50,31,1
174756,382,215,167,39,1
174756,1300,601,699,40,1
174756,2660,1135,1525,41,4
174756,2660,1135,1525,42,1
174756,2216,860,1356,43,1
174756,452,207,245,44,1
174756,1764,653,1111,45,1
174756,444,275,169,51,1
174756,305,114,191,59,1
174756,1459,539,920,60,1
174765,76,1,75,1,4
174765,76,1,75,2,1
174765,76,1,75,3,1
174765,23,0,23,4,1
174765,53,1,52,5,1
174765,53,1,52,20,1
174765,76,1,75,21,4
174765,76,1,75,22,1
174765,76,1,75,23,1
174765,23,0,23,24,1
174765,53,1,52,25,1
174765,53,1,52,40,1
174783,16765,7949,8816,1,4
174783,15134,7285,7849,2,1
174783,11535,5798,5737,3,1
174783,1701,779,922,4,1
174783,9834,5019,4815,5,1
174783,3599,1487,2112,11,1
174783,1631,664,967,12,3
174783,1078,524,554,19,1
174783,8756,4495,4261,20,1
174783,10447,5123,5324,21,4
174783,9860,4914,4946,22,1
174783,9544,4811,4733,23,1
174783,1659,758,901,24,1
174783,7885,4053,3832,25,1
174783,316,103,213,31,1
174783,587,209,378,32,3
174783,875,432,443,39,1
174783,7010,3621,3389,40,1
174783,6318,2826,3492,41,4
174783,5274,2371,2903,42,1
174783,1991,987,1004,43,1
174783,42,21,21,44,1
174783,1949,966,983,45,1
174783,3283,1384,1899,51,1
174783,1044,455,589,52,3
174783,203,92,111,59,1
174783,1746,874,872,60,1
174792,1979,1924,55,1,4
174792,1871,1871,0,2,1
174792,1871,1871,0,3,1
174792,500,500,0,4,1
174792,1371,1371,0,5,1
174792,108,53,55,12,3
174792,26,26,0,19,1
174792,1345,1345,0,20,1
174792,1904,1881,23,21,4
174792,1850,1850,0,22,1
174792,1850,1850,0,23,1
174792,497,497,0,24,1
174792,1353,1353,0,25,1
174792,54,31,23,32,3
174792,26,26,0,39,1
174792,1327,1327,0,40,1
174792,75,43,32,41,4
174792,21,21,0,42,1
174792,21,21,0,43,1
174792,3,3,0,44,1
174792,18,18,0,45,1
174792,54,22,32,52,3
174792,18,18,0,60,1
174817,5528,1961,3567,1,4
174817,1932,876,1056,2,1
174817,1897,859,1038,3,1
174817,319,138,181,4,1
174817,1578,721,857,5,1
174817,35,17,18,11,1
174817,3596,1085,2511,12,3
174817,197,93,104,19,1
174817,1381,628,753,20,1
174817,3294,1218,2076,21,4
174817,1307,613,694,22,1
174817,1296,610,686,23,1
174817,307,138,169,24,1
174817,989,472,517,25,1
174817,11,3,8,31,1
174817,1987,605,1382,32,3
174817,81,47,34,39,1
174817,908,425,483,40,1
174817,2234,743,1491,41,4
174817,625,263,362,42,1
174817,601,249,352,43,1
174817,12,0,12,44,1
174817,589,249,340,45,1
174817,24,14,10,51,1
174817,1609,480,1129,52,3
174817,116,46,70,59,1
174817,473,203,270,60,1
174844,3125,1370,1755,1,4
174844,3125,1370,1755,2,1
174844,3079,1350,1729,3,1
174844,752,319,433,4,1
174844,2327,1031,1296,5,1
174844,46,20,26,11,1
174844,19,8,11,19,1
174844,2308,1023,1285,20,1
174844,3081,1352,1729,21,4
174844,3081,1352,1729,22,1
174844,3071,1347,1724,23,1
174844,752,319,433,24,1
174844,2319,1028,1291,25,1
174844,10,5,5,31,1
174844,19,8,11,39,1
174844,2300,1020,1280,40,1
174844,44,18,26,41,4
174844,44,18,26,42,1
174844,8,3,5,43,1
174844,8,3,5,45,1
174844,36,15,21,51,1
174844,8,3,5,60,1
174862,1323,638,685,1,4
174862,1139,533,606,2,1
174862,1095,521,574,3,1
174862,210,118,92,4,1
174862,885,403,482,5,1
174862,44,12,32,11,1
174862,184,105,79,12,3
174862,53,26,27,19,1
174862,832,377,455,20,1
174862,1071,510,561,21,4
174862,935,436,499,22,1
174862,915,430,485,23,1
174862,198,112,86,24,1
174862,717,318,399,25,1
174862,20,6,14,31,1
174862,136,74,62,32,3
174862,51,24,27,39,1
174862,666,294,372,40,1
174862,252,128,124,41,4
174862,204,97,107,42,1
174862,180,91,89,43,1
174862,12,6,6,44,1
174862,168,85,83,45,1
174862,24,6,18,51,1
174862,48,31,17,52,3
174862,2,2,0,59,1
174862,166,83,83,60,1
174899,4206,1199,3007,1,4
174899,2917,896,2021,2,1
174899,2858,877,1981,3,1
174899,432,137,295,4,1
174899,2426,740,1686,5,1
174899,59,19,40,11,1
174899,1289,303,986,12,3
174899,449,104,345,19,1
174899,1977,636,1341,20,1
174899,3309,996,2313,21,4
174899,2423,782,1641,22,1
174899,2414,781,1633,23,1
174899,431,137,294,24,1
174899,1983,644,1339,25,1
174899,9,1,8,31,1
174899,886,214,672,32,3
174899,325,84,241,39,1
174899,1658,560,1098,40,1
174899,897,203,694,41,4
174899,494,114,380,42,1
174899,444,96,348,43,1
174899,1,0,1,44,1
174899,443,96,347,45,1
174899,50,18,32,51,1
174899,403,89,314,52,3
174899,124,20,104,59,1
174899,319,76,243,60,1
174914,10192,5235,4957,1,4
174914,6321,3337,2984,2,1
174914,6246,3310,2936,3,1
174914,1368,717,651,4,1
174914,4878,2593,2285,5,1
174914,75,27,48,11,1
174914,3871,1898,1973,12,3
174914,271,178,93,19,1
174914,4607,2415,2192,20,1
174914,7257,3768,3489,21,4
174914,6065,3200,2865,22,1
174914,6051,3197,2854,23,1
174914,1368,717,651,24,1
174914,4683,2480,2203,25,1
174914,14,3,11,31,1
174914,1192,568,624,32,3
174914,257,171,86,39,1
174914,4426,2309,2117,40,1
174914,2935,1467,1468,41,4
174914,256,137,119,42,1
174914,195,113,82,43,1
174914,195,113,82,45,1
174914,61,24,37,51,1
174914,2679,1330,1349,52,3
174914,14,7,7,59,1
174914,181,106,75,60,1
174978,148,3,145,1,4
174978,148,3,145,2,1
174978,148,3,145,3,1
174978,37,1,36,4,1
174978,111,2,109,5,1
174978,111,2,109,20,1
174978,116,2,114,21,4
174978,116,2,114,22,1
174978,116,2,114,23,1
174978,32,1,31,24,1
174978,84,1,83,25,1
174978,84,1,83,40,1
174978,32,1,31,41,4
174978,32,1,31,42,1
174978,32,1,31,43,1
174978,5,0,5,44,1
174978,27,1,26,45,1
174978,27,1,26,60,1
175005,5017,273,4744,1,4
175005,3559,123,3436,2,1
175005,3479,115,3364,3,1
175005,444,8,436,4,1
175005,3035,107,2928,5,1
175005,80,8,72,11,1
175005,1458,150,1308,12,3
175005,609,39,570,19,1
175005,2426,68,2358,20,1
175005,3254,133,3121,21,4
175005,2188,20,2168,22,1
175005,2174,19,2155,23,1
175005,419,6,413,24,1
175005,1755,13,1742,25,1
175005,14,1,13,31,1
175005,1066,113,953,32,3
175005,248,4,244,39,1
175005,1507,9,1498,40,1
175005,1763,140,1623,41,4
175005,1371,103,1268,42,1
175005,1305,96,1209,43,1
175005,25,2,23,44,1
175005,1280,94,1186,45,1
175005,66,7,59,51,1
175005,392,37,355,52,3
175005,361,35,326,59,1
175005,919,59,860,60,1
175014,5485,1285,4200,1,4
175014,5485,1285,4200,2,1
175014,4742,1268,3474,3,1
175014,207,54,153,4,1
175014,4535,1214,3321,5,1
175014,743,17,726,11,1
175014,1010,251,759,19,1
175014,3525,963,2562,20,1
175014,2787,733,2054,21,4
175014,2787,733,2054,22,1
175014,2784,732,2052,23,1
175014,161,44,117,24,1
175014,2623,688,1935,25,1
175014,3,1,2,31,1
175014,750,199,551,39,1
175014,1873,489,1384,40,1
175014,2698,552,2146,41,4
175014,2698,552,2146,42,1
175014,1958,536,1422,43,1
175014,46,10,36,44,1
175014,1912,526,1386,45,1
175014,740,16,724,51,1
175014,260,52,208,59,1
175014,1652,474,1178,60,1
175041,6740,3035,3705,1,4
175041,6740,3035,3705,2,1
175041,6083,2769,3314,3,1
175041,1246,666,580,4,1
175041,4837,2103,2734,5,1
175041,657,266,391,11,1
175041,993,423,570,19,1
175041,3844,1680,2164,20,1
175041,2740,1452,1288,21,4
175041,2740,1452,1288,22,1
175041,2686,1422,1264,23,1
175041,699,398,301,24,1
175041,1987,1024,963,25,1
175041,54,30,24,31,1
175041,444,234,210,39,1
175041,1543,790,753,40,1
175041,4000,1583,2417,41,4
175041,4000,1583,2417,42,1
175041,3397,1347,2050,43,1
175041,547,268,279,44,1
175041,2850,1079,1771,45,1
175041,603,236,367,51,1
175041,549,189,360,59,1
175041,2301,890,1411,60,1
175078,6917,2819,4098,1,4
175078,6467,2658,3809,2,1
175078,2426,1000,1426,3,1
175078,449,195,254,4,1
175078,1977,805,1172,5,1
175078,4041,1658,2383,11,1
175078,450,161,289,12,3
175078,244,96,148,19,1
175078,1733,709,1024,20,1
175078,2403,1019,1384,21,4
175078,2120,935,1185,22,1
175078,2006,884,1122,23,1
175078,445,192,253,24,1
175078,1561,692,869,25,1
175078,114,51,63,31,1
175078,283,84,199,32,3
175078,143,78,65,39,1
175078,1418,614,804,40,1
175078,4514,1800,2714,41,4
175078,4347,1723,2624,42,1
175078,420,116,304,43,1
175078,4,3,1,44,1
175078,416,113,303,45,1
175078,3927,1607,2320,51,1
175078,167,77,90,52,3
175078,101,18,83,59,1
175078,315,95,220,60,1
175120,252,159,93,1,4
175120,252,159,93,2,1
175120,252,159,93,3,1
175120,101,71,30,4,1
175120,151,88,63,5,1
175120,151,88,63,20,1
175120,244,153,91,21,4
175120,244,153,91,22,1
175120,244,153,91,23,1
175120,101,71,30,24,1
175120,143,82,61,25,1
175120,143,82,61,40,1
175120,8,6,2,41,4
175120,8,6,2,42,1
175120,8,6,2,43,1
175120,8,6,2,45,1
175120,8,6,2,60,1
175139,128,38,90,1,4
175139,128,38,90,12,3
175139,49,14,35,21,4
175139,49,14,35,32,3
175139,79,24,55,41,4
175139,79,24,55,52,3
175157,711,458,253,1,4
175157,711,458,253,2,1
175157,515,383,132,3,1
175157,163,120,43,4,1
175157,352,263,89,5,1
175157,196,75,121,11,1
175157,71,53,18,19,1
175157,281,210,71,20,1
175157,496,361,135,21,4
175157,496,361,135,22,1
175157,479,360,119,23,1
175157,162,119,43,24,1
175157,317,241,76,25,1
175157,17,1,16,31,1
175157,68,52,16,39,1
175157,249,189,60,40,1
175157,215,97,118,41,4
175157,215,97,118,42,1
175157,36,23,13,43,1
175157,1,1,0,44,1
175157,35,22,13,45,1
175157,179,74,105,51,1
175157,3,1,2,59,1
175157,32,21,11,60,1
175227,1071,940,131,1,4
175227,1071,940,131,2,1
175227,1065,935,130,3,1
175227,204,191,13,4,1
175227,861,744,117,5,1
175227,6,5,1,11,1
175227,219,191,28,19,1
175227,642,553,89,20,1
175227,855,768,87,21,4
175227,855,768,87,22,1
175227,854,767,87,23,1
175227,192,179,13,24,1
175227,662,588,74,25,1
175227,1,1,0,31,1
175227,188,172,16,39,1
175227,474,416,58,40,1
175227,216,172,44,41,4
175227,216,172,44,42,1
175227,211,168,43,43,1
175227,12,12,0,44,1
175227,199,156,43,45,1
175227,5,4,1,51,1
175227,31,19,12,59,1
175227,168,137,31,60,1
175236,3766,1731,2035,1,4
175236,3766,1731,2035,2,1
175236,3329,1598,1731,3,1
175236,739,439,300,4,1
175236,2590,1159,1431,5,1
175236,437,133,304,11,1
175236,406,194,212,19,1
175236,2184,965,1219,20,1
175236,2293,1188,1105,21,4
175236,2293,1188,1105,22,1
175236,2157,1145,1012,23,1
175236,605,374,231,24,1
175236,1552,771,781,25,1
175236,136,43,93,31,1
175236,297,161,136,39,1
175236,1255,610,645,40,1
175236,1473,543,930,41,4
175236,1473,543,930,42,1
175236,1172,453,719,43,1
175236,134,65,69,44,1
175236,1038,388,650,45,1
175236,301,90,211,51,1
175236,109,33,76,59,1
175236,929,355,574,60,1
175263,2207,913,1294,1,4
175263,2207,913,1294,2,1
175263,1875,777,1098,3,1
175263,298,165,133,4,1
175263,1577,612,965,5,1
175263,332,136,196,11,1
175263,321,165,156,19,1
175263,1256,447,809,20,1
175263,1135,536,599,21,4
175263,1135,536,599,22,1
175263,1111,526,585,23,1
175263,206,129,77,24,1
175263,905,397,508,25,1
175263,24,10,14,31,1
175263,210,128,82,39,1
175263,695,269,426,40,1
175263,1072,377,695,41,4
175263,1072,377,695,42,1
175263,764,251,513,43,1
175263,92,36,56,44,1
175263,672,215,457,45,1
175263,308,126,182,51,1
175263,111,37,74,59,1
175263,561,178,383,60,1
175272,8782,3340,5442,1,4
175272,8253,3206,5047,2,1
175272,8079,3139,4940,3,1
175272,1641,583,1058,4,1
175272,6438,2556,3882,5,1
175272,174,67,107,11,1
175272,529,134,395,12,3
175272,576,250,326,19,1
175272,5862,2306,3556,20,1
175272,7487,2926,4561,21,4
175272,7354,2899,4455,22,1
175272,7262,2868,4394,23,1
175272,1630,579,1051,24,1
175272,5632,2289,3343,25,1
175272,92,31,61,31,1
175272,133,27,106,32,3
175272,369,199,170,39,1
175272,5263,2090,3173,40,1
175272,1295,414,881,41,4
175272,899,307,592,42,1
175272,817,271,546,43,1
175272,11,4,7,44,1
175272,806,267,539,45,1
175272,82,36,46,51,1
175272,396,107,289,52,3
175272,207,51,156,59,1
175272,599,216,383,60,1
175281,813,399,414,1,4
175281,813,399,414,12,3
175281,553,271,282,21,4
175281,553,271,282,32,3
175281,260,128,132,41,4
175281,260,128,132,52,3
175315,10073,4513,5560,1,4
175315,10073,4513,5560,2,1
175315,9484,4248,5236,3,1
175315,1410,765,645,4,1
175315,8074,3483,4591,5,1
175315,589,265,324,11,1
175315,1377,592,785,19,1
175315,6697,2891,3806,20,1
175315,3985,2067,1918,21,4
175315,3985,2067,1918,22,1
175315,3809,1976,1833,23,1
175315,812,452,360,24,1
175315,2997,1524,1473,25,1
175315,176,91,85,31,1
175315,656,333,323,39,1
175315,2341,1191,1150,40,1
175315,6088,2446,3642,41,4
175315,6088,2446,3642,42,1
175315,5675,2272,3403,43,1
175315,598,313,285,44,1
175315,5077,1959,3118,45,1
175315,413,174,239,51,1
175315,721,259,462,59,1
175315,4356,1700,2656,60,1
175342,3848,1285,2563,1,4
175342,3157,1118,2039,2,1
175342,3157,1118,2039,3,1
175342,574,228,346,4,1
175342,2583,890,1693,5,1
175342,691,167,524,12,3
175342,152,53,99,19,1
175342,2431,837,1594,20,1
175342,2917,1075,1842,21,4
175342,2732,1020,1712,22,1
175342,2732,1020,1712,23,1
175342,545,215,330,24,1
175342,2187,805,1382,25,1
175342,185,55,130,32,3
175342,136,53,83,39,1
175342,2051,752,1299,40,1
175342,931,210,721,41,4
175342,425,98,327,42,1
175342,425,98,327,43,1
175342,29,13,16,44,1
175342,396,85,311,45,1
175342,506,112,394,52,3
175342,16,0,16,59,1
175342,380,85,295,60,1
175421,4025,1427,2598,1,4
175421,2749,1050,1699,2,1
175421,2487,958,1529,3,1
175421,280,125,155,4,1
175421,2207,833,1374,5,1
175421,262,92,170,11,1
175421,1276,377,899,12,3
175421,437,180,257,19,1
175421,1770,653,1117,20,1
175421,1411,613,798,21,4
175421,1242,558,684,22,1
175421,1241,557,684,23,1
175421,217,101,116,24,1
175421,1024,456,568,25,1
175421,1,1,0,31,1
175421,169,55,114,32,3
175421,200,109,91,39,1
175421,824,347,477,40,1
175421,2614,814,1800,41,4
175421,1507,492,1015,42,1
175421,1246,401,845,43,1
175421,63,24,39,44,1
175421,1183,377,806,45,1
175421,261,91,170,51,1
175421,1107,322,785,52,3
175421,237,71,166,59,1
175421,946,306,640,60,1
175430,532,217,315,1,4
175430,520,217,303,2,1
175430,497,207,290,3,1
175430,85,39,46,4,1
175430,412,168,244,5,1
175430,23,10,13,11,1
175430,12,0,12,12,3
175430,91,37,54,19,1
175430,321,131,190,20,1
175430,461,193,268,21,4
175430,453,193,260,22,1
175430,453,193,260,23,1
175430,81,37,44,24,1
175430,372,156,216,25,1
175430,8,0,8,32,3
175430,82,35,47,39,1
175430,290,121,169,40,1
175430,71,24,47,41,4
175430,67,24,43,42,1
175430,44,14,30,43,1
175430,4,2,2,44,1
175430,40,12,28,45,1
175430,23,10,13,51,1
175430,4,0,4,52,3
175430,9,2,7,59,1
175430,31,10,21,60,1
175494,97,4,93,1,4
175494,97,4,93,2,1
175494,97,4,93,3,1
175494,26,1,25,4,1
175494,71,3,68,5,1
175494,71,3,68,20,1
175494,97,4,93,21,4
175494,97,4,93,22,1
175494,97,4,93,23,1
175494,26,1,25,24,1
175494,71,3,68,25,1
175494,71,3,68,40,1
175519,2073,781,1292,1,4
175519,2073,781,1292,2,1
175519,1959,756,1203,3,1
175519,468,228,240,4,1
175519,1491,528,963,5,1
175519,114,25,89,11,1
175519,90,45,45,19,1
175519,1401,483,918,20,1
175519,1854,731,1123,21,4
175519,1854,731,1123,22,1
175519,1854,731,1123,23,1
175519,457,227,230,24,1
175519,1397,504,893,25,1
175519,80,42,38,39,1
175519,1317,462,855,40,1
175519,219,50,169,41,4
175519,219,50,169,42,1
175519,105,25,80,43,1
175519,11,1,10,44,1
175519,94,24,70,45,1
175519,114,25,89,51,1
175519,10,3,7,59,1
175519,84,21,63,60,1
175528,485,56,429,1,4
175528,485,56,429,2,1
175528,485,56,429,3,1
175528,48,3,45,4,1
175528,437,53,384,5,1
175528,40,3,37,19,1
175528,397,50,347,20,1
175528,375,44,331,21,4
175528,375,44,331,22,1
175528,375,44,331,23,1
175528,44,3,41,24,1
175528,331,41,290,25,1
175528,36,2,34,39,1
175528,295,39,256,40,1
175528,110,12,98,41,4
175528,110,12,98,42,1
175528,110,12,98,43,1
175528,4,0,4,44,1
175528,106,12,94,45,1
175528,4,1,3,59,1
175528,102,11,91,60,1
175573,3157,1176,1981,1,4
175573,3157,1176,1981,2,1
175573,2859,1067,1792,3,1
175573,692,322,370,4,1
175573,2167,745,1422,5,1
175573,298,109,189,11,1
175573,205,72,133,19,1
175573,1962,673,1289,20,1
175573,2509,976,1533,21,4
175573,2509,976,1533,22,1
175573,2505,975,1530,23,1
175573,655,310,345,24,1
175573,1850,665,1185,25,1
175573,4,1,3,31,1
175573,176,63,113,39,1
175573,1674,602,1072,40,1
175573,648,200,448,41,4
175573,648,200,448,42,1
175573,354,92,262,43,1
175573,37,12,25,44,1
175573,317,80,237,45,1
175573,294,108,186,51,1
175573,29,9,20,59,1
175573,288,71,217,60,1
175591,51,0,51,1,4
175591,51,0,51,2,1
175591,51,0,51,3,1
175591,7,0,7,4,1
175591,44,0,44,5,1
175591,44,0,44,20,1
175591,51,0,51,21,4
175591,51,0,51,22,1
175591,51,0,51,23,1
175591,7,0,7,24,1
175591,44,0,44,25,1
175591,44,0,44,40,1
175607,50,2,48,1,4
175607,50,2,48,2,1
175607,50,2,48,3,1
175607,3,0,3,4,1
175607,47,2,45,5,1
175607,47,2,45,20,1
175607,50,2,48,21,4
175607,50,2,48,22,1
175607,50,2,48,23,1
175607,3,0,3,24,1
175607,47,2,45,25,1
175607,47,2,45,40,1
175616,4785,1651,3134,1,4
175616,2638,1050,1588,2,1
175616,2638,1050,1588,3,1
175616,383,151,232,4,1
175616,2255,899,1356,5,1
175616,2147,601,1546,12,3
175616,470,180,290,19,1
175616,1785,719,1066,20,1
175616,3676,1300,2376,21,4
175616,2166,864,1302,22,1
175616,2166,864,1302,23,1
175616,381,150,231,24,1
175616,1785,714,1071,25,1
175616,1510,436,1074,32,3
175616,440,170,270,39,1
175616,1345,544,801,40,1
175616,1109,351,758,41,4
175616,472,186,286,42,1
175616,472,186,286,43,1
175616,2,1,1,44,1
175616,470,185,285,45,1
175616,637,165,472,52,3
175616,30,10,20,59,1
175616,440,175,265,60,1
175643,2572,1034,1538,1,4
175643,2572,1034,1538,2,1
175643,2323,934,1389,3,1
175643,754,376,378,4,1
175643,1569,558,1011,5,1
175643,249,100,149,11,1
175643,493,153,340,19,1
175643,1076,405,671,20,1
175643,1974,842,1132,21,4
175643,1974,842,1132,22,1
175643,1970,839,1131,23,1
175643,717,363,354,24,1
175643,1253,476,777,25,1
175643,4,3,1,31,1
175643,354,120,234,39,1
175643,899,356,543,40,1
175643,598,192,406,41,4
175643,598,192,406,42,1
175643,353,95,258,43,1
175643,37,13,24,44,1
175643,316,82,234,45,1
175643,245,97,148,51,1
175643,139,33,106,59,1
175643,177,49,128,60,1
175652,4364,1852,2512,1,4
175652,4364,1852,2512,2,1
175652,4364,1852,2512,3,1
175652,1083,513,570,4,1
175652,3281,1339,1942,5,1
175652,1151,471,680,19,1
175652,2130,868,1262,20,1
175652,2697,1169,1528,21,4
175652,2697,1169,1528,22,1
175652,2697,1169,1528,23,1
175652,733,348,385,24,1
175652,1964,821,1143,25,1
175652,628,247,381,39,1
175652,1336,574,762,40,1
175652,1667,683,984,41,4
175652,1667,683,984,42,1
175652,1667,683,984,43,1
175652,350,165,185,44,1
175652,1317,518,799,45,1
175652,523,224,299,59,1
175652,794,294,500,60,1
175698,32,21,11,1,4
175698,32,21,11,2,1
175698,32,21,11,3,1
175698,4,3,1,4,1
175698,28,18,10,5,1
175698,28,18,10,20,1
175698,11,8,3,21,4
175698,11,8,3,22,1
175698,11,8,3,23,1
175698,2,2,0,24,1
175698,9,6,3,25,1
175698,9,6,3,40,1
175698,21,13,8,41,4
175698,21,13,8,42,1
175698,21,13,8,43,1
175698,2,1,1,44,1
175698,19,12,7,45,1
175698,19,12,7,60,1
175722,40,1,39,1,4
175722,40,1,39,2,1
175722,40,1,39,3,1
175722,7,0,7,4,1
175722,33,1,32,5,1
175722,33,1,32,20,1
175722,40,1,39,21,4
175722,40,1,39,22,1
175722,40,1,39,23,1
175722,7,0,7,24,1
175722,33,1,32,25,1
175722,33,1,32,40,1
175786,11893,4352,7541,1,4
175786,11893,4352,7541,2,1
175786,10946,3975,6971,3,1
175786,2942,1314,1628,4,1
175786,8004,2661,5343,5,1
175786,947,377,570,11,1
175786,900,318,582,19,1
175786,7104,2343,4761,20,1
175786,8468,3250,5218,21,4
175786,8468,3250,5218,22,1
175786,8421,3230,5191,23,1
175786,2745,1236,1509,24,1
175786,5676,1994,3682,25,1
175786,47,20,27,31,1
175786,609,224,385,39,1
175786,5067,1770,3297,40,1
175786,3425,1102,2323,41,4
175786,3425,1102,2323,42,1
175786,2525,745,1780,43,1
175786,197,78,119,44,1
175786,2328,667,1661,45,1
175786,900,357,543,51,1
175786,291,94,197,59,1
175786,2037,573,1464,60,1
175810,5911,2121,3790,1,4
175810,5911,2121,3790,2,1
175810,5911,2121,3790,3,1
175810,1441,683,758,4,1
175810,4470,1438,3032,5,1
175810,936,278,658,19,1
175810,3534,1160,2374,20,1
175810,4048,1479,2569,21,4
175810,4048,1479,2569,22,1
175810,4048,1479,2569,23,1
175810,1038,514,524,24,1
175810,3010,965,2045,25,1
175810,629,181,448,39,1
175810,2381,784,1597,40,1
175810,1863,642,1221,41,4
175810,1863,642,1221,42,1
175810,1863,642,1221,43,1
175810,403,169,234,44,1
175810,1460,473,987,45,1
175810,307,97,210,59,1
175810,1153,376,777,60,1
175829,5693,2270,3423,1,4
175829,5693,2270,3423,2,1
175829,5477,2191,3286,3,1
175829,1577,707,870,4,1
175829,3900,1484,2416,5,1
175829,216,79,137,11,1
175829,1100,362,738,19,1
175829,2800,1122,1678,20,1
175829,4194,1747,2447,21,4
175829,4194,1747,2447,22,1
175829,4182,1747,2435,23,1
175829,1436,641,795,24,1
175829,2746,1106,1640,25,1
175829,12,0,12,31,1
175829,583,216,367,39,1
175829,2163,890,1273,40,1
175829,1499,523,976,41,4
175829,1499,523,976,42,1
175829,1295,444,851,43,1
175829,141,66,75,44,1
175829,1154,378,776,45,1
175829,204,79,125,51,1
175829,517,146,371,59,1
175829,637,232,405,60,1
175856,9134,3204,5930,1,4
175856,6903,2566,4337,2,1
175856,6880,2553,4327,3,1
175856,1103,470,633,4,1
175856,5777,2083,3694,5,1
175856,23,13,10,11,1
175856,2231,638,1593,12,3
175856,717,236,481,19,1
175856,5060,1847,3213,20,1
175856,6665,2564,4101,21,4
175856,5812,2304,3508,22,1
175856,5796,2294,3502,23,1
175856,1095,468,627,24,1
175856,4701,1826,2875,25,1
175856,16,10,6,31,1
175856,853,260,593,32,3
175856,591,189,402,39,1
175856,4110,1637,2473,40,1
175856,2469,640,1829,41,4
175856,1091,262,829,42,1
175856,1084,259,825,43,1
175856,8,2,6,44,1
175856,1076,257,819,45,1
175856,7,3,4,51,1
175856,1378,378,1000,52,3
175856,126,47,79,59,1
175856,950,210,740,60,1
175883,4443,1850,2593,1,4
175883,4443,1850,2593,2,1
175883,4443,1850,2593,3,1
175883,1584,732,852,4,1
175883,2859,1118,1741,5,1
175883,331,141,190,19,1
175883,2528,977,1551,20,1
175883,3573,1511,2062,21,4
175883,3573,1511,2062,22,1
175883,3573,1511,2062,23,1
175883,1237,597,640,24,1
175883,2336,914,1422,25,1
175883,278,116,162,39,1
175883,2058,798,1260,40,1
175883,870,339,531,41,4
175883,870,339,531,42,1
175883,870,339,531,43,1
175883,347,135,212,44,1
175883,523,204,319,45,1
175883,53,25,28,59,1
175883,470,179,291,60,1
175935,3713,1160,2553,1,4
175935,3713,1160,2553,2,1
175935,3601,1101,2500,3,1
175935,613,256,357,4,1
175935,2988,845,2143,5,1
175935,112,59,53,11,1
175935,1166,276,890,19,1
175935,1822,569,1253,20,1
175935,2481,774,1707,21,4
175935,2481,774,1707,22,1
175935,2472,766,1706,23,1
175935,483,201,282,24,1
175935,1989,565,1424,25,1
175935,9,8,1,31,1
175935,766,165,601,39,1
175935,1223,400,823,40,1
175935,1232,386,846,41,4
175935,1232,386,846,42,1
175935,1129,335,794,43,1
175935,130,55,75,44,1
175935,999,280,719,45,1
175935,103,51,52,51,1
175935,400,111,289,59,1
175935,599,169,430,60,1
175980,804,430,374,1,4
175980,744,389,355,2,1
175980,734,388,346,3,1
175980,171,96,75,4,1
175980,563,292,271,5,1
175980,10,1,9,11,1
175980,60,41,19,12,3
175980,26,18,8,19,1
175980,537,274,263,20,1
175980,767,409,358,21,4
175980,730,384,346,22,1
175980,729,384,345,23,1
175980,171,96,75,24,1
175980,558,288,270,25,1
175980,1,0,1,31,1
175980,37,25,12,32,3
175980,26,18,8,39,1
175980,532,270,262,40,1
175980,37,21,16,41,4
175980,14,5,9,42,1
175980,5,4,1,43,1
175980,5,4,1,45,1
175980,9,1,8,51,1
175980,23,16,7,52,3
175980,5,4,1,60,1
176008,2950,1098,1852,1,4
176008,2950,1098,1852,2,1
176008,2567,961,1606,3,1
176008,738,317,421,4,1
176008,1829,644,1185,5,1
176008,383,137,246,11,1
176008,246,81,165,19,1
176008,1583,563,1020,20,1
176008,2305,883,1422,21,4
176008,2305,883,1422,22,1
176008,2192,846,1346,23,1
176008,688,300,388,24,1
176008,1504,546,958,25,1
176008,113,37,76,31,1
176008,181,58,123,39,1
176008,1323,488,835,40,1
176008,645,215,430,41,4
176008,645,215,430,42,1
176008,375,115,260,43,1
176008,50,17,33,44,1
176008,325,98,227,45,1
176008,270,100,170,51,1
176008,65,23,42,59,1
176008,260,75,185,60,1
176017,19431,8767,10664,1,4
176017,16677,7513,9164,2,1
176017,16432,7393,9039,3,1
176017,3582,1575,2007,4,1
176017,12850,5818,7032,5,1
176017,245,120,125,11,1
176017,2754,1254,1500,12,3
176017,1228,541,687,19,1
176017,11622,5277,6345,20,1
176017,17612,8002,9610,21,4
176017,15628,7024,8604,22,1
176017,15411,6917,8494,23,1
176017,3564,1565,1999,24,1
176017,11847,5352,6495,25,1
176017,217,107,110,31,1
176017,1984,978,1006,32,3
176017,1133,506,627,39,1
176017,10714,4846,5868,40,1
176017,1819,765,1054,41,4
176017,1049,489,560,42,1
176017,1021,476,545,43,1
176017,18,10,8,44,1
176017,1003,466,537,45,1
176017,28,13,15,51,1
176017,770,276,494,52,3
176017,95,35,60,59,1
176017,908,431,477,60,1
176026,2268,731,1537,1,4
176026,700,122,578,2,1
176026,699,121,578,3,1
176026,699,121,578,5,1
176026,1,1,0,11,1
176026,1568,609,959,12,3
176026,262,44,218,19,1
176026,437,77,360,20,1
176026,1478,575,903,21,4
176026,360,49,311,22,1
176026,360,49,311,23,1
176026,360,49,311,25,1
176026,1118,526,592,32,3
176026,147,18,129,39,1
176026,213,31,182,40,1
176026,790,156,634,41,4
176026,340,73,267,42,1
176026,339,72,267,43,1
176026,339,72,267,45,1
176026,1,1,0,51,1
176026,450,83,367,52,3
176026,115,26,89,59,1
176026,224,46,178,60,1
176035,2629,475,2154,1,4
176035,2429,441,1988,2,1
176035,2252,370,1882,3,1
176035,183,30,153,4,1
176035,2069,340,1729,5,1
176035,177,71,106,11,1
176035,200,34,166,12,3
176035,594,92,502,19,1
176035,1475,248,1227,20,1
176035,2046,330,1716,21,4
176035,1945,316,1629,22,1
176035,1942,315,1627,23,1
176035,182,29,153,24,1
176035,1760,286,1474,25,1
176035,3,1,2,31,1
176035,101,14,87,32,3
176035,557,86,471,39,1
176035,1203,200,1003,40,1
176035,583,145,438,41,4
176035,484,125,359,42,1
176035,310,55,255,43,1
176035,1,1,0,44,1
176035,309,54,255,45,1
176035,174,70,104,51,1
176035,99,20,79,52,3
176035,37,6,31,59,1
176035,272,48,224,60,1
176044,2203,883,1320,1,4
176044,1926,814,1112,2,1
176044,1856,786,1070,3,1
176044,493,230,263,4,1
176044,1363,556,807,5,1
176044,70,28,42,11,1
176044,277,69,208,12,3
176044,181,82,99,19,1
176044,1182,474,708,20,1
176044,1711,723,988,21,4
176044,1600,696,904,22,1
176044,1600,696,904,23,1
176044,459,214,245,24,1
176044,1141,482,659,25,1
176044,111,27,84,32,3
176044,159,75,84,39,1
176044,982,407,575,40,1
176044,492,160,332,41,4
176044,326,118,208,42,1
176044,256,90,166,43,1
176044,34,16,18,44,1
176044,222,74,148,45,1
176044,70,28,42,51,1
176044,166,42,124,52,3
176044,22,7,15,59,1
176044,200,67,133,60,1
176053,4921,1964,2957,1,4
176053,2905,1196,1709,2,1
176053,2895,1192,1703,3,1
176053,598,289,309,4,1
176053,2297,903,1394,5,1
176053,10,4,6,11,1
176053,2016,768,1248,12,3
176053,316,136,180,19,1
176053,1981,767,1214,20,1
176053,3781,1594,2187,21,4
176053,2589,1084,1505,22,1
176053,2586,1084,1502,23,1
176053,588,284,304,24,1
176053,1998,800,1198,25,1
176053,3,0,3,31,1
176053,1192,510,682,32,3
176053,291,126,165,39,1
176053,1707,674,1033,40,1
176053,1140,370,770,41,4
176053,316,112,204,42,1
176053,309,108,201,43,1
176053,10,5,5,44,1
176053,299,103,196,45,1
176053,7,4,3,51,1
176053,824,258,566,52,3
176053,25,10,15,59,1
176053,274,93,181,60,1
176062,82,1,81,1,4
176062,82,1,81,2,1
176062,82,1,81,3,1
176062,16,0,16,4,1
176062,66,1,65,5,1
176062,66,1,65,20,1
176062,82,1,81,21,4
176062,82,1,81,22,1
176062,82,1,81,23,1
176062,16,0,16,24,1
176062,66,1,65,25,1
176062,66,1,65,40,1
176071,10106,4084,6022,1,4
176071,10106,4084,6022,2,1
176071,10074,4068,6006,3,1
176071,2919,1257,1662,4,1
176071,7155,2811,4344,5,1
176071,32,16,16,11,1
176071,646,296,350,19,1
176071,6509,2515,3994,20,1
176071,6941,2817,4124,21,4
176071,6941,2817,4124,22,1
176071,6935,2814,4121,23,1
176071,2085,914,1171,24,1
176071,4850,1900,2950,25,1
176071,6,3,3,31,1
176071,406,197,209,39,1
176071,4444,1703,2741,40,1
176071,3165,1267,1898,41,4
176071,3165,1267,1898,42,1
176071,3139,1254,1885,43,1
176071,834,343,491,44,1
176071,2305,911,1394,45,1
176071,26,13,13,51,1
176071,240,99,141,59,1
176071,2065,812,1253,60,1
176080,20161,10406,9755,1,4
176080,16399,8523,7876,2,1
176080,16399,8523,7876,3,1
176080,3156,1474,1682,4,1
176080,13243,7049,6194,5,1
176080,3762,1883,1879,12,3
176080,1534,839,695,19,1
176080,11709,6210,5499,20,1
176080,16951,8765,8186,21,4
176080,15048,7805,7243,22,1
176080,15048,7805,7243,23,1
176080,3149,1469,1680,24,1
176080,11899,6336,5563,25,1
176080,1903,960,943,32,3
176080,1421,784,637,39,1
176080,10478,5552,4926,40,1
176080,3210,1641,1569,41,4
176080,1351,718,633,42,1
176080,1351,718,633,43,1
176080,7,5,2,44,1
176080,1344,713,631,45,1
176080,1859,923,936,52,3
176080,113,55,58,59,1
176080,1231,658,573,60,1
176169,3271,1368,1903,1,4
176169,3271,1368,1903,2,1
176169,3105,1304,1801,3,1
176169,1087,510,577,4,1
176169,2018,794,1224,5,1
176169,166,64,102,11,1
176169,148,57,91,19,1
176169,1870,737,1133,20,1
176169,2710,1149,1561,21,4
176169,2710,1149,1561,22,1
176169,2710,1149,1561,23,1
176169,1030,482,548,24,1
176169,1680,667,1013,25,1
176169,116,42,74,39,1
176169,1564,625,939,40,1
176169,561,219,342,41,4
176169,561,219,342,42,1
176169,395,155,240,43,1
176169,57,28,29,44,1
176169,338,127,211,45,1
176169,166,64,102,51,1
176169,32,15,17,59,1
176169,306,112,194,60,1
176178,7871,3095,4776,1,4
176178,7871,3095,4776,2,1
176178,7530,2981,4549,3,1
176178,1927,873,1054,4,1
176178,5603,2108,3495,5,1
176178,341,114,227,11,1
176178,649,268,381,19,1
176178,4954,1840,3114,20,1
176178,5956,2411,3545,21,4
176178,5956,2411,3545,22,1
176178,5947,2408,3539,23,1
176178,1761,799,962,24,1
176178,4186,1609,2577,25,1
176178,9,3,6,31,1
176178,472,206,266,39,1
176178,3714,1403,2311,40,1
176178,1915,684,1231,41,4
176178,1915,684,1231,42,1
176178,1583,573,1010,43,1
176178,166,74,92,44,1
176178,1417,499,918,45,1
176178,332,111,221,51,1
176178,177,62,115,59,1
176178,1240,437,803,60,1
176239,5170,1949,3221,1,4
176239,5170,1949,3221,2,1
176239,5170,1949,3221,3,1
176239,2539,951,1588,4,1
176239,2631,998,1633,5,1
176239,423,172,251,19,1
176239,2208,826,1382,20,1
176239,3559,1379,2180,21,4
176239,3559,1379,2180,22,1
176239,3559,1379,2180,23,1
176239,1808,719,1089,24,1
176239,1751,660,1091,25,1
176239,255,109,146,39,1
176239,1496,551,945,40,1
176239,1611,570,1041,41,4
176239,1611,570,1041,42,1
176239,1611,570,1041,43,1
176239,731,232,499,44,1
176239,880,338,542,45,1
176239,168,63,105,59,1
176239,712,275,437,60,1
176318,922,358,564,1,4
176318,922,358,564,2,1
176318,922,358,564,3,1
176318,267,93,174,4,1
176318,655,265,390,5,1
176318,44,13,31,19,1
176318,611,252,359,20,1
176318,854,328,526,21,4
176318,854,328,526,22,1
176318,854,328,526,23,1
176318,267,93,174,24,1
176318,587,235,352,25,1
176318,44,13,31,39,1
176318,543,222,321,40,1
176318,68,30,38,41,4
176318,68,30,38,42,1
176318,68,30,38,43,1
176318,68,30,38,45,1
176318,68,30,38,60,1
176336,38,23,15,1,4
176336,38,23,15,2,1
176336,37,22,15,3,1
176336,8,6,2,4,1
176336,29,16,13,5,1
176336,1,1,0,11,1
176336,29,16,13,20,1
176336,27,15,12,21,4
176336,27,15,12,22,1
176336,27,15,12,23,1
176336,7,5,2,24,1
176336,20,10,10,25,1
176336,20,10,10,40,1
176336,11,8,3,41,4
176336,11,8,3,42,1
176336,10,7,3,43,1
176336,1,1,0,44,1
176336,9,6,3,45,1
176336,1,1,0,51,1
176336,9,6,3,60,1
176354,2021,769,1252,1,4
176354,2021,769,1252,2,1
176354,1933,737,1196,3,1
176354,663,312,351,4,1
176354,1270,425,845,5,1
176354,88,32,56,11,1
176354,119,34,85,19,1
176354,1151,391,760,20,1
176354,1767,701,1066,21,4
176354,1767,701,1066,22,1
176354,1766,701,1065,23,1
176354,646,305,341,24,1
176354,1120,396,724,25,1
176354,1,0,1,31,1
176354,98,29,69,39,1
176354,1022,367,655,40,1
176354,254,68,186,41,4
176354,254,68,186,42,1
176354,167,36,131,43,1
176354,17,7,10,44,1
176354,150,29,121,45,1
176354,87,32,55,51,1
176354,21,5,16,59,1
176354,129,24,105,60,1
176372,15249,5595,9654,1,4
176372,12475,4522,7953,2,1
176372,12371,4478,7893,3,1
176372,1746,583,1163,4,1
176372,10625,3895,6730,5,1
176372,104,44,60,11,1
176372,2774,1073,1701,12,3
176372,1622,592,1030,19,1
176372,9003,3303,5700,20,1
176372,12317,4508,7809,21,4
176372,10841,3882,6959,22,1
176372,10829,3875,6954,23,1
176372,1726,576,1150,24,1
176372,9103,3299,5804,25,1
176372,12,7,5,31,1
176372,1476,626,850,32,3
176372,1449,528,921,39,1
176372,7654,2771,4883,40,1
176372,2932,1087,1845,41,4
176372,1634,640,994,42,1
176372,1542,603,939,43,1
176372,20,7,13,44,1
176372,1522,596,926,45,1
176372,92,37,55,51,1
176372,1298,447,851,52,3
176372,173,64,109,59,1
176372,1349,532,817,60,1
176390,133,8,125,1,4
176390,133,8,125,2,1
176390,133,8,125,3,1
176390,37,4,33,4,1
176390,96,4,92,5,1
176390,96,4,92,20,1
176390,133,8,125,21,4
176390,133,8,125,22,1
176390,133,8,125,23,1
176390,37,4,33,24,1
176390,96,4,92,25,1
176390,96,4,92,40,1
176406,878,311,567,1,4
176406,878,311,567,2,1
176406,877,311,566,3,1
176406,153,49,104,4,1
176406,724,262,462,5,1
176406,1,0,1,11,1
176406,60,26,34,19,1
176406,664,236,428,20,1
176406,849,299,550,21,4
176406,849,299,550,22,1
176406,849,299,550,23,1
176406,153,49,104,24,1
176406,696,250,446,25,1
176406,59,25,34,39,1
176406,637,225,412,40,1
176406,29,12,17,41,4
176406,29,12,17,42,1
176406,28,12,16,43,1
176406,28,12,16,45,1
176406,1,0,1,51,1
176406,1,1,0,59,1
176406,27,11,16,60,1
176451,44,34,10,1,4
176451,44,34,10,12,3
176451,7,3,4,21,4
176451,7,3,4,32,3
176451,37,31,6,41,4
176451,37,31,6,52,3
176479,3882,1327,2555,1,4
176479,2257,807,1450,2,1
176479,2166,776,1390,3,1
176479,182,89,93,4,1
176479,1984,687,1297,5,1
176479,91,31,60,11,1
176479,1625,520,1105,12,3
176479,383,132,251,19,1
176479,1601,555,1046,20,1
176479,2826,1062,1764,21,4
176479,1886,705,1181,22,1
176479,1886,705,1181,23,1
176479,179,87,92,24,1
176479,1707,618,1089,25,1
176479,940,357,583,32,3
176479,333,118,215,39,1
176479,1374,500,874,40,1
176479,1056,265,791,41,4
176479,371,102,269,42,1
176479,280,71,209,43,1
176479,3,2,1,44,1
176479,277,69,208,45,1
176479,91,31,60,51,1
176479,685,163,522,52,3
176479,50,14,36,59,1
176479,227,55,172,60,1
176549,277,41,236,1,4
176549,277,41,236,2,1
176549,277,41,236,3,1
176549,115,20,95,4,1
176549,162,21,141,5,1
176549,162,21,141,20,1
176549,277,41,236,21,4
176549,277,41,236,22,1
176549,277,41,236,23,1
176549,115,20,95,24,1
176549,162,21,141,25,1
176549,162,21,141,40,1
176600,149,82,67,1,4
176600,149,82,67,12,3
176600,45,34,11,21,4
176600,45,34,11,32,3
176600,104,48,56,41,4
176600,104,48,56,52,3
176619,404,283,121,1,4
176619,404,283,121,12,3
176619,118,72,46,21,4
176619,118,72,46,32,3
176619,286,211,75,41,4
176619,286,211,75,52,3
176628,1971,645,1326,1,4
176628,1401,484,917,2,1
176628,1336,445,891,3,1
176628,182,57,125,4,1
176628,1154,388,766,5,1
176628,65,39,26,11,1
176628,570,161,409,12,3
176628,167,72,95,19,1
176628,987,316,671,20,1
176628,1526,539,987,21,4
176628,1124,422,702,22,1
176628,1073,388,685,23,1
176628,182,57,125,24,1
176628,891,331,560,25,1
176628,51,34,17,31,1
176628,402,117,285,32,3
176628,163,71,92,39,1
176628,728,260,468,40,1
176628,445,106,339,41,4
176628,277,62,215,42,1
176628,263,57,206,43,1
176628,263,57,206,45,1
176628,14,5,9,51,1
176628,168,44,124,52,3
176628,4,1,3,59,1
176628,259,56,203,60,1
176637,602,432,170,1,4
176637,602,432,170,2,1
176637,602,432,170,3,1
176637,103,70,33,4,1
176637,499,362,137,5,1
176637,21,8,13,19,1
176637,478,354,124,20,1
176637,481,347,134,21,4
176637,481,347,134,22,1
176637,481,347,134,23,1
176637,96,63,33,24,1
176637,385,284,101,25,1
176637,10,4,6,39,1
176637,375,280,95,40,1
176637,121,85,36,41,4
176637,121,85,36,42,1
176637,121,85,36,43,1
176637,7,7,0,44,1
176637,114,78,36,45,1
176637,11,4,7,59,1
176637,103,74,29,60,1
176664,367,214,153,1,4
176664,305,166,139,2,1
176664,305,166,139,3,1
176664,56,27,29,4,1
176664,249,139,110,5,1
176664,62,48,14,12,3
176664,24,16,8,19,1
176664,225,123,102,20,1
176664,278,156,122,21,4
176664,268,148,120,22,1
176664,268,148,120,23,1
176664,55,27,28,24,1
176664,213,121,92,25,1
176664,10,8,2,32,3
176664,21,13,8,39,1
176664,192,108,84,40,1
176664,89,58,31,41,4
176664,37,18,19,42,1
176664,37,18,19,43,1
176664,1,0,1,44,1
176664,36,18,18,45,1
176664,52,40,12,52,3
176664,3,3,0,59,1
176664,33,15,18,60,1
176716,90,6,84,1,4
176716,90,6,84,2,1
176716,90,6,84,3,1
176716,19,2,17,4,1
176716,71,4,67,5,1
176716,71,4,67,20,1
176716,90,6,84,21,4
176716,90,6,84,22,1
176716,90,6,84,23,1
176716,19,2,17,24,1
176716,71,4,67,25,1
176716,71,4,67,40,1
176770,880,97,783,1,4
176770,832,97,735,2,1
176770,832,97,735,3,1
176770,15,1,14,4,1
176770,817,96,721,5,1
176770,48,0,48,12,3
176770,206,37,169,19,1
176770,611,59,552,20,1
176770,455,51,404,21,4
176770,433,51,382,22,1
176770,433,51,382,23,1
176770,7,0,7,24,1
176770,426,51,375,25,1
176770,22,0,22,32,3
176770,101,21,80,39,1
176770,325,30,295,40,1
176770,425,46,379,41,4
176770,399,46,353,42,1
176770,399,46,353,43,1
176770,8,1,7,44,1
176770,391,45,346,45,1
176770,26,0,26,52,3
176770,105,16,89,59,1
176770,286,29,257,60,1
176789,328,167,161,1,4
176789,272,130,142,2,1
176789,251,120,131,3,1
176789,44,17,27,4,1
176789,207,103,104,5,1
176789,21,10,11,11,1
176789,56,37,19,12,3
176789,46,22,24,19,1
176789,161,81,80,20,1
176789,187,93,94,21,4
176789,174,81,93,22,1
176789,173,81,92,23,1
176789,37,15,22,24,1
176789,136,66,70,25,1
176789,1,0,1,31,1
176789,13,12,1,32,3
176789,34,15,19,39,1
176789,102,51,51,40,1
176789,141,74,67,41,4
176789,98,49,49,42,1
176789,78,39,39,43,1
176789,7,2,5,44,1
176789,71,37,34,45,1
176789,20,10,10,51,1
176789,43,25,18,52,3
176789,12,7,5,59,1
176789,59,30,29,60,1
176798,305,116,189,1,4
176798,305,116,189,2,1
176798,305,116,189,3,1
176798,49,30,19,4,1
176798,256,86,170,5,1
176798,256,86,170,20,1
176798,149,44,105,21,4
176798,149,44,105,22,1
176798,149,44,105,23,1
176798,14,4,10,24,1
176798,135,40,95,25,1
176798,135,40,95,40,1
176798,156,72,84,41,4
176798,156,72,84,42,1
176798,156,72,84,43,1
176798,35,26,9,44,1
176798,121,46,75,45,1
176798,121,46,75,60,1
176910,302,161,141,1,4
176910,302,161,141,2,1
176910,297,158,139,3,1
176910,64,29,35,4,1
176910,233,129,104,5,1
176910,5,3,2,11,1
176910,31,20,11,19,1
176910,202,109,93,20,1
176910,237,123,114,21,4
176910,237,123,114,22,1
176910,237,123,114,23,1
176910,49,22,27,24,1
176910,188,101,87,25,1
176910,26,18,8,39,1
176910,162,83,79,40,1
176910,65,38,27,41,4
176910,65,38,27,42,1
176910,60,35,25,43,1
176910,15,7,8,44,1
176910,45,28,17,45,1
176910,5,3,2,51,1
176910,5,2,3,59,1
176910,40,26,14,60,1
176947,1107,540,567,1,4
176947,1107,540,567,2,1
176947,1104,538,566,3,1
176947,291,147,144,4,1
176947,813,391,422,5,1
176947,3,2,1,11,1
176947,108,46,62,19,1
176947,705,345,360,20,1
176947,1024,511,513,21,4
176947,1024,511,513,22,1
176947,1024,511,513,23,1
176947,291,147,144,24,1
176947,733,364,369,25,1
176947,99,45,54,39,1
176947,634,319,315,40,1
176947,83,29,54,41,4
176947,83,29,54,42,1
176947,80,27,53,43,1
176947,80,27,53,45,1
176947,3,2,1,51,1
176947,9,1,8,59,1
176947,71,26,45,60,1
176965,12513,5620,6893,1,4
176965,9974,4574,5400,2,1
176965,9160,4193,4967,3,1
176965,1769,801,968,4,1
176965,7391,3392,3999,5,1
176965,814,381,433,11,1
176965,2539,1046,1493,12,3
176965,992,435,557,19,1
176965,6399,2957,3442,20,1
176965,9203,4302,4901,21,4
176965,8290,3800,4490,22,1
176965,8201,3765,4436,23,1
176965,1746,786,960,24,1
176965,6455,2979,3476,25,1
176965,89,35,54,31,1
176965,913,502,411,32,3
176965,831,377,454,39,1
176965,5624,2602,3022,40,1
176965,3310,1318,1992,41,4
176965,1684,774,910,42,1
176965,959,428,531,43,1
176965,23,15,8,44,1
176965,936,413,523,45,1
176965,725,346,379,51,1
176965,1626,544,1082,52,3
176965,161,58,103,59,1
176965,775,355,420,60,1
176983,90,82,8,1,4
176983,90,82,8,2,1
176983,90,82,8,3,1
176983,46,44,2,4,1
176983,44,38,6,5,1
176983,44,38,6,20,1
176983,90,82,8,21,4
176983,90,82,8,22,1
176983,90,82,8,23,1
176983,46,44,2,24,1
176983,44,38,6,25,1
176983,44,38,6,40,1
176992,12,2,10,1,4
176992,12,2,10,2,1
176992,12,2,10,3,1
176992,8,2,6,4,1
176992,4,0,4,5,1
176992,4,0,4,20,1
176992,12,2,10,21,4
176992,12,2,10,22,1
176992,12,2,10,23,1
176992,8,2,6,24,1
176992,4,0,4,25,1
176992,4,0,4,40,1
177038,500,318,182,1,4
177038,66,43,23,2,1
177038,66,43,23,3,1
177038,66,43,23,5,1
177038,434,275,159,12,3
177038,35,25,10,19,1
177038,31,18,13,20,1
177038,482,307,175,21,4
177038,54,36,18,22,1
177038,54,36,18,23,1
177038,54,36,18,25,1
177038,428,271,157,32,3
177038,31,22,9,39,1
177038,23,14,9,40,1
177038,18,11,7,41,4
177038,12,7,5,42,1
177038,12,7,5,43,1
177038,12,7,5,45,1
177038,6,4,2,52,3
177038,4,3,1,59,1
177038,8,4,4,60,1
177056,78,23,55,1,4
177056,78,23,55,2,1
177056,78,23,55,3,1
177056,21,10,11,4,1
177056,57,13,44,5,1
177056,57,13,44,20,1
177056,44,7,37,21,4
177056,44,7,37,22,1
177056,44,7,37,23,1
177056,8,3,5,24,1
177056,36,4,32,25,1
177056,36,4,32,40,1
177056,34,16,18,41,4
177056,34,16,18,42,1
177056,34,16,18,43,1
177056,13,7,6,44,1
177056,21,9,12,45,1
177056,21,9,12,60,1
177065,16946,6867,10079,1,4
177065,15998,6489,9509,2,1
177065,15498,6217,9281,3,1
177065,990,402,588,4,1
177065,14508,5815,8693,5,1
177065,500,272,228,11,1
177065,948,378,570,12,3
177065,1398,560,838,19,1
177065,13110,5255,7855,20,1
177065,9572,3846,5726,21,4
177065,9442,3799,5643,22,1
177065,9340,3750,5590,23,1
177065,671,247,424,24,1
177065,8669,3503,5166,25,1
177065,102,49,53,31,1
177065,130,47,83,32,3
177065,959,376,583,39,1
177065,7710,3127,4583,40,1
177065,7374,3021,4353,41,4
177065,6556,2690,3866,42,1
177065,6158,2467,3691,43,1
177065,319,155,164,44,1
177065,5839,2312,3527,45,1
177065,398,223,175,51,1
177065,818,331,487,52,3
177065,439,184,255,59,1
177065,5400,2128,3272,60,1
177083,99,94,5,1,4
177083,99,94,5,2,1
177083,90,89,1,3,1
177083,19,19,0,4,1
177083,71,70,1,5,1
177083,9,5,4,11,1
177083,17,16,1,19,1
177083,54,54,0,20,1
177083,90,89,1,21,4
177083,90,89,1,22,1
177083,90,89,1,23,1
177083,19,19,0,24,1
177083,71,70,1,25,1
177083,17,16,1,39,1
177083,54,54,0,40,1
177083,9,5,4,41,4
177083,9,5,4,42,1
177083,9,5,4,51,1
177092,376,355,21,1,4
177092,376,355,21,12,3
177092,211,204,7,21,4
177092,211,204,7,32,3
177092,165,151,14,41,4
177092,165,151,14,52,3
177117,277,0,277,1,4
177117,277,0,277,2,1
177117,277,0,277,3,1
177117,124,0,124,4,1
177117,153,0,153,5,1
177117,10,0,10,19,1
177117,143,0,143,20,1
177117,275,0,275,21,4
177117,275,0,275,22,1
177117,275,0,275,23,1
177117,124,0,124,24,1
177117,151,0,151,25,1
177117,10,0,10,39,1
177117,141,0,141,40,1
177117,2,0,2,41,4
177117,2,0,2,42,1
177117,2,0,2,43,1
177117,2,0,2,45,1
177117,2,0,2,60,1
177126,602,458,144,1,4
177126,602,458,144,12,3
177126,257,211,46,21,4
177126,257,211,46,32,3
177126,345,247,98,41,4
177126,345,247,98,52,3
177135,5845,2097,3748,1,4
177135,5845,2097,3748,2,1
177135,4336,1535,2801,3,1
177135,1286,541,745,4,1
177135,3050,994,2056,5,1
177135,1509,562,947,11,1
177135,180,62,118,19,1
177135,2870,932,1938,20,1
177135,2561,1003,1558,21,4
177135,2561,1003,1558,22,1
177135,2517,983,1534,23,1
177135,967,409,558,24,1
177135,1550,574,976,25,1
177135,44,20,24,31,1
177135,121,46,75,39,1
177135,1429,528,901,40,1
177135,3284,1094,2190,41,4
177135,3284,1094,2190,42,1
177135,1819,552,1267,43,1
177135,319,132,187,44,1
177135,1500,420,1080,45,1
177135,1465,542,923,51,1
177135,59,16,43,59,1
177135,1441,404,1037,60,1
177144,843,420,423,1,4
177144,830,413,417,2,1
177144,809,407,402,3,1
177144,220,100,120,4,1
177144,589,307,282,5,1
177144,21,6,15,11,1
177144,13,7,6,12,3
177144,80,48,32,19,1
177144,509,259,250,20,1
177144,785,408,377,21,4
177144,772,401,371,22,1
177144,772,401,371,23,1
177144,220,100,120,24,1
177144,552,301,251,25,1
177144,13,7,6,32,3
177144,71,47,24,39,1
177144,481,254,227,40,1
177144,58,12,46,41,4
177144,58,12,46,42,1
177144,37,6,31,43,1
177144,37,6,31,45,1
177144,21,6,15,51,1
177144,9,1,8,59,1
177144,28,5,23,60,1
177214,4649,1783,2866,1,4
177214,4231,1666,2565,2,1
177214,4001,1558,2443,3,1
177214,519,222,297,4,1
177214,3482,1336,2146,5,1
177214,230,108,122,11,1
177214,418,117,301,12,3
177214,276,106,170,19,1
177214,3206,1230,1976,20,1
177214,3278,1289,1989,21,4
177214,3008,1206,1802,22,1
177214,2958,1181,1777,23,1
177214,433,185,248,24,1
177214,2525,996,1529,25,1
177214,50,25,25,31,1
177214,270,83,187,32,3
177214,192,73,119,39,1
177214,2333,923,1410,40,1
177214,1371,494,877,41,4
177214,1223,460,763,42,1
177214,1043,377,666,43,1
177214,86,37,49,44,1
177214,957,340,617,45,1
177214,180,83,97,51,1
177214,148,34,114,52,3
177214,84,33,51,59,1
177214,873,307,566,60,1
177250,3900,1481,2419,1,4
177250,3900,1481,2419,2,1
177250,3113,1115,1998,3,1
177250,773,344,429,4,1
177250,2340,771,1569,5,1
177250,787,366,421,11,1
177250,225,72,153,19,1
177250,2115,699,1416,20,1
177250,1852,727,1125,21,4
177250,1852,727,1125,22,1
177250,1788,692,1096,23,1
177250,624,278,346,24,1
177250,1164,414,750,25,1
177250,64,35,29,31,1
177250,145,56,89,39,1
177250,1019,358,661,40,1
177250,2048,754,1294,41,4
177250,2048,754,1294,42,1
177250,1325,423,902,43,1
177250,149,66,83,44,1
177250,1176,357,819,45,1
177250,723,331,392,51,1
177250,80,16,64,59,1
177250,1096,341,755,60,1
177278,167,80,87,1,4
177278,167,80,87,12,3
177278,100,50,50,21,4
177278,100,50,50,32,3
177278,67,30,37,41,4
177278,67,30,37,52,3
177287,186,6,180,1,4
177287,186,6,180,2,1
177287,186,6,180,3,1
177287,47,1,46,4,1
177287,139,5,134,5,1
177287,139,5,134,20,1
177287,149,5,144,21,4
177287,149,5,144,22,1
177287,149,5,144,23,1
177287,40,1,39,24,1
177287,109,4,105,25,1
177287,109,4,105,40,1
177287,37,1,36,41,4
177287,37,1,36,42,1
177287,37,1,36,43,1
177287,7,0,7,44,1
177287,30,1,29,45,1
177287,30,1,29,60,1
177302,555,204,351,1,4
177302,555,204,351,2,1
177302,555,204,351,3,1
177302,338,110,228,4,1
177302,217,94,123,5,1
177302,196,77,119,19,1
177302,21,17,4,20,1
177302,555,204,351,21,4
177302,555,204,351,22,1
177302,555,204,351,23,1
177302,338,110,228,24,1
177302,217,94,123,25,1
177302,196,77,119,39,1
177302,21,17,4,40,1
177339,2274,980,1294,1,4
177339,2077,915,1162,2,1
177339,2071,912,1159,3,1
177339,460,198,262,4,1
177339,1611,714,897,5,1
177339,6,3,3,11,1
177339,197,65,132,12,3
177339,112,51,61,19,1
177339,1499,663,836,20,1
177339,1984,871,1113,21,4
177339,1887,829,1058,22,1
177339,1886,829,1057,23,1
177339,458,198,260,24,1
177339,1428,631,797,25,1
177339,1,0,1,31,1
177339,97,42,55,32,3
177339,110,50,60,39,1
177339,1318,581,737,40,1
177339,290,109,181,41,4
177339,190,86,104,42,1
177339,185,83,102,43,1
177339,2,0,2,44,1
177339,183,83,100,45,1
177339,5,3,2,51,1
177339,100,23,77,52,3
177339,2,1,1,59,1
177339,181,82,99,60,1
177418,1997,599,1398,1,4
177418,1328,435,893,2,1
177418,1242,406,836,3,1
177418,160,68,92,4,1
177418,1082,338,744,5,1
177418,86,29,57,11,1
177418,669,164,505,12,3
177418,170,33,137,19,1
177418,912,305,607,20,1
177418,1192,404,788,21,4
177418,956,344,612,22,1
177418,948,341,607,23,1
177418,157,67,90,24,1
177418,791,274,517,25,1
177418,8,3,5,31,1
177418,236,60,176,32,3
177418,133,30,103,39,1
177418,658,244,414,40,1
177418,805,195,610,41,4
177418,372,91,281,42,1
177418,294,65,229,43,1
177418,3,1,2,44,1
177418,291,64,227,45,1
177418,78,26,52,51,1
177418,433,104,329,52,3
177418,37,3,34,59,1
177418,254,61,193,60,1
177427,254,71,183,1,4
177427,254,71,183,12,3
177427,199,58,141,21,4
177427,199,58,141,32,3
177427,55,13,42,41,4
177427,55,13,42,52,3
177436,41,7,34,1,4
177436,41,7,34,2,1
177436,41,7,34,3,1
177436,41,7,34,4,1
177436,34,1,33,21,4
177436,34,1,33,22,1
177436,34,1,33,23,1
177436,34,1,33,24,1
177436,7,6,1,41,4
177436,7,6,1,42,1
177436,7,6,1,43,1
177436,7,6,1,44,1
177472,14798,6262,8536,1,4
177472,14798,6262,8536,2,1
177472,13087,5480,7607,3,1
177472,3186,1484,1702,4,1
177472,9901,3996,5905,5,1
177472,1711,782,929,11,1
177472,893,403,490,19,1
177472,9008,3593,5415,20,1
177472,7049,3021,4028,21,4
177472,7049,3021,4028,22,1
177472,6896,2965,3931,23,1
177472,2255,1019,1236,24,1
177472,4641,1946,2695,25,1
177472,153,56,97,31,1
177472,514,255,259,39,1
177472,4127,1691,2436,40,1
177472,7749,3241,4508,41,4
177472,7749,3241,4508,42,1
177472,6191,2515,3676,43,1
177472,931,465,466,44,1
177472,5260,2050,3210,45,1
177472,1558,726,832,51,1
177472,379,148,231,59,1
177472,4881,1902,2979,60,1
177542,1229,509,720,1,4
177542,1198,503,695,2,1
177542,921,383,538,3,1
177542,196,91,105,4,1
177542,725,292,433,5,1
177542,277,120,157,11,1
177542,31,6,25,12,3
177542,156,60,96,19,1
177542,569,232,337,20,1
177542,883,366,517,21,4
177542,874,365,509,22,1
177542,853,356,497,23,1
177542,192,88,104,24,1
177542,661,268,393,25,1
177542,21,9,12,31,1
177542,9,1,8,32,3
177542,135,55,80,39,1
177542,526,213,313,40,1
177542,346,143,203,41,4
177542,324,138,186,42,1
177542,68,27,41,43,1
177542,4,3,1,44,1
177542,64,24,40,45,1
177542,256,111,145,51,1
177542,22,5,17,52,3
177542,21,5,16,59,1
177542,43,19,24,60,1
177551,1298,458,840,1,4
177551,1298,458,840,2,1
177551,1266,447,819,3,1
177551,195,81,114,4,1
177551,1071,366,705,5,1
177551,32,11,21,11,1
177551,159,56,103,19,1
177551,912,310,602,20,1
177551,984,367,617,21,4
177551,984,367,617,22,1
177551,979,365,614,23,1
177551,182,76,106,24,1
177551,797,289,508,25,1
177551,5,2,3,31,1
177551,138,53,85,39,1
177551,659,236,423,40,1
177551,314,91,223,41,4
177551,314,91,223,42,1
177551,287,82,205,43,1
177551,13,5,8,44,1
177551,274,77,197,45,1
177551,27,9,18,51,1
177551,21,3,18,59,1
177551,253,74,179,60,1
177579,372,90,282,1,4
177579,372,90,282,2,1
177579,372,90,282,3,1
177579,92,30,62,4,1
177579,280,60,220,5,1
177579,40,7,33,19,1
177579,240,53,187,20,1
177579,318,77,241,21,4
177579,318,77,241,22,1
177579,318,77,241,23,1
177579,92,30,62,24,1
177579,226,47,179,25,1
177579,40,7,33,39,1
177579,186,40,146,40,1
177579,54,13,41,41,4
177579,54,13,41,42,1
177579,54,13,41,43,1
177579,54,13,41,45,1
177579,54,13,41,60,1
177588,38,3,35,1,4
177588,38,3,35,2,1
177588,38,3,35,3,1
177588,5,1,4,4,1
177588,33,2,31,5,1
177588,33,2,31,20,1
177588,38,3,35,21,4
177588,38,3,35,22,1
177588,38,3,35,23,1
177588,5,1,4,24,1
177588,33,2,31,25,1
177588,33,2,31,40,1
177603,64,4,60,1,4
177603,64,4,60,2,1
177603,64,4,60,3,1
177603,9,2,7,4,1
177603,55,2,53,5,1
177603,55,2,53,20,1
177603,50,3,47,21,4
177603,50,3,47,22,1
177603,50,3,47,23,1
177603,4,1,3,24,1
177603,46,2,44,25,1
177603,46,2,44,40,1
177603,14,1,13,41,4
177603,14,1,13,42,1
177603,14,1,13,43,1
177603,5,1,4,44,1
177603,9,0,9,45,1
177603,9,0,9,60,1
177676,5194,2134,3060,1,4
177676,5194,2134,3060,2,1
177676,4974,2052,2922,3,1
177676,1134,556,578,4,1
177676,3840,1496,2344,5,1
177676,220,82,138,11,1
177676,321,130,191,19,1
177676,3519,1366,2153,20,1
177676,2715,1211,1504,21,4
177676,2715,1211,1504,22,1
177676,2667,1189,1478,23,1
177676,933,456,477,24,1
177676,1734,733,1001,25,1
177676,48,22,26,31,1
177676,177,87,90,39,1
177676,1557,646,911,40,1
177676,2479,923,1556,41,4
177676,2479,923,1556,42,1
177676,2307,863,1444,43,1
177676,201,100,101,44,1
177676,2106,763,1343,45,1
177676,172,60,112,51,1
177676,144,43,101,59,1
177676,1962,720,1242,60,1
177685,38,1,37,1,4
177685,38,1,37,2,1
177685,38,1,37,3,1
177685,9,0,9,4,1
177685,29,1,28,5,1
177685,29,1,28,20,1
177685,38,1,37,21,4
177685,38,1,37,22,1
177685,38,1,37,23,1
177685,9,0,9,24,1
177685,29,1,28,25,1
177685,29,1,28,40,1
177719,818,85,733,1,4
177719,654,64,590,2,1
177719,654,64,590,3,1
177719,654,64,590,5,1
177719,164,21,143,12,3
177719,179,15,164,19,1
177719,475,49,426,20,1
177719,736,78,658,21,4
177719,654,64,590,22,1
177719,654,64,590,23,1
177719,654,64,590,25,1
177719,82,14,68,32,3
177719,179,15,164,39,1
177719,475,49,426,40,1
177719,82,7,75,41,4
177719,82,7,75,52,3
177746,739,269,470,1,4
177746,739,269,470,2,1
177746,735,267,468,3,1
177746,141,38,103,4,1
177746,594,229,365,5,1
177746,4,2,2,11,1
177746,4,1,3,19,1
177746,590,228,362,20,1
177746,735,267,468,21,4
177746,735,267,468,22,1
177746,735,267,468,23,1
177746,141,38,103,24,1
177746,594,229,365,25,1
177746,4,1,3,39,1
177746,590,228,362,40,1
177746,4,2,2,41,4
177746,4,2,2,42,1
177746,4,2,2,51,1
177816,123,123,0,1,4
177816,54,54,0,2,1
177816,54,54,0,3,1
177816,8,8,0,4,1
177816,46,46,0,5,1
177816,69,69,0,12,3
177816,17,17,0,19,1
177816,29,29,0,20,1
177816,123,123,0,21,4
177816,54,54,0,22,1
177816,54,54,0,23,1
177816,8,8,0,24,1
177816,46,46,0,25,1
177816,69,69,0,32,3
177816,17,17,0,39,1
177816,29,29,0,40,1
177834,3314,1488,1826,1,4
177834,3314,1488,1826,12,3
177834,2177,1048,1129,21,4
177834,2177,1048,1129,32,3
177834,1137,440,697,41,4
177834,1137,440,697,52,3
177870,13,11,2,1,4
177870,13,11,2,2,1
177870,13,11,2,3,1
177870,12,10,2,4,1
177870,1,1,0,5,1
177870,1,1,0,20,1
177870,13,11,2,21,4
177870,13,11,2,22,1
177870,13,11,2,23,1
177870,12,10,2,24,1
177870,1,1,0,25,1
177870,1,1,0,40,1
177931,35,6,29,1,4
177931,35,6,29,2,1
177931,35,6,29,3,1
177931,13,6,7,4,1
177931,22,0,22,5,1
177931,22,0,22,20,1
177931,35,6,29,21,4
177931,35,6,29,22,1
177931,35,6,29,23,1
177931,13,6,7,24,1
177931,22,0,22,25,1
177931,22,0,22,40,1
177940,3043,1300,1743,1,4
177940,2892,1244,1648,2,1
177940,2268,978,1290,3,1
177940,417,195,222,4,1
177940,1851,783,1068,5,1
177940,624,266,358,11,1
177940,151,56,95,12,3
177940,209,97,112,19,1
177940,1642,686,956,20,1
177940,1916,900,1016,21,4
177940,1874,887,987,22,1
177940,1803,830,973,23,1
177940,400,187,213,24,1
177940,1403,643,760,25,1
177940,71,57,14,31,1
177940,42,13,29,32,3
177940,162,83,79,39,1
177940,1241,560,681,40,1
177940,1127,400,727,41,4
177940,1018,357,661,42,1
177940,465,148,317,43,1
177940,17,8,9,44,1
177940,448,140,308,45,1
177940,553,209,344,51,1
177940,109,43,66,52,3
177940,47,14,33,59,1
177940,401,126,275,60,1
177968,12213,5041,7172,1,4
177968,8453,3874,4579,2,1
177968,7928,3675,4253,3,1
177968,1324,649,675,4,1
177968,6604,3026,3578,5,1
177968,525,199,326,11,1
177968,3760,1167,2593,12,3
177968,914,370,544,19,1
177968,5690,2656,3034,20,1
177968,9238,4136,5102,21,4
177968,7502,3504,3998,22,1
177968,7444,3472,3972,23,1
177968,1311,643,668,24,1
177968,6133,2829,3304,25,1
177968,58,32,26,31,1
177968,1736,632,1104,32,3
177968,865,360,505,39,1
177968,5268,2469,2799,40,1
177968,2975,905,2070,41,4
177968,951,370,581,42,1
177968,484,203,281,43,1
177968,13,6,7,44,1
177968,471,197,274,45,1
177968,467,167,300,51,1
177968,2024,535,1489,52,3
177968,49,10,39,59,1
177968,422,187,235,60,1
177977,1294,1067,227,1,4
177977,1294,1067,227,2,1
177977,1241,1046,195,3,1
177977,492,432,60,4,1
177977,749,614,135,5,1
177977,53,21,32,11,1
177977,152,87,65,19,1
177977,597,527,70,20,1
177977,1108,952,156,21,4
177977,1108,952,156,22,1
177977,1108,952,156,23,1
177977,486,428,58,24,1
177977,622,524,98,25,1
177977,126,78,48,39,1
177977,496,446,50,40,1
177977,186,115,71,41,4
177977,186,115,71,42,1
177977,133,94,39,43,1
177977,6,4,2,44,1
177977,127,90,37,45,1
177977,53,21,32,51,1
177977,26,9,17,59,1
177977,101,81,20,60,1
177986,969,599,370,1,4
177986,52,35,17,2,1
177986,49,33,16,3,1
177986,49,33,16,5,1
177986,3,2,1,11,1
177986,917,564,353,12,3
177986,32,20,12,19,1
177986,17,13,4,20,1
177986,829,515,314,21,4
177986,29,19,10,22,1
177986,29,19,10,23,1
177986,29,19,10,25,1
177986,800,496,304,32,3
177986,22,13,9,39,1
177986,7,6,1,40,1
177986,140,84,56,41,4
177986,23,16,7,42,1
177986,20,14,6,43,1
177986,20,14,6,45,1
177986,3,2,1,51,1
177986,117,68,49,52,3
177986,10,7,3,59,1
177986,10,7,3,60,1
177995,19234,8328,10906,1,4
177995,19234,8328,10906,2,1
177995,16645,7174,9471,3,1
177995,4183,2073,2110,4,1
177995,12462,5101,7361,5,1
177995,2589,1154,1435,11,1
177995,1862,758,1104,19,1
177995,10600,4343,6257,20,1
177995,7734,3642,4092,21,4
177995,7734,3642,4092,22,1
177995,7413,3475,3938,23,1
177995,2473,1265,1208,24,1
177995,4940,2210,2730,25,1
177995,321,167,154,31,1
177995,870,382,488,39,1
177995,4070,1828,2242,40,1
177995,11500,4686,6814,41,4
177995,11500,4686,6814,42,1
177995,9232,3699,5533,43,1
177995,1710,808,902,44,1
177995,7522,2891,4631,45,1
177995,2268,987,1281,51,1
177995,992,376,616,59,1
177995,6530,2515,4015,60,1
178004,209,31,178,1,4
178004,209,31,178,2,1
178004,209,31,178,3,1
178004,1,0,1,4,1
178004,208,31,177,5,1
178004,208,31,177,20,1
178004,121,19,102,21,4
178004,121,19,102,22,1
178004,121,19,102,23,1
178004,1,0,1,24,1
178004,120,19,101,25,1
178004,120,19,101,40,1
178004,88,12,76,41,4
178004,88,12,76,42,1
178004,88,12,76,43,1
178004,88,12,76,45,1
178004,88,12,76,60,1
178059,5033,1146,3887,1,4
178059,2829,825,2004,2,1
178059,2746,798,1948,3,1
178059,409,145,264,4,1
178059,2337,653,1684,5,1
178059,83,27,56,11,1
178059,2204,321,1883,12,3
178059,324,100,224,19,1
178059,2013,553,1460,20,1
178059,1977,643,1334,21,4
178059,1786,600,1186,22,1
178059,1786,600,1186,23,1
178059,392,143,249,24,1
178059,1394,457,937,25,1
178059,191,43,148,32,3
178059,202,78,124,39,1
178059,1192,379,813,40,1
178059,3056,503,2553,41,4
178059,1043,225,818,42,1
178059,960,198,762,43,1
178059,17,2,15,44,1
178059,943,196,747,45,1
178059,83,27,56,51,1
178059,2013,278,1735,52,3
178059,122,22,100,59,1
178059,821,174,647,60,1
178077,107,5,102,1,4
178077,107,5,102,2,1
178077,107,5,102,3,1
178077,15,2,13,4,1
178077,92,3,89,5,1
178077,92,3,89,20,1
178077,107,5,102,21,4
178077,107,5,102,22,1
178077,107,5,102,23,1
178077,15,2,13,24,1
178077,92,3,89,25,1
178077,92,3,89,40,1
178110,137,22,115,1,4
178110,137,22,115,2,1
178110,137,22,115,3,1
178110,23,4,19,4,1
178110,114,18,96,5,1
178110,75,13,62,19,1
178110,39,5,34,20,1
178110,124,22,102,21,4
178110,124,22,102,22,1
178110,124,22,102,23,1
178110,23,4,19,24,1
178110,101,18,83,25,1
178110,70,13,57,39,1
178110,31,5,26,40,1
178110,13,0,13,41,4
178110,13,0,13,42,1
178110,13,0,13,43,1
178110,13,0,13,45,1
178110,5,0,5,59,1
178110,8,0,8,60,1
178183,179,59,120,1,4
178183,179,59,120,2,1
178183,179,59,120,3,1
178183,7,2,5,4,1
178183,172,57,115,5,1
178183,35,8,27,19,1
178183,137,49,88,20,1
178183,179,59,120,21,4
178183,179,59,120,22,1
178183,179,59,120,23,1
178183,7,2,5,24,1
178183,172,57,115,25,1
178183,35,8,27,39,1
178183,137,49,88,40,1
178208,1132,935,197,1,4
178208,261,190,71,2,1
178208,255,185,70,3,1
178208,55,40,15,4,1
178208,200,145,55,5,1
178208,6,5,1,11,1
178208,871,745,126,12,3
178208,24,19,5,19,1
178208,176,126,50,20,1
178208,768,630,138,21,4
178208,153,97,56,22,1
178208,153,97,56,23,1
178208,34,20,14,24,1
178208,119,77,42,25,1
178208,615,533,82,32,3
178208,15,12,3,39,1
178208,104,65,39,40,1
178208,364,305,59,41,4
178208,108,93,15,42,1
178208,102,88,14,43,1
178208,21,20,1,44,1
178208,81,68,13,45,1
178208,6,5,1,51,1
178208,256,212,44,52,3
178208,9,7,2,59,1
178208,72,61,11,60,1
178217,4508,1948,2560,1,4
178217,4508,1948,2560,2,1
178217,3744,1685,2059,3,1
178217,840,318,522,4,1
178217,2904,1367,1537,5,1
178217,764,263,501,11,1
178217,175,64,111,19,1
178217,2729,1303,1426,20,1
178217,2869,1334,1535,21,4
178217,2869,1334,1535,22,1
178217,2760,1297,1463,23,1
178217,744,271,473,24,1
178217,2016,1026,990,25,1
178217,109,37,72,31,1
178217,117,46,71,39,1
178217,1899,980,919,40,1
178217,1639,614,1025,41,4
178217,1639,614,1025,42,1
178217,984,388,596,43,1
178217,96,47,49,44,1
178217,888,341,547,45,1
178217,655,226,429,51,1
178217,58,18,40,59,1
178217,830,323,507,60,1
178226,298,148,150,1,4
178226,298,148,150,2,1
178226,298,148,150,3,1
178226,21,11,10,4,1
178226,277,137,140,5,1
178226,3,1,2,19,1
178226,274,136,138,20,1
178226,230,111,119,21,4
178226,230,111,119,22,1
178226,230,111,119,23,1
178226,21,11,10,24,1
178226,209,100,109,25,1
178226,209,100,109,40,1
178226,68,37,31,41,4
178226,68,37,31,42,1
178226,68,37,31,43,1
178226,68,37,31,45,1
178226,3,1,2,59,1
178226,65,36,29,60,1
178244,5345,2000,3345,1,4
178244,3950,1629,2321,2,1
178244,1710,762,948,3,1
178244,268,135,133,4,1
178244,1442,627,815,5,1
178244,2240,867,1373,11,1
178244,1395,371,1024,12,3
178244,364,165,199,19,1
178244,1078,462,616,20,1
178244,1723,744,979,21,4
178244,1417,669,748,22,1
178244,1411,667,744,23,1
178244,264,135,129,24,1
178244,1147,532,615,25,1
178244,6,2,4,31,1
178244,306,75,231,32,3
178244,274,143,131,39,1
178244,873,389,484,40,1
178244,3622,1256,2366,41,4
178244,2533,960,1573,42,1
178244,299,95,204,43,1
178244,4,0,4,44,1
178244,295,95,200,45,1
178244,2234,865,1369,51,1
178244,1089,296,793,52,3
178244,90,22,68,59,1
178244,205,73,132,60,1
178262,127,2,125,1,4
178262,127,2,125,2,1
178262,127,2,125,3,1
178262,37,0,37,4,1
178262,90,2,88,5,1
178262,90,2,88,20,1
178262,127,2,125,21,4
178262,127,2,125,22,1
178262,127,2,125,23,1
178262,37,0,37,24,1
178262,90,2,88,25,1
178262,90,2,88,40,1
178305,553,67,486,1,4
178305,553,67,486,2,1
178305,547,67,480,3,1
178305,73,18,55,4,1
178305,474,49,425,5,1
178305,6,0,6,11,1
178305,52,7,45,19,1
178305,422,42,380,20,1
178305,531,65,466,21,4
178305,531,65,466,22,1
178305,525,65,460,23,1
178305,73,18,55,24,1
178305,452,47,405,25,1
178305,6,0,6,31,1
178305,52,7,45,39,1
178305,400,40,360,40,1
178305,22,2,20,41,4
178305,22,2,20,42,1
178305,22,2,20,43,1
178305,22,2,20,45,1
178305,22,2,20,60,1
178314,20,17,3,1,4
178314,20,17,3,2,1
178314,20,17,3,3,1
178314,7,5,2,4,1
178314,13,12,1,5,1
178314,13,12,1,20,1
178314,20,17,3,21,4
178314,20,17,3,22,1
178314,20,17,3,23,1
178314,7,5,2,24,1
178314,13,12,1,25,1
178314,13,12,1,40,1
178341,5616,2363,3253,1,4
178341,5587,2354,3233,2,1
178341,5132,2188,2944,3,1
178341,808,365,443,4,1
178341,4324,1823,2501,5,1
178341,455,166,289,11,1
178341,29,9,20,12,3
178341,582,247,335,19,1
178341,3742,1576,2166,20,1
178341,4126,1797,2329,21,4
178341,4125,1797,2328,22,1
178341,4061,1754,2307,23,1
178341,762,340,422,24,1
178341,3299,1414,1885,25,1
178341,64,43,21,31,1
178341,1,0,1,32,3
178341,456,203,253,39,1
178341,2843,1211,1632,40,1
178341,1490,566,924,41,4
178341,1462,557,905,42,1
178341,1071,434,637,43,1
178341,46,25,21,44,1
178341,1025,409,616,45,1
178341,391,123,268,51,1
178341,28,9,19,52,3
178341,126,44,82,59,1
178341,899,365,534,60,1
178350,108,102,6,1,4
178350,108,102,6,2,1
178350,108,102,6,3,1
178350,2,2,0,4,1
178350,106,100,6,5,1
178350,33,32,1,19,1
178350,73,68,5,20,1
178350,21,20,1,21,4
178350,21,20,1,22,1
178350,21,20,1,23,1
178350,1,1,0,24,1
178350,20,19,1,25,1
178350,6,6,0,39,1
178350,14,13,1,40,1
178350,87,82,5,41,4
178350,87,82,5,42,1
178350,87,82,5,43,1
178350,1,1,0,44,1
178350,86,81,5,45,1
178350,27,26,1,59,1
178350,59,55,4,60,1
178369,1668,918,750,1,4
178369,1656,913,743,2,1
178369,1411,822,589,3,1
178369,415,272,143,4,1
178369,996,550,446,5,1
178369,245,91,154,11,1
178369,12,5,7,12,3
178369,163,86,77,19,1
178369,833,464,369,20,1
178369,1371,809,562,21,4
178369,1364,806,558,22,1
178369,1364,806,558,23,1
178369,412,272,140,24,1
178369,952,534,418,25,1
178369,7,3,4,32,3
178369,159,85,74,39,1
178369,793,449,344,40,1
178369,297,109,188,41,4
178369,292,107,185,42,1
178369,47,16,31,43,1
178369,3,0,3,44,1
178369,44,16,28,45,1
178369,245,91,154,51,1
178369,5,2,3,52,3
178369,4,1,3,59,1
178369,40,15,25,60,1
178387,5795,2483,3312,1,4
178387,5616,2422,3194,2,1
178387,4902,2104,2798,3,1
178387,970,440,530,4,1
178387,3932,1664,2268,5,1
178387,714,318,396,11,1
178387,179,61,118,12,3
178387,372,151,221,19,1
178387,3560,1513,2047,20,1
178387,3997,1760,2237,21,4
178387,3945,1729,2216,22,1
178387,3907,1706,2201,23,1
178387,845,379,466,24,1
178387,3062,1327,1735,25,1
178387,38,23,15,31,1
178387,52,31,21,32,3
178387,301,132,169,39,1
178387,2761,1195,1566,40,1
178387,1798,723,1075,41,4
178387,1671,693,978,42,1
178387,995,398,597,43,1
178387,125,61,64,44,1
178387,870,337,533,45,1
178387,676,295,381,51,1
178387,127,30,97,52,3
178387,71,19,52,59,1
178387,799,318,481,60,1
178396,34616,16321,18295,1,4
178396,26928,12964,13964,2,1
178396,26585,12801,13784,3,1
178396,6194,2909,3285,4,1
178396,20391,9892,10499,5,1
178396,343,163,180,11,1
178396,7688,3357,4331,12,3
178396,1127,593,534,19,1
178396,19264,9299,9965,20,1
178396,30318,14488,15830,21,4
178396,25258,12102,13156,22,1
178396,25168,12052,13116,23,1
178396,6060,2828,3232,24,1
178396,19108,9224,9884,25,1
178396,90,50,40,31,1
178396,5060,2386,2674,32,3
178396,1010,541,469,39,1
178396,18098,8683,9415,40,1
178396,4298,1833,2465,41,4
178396,1670,862,808,42,1
178396,1417,749,668,43,1
178396,134,81,53,44,1
178396,1283,668,615,45,1
178396,253,113,140,51,1
178396,2628,971,1657,52,3
178396,117,52,65,59,1
178396,1166,616,550,60,1
178402,15718,6839,8879,1,4
178402,10227,4325,5902,2,1
178402,8309,3543,4766,3,1
178402,1078,450,628,4,1
178402,7231,3093,4138,5,1
178402,1918,782,1136,11,1
178402,5491,2514,2977,12,3
178402,1371,589,782,19,1
178402,5860,2504,3356,20,1
178402,9917,4535,5382,21,4
178402,6813,2950,3863,22,1
178402,6699,2880,3819,23,1
178402,1060,442,618,24,1
178402,5639,2438,3201,25,1
178402,114,70,44,31,1
178402,3104,1585,1519,32,3
178402,1014,443,571,39,1
178402,4625,1995,2630,40,1
178402,5801,2304,3497,41,4
178402,3414,1375,2039,42,1
178402,1610,663,947,43,1
178402,18,8,10,44,1
178402,1592,655,937,45,1
178402,1804,712,1092,51,1
178402,2387,929,1458,52,3
178402,357,146,211,59,1
178402,1235,509,726,60,1
178411,8129,6290,1839,1,4
178411,6145,4713,1432,2,1
178411,6064,4668,1396,3,1
178411,1262,972,290,4,1
178411,4802,3696,1106,5,1
178411,81,45,36,11,1
178411,1984,1577,407,12,3
178411,424,319,105,19,1
178411,4378,3377,1001,20,1
178411,6663,5174,1489,21,4
178411,5472,4227,1245,22,1
178411,5434,4204,1230,23,1
178411,1244,959,285,24,1
178411,4190,3245,945,25,1
178411,38,23,15,31,1
178411,1191,947,244,32,3
178411,352,279,73,39,1
178411,3838,2966,872,40,1
178411,1466,1116,350,41,4
178411,673,486,187,42,1
178411,630,464,166,43,1
178411,18,13,5,44,1
178411,612,451,161,45,1
178411,43,22,21,51,1
178411,793,630,163,52,3
178411,72,40,32,59,1
178411,540,411,129,60,1
178420,16809,6806,10003,1,4
178420,13569,5702,7867,2,1
178420,8928,3813,5115,3,1
178420,482,187,295,4,1
178420,8446,3626,4820,5,1
178420,4641,1889,2752,11,1
178420,3240,1104,2136,12,3
178420,1626,683,943,19,1
178420,6820,2943,3877,20,1
178420,6988,2952,4036,21,4
178420,6035,2591,3444,22,1
178420,5801,2485,3316,23,1
178420,464,180,284,24,1
178420,5337,2305,3032,25,1
178420,234,106,128,31,1
178420,953,361,592,32,3
178420,1116,475,641,39,1
178420,4221,1830,2391,40,1
178420,9821,3854,5967,41,4
178420,7534,3111,4423,42,1
178420,3127,1328,1799,43,1
178420,18,7,11,44,1
178420,3109,1321,1788,45,1
178420,4407,1783,2624,51,1
178420,2287,743,1544,52,3
178420,510,208,302,59,1
178420,2599,1113,1486,60,1
178448,5710,2249,3461,1,4
178448,5710,2249,3461,2,1
178448,4608,1814,2794,3,1
178448,1265,539,726,4,1
178448,3343,1275,2068,5,1
178448,1102,435,667,11,1
178448,3,0,3,19,1
178448,3340,1275,2065,20,1
178448,2773,1138,1635,21,4
178448,2773,1138,1635,22,1
178448,2718,1114,1604,23,1
178448,904,389,515,24,1
178448,1814,725,1089,25,1
178448,55,24,31,31,1
178448,2,0,2,39,1
178448,1812,725,1087,40,1
178448,2937,1111,1826,41,4
178448,2937,1111,1826,42,1
178448,1890,700,1190,43,1
178448,361,150,211,44,1
178448,1529,550,979,45,1
178448,1047,411,636,51,1
178448,1,0,1,59,1
178448,1528,550,978,60,1
178466,154,46,108,1,4
178466,154,46,108,2,1
178466,154,46,108,3,1
178466,30,19,11,4,1
178466,124,27,97,5,1
178466,124,27,97,20,1
178466,148,42,106,21,4
178466,148,42,106,22,1
178466,148,42,106,23,1
178466,30,19,11,24,1
178466,118,23,95,25,1
178466,118,23,95,40,1
178466,6,4,2,41,4
178466,6,4,2,42,1
178466,6,4,2,43,1
178466,6,4,2,45,1
178466,6,4,2,60,1
178484,176,6,170,1,4
178484,176,6,170,2,1
178484,176,6,170,3,1
178484,73,3,70,4,1
178484,103,3,100,5,1
178484,103,3,100,20,1
178484,176,6,170,21,4
178484,176,6,170,22,1
178484,176,6,170,23,1
178484,73,3,70,24,1
178484,103,3,100,25,1
178484,103,3,100,40,1
178518,255,183,72,1,4
178518,255,183,72,12,3
178518,97,70,27,21,4
178518,97,70,27,32,3
178518,158,113,45,41,4
178518,158,113,45,52,3
178527,44,2,42,1,4
178527,44,2,42,2,1
178527,44,2,42,3,1
178527,24,1,23,4,1
178527,20,1,19,5,1
178527,20,1,19,20,1
178527,38,2,36,21,4
178527,38,2,36,22,1
178527,38,2,36,23,1
178527,20,1,19,24,1
178527,18,1,17,25,1
178527,18,1,17,40,1
178527,6,0,6,41,4
178527,6,0,6,42,1
178527,6,0,6,43,1
178527,4,0,4,44,1
178527,2,0,2,45,1
178527,2,0,2,60,1
178606,13,7,6,1,4
178606,13,7,6,2,1
178606,13,7,6,3,1
178606,7,1,6,4,1
178606,6,6,0,5,1
178606,6,6,0,20,1
178606,13,7,6,41,4
178606,13,7,6,42,1
178606,13,7,6,43,1
178606,7,1,6,44,1
178606,6,6,0,45,1
178606,6,6,0,60,1
178615,6225,2477,3748,1,4
178615,5898,2387,3511,2,1
178615,5482,2239,3243,3,1
178615,1329,544,785,4,1
178615,4153,1695,2458,5,1
178615,416,148,268,11,1
178615,327,90,237,12,3
178615,150,71,79,19,1
178615,4003,1624,2379,20,1
178615,5612,2255,3357,21,4
178615,5375,2178,3197,22,1
178615,5313,2150,3163,23,1
178615,1325,542,783,24,1
178615,3988,1608,2380,25,1
178615,62,28,34,31,1
178615,237,77,160,32,3
178615,146,69,77,39,1
178615,3842,1539,2303,40,1
178615,613,222,391,41,4
178615,523,209,314,42,1
178615,169,89,80,43,1
178615,4,2,2,44,1
178615,165,87,78,45,1
178615,354,120,234,51,1
178615,90,13,77,52,3
178615,4,2,2,59,1
178615,161,85,76,60,1
178624,6485,2924,3561,1,4
178624,5542,2483,3059,2,1
178624,5274,2372,2902,3,1
178624,1321,580,741,4,1
178624,3953,1792,2161,5,1
178624,268,111,157,11,1
178624,943,441,502,12,3
178624,236,112,124,19,1
178624,3717,1680,2037,20,1
178624,5362,2458,2904,21,4
178624,4988,2227,2761,22,1
178624,4955,2212,2743,23,1
178624,1313,575,738,24,1
178624,3642,1637,2005,25,1
178624,33,15,18,31,1
178624,374,231,143,32,3
178624,222,106,116,39,1
178624,3420,1531,1889,40,1
178624,1123,466,657,41,4
178624,554,256,298,42,1
178624,319,160,159,43,1
178624,8,5,3,44,1
178624,311,155,156,45,1
178624,235,96,139,51,1
178624,569,210,359,52,3
178624,14,6,8,59,1
178624,297,149,148,60,1
178679,751,425,326,1,4
178679,751,425,326,2,1
178679,742,419,323,3,1
178679,177,91,86,4,1
178679,565,328,237,5,1
178679,9,6,3,11,1
178679,55,29,26,19,1
178679,510,299,211,20,1
178679,652,377,275,21,4
178679,652,377,275,22,1
178679,650,375,275,23,1
178679,175,91,84,24,1
178679,475,284,191,25,1
178679,2,2,0,31,1
178679,50,29,21,39,1
178679,425,255,170,40,1
178679,99,48,51,41,4
178679,99,48,51,42,1
178679,92,44,48,43,1
178679,2,0,2,44,1
178679,90,44,46,45,1
178679,7,4,3,51,1
178679,5,0,5,59,1
178679,85,44,41,60,1
178697,1513,717,796,1,4
178697,1513,717,796,2,1
178697,1513,717,796,3,1
178697,355,195,160,4,1
178697,1158,522,636,5,1
178697,49,35,14,19,1
178697,1109,487,622,20,1
178697,1498,712,786,21,4
178697,1498,712,786,22,1
178697,1498,712,786,23,1
178697,355,195,160,24,1
178697,1143,517,626,25,1
178697,46,35,11,39,1
178697,1097,482,615,40,1
178697,15,5,10,41,4
178697,15,5,10,42,1
178697,15,5,10,43,1
178697,15,5,10,45,1
178697,3,0,3,59,1
178697,12,5,7,60,1
178721,10978,5809,5169,1,4
178721,10198,5470,4728,2,1
178721,9723,5147,4576,3,1
178721,162,65,97,4,1
178721,9561,5082,4479,5,1
178721,475,323,152,11,1
178721,780,339,441,12,3
178721,812,478,334,19,1
178721,8749,4604,4145,20,1
178721,1184,553,631,21,4
178721,1168,546,622,22,1
178721,1168,546,622,23,1
178721,157,64,93,24,1
178721,1011,482,529,25,1
178721,16,7,9,32,3
178721,140,64,76,39,1
178721,871,418,453,40,1
178721,9794,5256,4538,41,4
178721,9030,4924,4106,42,1
178721,8555,4601,3954,43,1
178721,5,1,4,44,1
178721,8550,4600,3950,45,1
178721,475,323,152,51,1
178721,764,332,432,52,3
178721,672,414,258,59,1
178721,7878,4186,3692,60,1
178767,172,19,153,1,4
178767,172,19,153,2,1
178767,172,19,153,3,1
178767,5,0,5,4,1
178767,167,19,148,5,1
178767,40,5,35,19,1
178767,127,14,113,20,1
178767,124,15,109,21,4
178767,124,15,109,22,1
178767,124,15,109,23,1
178767,4,0,4,24,1
178767,120,15,105,25,1
178767,32,5,27,39,1
178767,88,10,78,40,1
178767,48,4,44,41,4
178767,48,4,44,42,1
178767,48,4,44,43,1
178767,1,0,1,44,1
178767,47,4,43,45,1
178767,8,0,8,59,1
178767,39,4,35,60,1
178828,58,16,42,1,4
178828,58,16,42,2,1
178828,58,16,42,3,1
178828,57,16,41,4,1
178828,1,0,1,5,1
178828,1,0,1,20,1
178828,58,16,42,21,4
178828,58,16,42,22,1
178828,58,16,42,23,1
178828,57,16,41,24,1
178828,1,0,1,25,1
178828,1,0,1,40,1
178891,2097,2000,97,1,4
178891,2097,2000,97,2,1
178891,2097,2000,97,3,1
178891,777,743,34,4,1
178891,1320,1257,63,5,1
178891,1320,1257,63,20,1
178891,1313,1243,70,21,4
178891,1313,1243,70,22,1
178891,1313,1243,70,23,1
178891,519,494,25,24,1
178891,794,749,45,25,1
178891,794,749,45,40,1
178891,784,757,27,41,4
178891,784,757,27,42,1
178891,784,757,27,43,1
178891,258,249,9,44,1
178891,526,508,18,45,1
178891,526,508,18,60,1
178989,408,31,377,1,4
178989,281,21,260,2,1
178989,281,21,260,3,1
178989,281,21,260,5,1
178989,127,10,117,12,3
178989,281,21,260,20,1
178989,281,21,260,21,4
178989,277,21,256,22,1
178989,277,21,256,23,1
178989,277,21,256,25,1
178989,4,0,4,32,3
178989,277,21,256,40,1
178989,127,10,117,41,4
178989,4,0,4,42,1
178989,4,0,4,43,1
178989,4,0,4,45,1
178989,123,10,113,52,3
178989,4,0,4,60,1
179043,2920,1169,1751,1,4
179043,2241,895,1346,2,1
179043,1682,688,994,3,1
179043,438,174,264,4,1
179043,1244,514,730,5,1
179043,559,207,352,11,1
179043,679,274,405,12,3
179043,80,36,44,19,1
179043,1164,478,686,20,1
179043,1970,811,1159,21,4
179043,1546,666,880,22,1
179043,1546,666,880,23,1
179043,437,173,264,24,1
179043,1109,493,616,25,1
179043,424,145,279,32,3
179043,76,36,40,39,1
179043,1033,457,576,40,1
179043,950,358,592,41,4
179043,695,229,466,42,1
179043,136,22,114,43,1
179043,1,1,0,44,1
179043,135,21,114,45,1
179043,559,207,352,51,1
179043,255,129,126,52,3
179043,4,0,4,59,1
179043,131,21,110,60,1
179052,167,64,103,1,4
179052,167,64,103,2,1
179052,167,64,103,3,1
179052,45,27,18,4,1
179052,122,37,85,5,1
179052,122,37,85,20,1
179052,167,64,103,21,4
179052,167,64,103,22,1
179052,167,64,103,23,1
179052,45,27,18,24,1
179052,122,37,85,25,1
179052,122,37,85,40,1
179070,303,90,213,1,4
179070,303,90,213,2,1
179070,303,90,213,3,1
179070,29,3,26,4,1
179070,274,87,187,5,1
179070,47,11,36,19,1
179070,227,76,151,20,1
179070,215,44,171,21,4
179070,215,44,171,22,1
179070,215,44,171,23,1
179070,27,1,26,24,1
179070,188,43,145,25,1
179070,36,7,29,39,1
179070,152,36,116,40,1
179070,88,46,42,41,4
179070,88,46,42,42,1
179070,88,46,42,43,1
179070,2,2,0,44,1
179070,86,44,42,45,1
179070,11,4,7,59,1
179070,75,40,35,60,1
179159,17343,7192,10151,1,4
179159,12567,5212,7355,2,1
179159,7961,3220,4741,3,1
179159,1638,721,917,4,1
179159,6323,2499,3824,5,1
179159,4606,1992,2614,11,1
179159,4776,1980,2796,12,3
179159,519,183,336,19,1
179159,5804,2316,3488,20,1
179159,10521,4454,6067,21,4
179159,7210,3034,4176,22,1
179159,7145,2995,4150,23,1
179159,1638,721,917,24,1
179159,5507,2274,3233,25,1
179159,65,39,26,31,1
179159,3311,1420,1891,32,3
179159,358,137,221,39,1
179159,5149,2137,3012,40,1
179159,6822,2738,4084,41,4
179159,5357,2178,3179,42,1
179159,816,225,591,43,1
179159,816,225,591,45,1
179159,4541,1953,2588,51,1
179159,1465,560,905,52,3
179159,161,46,115,59,1
179159,655,179,476,60,1
179195,45,6,39,1,4
179195,45,6,39,2,1
179195,45,6,39,3,1
179195,6,0,6,4,1
179195,39,6,33,5,1
179195,39,6,33,20,1
179195,45,6,39,21,4
179195,45,6,39,22,1
179195,45,6,39,23,1
179195,6,0,6,24,1
179195,39,6,33,25,1
179195,39,6,33,40,1
179201,216,47,169,1,4
179201,216,47,169,2,1
179201,216,47,169,3,1
179201,216,47,169,5,1
179201,216,47,169,20,1
179201,198,37,161,21,4
179201,198,37,161,22,1
179201,198,37,161,23,1
179201,198,37,161,25,1
179201,198,37,161,40,1
179201,18,10,8,41,4
179201,18,10,8,42,1
179201,18,10,8,43,1
179201,18,10,8,45,1
179201,18,10,8,60,1
179229,26,2,24,1,4
179229,26,2,24,2,1
179229,26,2,24,3,1
179229,10,0,10,4,1
179229,16,2,14,5,1
179229,16,2,14,20,1
179229,26,2,24,21,4
179229,26,2,24,22,1
179229,26,2,24,23,1
179229,10,0,10,24,1
179229,16,2,14,25,1
179229,16,2,14,40,1
179238,71,23,48,1,4
179238,71,23,48,2,1
179238,71,23,48,3,1
179238,24,16,8,4,1
179238,47,7,40,5,1
179238,47,7,40,20,1
179238,71,23,48,21,4
179238,71,23,48,22,1
179238,71,23,48,23,1
179238,24,16,8,24,1
179238,47,7,40,25,1
179238,47,7,40,40,1
179256,245,136,109,1,4
179256,245,136,109,2,1
179256,219,126,93,3,1
179256,21,12,9,4,1
179256,198,114,84,5,1
179256,26,10,16,11,1
179256,23,14,9,19,1
179256,175,100,75,20,1
179256,171,100,71,21,4
179256,171,100,71,22,1
179256,171,100,71,23,1
179256,21,12,9,24,1
179256,150,88,62,25,1
179256,18,13,5,39,1
179256,132,75,57,40,1
179256,74,36,38,41,4
179256,74,36,38,42,1
179256,48,26,22,43,1
179256,48,26,22,45,1
179256,26,10,16,51,1
179256,5,1,4,59,1
179256,43,25,18,60,1
179265,1350,548,802,1,4
179265,723,291,432,2,1
179265,723,291,432,3,1
179265,246,96,150,4,1
179265,477,195,282,5,1
179265,627,257,370,12,3
179265,32,11,21,19,1
179265,445,184,261,20,1
179265,1343,544,799,21,4
179265,723,291,432,22,1
179265,723,291,432,23,1
179265,246,96,150,24,1
179265,477,195,282,25,1
179265,620,253,367,32,3
179265,32,11,21,39,1
179265,445,184,261,40,1
179265,7,4,3,41,4
179265,7,4,3,52,3
179308,24005,9780,14225,1,4
179308,24005,9780,14225,2,1
179308,21446,8597,12849,3,1
179308,4007,1918,2089,4,1
179308,17439,6679,10760,5,1
179308,2559,1183,1376,11,1
179308,1933,743,1190,19,1
179308,15506,5936,9570,20,1
179308,9968,4566,5402,21,4
179308,9968,4566,5402,22,1
179308,9418,4277,5141,23,1
179308,2840,1360,1480,24,1
179308,6578,2917,3661,25,1
179308,550,289,261,31,1
179308,829,364,465,39,1
179308,5749,2553,3196,40,1
179308,14037,5214,8823,41,4
179308,14037,5214,8823,42,1
179308,12028,4320,7708,43,1
179308,1167,558,609,44,1
179308,10861,3762,7099,45,1
179308,2009,894,1115,51,1
179308,1104,379,725,59,1
179308,9757,3383,6374,60,1
179317,160,90,70,1,4
179317,160,90,70,12,3
179317,120,72,48,21,4
179317,120,72,48,32,3
179317,40,18,22,41,4
179317,40,18,22,52,3
179326,3812,1352,2460,1,4
179326,2962,1052,1910,2,1
179326,2515,887,1628,3,1
179326,482,212,270,4,1
179326,2033,675,1358,5,1
179326,447,165,282,11,1
179326,850,300,550,12,3
179326,317,92,225,19,1
179326,1716,583,1133,20,1
179326,2301,909,1392,21,4
179326,2019,792,1227,22,1
179326,1975,782,1193,23,1
179326,458,203,255,24,1
179326,1517,579,938,25,1
179326,44,10,34,31,1
179326,282,117,165,32,3
179326,224,73,151,39,1
179326,1293,506,787,40,1
179326,1511,443,1068,41,4
179326,943,260,683,42,1
179326,540,105,435,43,1
179326,24,9,15,44,1
179326,516,96,420,45,1
179326,403,155,248,51,1
179326,568,183,385,52,3
179326,93,19,74,59,1
179326,423,77,346,60,1
179344,2123,911,1212,1,4
179344,2123,911,1212,2,1
179344,1648,705,943,3,1
179344,667,333,334,4,1
179344,981,372,609,5,1
179344,475,206,269,11,1
179344,226,99,127,19,1
179344,755,273,482,20,1
179344,1256,561,695,21,4
179344,1256,561,695,22,1
179344,1230,550,680,23,1
179344,596,298,298,24,1
179344,634,252,382,25,1
179344,26,11,15,31,1
179344,192,88,104,39,1
179344,442,164,278,40,1
179344,867,350,517,41,4
179344,867,350,517,42,1
179344,418,155,263,43,1
179344,71,35,36,44,1
179344,347,120,227,45,1
179344,449,195,254,51,1
179344,34,11,23,59,1
179344,313,109,204,60,1
179399,15,5,10,1,4
179399,15,5,10,2,1
179399,15,5,10,3,1
179399,15,5,10,5,1
179399,15,5,10,20,1
179399,15,5,10,21,4
179399,15,5,10,22,1
179399,15,5,10,23,1
179399,15,5,10,25,1
179399,15,5,10,40,1
179450,436,55,381,1,4
179450,375,44,331,2,1
179450,375,44,331,3,1
179450,375,44,331,5,1
179450,61,11,50,12,3
179450,95,11,84,19,1
179450,280,33,247,20,1
179450,388,50,338,21,4
179450,354,43,311,22,1
179450,354,43,311,23,1
179450,354,43,311,25,1
179450,34,7,27,32,3
179450,95,11,84,39,1
179450,259,32,227,40,1
179450,48,5,43,41,4
179450,21,1,20,42,1
179450,21,1,20,43,1
179450,21,1,20,45,1
179450,27,4,23,52,3
179450,21,1,20,60,1
179511,295,26,269,1,4
179511,295,26,269,2,1
179511,295,26,269,3,1
179511,4,2,2,4,1
179511,291,24,267,5,1
179511,128,3,125,19,1
179511,163,21,142,20,1
179511,286,26,260,21,4
179511,286,26,260,22,1
179511,286,26,260,23,1
179511,4,2,2,24,1
179511,282,24,258,25,1
179511,124,3,121,39,1
179511,158,21,137,40,1
179511,9,0,9,41,4
179511,9,0,9,42,1
179511,9,0,9,43,1
179511,9,0,9,45,1
179511,4,0,4,59,1
179511,5,0,5,60,1
179539,5185,1846,3339,1,4
179539,5185,1846,3339,2,1
179539,4374,1503,2871,3,1
179539,1257,491,766,4,1
179539,3117,1012,2105,5,1
179539,811,343,468,11,1
179539,356,117,239,19,1
179539,2761,895,1866,20,1
179539,2744,928,1816,21,4
179539,2744,928,1816,22,1
179539,2717,918,1799,23,1
179539,947,350,597,24,1
179539,1770,568,1202,25,1
179539,27,10,17,31,1
179539,199,65,134,39,1
179539,1571,503,1068,40,1
179539,2441,918,1523,41,4
179539,2441,918,1523,42,1
179539,1657,585,1072,43,1
179539,310,141,169,44,1
179539,1347,444,903,45,1
179539,784,333,451,51,1
179539,157,52,105,59,1
179539,1190,392,798,60,1
179548,854,35,819,1,4
179548,647,9,638,2,1
179548,646,9,637,3,1
179548,168,0,168,4,1
179548,478,9,469,5,1
179548,1,0,1,11,1
179548,207,26,181,12,3
179548,56,2,54,19,1
179548,422,7,415,20,1
179548,673,22,651,21,4
179548,521,0,521,22,1
179548,521,0,521,23,1
179548,168,0,168,24,1
179548,353,0,353,25,1
179548,152,22,130,32,3
179548,36,0,36,39,1
179548,317,0,317,40,1
179548,181,13,168,41,4
179548,126,9,117,42,1
179548,125,9,116,43,1
179548,125,9,116,45,1
179548,1,0,1,51,1
179548,55,4,51,52,3
179548,20,2,18,59,1
179548,105,7,98,60,1
179557,11767,4946,6821,1,4
179557,10605,4555,6050,2,1
179557,9382,4054,5328,3,1
179557,1725,750,975,4,1
179557,7657,3304,4353,5,1
179557,1223,501,722,11,1
179557,1162,391,771,12,3
179557,659,309,350,19,1
179557,6998,2995,4003,20,1
179557,8332,3623,4709,21,4
179557,7953,3466,4487,22,1
179557,7852,3413,4439,23,1
179557,1583,691,892,24,1
179557,6269,2722,3547,25,1
179557,101,53,48,31,1
179557,379,157,222,32,3
179557,565,272,293,39,1
179557,5704,2450,3254,40,1
179557,3435,1323,2112,41,4
179557,2652,1089,1563,42,1
179557,1530,641,889,43,1
179557,142,59,83,44,1
179557,1388,582,806,45,1
179557,1122,448,674,51,1
179557,783,234,549,52,3
179557,94,37,57,59,1
179557,1294,545,749,60,1
179566,21271,9020,12251,1,4
179566,18027,7822,10205,2,1
179566,15746,6910,8836,3,1
179566,2751,1088,1663,4,1
179566,12995,5822,7173,5,1
179566,2281,912,1369,11,1
179566,3244,1198,2046,12,3
179566,1699,803,896,19,1
179566,11296,5019,6277,20,1
179566,15407,6593,8814,21,4
179566,13805,5982,7823,22,1
179566,13686,5946,7740,23,1
179566,2700,1060,1640,24,1
179566,10986,4886,6100,25,1
179566,119,36,83,31,1
179566,1602,611,991,32,3
179566,1380,655,725,39,1
179566,9606,4231,5375,40,1
179566,5864,2427,3437,41,4
179566,4222,1840,2382,42,1
179566,2060,964,1096,43,1
179566,51,28,23,44,1
179566,2009,936,1073,45,1
179566,2162,876,1286,51,1
179566,1642,587,1055,52,3
179566,319,148,171,59,1
179566,1690,788,902,60,1
179645,4399,1484,2915,1,4
179645,4399,1484,2915,2,1
179645,3087,1173,1914,3,1
179645,949,422,527,4,1
179645,2138,751,1387,5,1
179645,1312,311,1001,11,1
179645,103,42,61,19,1
179645,2035,709,1326,20,1
179645,2559,862,1697,21,4
179645,2559,862,1697,22,1
179645,2069,802,1267,23,1
179645,714,311,403,24,1
179645,1355,491,864,25,1
179645,490,60,430,31,1
179645,67,30,37,39,1
179645,1288,461,827,40,1
179645,1840,622,1218,41,4
179645,1840,622,1218,42,1
179645,1018,371,647,43,1
179645,235,111,124,44,1
179645,783,260,523,45,1
179645,822,251,571,51,1
179645,36,12,24,59,1
179645,747,248,499,60,1
179715,1774,548,1226,1,4
179715,1774,548,1226,2,1
179715,1220,347,873,3,1
179715,411,157,254,4,1
179715,809,190,619,5,1
179715,554,201,353,11,1
179715,68,18,50,19,1
179715,741,172,569,20,1
179715,926,288,638,21,4
179715,926,288,638,22,1
179715,908,280,628,23,1
179715,364,140,224,24,1
179715,544,140,404,25,1
179715,18,8,10,31,1
179715,46,16,30,39,1
179715,498,124,374,40,1
179715,848,260,588,41,4
179715,848,260,588,42,1
179715,312,67,245,43,1
179715,47,17,30,44,1
179715,265,50,215,45,1
179715,536,193,343,51,1
179715,22,2,20,59,1
179715,243,48,195,60,1
179724,21,1,20,1,4
179724,21,1,20,2,1
179724,21,1,20,3,1
179724,21,1,20,5,1
179724,21,1,20,20,1
179724,21,1,20,21,4
179724,21,1,20,22,1
179724,21,1,20,23,1
179724,21,1,20,25,1
179724,21,1,20,40,1
179742,44,18,26,1,4
179742,44,18,26,12,3
179742,44,18,26,21,4
179742,44,18,26,32,3
179812,1034,590,444,1,4
179812,1034,590,444,12,3
179812,1033,590,443,21,4
179812,1033,590,443,32,3
179812,1,0,1,41,4
179812,1,0,1,52,3
179867,14032,6862,7170,1,4
179867,7336,3596,3740,2,1
179867,6851,3417,3434,3,1
179867,1608,809,799,4,1
179867,5243,2608,2635,5,1
179867,485,179,306,11,1
179867,6696,3266,3430,12,3
179867,128,74,54,19,1
179867,5115,2534,2581,20,1
179867,12078,5985,6093,21,4
179867,6587,3328,3259,22,1
179867,6528,3297,3231,23,1
179867,1595,804,791,24,1
179867,4933,2493,2440,25,1
179867,59,31,28,31,1
179867,5491,2657,2834,32,3
179867,103,64,39,39,1
179867,4830,2429,2401,40,1
179867,1954,877,1077,41,4
179867,749,268,481,42,1
179867,323,120,203,43,1
179867,13,5,8,44,1
179867,310,115,195,45,1
179867,426,148,278,51,1
179867,1205,609,596,52,3
179867,25,10,15,59,1
179867,285,105,180,60,1
179894,17904,7577,10327,1,4
179894,3528,1530,1998,2,1
179894,3398,1490,1908,3,1
179894,502,256,246,4,1
179894,2896,1234,1662,5,1
179894,130,40,90,11,1
179894,14376,6047,8329,12,3
179894,420,176,244,19,1
179894,2476,1058,1418,20,1
179894,5783,2722,3061,21,4
179894,2579,1182,1397,22,1
179894,2568,1181,1387,23,1
179894,487,247,240,24,1
179894,2081,934,1147,25,1
179894,11,1,10,31,1
179894,3204,1540,1664,32,3
179894,273,133,140,39,1
179894,1808,801,1007,40,1
179894,12121,4855,7266,41,4
179894,949,348,601,42,1
179894,830,309,521,43,1
179894,15,9,6,44,1
179894,815,300,515,45,1
179894,119,39,80,51,1
179894,11172,4507,6665,52,3
179894,147,43,104,59,1
179894,668,257,411,60,1
179919,851,404,447,1,4
179919,851,404,447,2,1
179919,399,212,187,3,1
179919,185,108,77,4,1
179919,214,104,110,5,1
179919,452,192,260,11,1
179919,10,4,6,19,1
179919,204,100,104,20,1
179919,337,196,141,21,4
179919,337,196,141,22,1
179919,336,195,141,23,1
179919,163,99,64,24,1
179919,173,96,77,25,1
179919,1,1,0,31,1
179919,6,4,2,39,1
179919,167,92,75,40,1
179919,514,208,306,41,4
179919,514,208,306,42,1
179919,63,17,46,43,1
179919,22,9,13,44,1
179919,41,8,33,45,1
179919,451,191,260,51,1
179919,4,0,4,59,1
179919,37,8,29,60,1
179946,1026,570,456,1,4
179946,1026,570,456,2,1
179946,1022,567,455,3,1
179946,266,137,129,4,1
179946,756,430,326,5,1
179946,4,3,1,11,1
179946,57,34,23,19,1
179946,699,396,303,20,1
179946,1018,566,452,21,4
179946,1018,566,452,22,1
179946,1016,564,452,23,1
179946,266,137,129,24,1
179946,750,427,323,25,1
179946,2,2,0,31,1
179946,57,34,23,39,1
179946,693,393,300,40,1
179946,8,4,4,41,4
179946,8,4,4,42,1
179946,6,3,3,43,1
179946,6,3,3,45,1
179946,2,1,1,51,1
179946,6,3,3,60,1
179955,1044,452,592,1,4
179955,1044,452,592,2,1
179955,1044,452,592,3,1
179955,259,120,139,4,1
179955,785,332,453,5,1
179955,41,21,20,19,1
179955,744,311,433,20,1
179955,1012,437,575,21,4
179955,1012,437,575,22,1
179955,1012,437,575,23,1
179955,259,120,139,24,1
179955,753,317,436,25,1
179955,40,20,20,39,1
179955,713,297,416,40,1
179955,32,15,17,41,4
179955,32,15,17,42,1
179955,32,15,17,43,1
179955,32,15,17,45,1
179955,1,1,0,59,1
179955,31,14,17,60,1
179964,2136,693,1443,1,4
179964,1002,268,734,2,1
179964,1001,268,733,3,1
179964,159,25,134,4,1
179964,842,243,599,5,1
179964,1,0,1,11,1
179964,1134,425,709,12,3
179964,75,22,53,19,1
179964,767,221,546,20,1
179964,1261,359,902,21,4
179964,843,217,626,22,1
179964,843,217,626,23,1
179964,158,25,133,24,1
179964,685,192,493,25,1
179964,418,142,276,32,3
179964,63,18,45,39,1
179964,622,174,448,40,1
179964,875,334,541,41,4
179964,159,51,108,42,1
179964,158,51,107,43,1
179964,1,0,1,44,1
179964,157,51,106,45,1
179964,1,0,1,51,1
179964,716,283,433,52,3
179964,12,4,8,59,1
179964,145,47,98,60,1
179991,42,1,41,1,4
179991,42,1,41,2,1
179991,42,1,41,3,1
179991,29,0,29,4,1
179991,13,1,12,5,1
179991,13,1,12,20,1
179991,42,1,41,21,4
179991,42,1,41,22,1
179991,42,1,41,23,1
179991,29,0,29,24,1
179991,13,1,12,25,1
179991,13,1,12,40,1
180054,450,170,280,1,4
180054,450,170,280,2,1
180054,448,169,279,3,1
180054,100,45,55,4,1
180054,348,124,224,5,1
180054,2,1,1,11,1
180054,28,11,17,19,1
180054,320,113,207,20,1
180054,382,145,237,21,4
180054,382,145,237,22,1
180054,382,145,237,23,1
180054,91,41,50,24,1
180054,291,104,187,25,1
180054,24,10,14,39,1
180054,267,94,173,40,1
180054,68,25,43,41,4
180054,68,25,43,42,1
180054,66,24,42,43,1
180054,9,4,5,44,1
180054,57,20,37,45,1
180054,2,1,1,51,1
180054,4,1,3,59,1
180054,53,19,34,60,1
180063,37,2,35,1,4
180063,37,2,35,2,1
180063,37,2,35,3,1
180063,16,2,14,4,1
180063,21,0,21,5,1
180063,21,0,21,20,1
180063,37,2,35,21,4
180063,37,2,35,22,1
180063,37,2,35,23,1
180063,16,2,14,24,1
180063,21,0,21,25,1
180063,21,0,21,40,1
180081,913,433,480,1,4
180081,913,433,480,2,1
180081,628,302,326,3,1
180081,177,99,78,4,1
180081,451,203,248,5,1
180081,285,131,154,11,1
180081,53,29,24,19,1
180081,398,174,224,20,1
180081,529,272,257,21,4
180081,529,272,257,22,1
180081,528,272,256,23,1
180081,164,96,68,24,1
180081,364,176,188,25,1
180081,1,0,1,31,1
180081,46,27,19,39,1
180081,318,149,169,40,1
180081,384,161,223,41,4
180081,384,161,223,42,1
180081,100,30,70,43,1
180081,13,3,10,44,1
180081,87,27,60,45,1
180081,284,131,153,51,1
180081,7,2,5,59,1
180081,80,25,55,60,1
180090,83,2,81,1,4
180090,83,2,81,2,1
180090,83,2,81,3,1
180090,59,2,57,4,1
180090,24,0,24,5,1
180090,24,0,24,20,1
180090,83,2,81,21,4
180090,83,2,81,22,1
180090,83,2,81,23,1
180090,59,2,57,24,1
180090,24,0,24,25,1
180090,24,0,24,40,1
180106,1431,603,828,1,4
180106,1431,603,828,2,1
180106,1376,578,798,3,1
180106,315,133,182,4,1
180106,1061,445,616,5,1
180106,55,25,30,11,1
180106,50,24,26,19,1
180106,1011,421,590,20,1
180106,1349,563,786,21,4
180106,1349,563,786,22,1
180106,1339,561,778,23,1
180106,315,133,182,24,1
180106,1024,428,596,25,1
180106,10,2,8,31,1
180106,46,22,24,39,1
180106,978,406,572,40,1
180106,82,40,42,41,4
180106,82,40,42,42,1
180106,37,17,20,43,1
180106,37,17,20,45,1
180106,45,23,22,51,1
180106,4,2,2,59,1
180106,33,15,18,60,1
180151,372,168,204,1,4
180151,372,168,204,2,1
180151,266,122,144,3,1
180151,118,59,59,4,1
180151,148,63,85,5,1
180151,106,46,60,11,1
180151,54,24,30,19,1
180151,94,39,55,20,1
180151,227,111,116,21,4
180151,227,111,116,22,1
180151,226,110,116,23,1
180151,113,58,55,24,1
180151,113,52,61,25,1
180151,1,1,0,31,1
180151,44,22,22,39,1
180151,69,30,39,40,1
180151,145,57,88,41,4
180151,145,57,88,42,1
180151,40,12,28,43,1
180151,5,1,4,44,1
180151,35,11,24,45,1
180151,105,45,60,51,1
180151,10,2,8,59,1
180151,25,9,16,60,1
180160,201,76,125,1,4
180160,201,76,125,2,1
180160,178,67,111,3,1
180160,38,19,19,4,1
180160,140,48,92,5,1
180160,23,9,14,11,1
180160,140,48,92,20,1
180160,128,53,75,21,4
180160,128,53,75,22,1
180160,128,53,75,23,1
180160,37,19,18,24,1
180160,91,34,57,25,1
180160,91,34,57,40,1
180160,73,23,50,41,4
180160,73,23,50,42,1
180160,50,14,36,43,1
180160,1,0,1,44,1
180160,49,14,35,45,1
180160,23,9,14,51,1
180160,49,14,35,60,1
180179,4969,1884,3085,1,4
180179,4465,1755,2710,2,1
180179,4234,1655,2579,3,1
180179,761,330,431,4,1
180179,3473,1325,2148,5,1
180179,231,100,131,11,1
180179,504,129,375,12,3
180179,426,184,242,19,1
180179,3047,1141,1906,20,1
180179,3372,1398,1974,21,4
180179,3162,1337,1825,22,1
180179,3138,1323,1815,23,1
180179,666,306,360,24,1
180179,2472,1017,1455,25,1
180179,24,14,10,31,1
180179,210,61,149,32,3
180179,301,140,161,39,1
180179,2171,877,1294,40,1
180179,1597,486,1111,41,4
180179,1303,418,885,42,1
180179,1096,332,764,43,1
180179,95,24,71,44,1
180179,1001,308,693,45,1
180179,207,86,121,51,1
180179,294,68,226,52,3
180179,125,44,81,59,1
180179,876,264,612,60,1
180197,2216,872,1344,1,4
180197,2216,872,1344,2,1
180197,1773,706,1067,3,1
180197,368,171,197,4,1
180197,1405,535,870,5,1
180197,443,166,277,11,1
180197,126,56,70,19,1
180197,1279,479,800,20,1
180197,1082,493,589,21,4
180197,1082,493,589,22,1
180197,1067,483,584,23,1
180197,285,136,149,24,1
180197,782,347,435,25,1
180197,15,10,5,31,1
180197,74,39,35,39,1
180197,708,308,400,40,1
180197,1134,379,755,41,4
180197,1134,379,755,42,1
180197,706,223,483,43,1
180197,83,35,48,44,1
180197,623,188,435,45,1
180197,428,156,272,51,1
180197,52,17,35,59,1
180197,571,171,400,60,1
180203,139,60,79,1,4
180203,139,60,79,2,1
180203,134,60,74,3,1
180203,28,19,9,4,1
180203,106,41,65,5,1
180203,5,0,5,11,1
180203,12,7,5,19,1
180203,94,34,60,20,1
180203,121,56,65,21,4
180203,121,56,65,22,1
180203,121,56,65,23,1
180203,25,18,7,24,1
180203,96,38,58,25,1
180203,10,6,4,39,1
180203,86,32,54,40,1
180203,18,4,14,41,4
180203,18,4,14,42,1
180203,13,4,9,43,1
180203,3,1,2,44,1
180203,10,3,7,45,1
180203,5,0,5,51,1
180203,2,1,1,59,1
180203,8,2,6,60,1
180212,405,147,258,1,4
180212,405,147,258,2,1
180212,350,130,220,3,1
180212,48,28,20,4,1
180212,302,102,200,5,1
180212,55,17,38,11,1
180212,14,4,10,19,1
180212,288,98,190,20,1
180212,228,106,122,21,4
180212,228,106,122,22,1
180212,228,106,122,23,1
180212,40,26,14,24,1
180212,188,80,108,25,1
180212,11,4,7,39,1
180212,177,76,101,40,1
180212,177,41,136,41,4
180212,177,41,136,42,1
180212,122,24,98,43,1
180212,8,2,6,44,1
180212,114,22,92,45,1
180212,55,17,38,51,1
180212,3,0,3,59,1
180212,111,22,89,60,1
180249,1875,526,1349,1,4
180249,1875,526,1349,2,1
180249,1626,436,1190,3,1
180249,284,119,165,4,1
180249,1342,317,1025,5,1
180249,249,90,159,11,1
180249,169,47,122,19,1
180249,1173,270,903,20,1
180249,892,293,599,21,4
180249,892,293,599,22,1
180249,874,278,596,23,1
180249,196,89,107,24,1
180249,678,189,489,25,1
180249,18,15,3,31,1
180249,96,28,68,39,1
180249,582,161,421,40,1
180249,983,233,750,41,4
180249,983,233,750,42,1
180249,752,158,594,43,1
180249,88,30,58,44,1
180249,664,128,536,45,1
180249,231,75,156,51,1
180249,73,19,54,59,1
180249,591,109,482,60,1
180258,1138,372,766,1,4
180258,1046,339,707,2,1
180258,1032,332,700,3,1
180258,152,61,91,4,1
180258,880,271,609,5,1
180258,14,7,7,11,1
180258,92,33,59,12,3
180258,153,37,116,19,1
180258,727,234,493,20,1
180258,716,280,436,21,4
180258,665,263,402,22,1
180258,665,263,402,23,1
180258,150,61,89,24,1
180258,515,202,313,25,1
180258,51,17,34,32,3
180258,70,30,40,39,1
180258,445,172,273,40,1
180258,422,92,330,41,4
180258,381,76,305,42,1
180258,367,69,298,43,1
180258,2,0,2,44,1
180258,365,69,296,45,1
180258,14,7,7,51,1
180258,41,16,25,52,3
180258,83,7,76,59,1
180258,282,62,220,60,1
180276,1430,599,831,1,4
180276,1430,599,831,2,1
180276,1118,467,651,3,1
180276,271,136,135,4,1
180276,847,331,516,5,1
180276,312,132,180,11,1
180276,101,33,68,19,1
180276,746,298,448,20,1
180276,670,337,333,21,4
180276,670,337,333,22,1
180276,670,337,333,23,1
180276,204,112,92,24,1
180276,466,225,241,25,1
180276,61,25,36,39,1
180276,405,200,205,40,1
180276,760,262,498,41,4
180276,760,262,498,42,1
180276,448,130,318,43,1
180276,67,24,43,44,1
180276,381,106,275,45,1
180276,312,132,180,51,1
180276,40,8,32,59,1
180276,341,98,243,60,1
180328,329,109,220,1,4
180328,329,109,220,2,1
180328,309,105,204,3,1
180328,77,39,38,4,1
180328,232,66,166,5,1
180328,20,4,16,11,1
180328,19,7,12,19,1
180328,213,59,154,20,1
180328,269,96,173,21,4
180328,269,96,173,22,1
180328,266,95,171,23,1
180328,73,36,37,24,1
180328,193,59,134,25,1
180328,3,1,2,31,1
180328,17,7,10,39,1
180328,176,52,124,40,1
180328,60,13,47,41,4
180328,60,13,47,42,1
180328,43,10,33,43,1
180328,4,3,1,44,1
180328,39,7,32,45,1
180328,17,3,14,51,1
180328,2,0,2,59,1
180328,37,7,30,60,1
180373,422,169,253,1,4
180373,422,169,253,2,1
180373,351,136,215,3,1
180373,106,52,54,4,1
180373,245,84,161,5,1
180373,71,33,38,11,1
180373,53,16,37,19,1
180373,192,68,124,20,1
180373,249,126,123,21,4
180373,249,126,123,22,1
180373,244,124,120,23,1
180373,97,51,46,24,1
180373,147,73,74,25,1
180373,5,2,3,31,1
180373,32,15,17,39,1
180373,115,58,57,40,1
180373,173,43,130,41,4
180373,173,43,130,42,1
180373,107,12,95,43,1
180373,9,1,8,44,1
180373,98,11,87,45,1
180373,66,31,35,51,1
180373,21,1,20,59,1
180373,77,10,67,60,1
180391,45,3,42,1,4
180391,45,3,42,2,1
180391,45,3,42,3,1
180391,14,1,13,4,1
180391,31,2,29,5,1
180391,31,2,29,20,1
180391,45,3,42,21,4
180391,45,3,42,22,1
180391,45,3,42,23,1
180391,14,1,13,24,1
180391,31,2,29,25,1
180391,31,2,29,40,1
180416,2010,1337,673,1,4
180416,1844,1231,613,2,1
180416,1825,1223,602,3,1
180416,265,187,78,4,1
180416,1560,1036,524,5,1
180416,19,8,11,11,1
180416,166,106,60,12,3
180416,173,119,54,19,1
180416,1387,917,470,20,1
180416,1726,1191,535,21,4
180416,1661,1149,512,22,1
180416,1660,1149,511,23,1
180416,262,184,78,24,1
180416,1398,965,433,25,1
180416,1,0,1,31,1
180416,65,42,23,32,3
180416,151,113,38,39,1
180416,1247,852,395,40,1
180416,284,146,138,41,4
180416,183,82,101,42,1
180416,165,74,91,43,1
180416,3,3,0,44,1
180416,162,71,91,45,1
180416,18,8,10,51,1
180416,101,64,37,52,3
180416,22,6,16,59,1
180416,140,65,75,60,1
180461,14852,8051,6801,1,4
180461,13174,7236,5938,2,1
180461,13055,7170,5885,3,1
180461,2914,1657,1257,4,1
180461,10141,5513,4628,5,1
180461,119,66,53,11,1
180461,1678,815,863,12,3
180461,1025,498,527,19,1
180461,9116,5015,4101,20,1
180461,11549,6382,5167,21,4
180461,11012,6108,4904,22,1
180461,10902,6047,4855,23,1
180461,2345,1352,993,24,1
180461,8557,4695,3862,25,1
180461,110,61,49,31,1
180461,537,274,263,32,3
180461,720,366,354,39,1
180461,7837,4329,3508,40,1
180461,3303,1669,1634,41,4
180461,2162,1128,1034,42,1
180461,2153,1123,1030,43,1
180461,569,305,264,44,1
180461,1584,818,766,45,1
180461,9,5,4,51,1
180461,1141,541,600,52,3
180461,305,132,173,59,1
180461,1279,686,593,60,1
180489,14525,6623,7902,1,4
180489,12254,5676,6578,2,1
180489,11630,5379,6251,3,1
180489,1963,891,1072,4,1
180489,9667,4488,5179,5,1
180489,624,297,327,11,1
180489,2271,947,1324,12,3
180489,859,398,461,19,1
180489,8808,4090,4718,20,1
180489,10582,4974,5608,21,4
180489,9446,4465,4981,22,1
180489,9382,4439,4943,23,1
180489,1783,804,979,24,1
180489,7599,3635,3964,25,1
180489,64,26,38,31,1
180489,1136,509,627,32,3
180489,681,331,350,39,1
180489,6918,3304,3614,40,1
180489,3943,1649,2294,41,4
180489,2808,1211,1597,42,1
180489,2248,940,1308,43,1
180489,180,87,93,44,1
180489,2068,853,1215,45,1
180489,560,271,289,51,1
180489,1135,438,697,52,3
180489,178,67,111,59,1
180489,1890,786,1104,60,1
180522,1334,646,688,1,4
180522,1250,629,621,2,1
180522,1250,629,621,3,1
180522,200,149,51,4,1
180522,1050,480,570,5,1
180522,84,17,67,12,3
180522,167,71,96,19,1
180522,883,409,474,20,1
180522,918,551,367,21,4
180522,917,551,366,22,1
180522,917,551,366,23,1
180522,179,138,41,24,1
180522,738,413,325,25,1
180522,1,0,1,32,3
180522,127,62,65,39,1
180522,611,351,260,40,1
180522,416,95,321,41,4
180522,333,78,255,42,1
180522,333,78,255,43,1
180522,21,11,10,44,1
180522,312,67,245,45,1
180522,83,17,66,52,3
180522,40,9,31,59,1
180522,272,58,214,60,1
180595,1067,549,518,1,4
180595,988,513,475,2,1
180595,961,500,461,3,1
180595,238,129,109,4,1
180595,723,371,352,5,1
180595,27,13,14,11,1
180595,79,36,43,12,3
180595,69,39,30,19,1
180595,654,332,322,20,1
180595,1024,524,500,21,4
180595,947,490,457,22,1
180595,939,488,451,23,1
180595,238,129,109,24,1
180595,701,359,342,25,1
180595,8,2,6,31,1
180595,77,34,43,32,3
180595,64,37,27,39,1
180595,637,322,315,40,1
180595,43,25,18,41,4
180595,41,23,18,42,1
180595,22,12,10,43,1
180595,22,12,10,45,1
180595,19,11,8,51,1
180595,2,2,0,52,3
180595,5,2,3,59,1
180595,17,10,7,60,1
180647,840,333,507,1,4
180647,840,333,507,2,1
180647,809,321,488,3,1
180647,123,58,65,4,1
180647,686,263,423,5,1
180647,31,12,19,11,1
180647,89,31,58,19,1
180647,597,232,365,20,1
180647,696,292,404,21,4
180647,696,292,404,22,1
180647,694,291,403,23,1
180647,107,53,54,24,1
180647,587,238,349,25,1
180647,2,1,1,31,1
180647,78,29,49,39,1
180647,509,209,300,40,1
180647,144,41,103,41,4
180647,144,41,103,42,1
180647,115,30,85,43,1
180647,16,5,11,44,1
180647,99,25,74,45,1
180647,29,11,18,51,1
180647,11,2,9,59,1
180647,88,23,65,60,1
180692,1455,609,846,1,4
180692,1455,609,846,2,1
180692,1452,609,843,3,1
180692,254,125,129,4,1
180692,1198,484,714,5,1
180692,3,0,3,11,1
180692,323,114,209,19,1
180692,875,370,505,20,1
180692,1196,550,646,21,4
180692,1196,550,646,22,1
180692,1195,550,645,23,1
180692,250,124,126,24,1
180692,945,426,519,25,1
180692,1,0,1,31,1
180692,246,99,147,39,1
180692,699,327,372,40,1
180692,259,59,200,41,4
180692,259,59,200,42,1
180692,257,59,198,43,1
180692,4,1,3,44,1
180692,253,58,195,45,1
180692,2,0,2,51,1
180692,77,15,62,59,1
180692,176,43,133,60,1
180771,33,1,32,1,4
180771,33,1,32,2,1
180771,33,1,32,3,1
180771,6,0,6,4,1
180771,27,1,26,5,1
180771,27,1,26,20,1
180771,33,1,32,21,4
180771,33,1,32,22,1
180771,33,1,32,23,1
180771,6,0,6,24,1
180771,27,1,26,25,1
180771,27,1,26,40,1
180814,9788,4719,5069,1,4
180814,6202,3075,3127,2,1
180814,6134,3039,3095,3,1
180814,124,62,62,4,1
180814,6010,2977,3033,5,1
180814,68,36,32,11,1
180814,3586,1644,1942,12,3
180814,2935,1421,1514,19,1
180814,3075,1556,1519,20,1
180814,7798,3682,4116,21,4
180814,5180,2520,2660,22,1
180814,5174,2519,2655,23,1
180814,87,39,48,24,1
180814,5087,2480,2607,25,1
180814,6,1,5,31,1
180814,2618,1162,1456,32,3
180814,2575,1227,1348,39,1
180814,2512,1253,1259,40,1
180814,1990,1037,953,41,4
180814,1022,555,467,42,1
180814,960,520,440,43,1
180814,37,23,14,44,1
180814,923,497,426,45,1
180814,62,35,27,51,1
180814,968,482,486,52,3
180814,360,194,166,59,1
180814,563,303,260,60,1
180832,1238,160,1078,1,4
180832,780,104,676,2,1
180832,778,103,675,3,1
180832,36,2,34,4,1
180832,742,101,641,5,1
180832,2,1,1,11,1
180832,458,56,402,12,3
180832,166,29,137,19,1
180832,576,72,504,20,1
180832,467,69,398,21,4
180832,446,63,383,22,1
180832,446,63,383,23,1
180832,32,2,30,24,1
180832,414,61,353,25,1
180832,21,6,15,32,3
180832,87,17,70,39,1
180832,327,44,283,40,1
180832,771,91,680,41,4
180832,334,41,293,42,1
180832,332,40,292,43,1
180832,4,0,4,44,1
180832,328,40,288,45,1
180832,2,1,1,51,1
180832,437,50,387,52,3
180832,79,12,67,59,1
180832,249,28,221,60,1
180878,711,80,631,1,4
180878,627,58,569,2,1
180878,593,56,537,3,1
180878,37,5,32,4,1
180878,556,51,505,5,1
180878,34,2,32,11,1
180878,84,22,62,12,3
180878,92,8,84,19,1
180878,464,43,421,20,1
180878,343,45,298,21,4
180878,298,25,273,22,1
180878,298,25,273,23,1
180878,36,5,31,24,1
180878,262,20,242,25,1
180878,45,20,25,32,3
180878,42,6,36,39,1
180878,220,14,206,40,1
180878,368,35,333,41,4
180878,329,33,296,42,1
180878,295,31,264,43,1
180878,1,0,1,44,1
180878,294,31,263,45,1
180878,34,2,32,51,1
180878,39,2,37,52,3
180878,50,2,48,59,1
180878,244,29,215,60,1
180902,6906,2880,4026,1,4
180902,6906,2880,4026,2,1
180902,4321,1667,2654,3,1
180902,904,468,436,4,1
180902,3417,1199,2218,5,1
180902,2585,1213,1372,11,1
180902,273,113,160,19,1
180902,3144,1086,2058,20,1
180902,2215,1068,1147,21,4
180902,2215,1068,1147,22,1
180902,2182,1052,1130,23,1
180902,710,380,330,24,1
180902,1472,672,800,25,1
180902,33,16,17,31,1
180902,205,96,109,39,1
180902,1267,576,691,40,1
180902,4691,1812,2879,41,4
180902,4691,1812,2879,42,1
180902,2139,615,1524,43,1
180902,194,88,106,44,1
180902,1945,527,1418,45,1
180902,2552,1197,1355,51,1
180902,68,17,51,59,1
180902,1877,510,1367,60,1
180948,3056,1295,1761,1,4
180948,2432,1035,1397,2,1
180948,2131,912,1219,3,1
180948,463,229,234,4,1
180948,1668,683,985,5,1
180948,301,123,178,11,1
180948,624,260,364,12,3
180948,175,67,108,19,1
180948,1493,616,877,20,1
180948,1912,865,1047,21,4
180948,1772,799,973,22,1
180948,1766,794,972,23,1
180948,458,227,231,24,1
180948,1308,567,741,25,1
180948,6,5,1,31,1
180948,140,66,74,32,3
180948,120,53,67,39,1
180948,1188,514,674,40,1
180948,1144,430,714,41,4
180948,660,236,424,42,1
180948,365,118,247,43,1
180948,5,2,3,44,1
180948,360,116,244,45,1
180948,295,118,177,51,1
180948,484,194,290,52,3
180948,55,14,41,59,1
180948,305,102,203,60,1
180957,116,20,96,1,4
180957,116,20,96,2,1
180957,116,20,96,3,1
180957,8,2,6,4,1
180957,108,18,90,5,1
180957,108,18,90,20,1
180957,116,20,96,21,4
180957,116,20,96,22,1
180957,116,20,96,23,1
180957,8,2,6,24,1
180957,108,18,90,25,1
180957,108,18,90,40,1
180984,2206,892,1314,1,4
180984,1508,742,766,2,1
180984,1185,594,591,3,1
180984,282,153,129,4,1
180984,903,441,462,5,1
180984,323,148,175,11,1
180984,698,150,548,12,3
180984,61,37,24,19,1
180984,842,404,438,20,1
180984,1725,699,1026,21,4
180984,1134,581,553,22,1
180984,1133,581,552,23,1
180984,281,153,128,24,1
180984,852,428,424,25,1
180984,1,0,1,31,1
180984,591,118,473,32,3
180984,56,36,20,39,1
180984,796,392,404,40,1
180984,481,193,288,41,4
180984,374,161,213,42,1
180984,52,13,39,43,1
180984,1,0,1,44,1
180984,51,13,38,45,1
180984,322,148,174,51,1
180984,107,32,75,52,3
180984,5,1,4,59,1
180984,46,12,34,60,1
181002,8019,3465,4554,1,4
181002,4076,1664,2412,2,1
181002,3943,1586,2357,3,1
181002,966,383,583,4,1
181002,2977,1203,1774,5,1
181002,133,78,55,11,1
181002,3943,1801,2142,12,3
181002,166,56,110,19,1
181002,2811,1147,1664,20,1
181002,6711,2869,3842,21,4
181002,3815,1545,2270,22,1
181002,3790,1533,2257,23,1
181002,963,381,582,24,1
181002,2827,1152,1675,25,1
181002,25,12,13,31,1
181002,2896,1324,1572,32,3
181002,148,50,98,39,1
181002,2679,1102,1577,40,1
181002,1308,596,712,41,4
181002,261,119,142,42,1
181002,153,53,100,43,1
181002,3,2,1,44,1
181002,150,51,99,45,1
181002,108,66,42,51,1
181002,1047,477,570,52,3
181002,18,6,12,59,1
181002,132,45,87,60,1
181020,1113,556,557,1,4
181020,1113,556,557,2,1
181020,1111,556,555,3,1
181020,287,150,137,4,1
181020,824,406,418,5,1
181020,2,0,2,11,1
181020,50,36,14,19,1
181020,774,370,404,20,1
181020,1106,553,553,21,4
181020,1106,553,553,22,1
181020,1106,553,553,23,1
181020,287,150,137,24,1
181020,819,403,416,25,1
181020,50,36,14,39,1
181020,769,367,402,40,1
181020,7,3,4,41,4
181020,7,3,4,42,1
181020,5,3,2,43,1
181020,5,3,2,45,1
181020,2,0,2,51,1
181020,5,3,2,60,1
181093,481,221,260,1,4
181093,410,196,214,2,1
181093,410,196,214,3,1
181093,97,38,59,4,1
181093,313,158,155,5,1
181093,71,25,46,12,3
181093,63,43,20,19,1
181093,250,115,135,20,1
181093,372,165,207,21,4
181093,341,156,185,22,1
181093,341,156,185,23,1
181093,96,38,58,24,1
181093,245,118,127,25,1
181093,31,9,22,32,3
181093,62,42,20,39,1
181093,183,76,107,40,1
181093,109,56,53,41,4
181093,69,40,29,42,1
181093,69,40,29,43,1
181093,1,0,1,44,1
181093,68,40,28,45,1
181093,40,16,24,52,3
181093,1,1,0,59,1
181093,67,39,28,60,1
181127,1144,583,561,1,4
181127,1118,571,547,2,1
181127,1060,545,515,3,1
181127,345,180,165,4,1
181127,715,365,350,5,1
181127,58,26,32,11,1
181127,26,12,14,12,3
181127,48,27,21,19,1
181127,667,338,329,20,1
181127,1076,550,526,21,4
181127,1060,543,517,22,1
181127,1050,540,510,23,1
181127,345,180,165,24,1
181127,705,360,345,25,1
181127,10,3,7,31,1
181127,16,7,9,32,3
181127,48,27,21,39,1
181127,657,333,324,40,1
181127,68,33,35,41,4
181127,58,28,30,42,1
181127,10,5,5,43,1
181127,10,5,5,45,1
181127,48,23,25,51,1
181127,10,5,5,52,3
181127,10,5,5,60,1
181136,34,1,33,1,4
181136,34,1,33,2,1
181136,34,1,33,3,1
181136,14,1,13,4,1
181136,20,0,20,5,1
181136,20,0,20,20,1
181136,34,1,33,21,4
181136,34,1,33,22,1
181136,34,1,33,23,1
181136,14,1,13,24,1
181136,20,0,20,25,1
181136,20,0,20,40,1
181145,22,1,21,1,4
181145,22,1,21,2,1
181145,22,1,21,3,1
181145,22,1,21,5,1
181145,12,1,11,19,1
181145,10,0,10,20,1
181145,22,1,21,21,4
181145,22,1,21,22,1
181145,22,1,21,23,1
181145,22,1,21,25,1
181145,12,1,11,39,1
181145,10,0,10,40,1
181190,281,3,278,1,4
181190,281,3,278,2,1
181190,281,3,278,3,1
181190,46,0,46,4,1
181190,235,3,232,5,1
181190,235,3,232,20,1
181190,281,3,278,21,4
181190,281,3,278,22,1
181190,281,3,278,23,1
181190,46,0,46,24,1
181190,235,3,232,25,1
181190,235,3,232,40,1
181215,7052,2838,4214,1,4
181215,5502,2339,3163,2,1
181215,5247,2228,3019,3,1
181215,1022,431,591,4,1
181215,4225,1797,2428,5,1
181215,255,111,144,11,1
181215,1550,499,1051,12,3
181215,342,134,208,19,1
181215,3883,1663,2220,20,1
181215,5034,2133,2901,21,4
181215,4777,2062,2715,22,1
181215,4702,2042,2660,23,1
181215,1007,423,584,24,1
181215,3695,1619,2076,25,1
181215,75,20,55,31,1
181215,257,71,186,32,3
181215,288,128,160,39,1
181215,3407,1491,1916,40,1
181215,2018,705,1313,41,4
181215,725,277,448,42,1
181215,545,186,359,43,1
181215,15,8,7,44,1
181215,530,178,352,45,1
181215,180,91,89,51,1
181215,1293,428,865,52,3
181215,54,6,48,59,1
181215,476,172,304,60,1
181242,501,122,379,1,4
181242,472,111,361,2,1
181242,471,111,360,3,1
181242,37,7,30,4,1
181242,434,104,330,5,1
181242,1,0,1,11,1
181242,29,11,18,12,3
181242,155,36,119,19,1
181242,279,68,211,20,1
181242,330,89,241,21,4
181242,313,82,231,22,1
181242,313,82,231,23,1
181242,29,7,22,24,1
181242,284,75,209,25,1
181242,17,7,10,32,3
181242,97,26,71,39,1
181242,187,49,138,40,1
181242,171,33,138,41,4
181242,159,29,130,42,1
181242,158,29,129,43,1
181242,8,0,8,44,1
181242,150,29,121,45,1
181242,1,0,1,51,1
181242,12,4,8,52,3
181242,58,10,48,59,1
181242,92,19,73,60,1
181297,943,92,851,1,4
181297,742,67,675,2,1
181297,740,66,674,3,1
181297,44,4,40,4,1
181297,696,62,634,5,1
181297,2,1,1,11,1
181297,201,25,176,12,3
181297,154,12,142,19,1
181297,542,50,492,20,1
181297,588,55,533,21,4
181297,463,42,421,22,1
181297,463,42,421,23,1
181297,37,4,33,24,1
181297,426,38,388,25,1
181297,125,13,112,32,3
181297,121,10,111,39,1
181297,305,28,277,40,1
181297,355,37,318,41,4
181297,279,25,254,42,1
181297,277,24,253,43,1
181297,7,0,7,44,1
181297,270,24,246,45,1
181297,2,1,1,51,1
181297,76,12,64,52,3
181297,33,2,31,59,1
181297,237,22,215,60,1
181303,15752,7107,8645,1,4
181303,15752,7107,8645,2,1
181303,7737,3436,4301,3,1
181303,1943,942,1001,4,1
181303,5794,2494,3300,5,1
181303,8015,3671,4344,11,1
181303,5794,2494,3300,20,1
181303,5976,2798,3178,21,4
181303,5976,2798,3178,22,1
181303,3412,1593,1819,23,1
181303,1077,541,536,24,1
181303,2335,1052,1283,25,1
181303,2564,1205,1359,31,1
181303,2335,1052,1283,40,1
181303,9776,4309,5467,41,4
181303,9776,4309,5467,42,1
181303,4325,1843,2482,43,1
181303,866,401,465,44,1
181303,3459,1442,2017,45,1
181303,5451,2466,2985,51,1
181303,3459,1442,2017,60,1
181312,2491,962,1529,1,4
181312,2491,962,1529,2,1
181312,1437,542,895,3,1
181312,485,215,270,4,1
181312,952,327,625,5,1
181312,1054,420,634,11,1
181312,85,42,43,19,1
181312,867,285,582,20,1
181312,960,425,535,21,4
181312,960,425,535,22,1
181312,929,410,519,23,1
181312,398,185,213,24,1
181312,531,225,306,25,1
181312,31,15,16,31,1
181312,73,37,36,39,1
181312,458,188,270,40,1
181312,1531,537,994,41,4
181312,1531,537,994,42,1
181312,508,132,376,43,1
181312,87,30,57,44,1
181312,421,102,319,45,1
181312,1023,405,618,51,1
181312,12,5,7,59,1
181312,409,97,312,60,1
181330,1288,647,641,1,4
181330,1192,601,591,2,1
181330,1189,599,590,3,1
181330,367,208,159,4,1
181330,822,391,431,5,1
181330,3,2,1,11,1
181330,96,46,50,12,3
181330,125,70,55,19,1
181330,697,321,376,20,1
181330,1199,616,583,21,4
181330,1164,593,571,22,1
181330,1163,593,570,23,1
181330,367,208,159,24,1
181330,796,385,411,25,1
181330,1,0,1,31,1
181330,35,23,12,32,3
181330,118,68,50,39,1
181330,678,317,361,40,1
181330,89,31,58,41,4
181330,28,8,20,42,1
181330,26,6,20,43,1
181330,26,6,20,45,1
181330,2,2,0,51,1
181330,61,23,38,52,3
181330,7,2,5,59,1
181330,19,4,15,60,1
181376,150,82,68,1,4
181376,150,82,68,2,1
181376,150,82,68,3,1
181376,56,34,22,4,1
181376,94,48,46,5,1
181376,15,7,8,19,1
181376,79,41,38,20,1
181376,126,70,56,21,4
181376,126,70,56,22,1
181376,126,70,56,23,1
181376,52,33,19,24,1
181376,74,37,37,25,1
181376,8,4,4,39,1
181376,66,33,33,40,1
181376,24,12,12,41,4
181376,24,12,12,42,1
181376,24,12,12,43,1
181376,4,1,3,44,1
181376,20,11,9,45,1
181376,7,3,4,59,1
181376,13,8,5,60,1
181394,15227,7211,8016,1,4
181394,12335,5960,6375,2,1
181394,12153,5859,6294,3,1
181394,1889,896,993,4,1
181394,10264,4963,5301,5,1
181394,182,101,81,11,1
181394,2892,1251,1641,12,3
181394,1356,636,720,19,1
181394,8908,4327,4581,20,1
181394,10374,4920,5454,21,4
181394,9511,4503,5008,22,1
181394,9446,4462,4984,23,1
181394,1794,846,948,24,1
181394,7652,3616,4036,25,1
181394,65,41,24,31,1
181394,863,417,446,32,3
181394,1017,461,556,39,1
181394,6635,3155,3480,40,1
181394,4853,2291,2562,41,4
181394,2824,1457,1367,42,1
181394,2707,1397,1310,43,1
181394,95,50,45,44,1
181394,2612,1347,1265,45,1
181394,117,60,57,51,1
181394,2029,834,1195,52,3
181394,339,175,164,59,1
181394,2273,1172,1101,60,1
181400,795,162,633,1,4
181400,728,144,584,2,1
181400,728,144,584,3,1
181400,93,19,74,4,1
181400,635,125,510,5,1
181400,67,18,49,12,3
181400,195,29,166,19,1
181400,440,96,344,20,1
181400,544,110,434,21,4
181400,495,95,400,22,1
181400,495,95,400,23,1
181400,64,14,50,24,1
181400,431,81,350,25,1
181400,49,15,34,32,3
181400,108,16,92,39,1
181400,323,65,258,40,1
181400,251,52,199,41,4
181400,233,49,184,42,1
181400,233,49,184,43,1
181400,29,5,24,44,1
181400,204,44,160,45,1
181400,18,3,15,52,3
181400,87,13,74,59,1
181400,117,31,86,60,1
181419,199,60,139,1,4
181419,199,60,139,2,1
181419,191,59,132,3,1
181419,55,16,39,4,1
181419,136,43,93,5,1
181419,8,1,7,11,1
181419,136,43,93,20,1
181419,106,29,77,21,4
181419,106,29,77,22,1
181419,104,29,75,23,1
181419,38,11,27,24,1
181419,66,18,48,25,1
181419,2,0,2,31,1
181419,66,18,48,40,1
181419,93,31,62,41,4
181419,93,31,62,42,1
181419,87,30,57,43,1
181419,17,5,12,44,1
181419,70,25,45,45,1
181419,6,1,5,51,1
181419,70,25,45,60,1
181428,3681,1326,2355,1,4
181428,835,103,732,2,1
181428,810,100,710,3,1
181428,810,100,710,5,1
181428,25,3,22,11,1
181428,2846,1223,1623,12,3
181428,408,49,359,19,1
181428,402,51,351,20,1
181428,3126,1199,1927,21,4
181428,715,82,633,22,1
181428,715,82,633,23,1
181428,715,82,633,25,1
181428,2411,1117,1294,32,3
181428,366,41,325,39,1
181428,349,41,308,40,1
181428,555,127,428,41,4
181428,120,21,99,42,1
181428,95,18,77,43,1
181428,95,18,77,45,1
181428,25,3,22,51,1
181428,435,106,329,52,3
181428,42,8,34,59,1
181428,53,10,43,60,1
181446,2149,771,1378,1,4
181446,1927,729,1198,2,1
181446,1892,715,1177,3,1
181446,379,172,207,4,1
181446,1513,543,970,5,1
181446,35,14,21,11,1
181446,222,42,180,12,3
181446,98,35,63,19,1
181446,1415,508,907,20,1
181446,1639,674,965,21,4
181446,1605,674,931,22,1
181446,1578,662,916,23,1
181446,379,172,207,24,1
181446,1199,490,709,25,1
181446,27,12,15,31,1
181446,34,0,34,32,3
181446,98,35,63,39,1
181446,1101,455,646,40,1
181446,510,97,413,41,4
181446,322,55,267,42,1
181446,314,53,261,43,1
181446,314,53,261,45,1
181446,8,2,6,51,1
181446,188,42,146,52,3
181446,314,53,261,60,1
181464,24445,12892,11553,1,4
181464,19376,10438,8938,2,1
181464,19376,10438,8938,3,1
181464,4420,2259,2161,4,1
181464,14956,8179,6777,5,1
181464,5069,2454,2615,12,3
181464,995,530,465,19,1
181464,13961,7649,6312,20,1
181464,20880,11171,9709,21,4
181464,18102,9697,8405,22,1
181464,18102,9697,8405,23,1
181464,4396,2243,2153,24,1
181464,13706,7454,6252,25,1
181464,2778,1474,1304,32,3
181464,920,480,440,39,1
181464,12786,6974,5812,40,1
181464,3565,1721,1844,41,4
181464,1274,741,533,42,1
181464,1274,741,533,43,1
181464,24,16,8,44,1
181464,1250,725,525,45,1
181464,2291,980,1311,52,3
181464,75,50,25,59,1
181464,1175,675,500,60,1
181491,5145,2729,2416,1,4
181491,5145,2729,2416,2,1
181491,2812,1282,1530,3,1
181491,827,445,382,4,1
181491,1985,837,1148,5,1
181491,2333,1447,886,11,1
181491,268,105,163,19,1
181491,1717,732,985,20,1
181491,2200,1116,1084,21,4
181491,2200,1116,1084,22,1
181491,2145,1094,1051,23,1
181491,749,417,332,24,1
181491,1396,677,719,25,1
181491,55,22,33,31,1
181491,191,80,111,39,1
181491,1205,597,608,40,1
181491,2945,1613,1332,41,4
181491,2945,1613,1332,42,1
181491,667,188,479,43,1
181491,78,28,50,44,1
181491,589,160,429,45,1
181491,2278,1425,853,51,1
181491,77,25,52,59,1
181491,512,135,377,60,1
181534,2422,948,1474,1,4
181534,2158,879,1279,2,1
181534,1534,648,886,3,1
181534,278,118,160,4,1
181534,1256,530,726,5,1
181534,624,231,393,11,1
181534,264,69,195,12,3
181534,206,92,114,19,1
181534,1050,438,612,20,1
181534,1255,514,741,21,4
181534,1186,500,686,22,1
181534,1177,496,681,23,1
181534,272,116,156,24,1
181534,905,380,525,25,1
181534,9,4,5,31,1
181534,69,14,55,32,3
181534,148,67,81,39,1
181534,757,313,444,40,1
181534,1167,434,733,41,4
181534,972,379,593,42,1
181534,357,152,205,43,1
181534,6,2,4,44,1
181534,351,150,201,45,1
181534,615,227,388,51,1
181534,195,55,140,52,3
181534,58,25,33,59,1
181534,293,125,168,60,1
181543,29,14,15,1,4
181543,29,14,15,2,1
181543,29,14,15,3,1
181543,4,3,1,4,1
181543,25,11,14,5,1
181543,4,3,1,19,1
181543,21,8,13,20,1
181543,19,7,12,21,4
181543,19,7,12,22,1
181543,19,7,12,23,1
181543,3,2,1,24,1
181543,16,5,11,25,1
181543,2,1,1,39,1
181543,14,4,10,40,1
181543,10,7,3,41,4
181543,10,7,3,42,1
181543,10,7,3,43,1
181543,1,1,0,44,1
181543,9,6,3,45,1
181543,2,2,0,59,1
181543,7,4,3,60,1
181604,970,32,938,1,4
181604,735,11,724,2,1
181604,691,0,691,3,1
181604,89,0,89,4,1
181604,602,0,602,5,1
181604,44,11,33,11,1
181604,235,21,214,12,3
181604,149,0,149,19,1
181604,453,0,453,20,1
181604,777,12,765,21,4
181604,639,0,639,22,1
181604,639,0,639,23,1
181604,89,0,89,24,1
181604,550,0,550,25,1
181604,138,12,126,32,3
181604,144,0,144,39,1
181604,406,0,406,40,1
181604,193,20,173,41,4
181604,96,11,85,42,1
181604,52,0,52,43,1
181604,52,0,52,45,1
181604,44,11,33,51,1
181604,97,9,88,52,3
181604,5,0,5,59,1
181604,47,0,47,60,1
181640,9751,4460,5291,1,4
181640,9751,4460,5291,2,1
181640,7512,3466,4046,3,1
181640,1566,799,767,4,1
181640,5946,2667,3279,5,1
181640,2239,994,1245,11,1
181640,562,256,306,19,1
181640,5384,2411,2973,20,1
181640,4858,2530,2328,21,4
181640,4858,2530,2328,22,1
181640,4493,2327,2166,23,1
181640,1205,649,556,24,1
181640,3288,1678,1610,25,1
181640,365,203,162,31,1
181640,381,198,183,39,1
181640,2907,1480,1427,40,1
181640,4893,1930,2963,41,4
181640,4893,1930,2963,42,1
181640,3019,1139,1880,43,1
181640,361,150,211,44,1
181640,2658,989,1669,45,1
181640,1874,791,1083,51,1
181640,181,58,123,59,1
181640,2477,931,1546,60,1
181738,911,368,543,1,4
181738,821,349,472,2,1
181738,759,327,432,3,1
181738,178,76,102,4,1
181738,581,251,330,5,1
181738,62,22,40,11,1
181738,90,19,71,12,3
181738,56,20,36,19,1
181738,525,231,294,20,1
181738,803,328,475,21,4
181738,713,309,404,22,1
181738,713,309,404,23,1
181738,178,76,102,24,1
181738,535,233,302,25,1
181738,90,19,71,32,3
181738,55,20,35,39,1
181738,480,213,267,40,1
181738,108,40,68,41,4
181738,108,40,68,42,1
181738,46,18,28,43,1
181738,46,18,28,45,1
181738,62,22,40,51,1
181738,1,0,1,59,1
181738,45,18,27,60,1
181756,330,100,230,1,4
181756,330,100,230,2,1
181756,330,100,230,3,1
181756,33,9,24,4,1
181756,297,91,206,5,1
181756,31,9,22,19,1
181756,266,82,184,20,1
181756,330,100,230,21,4
181756,330,100,230,22,1
181756,330,100,230,23,1
181756,33,9,24,24,1
181756,297,91,206,25,1
181756,31,9,22,39,1
181756,266,82,184,40,1
181765,300,132,168,1,4
181765,300,132,168,2,1
181765,225,105,120,3,1
181765,70,32,38,4,1
181765,155,73,82,5,1
181765,75,27,48,11,1
181765,21,11,10,19,1
181765,134,62,72,20,1
181765,214,101,113,21,4
181765,214,101,113,22,1
181765,214,101,113,23,1
181765,70,32,38,24,1
181765,144,69,75,25,1
181765,21,11,10,39,1
181765,123,58,65,40,1
181765,86,31,55,41,4
181765,86,31,55,42,1
181765,11,4,7,43,1
181765,11,4,7,45,1
181765,75,27,48,51,1
181765,11,4,7,60,1
181783,3506,1508,1998,1,4
181783,2991,1277,1714,2,1
181783,2900,1240,1660,3,1
181783,691,293,398,4,1
181783,2209,947,1262,5,1
181783,91,37,54,11,1
181783,515,231,284,12,3
181783,184,80,104,19,1
181783,2025,867,1158,20,1
181783,2815,1204,1611,21,4
181783,2735,1173,1562,22,1
181783,2733,1172,1561,23,1
181783,690,292,398,24,1
181783,2043,880,1163,25,1
181783,2,1,1,31,1
181783,80,31,49,32,3
181783,167,76,91,39,1
181783,1876,804,1072,40,1
181783,691,304,387,41,4
181783,256,104,152,42,1
181783,167,68,99,43,1
181783,1,1,0,44,1
181783,166,67,99,45,1
181783,89,36,53,51,1
181783,435,200,235,52,3
181783,17,4,13,59,1
181783,149,63,86,60,1
181792,8,2,6,1,4
181792,8,2,6,2,1
181792,8,2,6,3,1
181792,8,2,6,5,1
181792,8,2,6,20,1
181792,8,2,6,21,4
181792,8,2,6,22,1
181792,8,2,6,23,1
181792,8,2,6,25,1
181792,8,2,6,40,1
181817,1960,715,1245,1,4
181817,1960,715,1245,2,1
181817,1478,516,962,3,1
181817,419,182,237,4,1
181817,1059,334,725,5,1
181817,482,199,283,11,1
181817,66,17,49,19,1
181817,993,317,676,20,1
181817,924,370,554,21,4
181817,924,370,554,22,1
181817,913,366,547,23,1
181817,336,142,194,24,1
181817,577,224,353,25,1
181817,11,4,7,31,1
181817,39,14,25,39,1
181817,538,210,328,40,1
181817,1036,345,691,41,4
181817,1036,345,691,42,1
181817,565,150,415,43,1
181817,83,40,43,44,1
181817,482,110,372,45,1
181817,471,195,276,51,1
181817,27,3,24,59,1
181817,455,107,348,60,1
181853,470,254,216,1,4
181853,459,247,212,2,1
181853,456,246,210,3,1
181853,94,52,42,4,1
181853,362,194,168,5,1
181853,3,1,2,11,1
181853,11,7,4,12,3
181853,59,36,23,19,1
181853,303,158,145,20,1
181853,442,237,205,21,4
181853,442,237,205,22,1
181853,442,237,205,23,1
181853,94,52,42,24,1
181853,348,185,163,25,1
181853,58,36,22,39,1
181853,290,149,141,40,1
181853,28,17,11,41,4
181853,17,10,7,42,1
181853,14,9,5,43,1
181853,14,9,5,45,1
181853,3,1,2,51,1
181853,11,7,4,52,3
181853,1,0,1,59,1
181853,13,9,4,60,1
181880,154,10,144,1,4
181880,154,10,144,2,1
181880,154,10,144,3,1
181880,38,2,36,4,1
181880,116,8,108,5,1
181880,116,8,108,20,1
181880,154,10,144,21,4
181880,154,10,144,22,1
181880,154,10,144,23,1
181880,38,2,36,24,1
181880,116,8,108,25,1
181880,116,8,108,40,1
181941,556,198,358,1,4
181941,556,198,358,2,1
181941,556,198,358,3,1
181941,166,54,112,4,1
181941,390,144,246,5,1
181941,15,2,13,19,1
181941,375,142,233,20,1
181941,556,198,358,21,4
181941,556,198,358,22,1
181941,556,198,358,23,1
181941,166,54,112,24,1
181941,390,144,246,25,1
181941,15,2,13,39,1
181941,375,142,233,40,1
182005,34177,15467,18710,1,4
182005,34177,15467,18710,2,1
182005,29848,13447,16401,3,1
182005,5072,2554,2518,4,1
182005,24776,10893,13883,5,1
182005,4329,2020,2309,11,1
182005,2488,1018,1470,19,1
182005,22288,9875,12413,20,1
182005,8903,4238,4665,21,4
182005,8903,4238,4665,22,1
182005,8539,4043,4496,23,1
182005,1767,834,933,24,1
182005,6772,3209,3563,25,1
182005,364,195,169,31,1
182005,844,399,445,39,1
182005,5928,2810,3118,40,1
182005,25274,11229,14045,41,4
182005,25274,11229,14045,42,1
182005,21309,9404,11905,43,1
182005,3305,1720,1585,44,1
182005,18004,7684,10320,45,1
182005,3965,1825,2140,51,1
182005,1644,619,1025,59,1
182005,16360,7065,9295,60,1
182111,1097,598,499,1,4
182111,1097,598,499,2,1
182111,1097,598,499,3,1
182111,299,175,124,4,1
182111,798,423,375,5,1
182111,125,66,59,19,1
182111,673,357,316,20,1
182111,808,435,373,21,4
182111,808,435,373,22,1
182111,808,435,373,23,1
182111,241,136,105,24,1
182111,567,299,268,25,1
182111,95,50,45,39,1
182111,472,249,223,40,1
182111,289,163,126,41,4
182111,289,163,126,42,1
182111,289,163,126,43,1
182111,58,39,19,44,1
182111,231,124,107,45,1
182111,30,16,14,59,1
182111,201,108,93,60,1
182148,915,255,660,1,4
182148,915,255,660,2,1
182148,915,255,660,3,1
182148,81,8,73,4,1
182148,834,247,587,5,1
182148,90,29,61,19,1
182148,744,218,526,20,1
182148,714,188,526,21,4
182148,714,188,526,22,1
182148,714,188,526,23,1
182148,81,8,73,24,1
182148,633,180,453,25,1
182148,85,27,58,39,1
182148,548,153,395,40,1
182148,201,67,134,41,4
182148,201,67,134,42,1
182148,201,67,134,43,1
182148,201,67,134,45,1
182148,5,2,3,59,1
182148,196,65,131,60,1
182209,398,35,363,1,4
182209,398,35,363,2,1
182209,398,35,363,3,1
182209,127,8,119,4,1
182209,271,27,244,5,1
182209,271,27,244,20,1
182209,183,24,159,21,4
182209,183,24,159,22,1
182209,183,24,159,23,1
182209,63,5,58,24,1
182209,120,19,101,25,1
182209,120,19,101,40,1
182209,215,11,204,41,4
182209,215,11,204,42,1
182209,215,11,204,43,1
182209,64,3,61,44,1
182209,151,8,143,45,1
182209,151,8,143,60,1
182281,27848,12360,15488,1,4
182281,23097,10274,12823,2,1
182281,22742,10096,12646,3,1
182281,3773,1555,2218,4,1
182281,18969,8541,10428,5,1
182281,355,178,177,11,1
182281,4751,2086,2665,12,3
182281,2465,1076,1389,19,1
182281,16504,7465,9039,20,1
182281,18795,8288,10507,21,4
182281,16523,7255,9268,22,1
182281,16508,7245,9263,23,1
182281,3585,1463,2122,24,1
182281,12923,5782,7141,25,1
182281,15,10,5,31,1
182281,2272,1033,1239,32,3
182281,1516,682,834,39,1
182281,11407,5100,6307,40,1
182281,9053,4072,4981,41,4
182281,6574,3019,3555,42,1
182281,6234,2851,3383,43,1
182281,188,92,96,44,1
182281,6046,2759,3287,45,1
182281,340,168,172,51,1
182281,2479,1053,1426,52,3
182281,949,394,555,59,1
182281,5097,2365,2732,60,1
182290,18776,8929,9847,1,4
182290,15694,7453,8241,2,1
182290,15310,7238,8072,3,1
182290,3086,1454,1632,4,1
182290,12224,5784,6440,5,1
182290,384,215,169,11,1
182290,3082,1476,1606,12,3
182290,1310,567,743,19,1
182290,10914,5217,5697,20,1
182290,14208,6694,7514,21,4
182290,12934,6104,6830,22,1
182290,12919,6097,6822,23,1
182290,3046,1430,1616,24,1
182290,9873,4667,5206,25,1
182290,15,7,8,31,1
182290,1274,590,684,32,3
182290,945,428,517,39,1
182290,8928,4239,4689,40,1
182290,4568,2235,2333,41,4
182290,2760,1349,1411,42,1
182290,2391,1141,1250,43,1
182290,40,24,16,44,1
182290,2351,1117,1234,45,1
182290,369,208,161,51,1
182290,1808,886,922,52,3
182290,365,139,226,59,1
182290,1986,978,1008,60,1
182306,3181,1154,2027,1,4
182306,3164,1148,2016,2,1
182306,2387,872,1515,3,1
182306,295,138,157,4,1
182306,2092,734,1358,5,1
182306,777,276,501,11,1
182306,17,6,11,12,3
182306,67,24,43,19,1
182306,2025,710,1315,20,1
182306,907,383,524,21,4
182306,906,383,523,22,1
182306,884,371,513,23,1
182306,170,95,75,24,1
182306,714,276,438,25,1
182306,22,12,10,31,1
182306,1,0,1,32,3
182306,32,11,21,39,1
182306,682,265,417,40,1
182306,2274,771,1503,41,4
182306,2258,765,1493,42,1
182306,1503,501,1002,43,1
182306,125,43,82,44,1
182306,1378,458,920,45,1
182306,755,264,491,51,1
182306,16,6,10,52,3
182306,35,13,22,59,1
182306,1343,445,898,60,1
182397,275,7,268,1,4
182397,275,7,268,2,1
182397,275,7,268,3,1
182397,80,3,77,4,1
182397,195,4,191,5,1
182397,195,4,191,20,1
182397,127,6,121,21,4
182397,127,6,121,22,1
182397,127,6,121,23,1
182397,37,3,34,24,1
182397,90,3,87,25,1
182397,90,3,87,40,1
182397,148,1,147,41,4
182397,148,1,147,42,1
182397,148,1,147,43,1
182397,43,0,43,44,1
182397,105,1,104,45,1
182397,105,1,104,60,1
182430,411,205,206,1,4
182430,374,192,182,2,1
182430,374,192,182,3,1
182430,142,81,61,4,1
182430,232,111,121,5,1
182430,37,13,24,12,3
182430,232,111,121,20,1
182430,399,201,198,21,4
182430,374,192,182,22,1
182430,374,192,182,23,1
182430,142,81,61,24,1
182430,232,111,121,25,1
182430,25,9,16,32,3
182430,232,111,121,40,1
182430,12,4,8,41,4
182430,12,4,8,52,3
182458,955,405,550,1,4
182458,529,302,227,2,1
182458,476,281,195,3,1
182458,91,59,32,4,1
182458,385,222,163,5,1
182458,53,21,32,11,1
182458,426,103,323,12,3
182458,71,37,34,19,1
182458,314,185,129,20,1
182458,770,353,417,21,4
182458,476,281,195,22,1
182458,476,281,195,23,1
182458,91,59,32,24,1
182458,385,222,163,25,1
182458,294,72,222,32,3
182458,71,37,34,39,1
182458,314,185,129,40,1
182458,185,52,133,41,4
182458,53,21,32,42,1
182458,53,21,32,51,1
182458,132,31,101,52,3
182500,11204,5026,6178,1,4
182500,11204,5026,6178,2,1
182500,9051,3930,5121,3,1
182500,1504,711,793,4,1
182500,7547,3219,4328,5,1
182500,2153,1096,1057,11,1
182500,526,234,292,19,1
182500,7021,2985,4036,20,1
182500,2905,1376,1529,21,4
182500,2905,1376,1529,22,1
182500,2713,1273,1440,23,1
182500,623,305,318,24,1
182500,2090,968,1122,25,1
182500,192,103,89,31,1
182500,171,96,75,39,1
182500,1919,872,1047,40,1
182500,8299,3650,4649,41,4
182500,8299,3650,4649,42,1
182500,6338,2657,3681,43,1
182500,881,406,475,44,1
182500,5457,2251,3206,45,1
182500,1961,993,968,51,1
182500,355,138,217,59,1
182500,5102,2113,2989,60,1
182564,3975,1645,2330,1,4
182564,3975,1645,2330,2,1
182564,3511,1415,2096,3,1
182564,626,285,341,4,1
182564,2885,1130,1755,5,1
182564,464,230,234,11,1
182564,216,92,124,19,1
182564,2669,1038,1631,20,1
182564,1230,563,667,21,4
182564,1230,563,667,22,1
182564,1217,556,661,23,1
182564,329,153,176,24,1
182564,888,403,485,25,1
182564,13,7,6,31,1
182564,74,35,39,39,1
182564,814,368,446,40,1
182564,2745,1082,1663,41,4
182564,2745,1082,1663,42,1
182564,2294,859,1435,43,1
182564,297,132,165,44,1
182564,1997,727,1270,45,1
182564,451,223,228,51,1
182564,142,57,85,59,1
182564,1855,670,1185,60,1
182634,1409,419,990,1,4
182634,1409,419,990,2,1
182634,1395,413,982,3,1
182634,399,120,279,4,1
182634,996,293,703,5,1
182634,14,6,8,11,1
182634,24,13,11,19,1
182634,972,280,692,20,1
182634,1386,410,976,21,4
182634,1386,410,976,22,1
182634,1386,410,976,23,1
182634,399,120,279,24,1
182634,987,290,697,25,1
182634,21,12,9,39,1
182634,966,278,688,40,1
182634,23,9,14,41,4
182634,23,9,14,42,1
182634,9,3,6,43,1
182634,9,3,6,45,1
182634,14,6,8,51,1
182634,3,1,2,59,1
182634,6,2,4,60,1
182652,62,1,61,1,4
182652,62,1,61,2,1
182652,62,1,61,3,1
182652,40,1,39,4,1
182652,22,0,22,5,1
182652,22,0,22,20,1
182652,62,1,61,21,4
182652,62,1,61,22,1
182652,62,1,61,23,1
182652,40,1,39,24,1
182652,22,0,22,25,1
182652,22,0,22,40,1
182661,764,552,212,1,4
182661,632,498,134,2,1
182661,626,493,133,3,1
182661,164,131,33,4,1
182661,462,362,100,5,1
182661,6,5,1,11,1
182661,132,54,78,12,3
182661,61,44,17,19,1
182661,401,318,83,20,1
182661,684,497,187,21,4
182661,556,445,111,22,1
182661,556,445,111,23,1
182661,153,123,30,24,1
182661,403,322,81,25,1
182661,128,52,76,32,3
182661,52,39,13,39,1
182661,351,283,68,40,1
182661,80,55,25,41,4
182661,76,53,23,42,1
182661,70,48,22,43,1
182661,11,8,3,44,1
182661,59,40,19,45,1
182661,6,5,1,51,1
182661,4,2,2,52,3
182661,9,5,4,59,1
182661,50,35,15,60,1
182670,6342,3378,2964,1,4
182670,4276,2179,2097,2,1
182670,4154,2115,2039,3,1
182670,1109,545,564,4,1
182670,3045,1570,1475,5,1
182670,122,64,58,11,1
182670,2066,1199,867,12,3
182670,3,1,2,19,1
182670,3042,1569,1473,20,1
182670,6185,3308,2877,21,4
182670,4200,2140,2060,22,1
182670,4154,2115,2039,23,1
182670,1109,545,564,24,1
182670,3045,1570,1475,25,1
182670,46,25,21,31,1
182670,1985,1168,817,32,3
182670,3,1,2,39,1
182670,3042,1569,1473,40,1
182670,157,70,87,41,4
182670,76,39,37,42,1
182670,76,39,37,51,1
182670,81,31,50,52,3
182704,103,2,101,1,4
182704,103,2,101,2,1
182704,103,2,101,3,1
182704,15,1,14,4,1
182704,88,1,87,5,1
182704,88,1,87,20,1
182704,74,1,73,21,4
182704,74,1,73,22,1
182704,74,1,73,23,1
182704,7,0,7,24,1
182704,67,1,66,25,1
182704,67,1,66,40,1
182704,29,1,28,41,4
182704,29,1,28,42,1
182704,29,1,28,43,1
182704,8,1,7,44,1
182704,21,0,21,45,1
182704,21,0,21,60,1
182722,140,21,119,1,4
182722,140,21,119,2,1
182722,140,21,119,3,1
182722,14,4,10,4,1
182722,126,17,109,5,1
182722,126,17,109,20,1
182722,119,21,98,21,4
182722,119,21,98,22,1
182722,119,21,98,23,1
182722,11,4,7,24,1
182722,108,17,91,25,1
182722,108,17,91,40,1
182722,21,0,21,41,4
182722,21,0,21,42,1
182722,21,0,21,43,1
182722,3,0,3,44,1
182722,18,0,18,45,1
182722,18,0,18,60,1
182795,2204,946,1258,1,4
182795,1671,740,931,2,1
182795,1664,738,926,3,1
182795,450,219,231,4,1
182795,1214,519,695,5,1
182795,7,2,5,11,1
182795,533,206,327,12,3
182795,71,29,42,19,1
182795,1143,490,653,20,1
182795,1809,846,963,21,4
182795,1465,699,766,22,1
182795,1465,699,766,23,1
182795,450,219,231,24,1
182795,1015,480,535,25,1
182795,344,147,197,32,3
182795,43,24,19,39,1
182795,972,456,516,40,1
182795,395,100,295,41,4
182795,206,41,165,42,1
182795,199,39,160,43,1
182795,199,39,160,45,1
182795,7,2,5,51,1
182795,189,59,130,52,3
182795,28,5,23,59,1
182795,171,34,137,60,1
182829,315,185,130,1,4
182829,315,185,130,12,3
182829,299,176,123,21,4
182829,299,176,123,32,3
182829,16,9,7,41,4
182829,16,9,7,52,3
182865,2284,705,1579,1,4
182865,2284,705,1579,2,1
182865,2273,698,1575,3,1
182865,126,46,80,4,1
182865,2147,652,1495,5,1
182865,11,7,4,11,1
182865,402,121,281,19,1
182865,1745,531,1214,20,1
182865,1453,473,980,21,4
182865,1453,473,980,22,1
182865,1449,469,980,23,1
182865,113,40,73,24,1
182865,1336,429,907,25,1
182865,4,4,0,31,1
182865,286,96,190,39,1
182865,1050,333,717,40,1
182865,831,232,599,41,4
182865,831,232,599,42,1
182865,824,229,595,43,1
182865,13,6,7,44,1
182865,811,223,588,45,1
182865,7,3,4,51,1
182865,116,25,91,59,1
182865,695,198,497,60,1
182892,54,0,54,1,4
182892,54,0,54,2,1
182892,54,0,54,3,1
182892,42,0,42,4,1
182892,12,0,12,5,1
182892,12,0,12,20,1
182892,50,0,50,21,4
182892,50,0,50,22,1
182892,50,0,50,23,1
182892,40,0,40,24,1
182892,10,0,10,25,1
182892,10,0,10,40,1
182892,4,0,4,41,4
182892,4,0,4,42,1
182892,4,0,4,43,1
182892,2,0,2,44,1
182892,2,0,2,45,1
182892,2,0,2,60,1
182908,87,27,60,1,4
182908,87,27,60,2,1
182908,68,22,46,3,1
182908,8,2,6,4,1
182908,60,20,40,5,1
182908,19,5,14,11,1
182908,8,3,5,19,1
182908,52,17,35,20,1
182908,29,10,19,21,4
182908,29,10,19,22,1
182908,28,9,19,23,1
182908,5,1,4,24,1
182908,23,8,15,25,1
182908,1,1,0,31,1
182908,3,2,1,39,1
182908,20,6,14,40,1
182908,58,17,41,41,4
182908,58,17,41,42,1
182908,40,13,27,43,1
182908,3,1,2,44,1
182908,37,12,25,45,1
182908,18,4,14,51,1
182908,5,1,4,59,1
182908,32,11,21,60,1
182953,164,7,157,1,4
182953,164,7,157,2,1
182953,164,7,157,3,1
182953,61,2,59,4,1
182953,103,5,98,5,1
182953,103,5,98,20,1
182953,119,6,113,21,4
182953,119,6,113,22,1
182953,119,6,113,23,1
182953,46,2,44,24,1
182953,73,4,69,25,1
182953,73,4,69,40,1
182953,45,1,44,41,4
182953,45,1,44,42,1
182953,45,1,44,43,1
182953,15,0,15,44,1
182953,30,1,29,45,1
182953,30,1,29,60,1
182980,2224,924,1300,1,4
182980,1478,667,811,2,1
182980,1465,661,804,3,1
182980,383,182,201,4,1
182980,1082,479,603,5,1
182980,13,6,7,11,1
182980,746,257,489,12,3
182980,150,49,101,19,1
182980,932,430,502,20,1
182980,2087,867,1220,21,4
182980,1416,639,777,22,1
182980,1411,636,775,23,1
182980,375,180,195,24,1
182980,1036,456,580,25,1
182980,5,3,2,31,1
182980,671,228,443,32,3
182980,144,47,97,39,1
182980,892,409,483,40,1
182980,137,57,80,41,4
182980,62,28,34,42,1
182980,54,25,29,43,1
182980,8,2,6,44,1
182980,46,23,23,45,1
182980,8,3,5,51,1
182980,75,29,46,52,3
182980,6,2,4,59,1
182980,40,21,19,60,1
182999,57,0,57,1,4
182999,57,0,57,2,1
182999,57,0,57,3,1
182999,46,0,46,4,1
182999,11,0,11,5,1
182999,11,0,11,20,1
182999,54,0,54,21,4
182999,54,0,54,22,1
182999,54,0,54,23,1
182999,43,0,43,24,1
182999,11,0,11,25,1
182999,11,0,11,40,1
182999,3,0,3,41,4
182999,3,0,3,42,1
182999,3,0,3,43,1
182999,3,0,3,44,1
183026,28389,11456,16933,1,4
183026,18083,7237,10846,2,1
183026,17172,6906,10266,3,1
183026,1965,819,1146,4,1
183026,15207,6087,9120,5,1
183026,911,331,580,11,1
183026,10306,4219,6087,12,3
183026,2677,1011,1666,19,1
183026,12530,5076,7454,20,1
183026,13179,5561,7618,21,4
183026,9399,3949,5450,22,1
183026,9262,3907,5355,23,1
183026,1370,582,788,24,1
183026,7892,3325,4567,25,1
183026,137,42,95,31,1
183026,3780,1612,2168,32,3
183026,1593,592,1001,39,1
183026,6299,2733,3566,40,1
183026,15210,5895,9315,41,4
183026,8684,3288,5396,42,1
183026,7910,2999,4911,43,1
183026,595,237,358,44,1
183026,7315,2762,4553,45,1
183026,774,289,485,51,1
183026,6526,2607,3919,52,3
183026,1084,419,665,59,1
183026,6231,2343,3888,60,1
183035,32,3,29,1,4
183035,32,3,29,2,1
183035,32,3,29,3,1
183035,15,2,13,4,1
183035,17,1,16,5,1
183035,17,1,16,20,1
183035,32,3,29,21,4
183035,32,3,29,22,1
183035,32,3,29,23,1
183035,15,2,13,24,1
183035,17,1,16,25,1
183035,17,1,16,40,1
183044,14913,6788,8125,1,4
183044,12516,5782,6734,2,1
183044,12288,5654,6634,3,1
183044,2869,1308,1561,4,1
183044,9419,4346,5073,5,1
183044,228,128,100,11,1
183044,2397,1006,1391,12,3
183044,529,268,261,19,1
183044,8890,4078,4812,20,1
183044,13336,6038,7298,21,4
183044,12063,5552,6511,22,1
183044,11996,5517,6479,23,1
183044,2869,1308,1561,24,1
183044,9127,4209,4918,25,1
183044,67,35,32,31,1
183044,1273,486,787,32,3
183044,517,265,252,39,1
183044,8610,3944,4666,40,1
183044,1577,750,827,41,4
183044,453,230,223,42,1
183044,292,137,155,43,1
183044,292,137,155,45,1
183044,161,93,68,51,1
183044,1124,520,604,52,3
183044,12,3,9,59,1
183044,280,134,146,60,1
183062,4923,2084,2839,1,4
183062,4799,2056,2743,2,1
183062,4643,1971,2672,3,1
183062,1258,511,747,4,1
183062,3385,1460,1925,5,1
183062,156,85,71,11,1
183062,124,28,96,12,3
183062,150,76,74,19,1
183062,3235,1384,1851,20,1
183062,4580,1929,2651,21,4
183062,4538,1922,2616,22,1
183062,4521,1915,2606,23,1
183062,1254,509,745,24,1
183062,3267,1406,1861,25,1
183062,17,7,10,31,1
183062,42,7,35,32,3
183062,143,72,71,39,1
183062,3124,1334,1790,40,1
183062,343,155,188,41,4
183062,261,134,127,42,1
183062,122,56,66,43,1
183062,4,2,2,44,1
183062,118,54,64,45,1
183062,139,78,61,51,1
183062,82,21,61,52,3
183062,7,4,3,59,1
183062,111,50,61,60,1
183071,926,448,478,1,4
183071,833,427,406,2,1
183071,781,391,390,3,1
183071,94,47,47,4,1
183071,687,344,343,5,1
183071,52,36,16,11,1
183071,93,21,72,12,3
183071,163,84,79,19,1
183071,524,260,264,20,1
183071,599,290,309,21,4
183071,599,290,309,22,1
183071,595,287,308,23,1
183071,89,43,46,24,1
183071,506,244,262,25,1
183071,4,3,1,31,1
183071,132,67,65,39,1
183071,374,177,197,40,1
183071,327,158,169,41,4
183071,234,137,97,42,1
183071,186,104,82,43,1
183071,5,4,1,44,1
183071,181,100,81,45,1
183071,48,33,15,51,1
183071,93,21,72,52,3
183071,31,17,14,59,1
183071,150,83,67,60,1
183080,5236,2500,2736,1,4
183080,4065,2121,1944,2,1
183080,3986,2064,1922,3,1
183080,930,486,444,4,1
183080,3056,1578,1478,5,1
183080,79,57,22,11,1
183080,1171,379,792,12,3
183080,231,133,98,19,1
183080,2825,1445,1380,20,1
183080,4107,2071,2036,21,4
183080,3795,1975,1820,22,1
183080,3794,1974,1820,23,1
183080,923,486,437,24,1
183080,2871,1488,1383,25,1
183080,1,1,0,31,1
183080,312,96,216,32,3
183080,216,125,91,39,1
183080,2655,1363,1292,40,1
183080,1129,429,700,41,4
183080,270,146,124,42,1
183080,192,90,102,43,1
183080,7,0,7,44,1
183080,185,90,95,45,1
183080,78,56,22,51,1
183080,859,283,576,52,3
183080,15,8,7,59,1
183080,170,82,88,60,1
183099,4288,1987,2301,1,4
183099,4288,1987,2301,2,1
183099,3826,1786,2040,3,1
183099,1067,562,505,4,1
183099,2759,1224,1535,5,1
183099,462,201,261,11,1
183099,427,167,260,19,1
183099,2332,1057,1275,20,1
183099,1897,1022,875,21,4
183099,1897,1022,875,22,1
183099,1883,1016,867,23,1
183099,821,449,372,24,1
183099,1062,567,495,25,1
183099,14,6,8,31,1
183099,176,85,91,39,1
183099,886,482,404,40,1
183099,2391,965,1426,41,4
183099,2391,965,1426,42,1
183099,1943,770,1173,43,1
183099,246,113,133,44,1
183099,1697,657,1040,45,1
183099,448,195,253,51,1
183099,251,82,169,59,1
183099,1446,575,871,60,1
183105,937,346,591,1,4
183105,937,346,591,2,1
183105,627,220,407,3,1
183105,128,60,68,4,1
183105,499,160,339,5,1
183105,310,126,184,11,1
183105,58,20,38,19,1
183105,441,140,301,20,1
183105,268,112,156,21,4
183105,268,112,156,22,1
183105,261,109,152,23,1
183105,71,32,39,24,1
183105,190,77,113,25,1
183105,7,3,4,31,1
183105,31,8,23,39,1
183105,159,69,90,40,1
183105,669,234,435,41,4
183105,669,234,435,42,1
183105,366,111,255,43,1
183105,57,28,29,44,1
183105,309,83,226,45,1
183105,303,123,180,51,1
183105,27,12,15,59,1
183105,282,71,211,60,1
183114,987,284,703,1,4
183114,987,284,703,2,1
183114,898,245,653,3,1
183114,176,62,114,4,1
183114,722,183,539,5,1
183114,89,39,50,11,1
183114,118,36,82,19,1
183114,604,147,457,20,1
183114,239,108,131,21,4
183114,239,108,131,22,1
183114,217,93,124,23,1
183114,51,22,29,24,1
183114,166,71,95,25,1
183114,22,15,7,31,1
183114,34,17,17,39,1
183114,132,54,78,40,1
183114,748,176,572,41,4
183114,748,176,572,42,1
183114,681,152,529,43,1
183114,125,40,85,44,1
183114,556,112,444,45,1
183114,67,24,43,51,1
183114,84,19,65,59,1
183114,472,93,379,60,1
183123,1181,548,633,1,4
183123,1181,548,633,2,1
183123,1032,498,534,3,1
183123,328,196,132,4,1
183123,704,302,402,5,1
183123,149,50,99,11,1
183123,4,0,4,19,1
183123,700,302,398,20,1
183123,492,293,199,21,4
183123,492,293,199,22,1
183123,488,292,196,23,1
183123,223,145,78,24,1
183123,265,147,118,25,1
183123,4,1,3,31,1
183123,1,0,1,39,1
183123,264,147,117,40,1
183123,689,255,434,41,4
183123,689,255,434,42,1
183123,544,206,338,43,1
183123,105,51,54,44,1
183123,439,155,284,45,1
183123,145,49,96,51,1
183123,3,0,3,59,1
183123,436,155,281,60,1
183132,2898,1303,1595,1,4
183132,2898,1303,1595,2,1
183132,2450,1142,1308,3,1
183132,583,305,278,4,1
183132,1867,837,1030,5,1
183132,448,161,287,11,1
183132,274,124,150,19,1
183132,1593,713,880,20,1
183132,889,493,396,21,4
183132,889,493,396,22,1
183132,871,481,390,23,1
183132,307,172,135,24,1
183132,564,309,255,25,1
183132,18,12,6,31,1
183132,91,50,41,39,1
183132,473,259,214,40,1
183132,2009,810,1199,41,4
183132,2009,810,1199,42,1
183132,1579,661,918,43,1
183132,276,133,143,44,1
183132,1303,528,775,45,1
183132,430,149,281,51,1
183132,183,74,109,59,1
183132,1120,454,666,60,1
183141,2242,1094,1148,1,4
183141,2242,1094,1148,2,1
183141,2026,997,1029,3,1
183141,541,293,248,4,1
183141,1485,704,781,5,1
183141,216,97,119,11,1
183141,219,106,113,19,1
183141,1266,598,668,20,1
183141,754,430,324,21,4
183141,754,430,324,22,1
183141,748,427,321,23,1
183141,279,165,114,24,1
183141,469,262,207,25,1
183141,6,3,3,31,1
183141,77,42,35,39,1
183141,392,220,172,40,1
183141,1488,664,824,41,4
183141,1488,664,824,42,1
183141,1278,570,708,43,1
183141,262,128,134,44,1
183141,1016,442,574,45,1
183141,210,94,116,51,1
183141,142,64,78,59,1
183141,874,378,496,60,1
183150,2122,821,1301,1,4
183150,2122,821,1301,2,1
183150,1890,732,1158,3,1
183150,480,194,286,4,1
183150,1410,538,872,5,1
183150,232,89,143,11,1
183150,354,124,230,19,1
183150,1056,414,642,20,1
183150,614,268,346,21,4
183150,614,268,346,22,1
183150,603,260,343,23,1
183150,231,97,134,24,1
183150,372,163,209,25,1
183150,11,8,3,31,1
183150,95,41,54,39,1
183150,277,122,155,40,1
183150,1508,553,955,41,4
183150,1508,553,955,42,1
183150,1287,472,815,43,1
183150,249,97,152,44,1
183150,1038,375,663,45,1
183150,221,81,140,51,1
183150,259,83,176,59,1
183150,779,292,487,60,1
183202,26,2,24,1,4
183202,26,2,24,2,1
183202,26,2,24,3,1
183202,6,0,6,4,1
183202,20,2,18,5,1
183202,20,2,18,20,1
183202,26,2,24,21,4
183202,26,2,24,22,1
183202,26,2,24,23,1
183202,6,0,6,24,1
183202,20,2,18,25,1
183202,20,2,18,40,1
183211,2346,441,1905,1,4
183211,1591,293,1298,2,1
183211,1524,277,1247,3,1
183211,223,53,170,4,1
183211,1301,224,1077,5,1
183211,67,16,51,11,1
183211,755,148,607,12,3
183211,146,24,122,19,1
183211,1155,200,955,20,1
183211,1055,238,817,21,4
183211,891,202,689,22,1
183211,888,201,687,23,1
183211,216,53,163,24,1
183211,672,148,524,25,1
183211,3,1,2,31,1
183211,164,36,128,32,3
183211,51,12,39,39,1
183211,621,136,485,40,1
183211,1291,203,1088,41,4
183211,700,91,609,42,1
183211,636,76,560,43,1
183211,7,0,7,44,1
183211,629,76,553,45,1
183211,64,15,49,51,1
183211,591,112,479,52,3
183211,95,12,83,59,1
183211,534,64,470,60,1
183239,1923,779,1144,1,4
183239,1923,779,1144,2,1
183239,1912,770,1142,3,1
183239,508,203,305,4,1
183239,1404,567,837,5,1
183239,11,9,2,11,1
183239,20,8,12,19,1
183239,1384,559,825,20,1
183239,1878,762,1116,21,4
183239,1878,762,1116,22,1
183239,1877,761,1116,23,1
183239,508,203,305,24,1
183239,1369,558,811,25,1
183239,1,1,0,31,1
183239,20,8,12,39,1
183239,1349,550,799,40,1
183239,45,17,28,41,4
183239,45,17,28,42,1
183239,35,9,26,43,1
183239,35,9,26,45,1
183239,10,8,2,51,1
183239,35,9,26,60,1
183248,131,16,115,1,4
183248,131,16,115,2,1
183248,131,16,115,3,1
183248,1,0,1,4,1
183248,130,16,114,5,1
183248,64,7,57,19,1
183248,66,9,57,20,1
183248,85,14,71,21,4
183248,85,14,71,22,1
183248,85,14,71,23,1
183248,1,0,1,24,1
183248,84,14,70,25,1
183248,23,5,18,39,1
183248,61,9,52,40,1
183248,46,2,44,41,4
183248,46,2,44,42,1
183248,46,2,44,43,1
183248,46,2,44,45,1
183248,41,2,39,59,1
183248,5,0,5,60,1
183257,2058,598,1460,1,4
183257,1723,520,1203,2,1
183257,1680,505,1175,3,1
183257,98,19,79,4,1
183257,1582,486,1096,5,1
183257,43,15,28,11,1
183257,335,78,257,12,3
183257,335,107,228,19,1
183257,1247,379,868,20,1
183257,1017,324,693,21,4
183257,918,296,622,22,1
183257,912,293,619,23,1
183257,70,11,59,24,1
183257,842,282,560,25,1
183257,6,3,3,31,1
183257,99,28,71,32,3
183257,229,84,145,39,1
183257,613,198,415,40,1
183257,1041,274,767,41,4
183257,805,224,581,42,1
183257,768,212,556,43,1
183257,28,8,20,44,1
183257,740,204,536,45,1
183257,37,12,25,51,1
183257,236,50,186,52,3
183257,106,23,83,59,1
183257,634,181,453,60,1
183275,80,40,40,1,4
183275,80,40,40,2,1
183275,80,40,40,3,1
183275,14,6,8,4,1
183275,66,34,32,5,1
183275,11,8,3,19,1
183275,55,26,29,20,1
183275,80,40,40,21,4
183275,80,40,40,22,1
183275,80,40,40,23,1
183275,14,6,8,24,1
183275,66,34,32,25,1
183275,11,8,3,39,1
183275,55,26,29,40,1
183488,324,17,307,1,4
183488,324,17,307,2,1
183488,323,17,306,3,1
183488,87,8,79,4,1
183488,236,9,227,5,1
183488,1,0,1,11,1
183488,10,1,9,19,1
183488,226,8,218,20,1
183488,198,9,189,21,4
183488,198,9,189,22,1
183488,198,9,189,23,1
183488,76,5,71,24,1
183488,122,4,118,25,1
183488,8,1,7,39,1
183488,114,3,111,40,1
183488,126,8,118,41,4
183488,126,8,118,42,1
183488,125,8,117,43,1
183488,11,3,8,44,1
183488,114,5,109,45,1
183488,1,0,1,51,1
183488,2,0,2,59,1
183488,112,5,107,60,1
183600,38,3,35,1,4
183600,38,3,35,2,1
183600,37,2,35,3,1
183600,17,1,16,4,1
183600,20,1,19,5,1
183600,1,1,0,11,1
183600,20,1,19,20,1
183600,31,1,30,21,4
183600,31,1,30,22,1
183600,31,1,30,23,1
183600,16,1,15,24,1
183600,15,0,15,25,1
183600,15,0,15,40,1
183600,7,2,5,41,4
183600,7,2,5,42,1
183600,6,1,5,43,1
183600,1,0,1,44,1
183600,5,1,4,45,1
183600,1,1,0,51,1
183600,5,1,4,60,1
183655,7254,3009,4245,1,4
183655,7254,3009,4245,2,1
183655,6762,2797,3965,3,1
183655,1886,833,1053,4,1
183655,4876,1964,2912,5,1
183655,492,212,280,11,1
183655,109,45,64,19,1
183655,4767,1919,2848,20,1
183655,3675,1679,1996,21,4
183655,3675,1679,1996,22,1
183655,3524,1599,1925,23,1
183655,1264,592,672,24,1
183655,2260,1007,1253,25,1
183655,151,80,71,31,1
183655,79,37,42,39,1
183655,2181,970,1211,40,1
183655,3579,1330,2249,41,4
183655,3579,1330,2249,42,1
183655,3238,1198,2040,43,1
183655,622,241,381,44,1
183655,2616,957,1659,45,1
183655,341,132,209,51,1
183655,30,8,22,59,1
183655,2586,949,1637,60,1
183725,567,204,363,1,4
183725,567,204,363,2,1
183725,567,204,363,3,1
183725,115,40,75,4,1
183725,452,164,288,5,1
183725,452,164,288,20,1
183725,567,204,363,21,4
183725,567,204,363,22,1
183725,567,204,363,23,1
183725,115,40,75,24,1
183725,452,164,288,25,1
183725,452,164,288,40,1
183743,15882,8252,7630,1,4
183743,15882,8252,7630,2,1
183743,14688,7741,6947,3,1
183743,3214,1960,1254,4,1
183743,11474,5781,5693,5,1
183743,1194,511,683,11,1
183743,906,481,425,19,1
183743,10568,5300,5268,20,1
183743,8885,4859,4026,21,4
183743,8885,4859,4026,22,1
183743,8682,4756,3926,23,1
183743,2559,1555,1004,24,1
183743,6123,3201,2922,25,1
183743,203,103,100,31,1
183743,583,337,246,39,1
183743,5540,2864,2676,40,1
183743,6997,3393,3604,41,4
183743,6997,3393,3604,42,1
183743,6006,2985,3021,43,1
183743,655,405,250,44,1
183743,5351,2580,2771,45,1
183743,991,408,583,51,1
183743,323,144,179,59,1
183743,5028,2436,2592,60,1
183789,3671,1067,2604,1,4
183789,3671,1067,2604,2,1
183789,3667,1067,2600,3,1
183789,860,270,590,4,1
183789,2807,797,2010,5,1
183789,4,0,4,11,1
183789,844,170,674,19,1
183789,1963,627,1336,20,1
183789,2954,901,2053,21,4
183789,2954,901,2053,22,1
183789,2954,901,2053,23,1
183789,811,258,553,24,1
183789,2143,643,1500,25,1
183789,508,106,402,39,1
183789,1635,537,1098,40,1
183789,717,166,551,41,4
183789,717,166,551,42,1
183789,713,166,547,43,1
183789,49,12,37,44,1
183789,664,154,510,45,1
183789,4,0,4,51,1
183789,336,64,272,59,1
183789,328,90,238,60,1
183804,6754,6754,0,1,4
183804,2766,2766,0,2,1
183804,2766,2766,0,3,1
183804,2766,2766,0,5,1
183804,3988,3988,0,12,3
183804,523,523,0,19,1
183804,2243,2243,0,20,1
183804,5994,5994,0,21,4
183804,2742,2742,0,22,1
183804,2742,2742,0,23,1
183804,2742,2742,0,25,1
183804,3252,3252,0,32,3
183804,519,519,0,39,1
183804,2223,2223,0,40,1
183804,760,760,0,41,4
183804,24,24,0,42,1
183804,24,24,0,43,1
183804,24,24,0,45,1
183804,736,736,0,52,3
183804,4,4,0,59,1
183804,20,20,0,60,1
183822,1979,688,1291,1,4
183822,1972,686,1286,2,1
183822,1906,674,1232,3,1
183822,425,165,260,4,1
183822,1481,509,972,5,1
183822,66,12,54,11,1
183822,7,2,5,12,3
183822,171,57,114,19,1
183822,1310,452,858,20,1
183822,1776,635,1141,21,4
183822,1770,633,1137,22,1
183822,1757,630,1127,23,1
183822,416,163,253,24,1
183822,1341,467,874,25,1
183822,13,3,10,31,1
183822,6,2,4,32,3
183822,151,48,103,39,1
183822,1190,419,771,40,1
183822,203,53,150,41,4
183822,202,53,149,42,1
183822,149,44,105,43,1
183822,9,2,7,44,1
183822,140,42,98,45,1
183822,53,9,44,51,1
183822,1,0,1,52,3
183822,20,9,11,59,1
183822,120,33,87,60,1
183859,14360,6813,7547,1,4
183859,14360,6813,7547,2,1
183859,12492,6057,6435,3,1
183859,3052,1688,1364,4,1
183859,9440,4369,5071,5,1
183859,1868,756,1112,11,1
183859,270,124,146,19,1
183859,9170,4245,4925,20,1
183859,7421,3959,3462,21,4
183859,7421,3959,3462,22,1
183859,7308,3901,3407,23,1
183859,2519,1423,1096,24,1
183859,4789,2478,2311,25,1
183859,113,58,55,31,1
183859,169,86,83,39,1
183859,4620,2392,2228,40,1
183859,6939,2854,4085,41,4
183859,6939,2854,4085,42,1
183859,5184,2156,3028,43,1
183859,533,265,268,44,1
183859,4651,1891,2760,45,1
183859,1755,698,1057,51,1
183859,101,38,63,59,1
183859,4550,1853,2697,60,1
183877,9570,4118,5452,1,4
183877,9570,4118,5452,2,1
183877,8790,3748,5042,3,1
183877,2296,1113,1183,4,1
183877,6494,2635,3859,5,1
183877,780,370,410,11,1
183877,568,212,356,19,1
183877,5926,2423,3503,20,1
183877,4910,2284,2626,21,4
183877,4910,2284,2626,22,1
183877,4763,2205,2558,23,1
183877,1848,901,947,24,1
183877,2915,1304,1611,25,1
183877,147,79,68,31,1
183877,261,103,158,39,1
183877,2654,1201,1453,40,1
183877,4660,1834,2826,41,4
183877,4660,1834,2826,42,1
183877,4027,1543,2484,43,1
183877,448,212,236,44,1
183877,3579,1331,2248,45,1
183877,633,291,342,51,1
183877,307,109,198,59,1
183877,3272,1222,2050,60,1
183910,2160,602,1558,1,4
183910,1578,489,1089,2,1
183910,1570,488,1082,3,1
183910,373,98,275,4,1
183910,1197,390,807,5,1
183910,8,1,7,11,1
183910,582,113,469,12,3
183910,94,39,55,19,1
183910,1103,351,752,20,1
183910,1431,440,991,21,4
183910,1303,407,896,22,1
183910,1301,406,895,23,1
183910,349,88,261,24,1
183910,952,318,634,25,1
183910,2,1,1,31,1
183910,128,33,95,32,3
183910,70,28,42,39,1
183910,882,290,592,40,1
183910,729,162,567,41,4
183910,275,82,193,42,1
183910,269,82,187,43,1
183910,24,10,14,44,1
183910,245,72,173,45,1
183910,6,0,6,51,1
183910,454,80,374,52,3
183910,24,11,13,59,1
183910,221,61,160,60,1
183938,13301,5599,7702,1,4
183938,13301,5599,7702,2,1
183938,12096,5066,7030,3,1
183938,2635,1219,1416,4,1
183938,9461,3847,5614,5,1
183938,1205,533,672,11,1
183938,990,438,552,19,1
183938,8471,3409,5062,20,1
183938,7092,3140,3952,21,4
183938,7092,3140,3952,22,1
183938,6956,3064,3892,23,1
183938,2021,933,1088,24,1
183938,4935,2131,2804,25,1
183938,136,76,60,31,1
183938,578,285,293,39,1
183938,4357,1846,2511,40,1
183938,6209,2459,3750,41,4
183938,6209,2459,3750,42,1
183938,5140,2002,3138,43,1
183938,614,286,328,44,1
183938,4526,1716,2810,45,1
183938,1069,457,612,51,1
183938,412,153,259,59,1
183938,4114,1563,2551,60,1
183974,2400,883,1517,1,4
183974,1708,681,1027,2,1
183974,1708,681,1027,3,1
183974,217,82,135,4,1
183974,1491,599,892,5,1
183974,692,202,490,12,3
183974,145,62,83,19,1
183974,1346,537,809,20,1
183974,1962,770,1192,21,4
183974,1610,645,965,22,1
183974,1610,645,965,23,1
183974,206,79,127,24,1
183974,1404,566,838,25,1
183974,352,125,227,32,3
183974,128,52,76,39,1
183974,1276,514,762,40,1
183974,438,113,325,41,4
183974,98,36,62,42,1
183974,98,36,62,43,1
183974,11,3,8,44,1
183974,87,33,54,45,1
183974,340,77,263,52,3
183974,17,10,7,59,1
183974,70,23,47,60,1
183983,105,93,12,1,4
183983,105,93,12,2,1
183983,105,93,12,3,1
183983,65,59,6,4,1
183983,40,34,6,5,1
183983,40,34,6,20,1
183983,105,93,12,21,4
183983,105,93,12,22,1
183983,105,93,12,23,1
183983,65,59,6,24,1
183983,40,34,6,25,1
183983,40,34,6,40,1
184047,148,79,69,1,4
184047,148,79,69,2,1
184047,148,79,69,3,1
184047,55,31,24,4,1
184047,93,48,45,5,1
184047,93,48,45,20,1
184047,148,79,69,21,4
184047,148,79,69,22,1
184047,148,79,69,23,1
184047,55,31,24,24,1
184047,93,48,45,25,1
184047,93,48,45,40,1
184056,607,175,432,1,4
184056,607,175,432,2,1
184056,607,175,432,3,1
184056,170,51,119,4,1
184056,437,124,313,5,1
184056,437,124,313,20,1
184056,419,146,273,21,4
184056,419,146,273,22,1
184056,419,146,273,23,1
184056,141,50,91,24,1
184056,278,96,182,25,1
184056,278,96,182,40,1
184056,188,29,159,41,4
184056,188,29,159,42,1
184056,188,29,159,43,1
184056,29,1,28,44,1
184056,159,28,131,45,1
184056,159,28,131,60,1
184092,611,101,510,1,4
184092,611,101,510,2,1
184092,611,101,510,3,1
184092,98,18,80,4,1
184092,513,83,430,5,1
184092,513,83,430,20,1
184092,611,101,510,21,4
184092,611,101,510,22,1
184092,611,101,510,23,1
184092,98,18,80,24,1
184092,513,83,430,25,1
184092,513,83,430,40,1
184144,129,13,116,1,4
184144,129,13,116,2,1
184144,129,13,116,3,1
184144,37,3,34,4,1
184144,92,10,82,5,1
184144,92,10,82,20,1
184144,104,8,96,21,4
184144,104,8,96,22,1
184144,104,8,96,23,1
184144,33,2,31,24,1
184144,71,6,65,25,1
184144,71,6,65,40,1
184144,25,5,20,41,4
184144,25,5,20,42,1
184144,25,5,20,43,1
184144,4,1,3,44,1
184144,21,4,17,45,1
184144,21,4,17,60,1
184153,53,17,36,1,4
184153,41,9,32,2,1
184153,41,9,32,3,1
184153,41,9,32,5,1
184153,12,8,4,12,3
184153,41,9,32,20,1
184153,52,17,35,21,4
184153,41,9,32,22,1
184153,41,9,32,23,1
184153,41,9,32,25,1
184153,11,8,3,32,3
184153,41,9,32,40,1
184153,1,0,1,41,4
184153,1,0,1,52,3
184180,8447,4332,4115,1,4
184180,8447,4332,4115,2,1
184180,7583,3960,3623,3,1
184180,1831,1055,776,4,1
184180,5752,2905,2847,5,1
184180,864,372,492,11,1
184180,422,218,204,19,1
184180,5330,2687,2643,20,1
184180,4549,2549,2000,21,4
184180,4549,2549,2000,22,1
184180,4392,2471,1921,23,1
184180,1386,796,590,24,1
184180,3006,1675,1331,25,1
184180,157,78,79,31,1
184180,233,135,98,39,1
184180,2773,1540,1233,40,1
184180,3898,1783,2115,41,4
184180,3898,1783,2115,42,1
184180,3191,1489,1702,43,1
184180,445,259,186,44,1
184180,2746,1230,1516,45,1
184180,707,294,413,51,1
184180,189,83,106,59,1
184180,2557,1147,1410,60,1
184205,3919,1477,2442,1,4
184205,3919,1477,2442,2,1
184205,3814,1432,2382,3,1
184205,1013,428,585,4,1
184205,2801,1004,1797,5,1
184205,105,45,60,11,1
184205,64,15,49,19,1
184205,2737,989,1748,20,1
184205,2335,964,1371,21,4
184205,2335,964,1371,22,1
184205,2322,958,1364,23,1
184205,797,341,456,24,1
184205,1525,617,908,25,1
184205,13,6,7,31,1
184205,22,6,16,39,1
184205,1503,611,892,40,1
184205,1584,513,1071,41,4
184205,1584,513,1071,42,1
184205,1492,474,1018,43,1
184205,216,87,129,44,1
184205,1276,387,889,45,1
184205,92,39,53,51,1
184205,42,9,33,59,1
184205,1234,378,856,60,1
184278,236,231,5,1,4
184278,236,231,5,2,1
184278,236,231,5,3,1
184278,69,66,3,4,1
184278,167,165,2,5,1
184278,167,165,2,20,1
184278,236,231,5,21,4
184278,236,231,5,22,1
184278,236,231,5,23,1
184278,69,66,3,24,1
184278,167,165,2,25,1
184278,167,165,2,40,1
184320,1133,340,793,1,4
184320,1133,340,793,2,1
184320,1133,340,793,3,1
184320,1029,313,716,4,1
184320,104,27,77,5,1
184320,104,27,77,20,1
184320,1133,340,793,21,4
184320,1133,340,793,22,1
184320,1133,340,793,23,1
184320,1029,313,716,24,1
184320,104,27,77,25,1
184320,104,27,77,40,1
184348,2291,942,1349,1,4
184348,1493,574,919,2,1
184348,1453,555,898,3,1
184348,400,143,257,4,1
184348,1053,412,641,5,1
184348,40,19,21,11,1
184348,798,368,430,12,3
184348,32,13,19,19,1
184348,1021,399,622,20,1
184348,1790,723,1067,21,4
184348,1434,547,887,22,1
184348,1423,540,883,23,1
184348,399,143,256,24,1
184348,1024,397,627,25,1
184348,11,7,4,31,1
184348,356,176,180,32,3
184348,30,12,18,39,1
184348,994,385,609,40,1
184348,501,219,282,41,4
184348,59,27,32,42,1
184348,30,15,15,43,1
184348,1,0,1,44,1
184348,29,15,14,45,1
184348,29,12,17,51,1
184348,442,192,250,52,3
184348,2,1,1,59,1
184348,27,14,13,60,1
184357,32,8,24,1,4
184357,32,8,24,2,1
184357,32,8,24,3,1
184357,10,4,6,4,1
184357,22,4,18,5,1
184357,22,4,18,20,1
184357,19,5,14,21,4
184357,19,5,14,22,1
184357,19,5,14,23,1
184357,6,3,3,24,1
184357,13,2,11,25,1
184357,13,2,11,40,1
184357,13,3,10,41,4
184357,13,3,10,42,1
184357,13,3,10,43,1
184357,4,1,3,44,1
184357,9,2,7,45,1
184357,9,2,7,60,1
184427,255,251,4,1,4
184427,255,251,4,2,1
184427,255,251,4,3,1
184427,86,84,2,4,1
184427,169,167,2,5,1
184427,169,167,2,20,1
184427,255,251,4,21,4
184427,255,251,4,22,1
184427,255,251,4,23,1
184427,86,84,2,24,1
184427,169,167,2,25,1
184427,169,167,2,40,1
184481,12175,5054,7121,1,4
184481,12175,5054,7121,2,1
184481,11150,4613,6537,3,1
184481,2632,1182,1450,4,1
184481,8518,3431,5087,5,1
184481,1025,441,584,11,1
184481,212,97,115,19,1
184481,8306,3334,4972,20,1
184481,6391,2645,3746,21,4
184481,6391,2645,3746,22,1
184481,6274,2597,3677,23,1
184481,2109,939,1170,24,1
184481,4165,1658,2507,25,1
184481,117,48,69,31,1
184481,119,50,69,39,1
184481,4046,1608,2438,40,1
184481,5784,2409,3375,41,4
184481,5784,2409,3375,42,1
184481,4876,2016,2860,43,1
184481,523,243,280,44,1
184481,4353,1773,2580,45,1
184481,908,393,515,51,1
184481,93,47,46,59,1
184481,4260,1726,2534,60,1
184506,126,11,115,1,4
184506,126,11,115,2,1
184506,126,11,115,3,1
184506,53,3,50,4,1
184506,73,8,65,5,1
184506,73,8,65,20,1
184506,93,9,84,21,4
184506,93,9,84,22,1
184506,93,9,84,23,1
184506,42,3,39,24,1
184506,51,6,45,25,1
184506,51,6,45,40,1
184506,33,2,31,41,4
184506,33,2,31,42,1
184506,33,2,31,43,1
184506,11,0,11,44,1
184506,22,2,20,45,1
184506,22,2,20,60,1
184603,8546,3455,5091,1,4
184603,6108,2512,3596,2,1
184603,3915,1649,2266,3,1
184603,651,250,401,4,1
184603,3264,1399,1865,5,1
184603,2193,863,1330,11,1
184603,2438,943,1495,12,3
184603,380,179,201,19,1
184603,2884,1220,1664,20,1
184603,3596,1528,2068,21,4
184603,2727,1097,1630,22,1
184603,2673,1078,1595,23,1
184603,577,224,353,24,1
184603,2096,854,1242,25,1
184603,54,19,35,31,1
184603,869,431,438,32,3
184603,225,93,132,39,1
184603,1871,761,1110,40,1
184603,4950,1927,3023,41,4
184603,3381,1415,1966,42,1
184603,1242,571,671,43,1
184603,74,26,48,44,1
184603,1168,545,623,45,1
184603,2139,844,1295,51,1
184603,1569,512,1057,52,3
184603,155,86,69,59,1
184603,1013,459,554,60,1
184612,1933,501,1432,1,4
184612,1621,447,1174,2,1
184612,1618,447,1171,3,1
184612,153,63,90,4,1
184612,1465,384,1081,5,1
184612,3,0,3,11,1
184612,312,54,258,12,3
184612,227,49,178,19,1
184612,1238,335,903,20,1
184612,1374,397,977,21,4
184612,1340,390,950,22,1
184612,1339,390,949,23,1
184612,151,62,89,24,1
184612,1188,328,860,25,1
184612,1,0,1,31,1
184612,34,7,27,32,3
184612,167,43,124,39,1
184612,1021,285,736,40,1
184612,559,104,455,41,4
184612,281,57,224,42,1
184612,279,57,222,43,1
184612,2,1,1,44,1
184612,277,56,221,45,1
184612,2,0,2,51,1
184612,278,47,231,52,3
184612,60,6,54,59,1
184612,217,50,167,60,1
184694,3029,1302,1727,1,4
184694,2274,1026,1248,2,1
184694,2242,1017,1225,3,1
184694,512,227,285,4,1
184694,1730,790,940,5,1
184694,32,9,23,11,1
184694,755,276,479,12,3
184694,121,59,62,19,1
184694,1609,731,878,20,1
184694,2582,1097,1485,21,4
184694,2116,948,1168,22,1
184694,2112,948,1164,23,1
184694,509,225,284,24,1
184694,1603,723,880,25,1
184694,4,0,4,31,1
184694,466,149,317,32,3
184694,115,56,59,39,1
184694,1488,667,821,40,1
184694,447,205,242,41,4
184694,158,78,80,42,1
184694,130,69,61,43,1
184694,3,2,1,44,1
184694,127,67,60,45,1
184694,28,9,19,51,1
184694,289,127,162,52,3
184694,6,3,3,59,1
184694,121,64,57,60,1
184746,255,252,3,1,4
184746,255,252,3,2,1
184746,255,252,3,3,1
184746,147,145,2,4,1
184746,108,107,1,5,1
184746,108,107,1,20,1
184746,171,169,2,21,4
184746,171,169,2,22,1
184746,171,169,2,23,1
184746,106,105,1,24,1
184746,65,64,1,25,1
184746,65,64,1,40,1
184746,84,83,1,41,4
184746,84,83,1,42,1
184746,84,83,1,43,1
184746,41,40,1,44,1
184746,43,43,0,45,1
184746,43,43,0,60,1
184773,2257,420,1837,1,4
184773,1567,301,1266,2,1
184773,1398,205,1193,3,1
184773,275,75,200,4,1
184773,1123,130,993,5,1
184773,169,96,73,11,1
184773,690,119,571,12,3
184773,218,46,172,19,1
184773,905,84,821,20,1
184773,1471,208,1263,21,4
184773,1261,175,1086,22,1
184773,1261,175,1086,23,1
184773,275,75,200,24,1
184773,986,100,886,25,1
184773,210,33,177,32,3
184773,195,39,156,39,1
184773,791,61,730,40,1
184773,786,212,574,41,4
184773,306,126,180,42,1
184773,137,30,107,43,1
184773,137,30,107,45,1
184773,169,96,73,51,1
184773,480,86,394,52,3
184773,23,7,16,59,1
184773,114,23,91,60,1
184782,13349,6483,6866,1,4
184782,10951,5533,5418,2,1
184782,10656,5436,5220,3,1
184782,1505,905,600,4,1
184782,9151,4531,4620,5,1
184782,295,97,198,11,1
184782,2398,950,1448,12,3
184782,1364,651,713,19,1
184782,7787,3880,3907,20,1
184782,10499,5433,5066,21,4
184782,9348,4895,4453,22,1
184782,9340,4889,4451,23,1
184782,1382,836,546,24,1
184782,7958,4053,3905,25,1
184782,8,6,2,31,1
184782,1151,538,613,32,3
184782,1244,599,645,39,1
184782,6714,3454,3260,40,1
184782,2850,1050,1800,41,4
184782,1603,638,965,42,1
184782,1316,547,769,43,1
184782,123,69,54,44,1
184782,1193,478,715,45,1
184782,287,91,196,51,1
184782,1247,412,835,52,3
184782,120,52,68,59,1
184782,1073,426,647,60,1
184791,6720,2865,3855,1,4
184791,6720,2865,3855,2,1
184791,6362,2745,3617,3,1
184791,1918,910,1008,4,1
184791,4444,1835,2609,5,1
184791,358,120,238,11,1
184791,299,100,199,19,1
184791,4145,1735,2410,20,1
184791,4030,1890,2140,21,4
184791,4030,1890,2140,22,1
184791,4021,1887,2134,23,1
184791,1579,772,807,24,1
184791,2442,1115,1327,25,1
184791,9,3,6,31,1
184791,132,54,78,39,1
184791,2310,1061,1249,40,1
184791,2690,975,1715,41,4
184791,2690,975,1715,42,1
184791,2341,858,1483,43,1
184791,339,138,201,44,1
184791,2002,720,1282,45,1
184791,349,117,232,51,1
184791,167,46,121,59,1
184791,1835,674,1161,60,1
184816,91,13,78,1,4
184816,91,13,78,2,1
184816,91,13,78,3,1
184816,26,7,19,4,1
184816,65,6,59,5,1
184816,65,6,59,20,1
184816,69,10,59,21,4
184816,69,10,59,22,1
184816,69,10,59,23,1
184816,20,6,14,24,1
184816,49,4,45,25,1
184816,49,4,45,40,1
184816,22,3,19,41,4
184816,22,3,19,42,1
184816,22,3,19,43,1
184816,6,1,5,44,1
184816,16,2,14,45,1
184816,16,2,14,60,1
184870,346,44,302,1,4
184870,346,44,302,2,1
184870,346,44,302,3,1
184870,315,40,275,4,1
184870,31,4,27,5,1
184870,31,4,27,20,1
184870,245,35,210,21,4
184870,245,35,210,22,1
184870,245,35,210,23,1
184870,226,33,193,24,1
184870,19,2,17,25,1
184870,19,2,17,40,1
184870,101,9,92,41,4
184870,101,9,92,42,1
184870,101,9,92,43,1
184870,89,7,82,44,1
184870,12,2,10,45,1
184870,12,2,10,60,1
184959,1034,151,883,1,4
184959,1034,151,883,2,1
184959,987,148,839,3,1
184959,86,11,75,4,1
184959,901,137,764,5,1
184959,47,3,44,11,1
184959,121,26,95,19,1
184959,780,111,669,20,1
184959,475,77,398,21,4
184959,475,77,398,22,1
184959,475,77,398,23,1
184959,71,9,62,24,1
184959,404,68,336,25,1
184959,42,10,32,39,1
184959,362,58,304,40,1
184959,559,74,485,41,4
184959,559,74,485,42,1
184959,512,71,441,43,1
184959,15,2,13,44,1
184959,497,69,428,45,1
184959,47,3,44,51,1
184959,79,16,63,59,1
184959,418,53,365,60,1
184968,150,23,127,1,4
184968,150,23,127,2,1
184968,150,23,127,3,1
184968,5,2,3,4,1
184968,145,21,124,5,1
184968,145,21,124,20,1
184968,93,17,76,21,4
184968,93,17,76,22,1
184968,93,17,76,23,1
184968,4,2,2,24,1
184968,89,15,74,25,1
184968,89,15,74,40,1
184968,57,6,51,41,4
184968,57,6,51,42,1
184968,57,6,51,43,1
184968,1,0,1,44,1
184968,56,6,50,45,1
184968,56,6,50,60,1
184995,9036,3727,5309,1,4
184995,9036,3727,5309,2,1
184995,8753,3624,5129,3,1
184995,2582,1125,1457,4,1
184995,6171,2499,3672,5,1
184995,283,103,180,11,1
184995,450,180,270,19,1
184995,5721,2319,3402,20,1
184995,6066,2547,3519,21,4
184995,6066,2547,3519,22,1
184995,6053,2540,3513,23,1
184995,2106,914,1192,24,1
184995,3947,1626,2321,25,1
184995,13,7,6,31,1
184995,304,129,175,39,1
184995,3643,1497,2146,40,1
184995,2970,1180,1790,41,4
184995,2970,1180,1790,42,1
184995,2700,1084,1616,43,1
184995,476,211,265,44,1
184995,2224,873,1351,45,1
184995,270,96,174,51,1
184995,146,51,95,59,1
184995,2078,822,1256,60,1
185129,8442,3135,5307,1,4
185129,6437,2564,3873,2,1
185129,6373,2540,3833,3,1
185129,650,275,375,4,1
185129,5723,2265,3458,5,1
185129,64,24,40,11,1
185129,2005,571,1434,12,3
185129,971,358,613,19,1
185129,4752,1907,2845,20,1
185129,5204,2116,3088,21,4
185129,4776,1979,2797,22,1
185129,4772,1978,2794,23,1
185129,577,248,329,24,1
185129,4195,1730,2465,25,1
185129,4,1,3,31,1
185129,428,137,291,32,3
185129,724,295,429,39,1
185129,3471,1435,2036,40,1
185129,3238,1019,2219,41,4
185129,1661,585,1076,42,1
185129,1601,562,1039,43,1
185129,73,27,46,44,1
185129,1528,535,993,45,1
185129,60,23,37,51,1
185129,1577,434,1143,52,3
185129,247,63,184,59,1
185129,1281,472,809,60,1
185174,98,81,17,1,4
185174,98,81,17,2,1
185174,98,81,17,3,1
185174,51,43,8,4,1
185174,47,38,9,5,1
185174,47,38,9,20,1
185174,98,81,17,21,4
185174,98,81,17,22,1
185174,98,81,17,23,1
185174,51,43,8,24,1
185174,47,38,9,25,1
185174,47,38,9,40,1
185262,14404,5349,9055,1,4
185262,12078,4791,7287,2,1
185262,11975,4749,7226,3,1
185262,1525,650,875,4,1
185262,10450,4099,6351,5,1
185262,103,42,61,11,1
185262,2326,558,1768,12,3
185262,1438,524,914,19,1
185262,9012,3575,5437,20,1
185262,10081,4004,6077,21,4
185262,9251,3801,5450,22,1
185262,9246,3798,5448,23,1
185262,1493,632,861,24,1
185262,7753,3166,4587,25,1
185262,5,3,2,31,1
185262,830,203,627,32,3
185262,1013,389,624,39,1
185262,6740,2777,3963,40,1
185262,4323,1345,2978,41,4
185262,2827,990,1837,42,1
185262,2729,951,1778,43,1
185262,32,18,14,44,1
185262,2697,933,1764,45,1
185262,98,39,59,51,1
185262,1496,355,1141,52,3
185262,425,135,290,59,1
185262,2272,798,1474,60,1
185332,422,56,366,1,4
185332,422,56,366,2,1
185332,422,56,366,3,1
185332,419,55,364,4,1
185332,3,1,2,5,1
185332,3,1,2,20,1
185332,308,46,262,21,4
185332,308,46,262,22,1
185332,308,46,262,23,1
185332,306,45,261,24,1
185332,2,1,1,25,1
185332,2,1,1,40,1
185332,114,10,104,41,4
185332,114,10,104,42,1
185332,114,10,104,43,1
185332,113,10,103,44,1
185332,1,0,1,45,1
185332,1,0,1,60,1
185396,1171,1149,22,1,4
185396,1171,1149,22,2,1
185396,1171,1149,22,3,1
185396,289,283,6,4,1
185396,882,866,16,5,1
185396,882,866,16,20,1
185396,973,954,19,21,4
185396,973,954,19,22,1
185396,973,954,19,23,1
185396,265,259,6,24,1
185396,708,695,13,25,1
185396,708,695,13,40,1
185396,198,195,3,41,4
185396,198,195,3,42,1
185396,198,195,3,43,1
185396,24,24,0,44,1
185396,174,171,3,45,1
185396,174,171,3,60,1
185466,303,7,296,1,4
185466,303,7,296,2,1
185466,303,7,296,3,1
185466,271,7,264,4,1
185466,32,0,32,5,1
185466,32,0,32,20,1
185466,201,7,194,21,4
185466,201,7,194,22,1
185466,201,7,194,23,1
185466,199,7,192,24,1
185466,2,0,2,25,1
185466,2,0,2,40,1
185466,102,0,102,41,4
185466,102,0,102,42,1
185466,102,0,102,43,1
185466,72,0,72,44,1
185466,30,0,30,45,1
185466,30,0,30,60,1
185509,8501,4116,4385,1,4
185509,8501,4116,4385,2,1
185509,7885,3859,4026,3,1
185509,2151,1174,977,4,1
185509,5734,2685,3049,5,1
185509,616,257,359,11,1
185509,271,118,153,19,1
185509,5463,2567,2896,20,1
185509,3093,1561,1532,21,4
185509,3093,1561,1532,22,1
185509,3049,1540,1509,23,1
185509,1190,638,552,24,1
185509,1859,902,957,25,1
185509,44,21,23,31,1
185509,113,57,56,39,1
185509,1746,845,901,40,1
185509,5408,2555,2853,41,4
185509,5408,2555,2853,42,1
185509,4836,2319,2517,43,1
185509,961,536,425,44,1
185509,3875,1783,2092,45,1
185509,572,236,336,51,1
185509,158,61,97,59,1
185509,3717,1722,1995,60,1
185536,12602,5950,6652,1,4
185536,12602,5950,6652,2,1
185536,11433,5461,5972,3,1
185536,2573,1284,1289,4,1
185536,8860,4177,4683,5,1
185536,1169,489,680,11,1
185536,388,182,206,19,1
185536,8472,3995,4477,20,1
185536,6660,3320,3340,21,4
185536,6660,3320,3340,22,1
185536,6533,3249,3284,23,1
185536,2066,1033,1033,24,1
185536,4467,2216,2251,25,1
185536,127,71,56,31,1
185536,201,99,102,39,1
185536,4266,2117,2149,40,1
185536,5942,2630,3312,41,4
185536,5942,2630,3312,42,1
185536,4900,2212,2688,43,1
185536,507,251,256,44,1
185536,4393,1961,2432,45,1
185536,1042,418,624,51,1
185536,187,83,104,59,1
185536,4206,1878,2328,60,1
185572,6316,2285,4031,1,4
185572,4607,1881,2726,2,1
185572,4557,1859,2698,3,1
185572,906,381,525,4,1
185572,3651,1478,2173,5,1
185572,50,22,28,11,1
185572,1709,404,1305,12,3
185572,324,142,182,19,1
185572,3327,1336,1991,20,1
185572,4966,1941,3025,21,4
185572,4304,1761,2543,22,1
185572,4300,1759,2541,23,1
185572,906,381,525,24,1
185572,3394,1378,2016,25,1
185572,4,2,2,31,1
185572,662,180,482,32,3
185572,305,136,169,39,1
185572,3089,1242,1847,40,1
185572,1350,344,1006,41,4
185572,303,120,183,42,1
185572,257,100,157,43,1
185572,257,100,157,45,1
185572,46,20,26,51,1
185572,1047,224,823,52,3
185572,19,6,13,59,1
185572,238,94,144,60,1
185590,19464,7152,12312,1,4
185590,15431,6022,9409,2,1
185590,15182,5940,9242,3,1
185590,3040,1142,1898,4,1
185590,12142,4798,7344,5,1
185590,249,82,167,11,1
185590,4033,1130,2903,12,3
185590,1478,588,890,19,1
185590,10664,4210,6454,20,1
185590,14702,5555,9147,21,4
185590,13356,5159,8197,22,1
185590,13221,5128,8093,23,1
185590,3030,1138,1892,24,1
185590,10191,3990,6201,25,1
185590,135,31,104,31,1
185590,1346,396,950,32,3
185590,1277,524,753,39,1
185590,8914,3466,5448,40,1
185590,4762,1597,3165,41,4
185590,2075,863,1212,42,1
185590,1961,812,1149,43,1
185590,10,4,6,44,1
185590,1951,808,1143,45,1
185590,114,51,63,51,1
185590,2687,734,1953,52,3
185590,201,64,137,59,1
185590,1750,744,1006,60,1
185624,116,15,101,1,4
185624,116,15,101,2,1
185624,116,15,101,3,1
185624,116,15,101,5,1
185624,116,15,101,20,1
185624,116,15,101,21,4
185624,116,15,101,22,1
185624,116,15,101,23,1
185624,116,15,101,25,1
185624,116,15,101,40,1
185651,100,23,77,1,4
185651,100,23,77,2,1
185651,100,23,77,3,1
185651,2,0,2,4,1
185651,98,23,75,5,1
185651,98,23,75,20,1
185651,19,2,17,21,4
185651,19,2,17,22,1
185651,19,2,17,23,1
185651,2,0,2,24,1
185651,17,2,15,25,1
185651,17,2,15,40,1
185651,81,21,60,41,4
185651,81,21,60,42,1
185651,81,21,60,43,1
185651,81,21,60,45,1
185651,81,21,60,60,1
185679,361,56,305,1,4
185679,361,56,305,2,1
185679,361,56,305,3,1
185679,4,0,4,4,1
185679,357,56,301,5,1
185679,357,56,301,20,1
185679,29,3,26,21,4
185679,29,3,26,22,1
185679,29,3,26,23,1
185679,2,0,2,24,1
185679,27,3,24,25,1
185679,27,3,24,40,1
185679,332,53,279,41,4
185679,332,53,279,42,1
185679,332,53,279,43,1
185679,2,0,2,44,1
185679,330,53,277,45,1
185679,330,53,277,60,1
185721,579,245,334,1,4
185721,579,245,334,2,1
185721,579,245,334,3,1
185721,234,100,134,4,1
185721,345,145,200,5,1
185721,345,145,200,20,1
185721,579,245,334,21,4
185721,579,245,334,22,1
185721,579,245,334,23,1
185721,234,100,134,24,1
185721,345,145,200,25,1
185721,345,145,200,40,1
185730,71,8,63,1,4
185730,71,8,63,2,1
185730,71,8,63,3,1
185730,31,5,26,4,1
185730,40,3,37,5,1
185730,40,3,37,20,1
185730,71,8,63,21,4
185730,71,8,63,22,1
185730,71,8,63,23,1
185730,31,5,26,24,1
185730,40,3,37,25,1
185730,40,3,37,40,1
185758,171,77,94,1,4
185758,171,77,94,12,3
185758,30,11,19,21,4
185758,30,11,19,32,3
185758,141,66,75,41,4
185758,141,66,75,52,3
185767,259,22,237,1,4
185767,259,22,237,2,1
185767,259,22,237,3,1
185767,44,6,38,4,1
185767,215,16,199,5,1
185767,215,16,199,20,1
185767,138,16,122,21,4
185767,138,16,122,22,1
185767,138,16,122,23,1
185767,26,5,21,24,1
185767,112,11,101,25,1
185767,112,11,101,40,1
185767,121,6,115,41,4
185767,121,6,115,42,1
185767,121,6,115,43,1
185767,18,1,17,44,1
185767,103,5,98,45,1
185767,103,5,98,60,1
185828,10130,7547,2583,1,4
185828,7317,5583,1734,2,1
185828,6449,5105,1344,3,1
185828,1029,809,220,4,1
185828,5420,4296,1124,5,1
185828,868,478,390,11,1
185828,2813,1964,849,12,3
185828,629,508,121,19,1
185828,4791,3788,1003,20,1
185828,7305,5583,1722,21,4
185828,5709,4495,1214,22,1
185828,5679,4472,1207,23,1
185828,957,755,202,24,1
185828,4722,3717,1005,25,1
185828,30,23,7,31,1
185828,1596,1088,508,32,3
185828,510,409,101,39,1
185828,4212,3308,904,40,1
185828,2825,1964,861,41,4
185828,1608,1088,520,42,1
185828,770,633,137,43,1
185828,72,54,18,44,1
185828,698,579,119,45,1
185828,838,455,383,51,1
185828,1217,876,341,52,3
185828,119,99,20,59,1
185828,579,480,99,60,1
185873,9477,4226,5251,1,4
185873,9477,4226,5251,2,1
185873,8174,3738,4436,3,1
185873,2216,1122,1094,4,1
185873,5958,2616,3342,5,1
185873,1303,488,815,11,1
185873,345,144,201,19,1
185873,5613,2472,3141,20,1
185873,5138,2535,2603,21,4
185873,5138,2535,2603,22,1
185873,5062,2496,2566,23,1
185873,1810,940,870,24,1
185873,3252,1556,1696,25,1
185873,76,39,37,31,1
185873,181,92,89,39,1
185873,3071,1464,1607,40,1
185873,4339,1691,2648,41,4
185873,4339,1691,2648,42,1
185873,3112,1242,1870,43,1
185873,406,182,224,44,1
185873,2706,1060,1646,45,1
185873,1227,449,778,51,1
185873,164,52,112,59,1
185873,2542,1008,1534,60,1
185916,142,28,114,1,4
185916,142,28,114,2,1
185916,142,28,114,3,1
185916,11,0,11,4,1
185916,131,28,103,5,1
185916,131,28,103,20,1
185916,102,22,80,21,4
185916,102,22,80,22,1
185916,102,22,80,23,1
185916,10,0,10,24,1
185916,92,22,70,25,1
185916,92,22,70,40,1
185916,40,6,34,41,4
185916,40,6,34,42,1
185916,40,6,34,43,1
185916,1,0,1,44,1
185916,39,6,33,45,1
185916,39,6,33,60,1
185970,180,14,166,1,4
185970,180,14,166,2,1
185970,180,14,166,3,1
185970,48,4,44,4,1
185970,132,10,122,5,1
185970,132,10,122,20,1
185970,130,12,118,21,4
185970,130,12,118,22,1
185970,130,12,118,23,1
185970,42,3,39,24,1
185970,88,9,79,25,1
185970,88,9,79,40,1
185970,50,2,48,41,4
185970,50,2,48,42,1
185970,50,2,48,43,1
185970,6,1,5,44,1
185970,44,1,43,45,1
185970,44,1,43,60,1
186016,337,19,318,1,4
186016,337,19,318,2,1
186016,337,19,318,3,1
186016,41,1,40,4,1
186016,296,18,278,5,1
186016,296,18,278,20,1
186016,226,12,214,21,4
186016,226,12,214,22,1
186016,226,12,214,23,1
186016,32,1,31,24,1
186016,194,11,183,25,1
186016,194,11,183,40,1
186016,111,7,104,41,4
186016,111,7,104,42,1
186016,111,7,104,43,1
186016,9,0,9,44,1
186016,102,7,95,45,1
186016,102,7,95,60,1
186034,9129,3583,5546,1,4
186034,9129,3583,5546,2,1
186034,8379,3314,5065,3,1
186034,1552,708,844,4,1
186034,6827,2606,4221,5,1
186034,750,269,481,11,1
186034,242,103,139,19,1
186034,6585,2503,4082,20,1
186034,3369,1445,1924,21,4
186034,3369,1445,1924,22,1
186034,3345,1431,1914,23,1
186034,809,363,446,24,1
186034,2536,1068,1468,25,1
186034,24,14,10,31,1
186034,126,59,67,39,1
186034,2410,1009,1401,40,1
186034,5760,2138,3622,41,4
186034,5760,2138,3622,42,1
186034,5034,1883,3151,43,1
186034,743,345,398,44,1
186034,4291,1538,2753,45,1
186034,726,255,471,51,1
186034,116,44,72,59,1
186034,4175,1494,2681,60,1
186052,703,612,91,1,4
186052,703,612,91,2,1
186052,703,612,91,3,1
186052,510,434,76,4,1
186052,193,178,15,5,1
186052,193,178,15,20,1
186052,543,472,71,21,4
186052,543,472,71,22,1
186052,543,472,71,23,1
186052,425,362,63,24,1
186052,118,110,8,25,1
186052,118,110,8,40,1
186052,160,140,20,41,4
186052,160,140,20,42,1
186052,160,140,20,43,1
186052,85,72,13,44,1
186052,75,68,7,45,1
186052,75,68,7,60,1
186122,502,295,207,1,4
186122,502,295,207,12,3
186122,464,273,191,21,4
186122,464,273,191,32,3
186122,38,22,16,41,4
186122,38,22,16,52,3
186131,8014,4397,3617,1,4
186131,5323,2722,2601,2,1
186131,5234,2667,2567,3,1
186131,1284,655,629,4,1
186131,3950,2012,1938,5,1
186131,89,55,34,11,1
186131,2691,1675,1016,12,3
186131,3950,2012,1938,20,1
186131,7935,4348,3587,21,4
186131,5244,2673,2571,22,1
186131,5234,2667,2567,23,1
186131,1284,655,629,24,1
186131,3950,2012,1938,25,1
186131,10,6,4,31,1
186131,2691,1675,1016,32,3
186131,3950,2012,1938,40,1
186131,79,49,30,41,4
186131,79,49,30,42,1
186131,79,49,30,51,1
186186,239,239,0,1,4
186186,239,239,0,2,1
186186,239,239,0,3,1
186186,19,19,0,4,1
186186,220,220,0,5,1
186186,152,152,0,19,1
186186,68,68,0,20,1
186186,239,239,0,21,4
186186,239,239,0,22,1
186186,239,239,0,23,1
186186,19,19,0,24,1
186186,220,220,0,25,1
186186,152,152,0,39,1
186186,68,68,0,40,1
186201,5852,2576,3276,1,4
186201,5614,2494,3120,2,1
186201,5397,2422,2975,3,1
186201,901,437,464,4,1
186201,4496,1985,2511,5,1
186201,217,72,145,11,1
186201,238,82,156,12,3
186201,599,291,308,19,1
186201,3897,1694,2203,20,1
186201,5015,2244,2771,21,4
186201,4992,2239,2753,22,1
186201,4928,2226,2702,23,1
186201,901,437,464,24,1
186201,4027,1789,2238,25,1
186201,64,13,51,31,1
186201,23,5,18,32,3
186201,510,266,244,39,1
186201,3517,1523,1994,40,1
186201,837,332,505,41,4
186201,622,255,367,42,1
186201,469,196,273,43,1
186201,469,196,273,45,1
186201,153,59,94,51,1
186201,215,77,138,52,3
186201,89,25,64,59,1
186201,380,171,209,60,1
186274,193,35,158,1,4
186274,193,35,158,2,1
186274,193,35,158,3,1
186274,33,11,22,4,1
186274,160,24,136,5,1
186274,160,24,136,20,1
186274,116,23,93,21,4
186274,116,23,93,22,1
186274,116,23,93,23,1
186274,23,7,16,24,1
186274,93,16,77,25,1
186274,93,16,77,40,1
186274,77,12,65,41,4
186274,77,12,65,42,1
186274,77,12,65,43,1
186274,10,4,6,44,1
186274,67,8,59,45,1
186274,67,8,59,60,1
186283,5410,2171,3239,1,4
186283,4425,1836,2589,2,1
186283,4041,1677,2364,3,1
186283,760,310,450,4,1
186283,3281,1367,1914,5,1
186283,384,159,225,11,1
186283,985,335,650,12,3
186283,307,132,175,19,1
186283,2974,1235,1739,20,1
186283,4122,1679,2443,21,4
186283,3791,1547,2244,22,1
186283,3579,1471,2108,23,1
186283,758,309,449,24,1
186283,2821,1162,1659,25,1
186283,212,76,136,31,1
186283,331,132,199,32,3
186283,251,108,143,39,1
186283,2570,1054,1516,40,1
186283,1288,492,796,41,4
186283,634,289,345,42,1
186283,462,206,256,43,1
186283,2,1,1,44,1
186283,460,205,255,45,1
186283,172,83,89,51,1
186283,654,203,451,52,3
186283,56,24,32,59,1
186283,404,181,223,60,1
186335,61,8,53,1,4
186335,61,8,53,2,1
186335,61,8,53,3,1
186335,19,3,16,4,1
186335,42,5,37,5,1
186335,42,5,37,20,1
186335,49,7,42,21,4
186335,49,7,42,22,1
186335,49,7,42,23,1
186335,14,3,11,24,1
186335,35,4,31,25,1
186335,35,4,31,40,1
186335,12,1,11,41,4
186335,12,1,11,42,1
186335,12,1,11,43,1
186335,5,0,5,44,1
186335,7,1,6,45,1
186335,7,1,6,60,1
186371,6264,2995,3269,1,4
186371,4842,2183,2659,2,1
186371,4777,2160,2617,3,1
186371,496,254,242,4,1
186371,4281,1906,2375,5,1
186371,65,23,42,11,1
186371,1422,812,610,12,3
186371,837,346,491,19,1
186371,3444,1560,1884,20,1
186371,4746,2298,2448,21,4
186371,3939,1824,2115,22,1
186371,3933,1821,2112,23,1
186371,494,253,241,24,1
186371,3439,1568,1871,25,1
186371,6,3,3,31,1
186371,807,474,333,32,3
186371,668,286,382,39,1
186371,2771,1282,1489,40,1
186371,1518,697,821,41,4
186371,903,359,544,42,1
186371,844,339,505,43,1
186371,2,1,1,44,1
186371,842,338,504,45,1
186371,59,20,39,51,1
186371,615,338,277,52,3
186371,169,60,109,59,1
186371,673,278,395,60,1
186380,48036,22267,25769,1,4
186380,33901,16856,17045,2,1
186380,33427,16649,16778,3,1
186380,6403,3241,3162,4,1
186380,27024,13408,13616,5,1
186380,474,207,267,11,1
186380,14135,5411,8724,12,3
186380,2581,1227,1354,19,1
186380,24443,12181,12262,20,1
186380,40321,19588,20733,21,4
186380,31759,15975,15784,22,1
186380,31630,15908,15722,23,1
186380,6393,3233,3160,24,1
186380,25237,12675,12562,25,1
186380,129,67,62,31,1
186380,8562,3613,4949,32,3
186380,2361,1161,1200,39,1
186380,22876,11514,11362,40,1
186380,7715,2679,5036,41,4
186380,2142,881,1261,42,1
186380,1797,741,1056,43,1
186380,10,8,2,44,1
186380,1787,733,1054,45,1
186380,345,140,205,51,1
186380,5573,1798,3775,52,3
186380,220,66,154,59,1
186380,1567,667,900,60,1
186399,11212,5842,5370,1,4
186399,7217,3577,3640,2,1
186399,6748,3349,3399,3,1
186399,988,521,467,4,1
186399,5760,2828,2932,5,1
186399,469,228,241,11,1
186399,3995,2265,1730,12,3
186399,779,381,398,19,1
186399,4981,2447,2534,20,1
186399,7559,3926,3633,21,4
186399,5827,2929,2898,22,1
186399,5824,2929,2895,23,1
186399,985,520,465,24,1
186399,4839,2409,2430,25,1
186399,3,0,3,31,1
186399,1732,997,735,32,3
186399,657,327,330,39,1
186399,4182,2082,2100,40,1
186399,3653,1916,1737,41,4
186399,1390,648,742,42,1
186399,924,420,504,43,1
186399,3,1,2,44,1
186399,921,419,502,45,1
186399,466,228,238,51,1
186399,2263,1268,995,52,3
186399,122,54,68,59,1
186399,799,365,434,60,1
186405,15,3,12,1,4
186405,15,3,12,2,1
186405,15,3,12,3,1
186405,15,3,12,5,1
186405,15,3,12,20,1
186405,15,3,12,21,4
186405,15,3,12,22,1
186405,15,3,12,23,1
186405,15,3,12,25,1
186405,15,3,12,40,1
186423,56,7,49,1,4
186423,56,7,49,2,1
186423,56,7,49,3,1
186423,56,7,49,5,1
186423,56,7,49,20,1
186423,56,7,49,21,4
186423,56,7,49,22,1
186423,56,7,49,23,1
186423,56,7,49,25,1
186423,56,7,49,40,1
186432,3194,1214,1980,1,4
186432,2484,977,1507,2,1
186432,2369,947,1422,3,1
186432,610,274,336,4,1
186432,1759,673,1086,5,1
186432,115,30,85,11,1
186432,710,237,473,12,3
186432,127,52,75,19,1
186432,1632,621,1011,20,1
186432,2316,956,1360,21,4
186432,2068,870,1198,22,1
186432,2064,869,1195,23,1
186432,607,274,333,24,1
186432,1457,595,862,25,1
186432,4,1,3,31,1
186432,248,86,162,32,3
186432,99,42,57,39,1
186432,1358,553,805,40,1
186432,878,258,620,41,4
186432,416,107,309,42,1
186432,305,78,227,43,1
186432,3,0,3,44,1
186432,302,78,224,45,1
186432,111,29,82,51,1
186432,462,151,311,52,3
186432,28,10,18,59,1
186432,274,68,206,60,1
186469,1240,467,773,1,4
186469,1240,467,773,2,1
186469,1133,415,718,3,1
186469,304,140,164,4,1
186469,829,275,554,5,1
186469,107,52,55,11,1
186469,49,23,26,19,1
186469,780,252,528,20,1
186469,726,291,435,21,4
186469,726,291,435,22,1
186469,713,286,427,23,1
186469,221,106,115,24,1
186469,492,180,312,25,1
186469,13,5,8,31,1
186469,28,14,14,39,1
186469,464,166,298,40,1
186469,514,176,338,41,4
186469,514,176,338,42,1
186469,420,129,291,43,1
186469,83,34,49,44,1
186469,337,95,242,45,1
186469,94,47,47,51,1
186469,21,9,12,59,1
186469,316,86,230,60,1
186584,9903,4061,5842,1,4
186584,5839,2405,3434,2,1
186584,5632,2312,3320,3,1
186584,1342,589,753,4,1
186584,4290,1723,2567,5,1
186584,207,93,114,11,1
186584,4064,1656,2408,12,3
186584,432,138,294,19,1
186584,3858,1585,2273,20,1
186584,7141,2992,4149,21,4
186584,5380,2237,3143,22,1
186584,5370,2233,3137,23,1
186584,1338,586,752,24,1
186584,4032,1647,2385,25,1
186584,10,4,6,31,1
186584,1761,755,1006,32,3
186584,402,133,269,39,1
186584,3630,1514,2116,40,1
186584,2762,1069,1693,41,4
186584,459,168,291,42,1
186584,262,79,183,43,1
186584,4,3,1,44,1
186584,258,76,182,45,1
186584,197,89,108,51,1
186584,2303,901,1402,52,3
186584,30,5,25,59,1
186584,228,71,157,60,1
186593,150,15,135,1,4
186593,150,15,135,2,1
186593,150,15,135,3,1
186593,31,3,28,4,1
186593,119,12,107,5,1
186593,119,12,107,20,1
186593,116,11,105,21,4
186593,116,11,105,22,1
186593,116,11,105,23,1
186593,22,1,21,24,1
186593,94,10,84,25,1
186593,94,10,84,40,1
186593,34,4,30,41,4
186593,34,4,30,42,1
186593,34,4,30,43,1
186593,9,2,7,44,1
186593,25,2,23,45,1
186593,25,2,23,60,1
186618,1552,178,1374,1,4
186618,987,75,912,2,1
186618,947,69,878,3,1
186618,124,0,124,4,1
186618,823,69,754,5,1
186618,40,6,34,11,1
186618,565,103,462,12,3
186618,99,20,79,19,1
186618,724,49,675,20,1
186618,697,53,644,21,4
186618,554,20,534,22,1
186618,551,20,531,23,1
186618,124,0,124,24,1
186618,427,20,407,25,1
186618,3,0,3,31,1
186618,143,33,110,32,3
186618,33,8,25,39,1
186618,394,12,382,40,1
186618,855,125,730,41,4
186618,433,55,378,42,1
186618,396,49,347,43,1
186618,396,49,347,45,1
186618,37,6,31,51,1
186618,422,70,352,52,3
186618,66,12,54,59,1
186618,330,37,293,60,1
186645,8405,4056,4349,1,4
186645,8405,4056,4349,2,1
186645,7246,3558,3688,3,1
186645,1586,860,726,4,1
186645,5660,2698,2962,5,1
186645,1159,498,661,11,1
186645,447,190,257,19,1
186645,5213,2508,2705,20,1
186645,3600,1937,1663,21,4
186645,3600,1937,1663,22,1
186645,3535,1908,1627,23,1
186645,1260,694,566,24,1
186645,2275,1214,1061,25,1
186645,65,29,36,31,1
186645,226,112,114,39,1
186645,2049,1102,947,40,1
186645,4805,2119,2686,41,4
186645,4805,2119,2686,42,1
186645,3711,1650,2061,43,1
186645,326,166,160,44,1
186645,3385,1484,1901,45,1
186645,1094,469,625,51,1
186645,221,78,143,59,1
186645,3164,1406,1758,60,1
186867,5784,4261,1523,1,4
186867,2691,1933,758,2,1
186867,2662,1914,748,3,1
186867,622,438,184,4,1
186867,2040,1476,564,5,1
186867,29,19,10,11,1
186867,3093,2328,765,12,3
186867,2040,1476,564,20,1
186867,4180,3013,1167,21,4
186867,2661,1913,748,22,1
186867,2661,1913,748,23,1
186867,622,438,184,24,1
186867,2039,1475,564,25,1
186867,1519,1100,419,32,3
186867,2039,1475,564,40,1
186867,1604,1248,356,41,4
186867,30,20,10,42,1
186867,1,1,0,43,1
186867,1,1,0,45,1
186867,29,19,10,51,1
186867,1574,1228,346,52,3
186867,1,1,0,60,1
186876,8458,3279,5179,1,4
186876,7539,3060,4479,2,1
186876,7491,3037,4454,3,1
186876,1069,427,642,4,1
186876,6422,2610,3812,5,1
186876,48,23,25,11,1
186876,919,219,700,12,3
186876,1036,405,631,19,1
186876,5386,2205,3181,20,1
186876,7272,2899,4373,21,4
186876,6953,2824,4129,22,1
186876,6950,2822,4128,23,1
186876,1066,427,639,24,1
186876,5884,2395,3489,25,1
186876,3,2,1,31,1
186876,319,75,244,32,3
186876,957,382,575,39,1
186876,4927,2013,2914,40,1
186876,1186,380,806,41,4
186876,586,236,350,42,1
186876,541,215,326,43,1
186876,3,0,3,44,1
186876,538,215,323,45,1
186876,45,21,24,51,1
186876,600,144,456,52,3
186876,79,23,56,59,1
186876,459,192,267,60,1
186900,68,68,0,1,4
186900,68,68,0,2,1
186900,68,68,0,3,1
186900,18,18,0,4,1
186900,50,50,0,5,1
186900,32,32,0,19,1
186900,18,18,0,20,1
186900,68,68,0,21,4
186900,68,68,0,22,1
186900,68,68,0,23,1
186900,18,18,0,24,1
186900,50,50,0,25,1
186900,32,32,0,39,1
186900,18,18,0,40,1
187000,157,153,4,1,4
187000,157,153,4,2,1
187000,157,153,4,3,1
187000,57,56,1,4,1
187000,100,97,3,5,1
187000,100,97,3,20,1
187000,157,153,4,21,4
187000,157,153,4,22,1
187000,157,153,4,23,1
187000,57,56,1,24,1
187000,100,97,3,25,1
187000,100,97,3,40,1
187046,20877,10816,10061,1,4
187046,19596,10434,9162,2,1
187046,19596,10434,9162,3,1
187046,19596,10434,9162,5,1
187046,1281,382,899,12,3
187046,7846,4224,3622,19,1
187046,11750,6210,5540,20,1
187046,138,68,70,21,4
187046,138,68,70,22,1
187046,138,68,70,23,1
187046,138,68,70,25,1
187046,67,29,38,39,1
187046,71,39,32,40,1
187046,20739,10748,9991,41,4
187046,19458,10366,9092,42,1
187046,19458,10366,9092,43,1
187046,19458,10366,9092,45,1
187046,1281,382,899,52,3
187046,7779,4195,3584,59,1
187046,11679,6171,5508,60,1
187134,7340,2958,4382,1,4
187134,6653,2851,3802,2,1
187134,6446,2764,3682,3,1
187134,1404,546,858,4,1
187134,5042,2218,2824,5,1
187134,207,87,120,11,1
187134,687,107,580,12,3
187134,254,112,142,19,1
187134,4788,2106,2682,20,1
187134,6653,2808,3845,21,4
187134,6455,2775,3680,22,1
187134,6309,2700,3609,23,1
187134,1402,544,858,24,1
187134,4907,2156,2751,25,1
187134,146,75,71,31,1
187134,198,33,165,32,3
187134,251,111,140,39,1
187134,4656,2045,2611,40,1
187134,687,150,537,41,4
187134,198,76,122,42,1
187134,137,64,73,43,1
187134,2,2,0,44,1
187134,135,62,73,45,1
187134,61,12,49,51,1
187134,489,74,415,52,3
187134,3,1,2,59,1
187134,132,61,71,60,1
187161,735,84,651,1,4
187161,735,84,651,2,1
187161,735,84,651,3,1
187161,156,12,144,4,1
187161,579,72,507,5,1
187161,579,72,507,20,1
187161,735,84,651,21,4
187161,735,84,651,22,1
187161,735,84,651,23,1
187161,156,12,144,24,1
187161,579,72,507,25,1
187161,579,72,507,40,1
187198,11969,4570,7399,1,4
187198,11969,4570,7399,2,1
187198,11437,4318,7119,3,1
187198,2316,1071,1245,4,1
187198,9121,3247,5874,5,1
187198,532,252,280,11,1
187198,657,209,448,19,1
187198,8464,3038,5426,20,1
187198,5713,2380,3333,21,4
187198,5713,2380,3333,22,1
187198,5606,2319,3287,23,1
187198,1790,804,986,24,1
187198,3816,1515,2301,25,1
187198,107,61,46,31,1
187198,258,101,157,39,1
187198,3558,1414,2144,40,1
187198,6256,2190,4066,41,4
187198,6256,2190,4066,42,1
187198,5831,1999,3832,43,1
187198,526,267,259,44,1
187198,5305,1732,3573,45,1
187198,425,191,234,51,1
187198,399,108,291,59,1
187198,4906,1624,3282,60,1
187444,11414,4904,6510,1,4
187444,10027,4562,5465,2,1
187444,9930,4509,5421,3,1
187444,1295,635,660,4,1
187444,8635,3874,4761,5,1
187444,97,53,44,11,1
187444,1387,342,1045,12,3
187444,1442,625,817,19,1
187444,7193,3249,3944,20,1
187444,8575,3854,4721,21,4
187444,8269,3763,4506,22,1
187444,8248,3757,4491,23,1
187444,1289,630,659,24,1
187444,6959,3127,3832,25,1
187444,21,6,15,31,1
187444,306,91,215,32,3
187444,1141,500,641,39,1
187444,5818,2627,3191,40,1
187444,2839,1050,1789,41,4
187444,1758,799,959,42,1
187444,1682,752,930,43,1
187444,6,5,1,44,1
187444,1676,747,929,45,1
187444,76,47,29,51,1
187444,1081,251,830,52,3
187444,301,125,176,59,1
187444,1375,622,753,60,1
187505,1017,71,946,1,4
187505,1017,71,946,2,1
187505,1017,71,946,3,1
187505,350,20,330,4,1
187505,667,51,616,5,1
187505,667,51,616,20,1
187505,1017,71,946,21,4
187505,1017,71,946,22,1
187505,1017,71,946,23,1
187505,350,20,330,24,1
187505,667,51,616,25,1
187505,667,51,616,40,1
187532,28891,12835,16056,1,4
187532,28891,12835,16056,2,1
187532,25090,11061,14029,3,1
187532,4033,2049,1984,4,1
187532,21057,9012,12045,5,1
187532,3801,1774,2027,11,1
187532,1658,723,935,19,1
187532,19399,8289,11110,20,1
187532,9546,4515,5031,21,4
187532,9546,4515,5031,22,1
187532,9407,4454,4953,23,1
187532,2410,1175,1235,24,1
187532,6997,3279,3718,25,1
187532,139,61,78,31,1
187532,671,325,346,39,1
187532,6326,2954,3372,40,1
187532,19345,8320,11025,41,4
187532,19345,8320,11025,42,1
187532,15683,6607,9076,43,1
187532,1623,874,749,44,1
187532,14060,5733,8327,45,1
187532,3662,1713,1949,51,1
187532,987,398,589,59,1
187532,13073,5335,7738,60,1
187596,1956,841,1115,1,4
187596,1956,841,1115,2,1
187596,1654,716,938,3,1
187596,373,181,192,4,1
187596,1281,535,746,5,1
187596,302,125,177,11,1
187596,84,22,62,19,1
187596,1197,513,684,20,1
187596,1271,585,686,21,4
187596,1271,585,686,22,1
187596,1269,583,686,23,1
187596,292,149,143,24,1
187596,977,434,543,25,1
187596,2,2,0,31,1
187596,59,19,40,39,1
187596,918,415,503,40,1
187596,685,256,429,41,4
187596,685,256,429,42,1
187596,385,133,252,43,1
187596,81,32,49,44,1
187596,304,101,203,45,1
187596,300,123,177,51,1
187596,25,3,22,59,1
187596,279,98,181,60,1
187602,86,13,73,1,4
187602,86,13,73,2,1
187602,86,13,73,3,1
187602,15,2,13,4,1
187602,71,11,60,5,1
187602,71,11,60,20,1
187602,86,13,73,21,4
187602,86,13,73,22,1
187602,86,13,73,23,1
187602,15,2,13,24,1
187602,71,11,60,25,1
187602,71,11,60,40,1
187620,8837,3798,5039,1,4
187620,8837,3798,5039,2,1
187620,6677,2860,3817,3,1
187620,1373,663,710,4,1
187620,5304,2197,3107,5,1
187620,2160,938,1222,11,1
187620,300,144,156,19,1
187620,5004,2053,2951,20,1
187620,4197,1865,2332,21,4
187620,4197,1865,2332,22,1
187620,4068,1803,2265,23,1
187620,1112,541,571,24,1
187620,2956,1262,1694,25,1
187620,129,62,67,31,1
187620,158,77,81,39,1
187620,2798,1185,1613,40,1
187620,4640,1933,2707,41,4
187620,4640,1933,2707,42,1
187620,2609,1057,1552,43,1
187620,261,122,139,44,1
187620,2348,935,1413,45,1
187620,2031,876,1155,51,1
187620,142,67,75,59,1
187620,2206,868,1338,60,1
187639,3596,1214,2382,1,4
187639,3596,1214,2382,2,1
187639,2021,563,1458,3,1
187639,438,137,301,4,1
187639,1583,426,1157,5,1
187639,1575,651,924,11,1
187639,189,49,140,19,1
187639,1394,377,1017,20,1
187639,905,275,630,21,4
187639,905,275,630,22,1
187639,880,262,618,23,1
187639,327,102,225,24,1
187639,553,160,393,25,1
187639,25,13,12,31,1
187639,57,17,40,39,1
187639,496,143,353,40,1
187639,2691,939,1752,41,4
187639,2691,939,1752,42,1
187639,1141,301,840,43,1
187639,111,35,76,44,1
187639,1030,266,764,45,1
187639,1550,638,912,51,1
187639,132,32,100,59,1
187639,898,234,664,60,1
187648,5847,2320,3527,1,4
187648,4567,1998,2569,2,1
187648,3767,1585,2182,3,1
187648,661,316,345,4,1
187648,3106,1269,1837,5,1
187648,800,413,387,11,1
187648,1280,322,958,12,3
187648,441,172,269,19,1
187648,2665,1097,1568,20,1
187648,3002,1250,1752,21,4
187648,2759,1204,1555,22,1
187648,2746,1202,1544,23,1
187648,654,313,341,24,1
187648,2092,889,1203,25,1
187648,13,2,11,31,1
187648,243,46,197,32,3
187648,280,115,165,39,1
187648,1812,774,1038,40,1
187648,2845,1070,1775,41,4
187648,1808,794,1014,42,1
187648,1021,383,638,43,1
187648,7,3,4,44,1
187648,1014,380,634,45,1
187648,787,411,376,51,1
187648,1037,276,761,52,3
187648,161,57,104,59,1
187648,853,323,530,60,1
187666,3883,1920,1963,1,4
187666,3883,1920,1963,2,1
187666,2134,832,1302,3,1
187666,523,219,304,4,1
187666,1611,613,998,5,1
187666,1749,1088,661,11,1
187666,173,88,85,19,1
187666,1438,525,913,20,1
187666,1155,513,642,21,4
187666,1155,513,642,22,1
187666,1069,446,623,23,1
187666,396,162,234,24,1
187666,673,284,389,25,1
187666,86,67,19,31,1
187666,79,41,38,39,1
187666,594,243,351,40,1
187666,2728,1407,1321,41,4
187666,2728,1407,1321,42,1
187666,1065,386,679,43,1
187666,127,57,70,44,1
187666,938,329,609,45,1
187666,1663,1021,642,51,1
187666,94,47,47,59,1
187666,844,282,562,60,1
187745,422,174,248,1,4
187745,392,161,231,2,1
187745,225,93,132,3,1
187745,41,19,22,4,1
187745,184,74,110,5,1
187745,167,68,99,11,1
187745,30,13,17,12,3
187745,23,13,10,19,1
187745,161,61,100,20,1
187745,192,76,116,21,4
187745,163,63,100,22,1
187745,162,63,99,23,1
187745,17,5,12,24,1
187745,145,58,87,25,1
187745,1,0,1,31,1
187745,29,13,16,32,3
187745,17,9,8,39,1
187745,128,49,79,40,1
187745,230,98,132,41,4
187745,229,98,131,42,1
187745,63,30,33,43,1
187745,24,14,10,44,1
187745,39,16,23,45,1
187745,166,68,98,51,1
187745,1,0,1,52,3
187745,6,4,2,59,1
187745,33,12,21,60,1
187897,3690,1374,2316,1,4
187897,2396,966,1430,2,1
187897,2221,900,1321,3,1
187897,353,190,163,4,1
187897,1868,710,1158,5,1
187897,175,66,109,11,1
187897,1294,408,886,12,3
187897,459,160,299,19,1
187897,1409,550,859,20,1
187897,2224,927,1297,21,4
187897,1646,753,893,22,1
187897,1630,741,889,23,1
187897,349,190,159,24,1
187897,1281,551,730,25,1
187897,16,12,4,31,1
187897,578,174,404,32,3
187897,293,125,168,39,1
187897,988,426,562,40,1
187897,1466,447,1019,41,4
187897,750,213,537,42,1
187897,591,159,432,43,1
187897,4,0,4,44,1
187897,587,159,428,45,1
187897,159,54,105,51,1
187897,716,234,482,52,3
187897,166,35,131,59,1
187897,421,124,297,60,1
187903,2320,1026,1294,1,4
187903,2320,1026,1294,2,1
187903,1500,622,878,3,1
187903,468,245,223,4,1
187903,1032,377,655,5,1
187903,820,404,416,11,1
187903,58,24,34,19,1
187903,974,353,621,20,1
187903,940,385,555,21,4
187903,940,385,555,22,1
187903,878,359,519,23,1
187903,264,130,134,24,1
187903,614,229,385,25,1
187903,62,26,36,31,1
187903,32,14,18,39,1
187903,582,215,367,40,1
187903,1380,641,739,41,4
187903,1380,641,739,42,1
187903,622,263,359,43,1
187903,204,115,89,44,1
187903,418,148,270,45,1
187903,758,378,380,51,1
187903,26,10,16,59,1
187903,392,138,254,60,1
187912,470,393,77,1,4
187912,470,393,77,2,1
187912,470,393,77,3,1
187912,261,223,38,4,1
187912,209,170,39,5,1
187912,43,32,11,19,1
187912,166,138,28,20,1
187912,470,393,77,21,4
187912,470,393,77,22,1
187912,470,393,77,23,1
187912,261,223,38,24,1
187912,209,170,39,25,1
187912,43,32,11,39,1
187912,166,138,28,40,1
187958,2675,957,1718,1,4
187958,2675,957,1718,2,1
187958,2233,761,1472,3,1
187958,415,183,232,4,1
187958,1818,578,1240,5,1
187958,442,196,246,11,1
187958,78,28,50,19,1
187958,1740,550,1190,20,1
187958,1252,465,787,21,4
187958,1252,465,787,22,1
187958,1206,451,755,23,1
187958,292,121,171,24,1
187958,914,330,584,25,1
187958,46,14,32,31,1
187958,38,14,24,39,1
187958,876,316,560,40,1
187958,1423,492,931,41,4
187958,1423,492,931,42,1
187958,1027,310,717,43,1
187958,123,62,61,44,1
187958,904,248,656,45,1
187958,396,182,214,51,1
187958,40,14,26,59,1
187958,864,234,630,60,1
187967,2134,1416,718,1,4
187967,1604,1117,487,2,1
187967,1490,1085,405,3,1
187967,318,242,76,4,1
187967,1172,843,329,5,1
187967,114,32,82,11,1
187967,530,299,231,12,3
187967,102,70,32,19,1
187967,1070,773,297,20,1
187967,1651,1179,472,21,4
187967,1418,1027,391,22,1
187967,1418,1027,391,23,1
187967,316,240,76,24,1
187967,1102,787,315,25,1
187967,233,152,81,32,3
187967,98,66,32,39,1
187967,1004,721,283,40,1
187967,483,237,246,41,4
187967,186,90,96,42,1
187967,72,58,14,43,1
187967,2,2,0,44,1
187967,70,56,14,45,1
187967,114,32,82,51,1
187967,297,147,150,52,3
187967,4,4,0,59,1
187967,66,52,14,60,1
187976,744,323,421,1,4
187976,744,323,421,2,1
187976,541,219,322,3,1
187976,76,39,37,4,1
187976,465,180,285,5,1
187976,203,104,99,11,1
187976,45,15,30,19,1
187976,420,165,255,20,1
187976,191,98,93,21,4
187976,191,98,93,22,1
187976,180,91,89,23,1
187976,62,33,29,24,1
187976,118,58,60,25,1
187976,11,7,4,31,1
187976,10,4,6,39,1
187976,108,54,54,40,1
187976,553,225,328,41,4
187976,553,225,328,42,1
187976,361,128,233,43,1
187976,14,6,8,44,1
187976,347,122,225,45,1
187976,192,97,95,51,1
187976,35,11,24,59,1
187976,312,111,201,60,1
187985,28592,12685,15907,1,4
187985,22416,9939,12477,2,1
187985,20847,9279,11568,3,1
187985,3517,1518,1999,4,1
187985,17330,7761,9569,5,1
187985,1569,660,909,11,1
187985,6176,2746,3430,12,3
187985,1250,588,662,19,1
187985,16080,7173,8907,20,1
187985,20668,9316,11352,21,4
187985,17091,7702,9389,22,1
187985,16826,7576,9250,23,1
187985,3470,1493,1977,24,1
187985,13356,6083,7273,25,1
187985,265,126,139,31,1
187985,3577,1614,1963,32,3
187985,841,420,421,39,1
187985,12515,5663,6852,40,1
187985,7924,3369,4555,41,4
187985,5325,2237,3088,42,1
187985,4021,1703,2318,43,1
187985,47,25,22,44,1
187985,3974,1678,2296,45,1
187985,1304,534,770,51,1
187985,2599,1132,1467,52,3
187985,409,168,241,59,1
187985,3565,1510,2055,60,1
187994,2458,929,1529,1,4
187994,2458,929,1529,2,1
187994,1379,547,832,3,1
187994,290,122,168,4,1
187994,1089,425,664,5,1
187994,1079,382,697,11,1
187994,112,54,58,19,1
187994,977,371,606,20,1
187994,875,370,505,21,4
187994,875,370,505,22,1
187994,861,364,497,23,1
187994,235,105,130,24,1
187994,626,259,367,25,1
187994,14,6,8,31,1
187994,65,32,33,39,1
187994,561,227,334,40,1
187994,1583,559,1024,41,4
187994,1583,559,1024,42,1
187994,518,183,335,43,1
187994,55,17,38,44,1
187994,463,166,297,45,1
187994,1065,376,689,51,1
187994,47,22,25,59,1
187994,416,144,272,60,1
188003,1861,640,1221,1,4
188003,1861,640,1221,2,1
188003,806,233,573,3,1
188003,215,72,143,4,1
188003,591,161,430,5,1
188003,1055,407,648,11,1
188003,61,24,37,19,1
188003,530,137,393,20,1
188003,534,160,374,21,4
188003,534,160,374,22,1
188003,516,154,362,23,1
188003,194,66,128,24,1
188003,322,88,234,25,1
188003,18,6,12,31,1
188003,33,14,19,39,1
188003,289,74,215,40,1
188003,1327,480,847,41,4
188003,1327,480,847,42,1
188003,290,79,211,43,1
188003,21,6,15,44,1
188003,269,73,196,45,1
188003,1037,401,636,51,1
188003,28,10,18,59,1
188003,241,63,178,60,1
188021,970,352,618,1,4
188021,970,352,618,2,1
188021,512,169,343,3,1
188021,104,40,64,4,1
188021,408,129,279,5,1
188021,458,183,275,11,1
188021,28,8,20,19,1
188021,380,121,259,20,1
188021,329,121,208,21,4
188021,329,121,208,22,1
188021,318,117,201,23,1
188021,80,31,49,24,1
188021,238,86,152,25,1
188021,11,4,7,31,1
188021,22,6,16,39,1
188021,216,80,136,40,1
188021,641,231,410,41,4
188021,641,231,410,42,1
188021,194,52,142,43,1
188021,24,9,15,44,1
188021,170,43,127,45,1
188021,447,179,268,51,1
188021,6,2,4,59,1
188021,164,41,123,60,1
188030,16765,7690,9075,1,4
188030,13582,6365,7217,2,1
188030,12886,6097,6789,3,1
188030,1918,888,1030,4,1
188030,10968,5209,5759,5,1
188030,696,268,428,11,1
188030,3183,1325,1858,12,3
188030,646,365,281,19,1
188030,10322,4844,5478,20,1
188030,13006,6135,6871,21,4
188030,11297,5366,5931,22,1
188030,11215,5331,5884,23,1
188030,1902,881,1021,24,1
188030,9313,4450,4863,25,1
188030,82,35,47,31,1
188030,1709,769,940,32,3
188030,544,317,227,39,1
188030,8769,4133,4636,40,1
188030,3759,1555,2204,41,4
188030,2285,999,1286,42,1
188030,1671,766,905,43,1
188030,16,7,9,44,1
188030,1655,759,896,45,1
188030,614,233,381,51,1
188030,1474,556,918,52,3
188030,102,48,54,59,1
188030,1553,711,842,60,1
188049,2245,806,1439,1,4
188049,2245,806,1439,2,1
188049,1775,627,1148,3,1
188049,329,133,196,4,1
188049,1446,494,952,5,1
188049,470,179,291,11,1
188049,61,16,45,19,1
188049,1385,478,907,20,1
188049,998,369,629,21,4
188049,998,369,629,22,1
188049,984,366,618,23,1
188049,270,105,165,24,1
188049,714,261,453,25,1
188049,14,3,11,31,1
188049,24,5,19,39,1
188049,690,256,434,40,1
188049,1247,437,810,41,4
188049,1247,437,810,42,1
188049,791,261,530,43,1
188049,59,28,31,44,1
188049,732,233,499,45,1
188049,456,176,280,51,1
188049,37,11,26,59,1
188049,695,222,473,60,1
188058,1681,717,964,1,4
188058,1653,709,944,2,1
188058,1173,470,703,3,1
188058,168,72,96,4,1
188058,1005,398,607,5,1
188058,480,239,241,11,1
188058,28,8,20,12,3
188058,64,29,35,19,1
188058,941,369,572,20,1
188058,822,348,474,21,4
188058,821,347,474,22,1
188058,793,334,459,23,1
188058,150,66,84,24,1
188058,643,268,375,25,1
188058,28,13,15,31,1
188058,1,1,0,32,3
188058,42,20,22,39,1
188058,601,248,353,40,1
188058,859,369,490,41,4
188058,832,362,470,42,1
188058,380,136,244,43,1
188058,18,6,12,44,1
188058,362,130,232,45,1
188058,452,226,226,51,1
188058,27,7,20,52,3
188058,22,9,13,59,1
188058,340,121,219,60,1
188100,8938,4251,4687,1,4
188100,8938,4251,4687,2,1
188100,6090,2273,3817,3,1
188100,904,411,493,4,1
188100,5186,1862,3324,5,1
188100,2848,1978,870,11,1
188100,377,91,286,19,1
188100,4809,1771,3038,20,1
188100,2954,1248,1706,21,4
188100,2954,1248,1706,22,1
188100,2917,1227,1690,23,1
188100,700,326,374,24,1
188100,2217,901,1316,25,1
188100,37,21,16,31,1
188100,132,48,84,39,1
188100,2085,853,1232,40,1
188100,5984,3003,2981,41,4
188100,5984,3003,2981,42,1
188100,3173,1046,2127,43,1
188100,204,85,119,44,1
188100,2969,961,2008,45,1
188100,2811,1957,854,51,1
188100,245,43,202,59,1
188100,2724,918,1806,60,1
188137,6265,2445,3820,1,4
188137,6265,2445,3820,2,1
188137,4173,1609,2564,3,1
188137,703,302,401,4,1
188137,3470,1307,2163,5,1
188137,2092,836,1256,11,1
188137,375,144,231,19,1
188137,3095,1163,1932,20,1
188137,1775,733,1042,21,4
188137,1775,733,1042,22,1
188137,1697,689,1008,23,1
188137,438,186,252,24,1
188137,1259,503,756,25,1
188137,78,44,34,31,1
188137,97,38,59,39,1
188137,1162,465,697,40,1
188137,4490,1712,2778,41,4
188137,4490,1712,2778,42,1
188137,2476,920,1556,43,1
188137,265,116,149,44,1
188137,2211,804,1407,45,1
188137,2014,792,1222,51,1
188137,278,106,172,59,1
188137,1933,698,1235,60,1
188146,826,385,441,1,4
188146,826,385,441,2,1
188146,659,322,337,3,1
188146,201,88,113,4,1
188146,458,234,224,5,1
188146,167,63,104,11,1
188146,72,42,30,19,1
188146,386,192,194,20,1
188146,819,381,438,21,4
188146,819,381,438,22,1
188146,655,320,335,23,1
188146,201,88,113,24,1
188146,454,232,222,25,1
188146,164,61,103,31,1
188146,72,42,30,39,1
188146,382,190,192,40,1
188146,7,4,3,41,4
188146,7,4,3,42,1
188146,4,2,2,43,1
188146,4,2,2,45,1
188146,3,2,1,51,1
188146,4,2,2,60,1
188182,923,312,611,1,4
188182,318,160,158,2,1
188182,318,160,158,3,1
188182,50,23,27,4,1
188182,268,137,131,5,1
188182,605,152,453,12,3
188182,89,48,41,19,1
188182,179,89,90,20,1
188182,359,150,209,21,4
188182,201,108,93,22,1
188182,201,108,93,23,1
188182,48,22,26,24,1
188182,153,86,67,25,1
188182,158,42,116,32,3
188182,42,26,16,39,1
188182,111,60,51,40,1
188182,564,162,402,41,4
188182,117,52,65,42,1
188182,117,52,65,43,1
188182,2,1,1,44,1
188182,115,51,64,45,1
188182,447,110,337,52,3
188182,47,22,25,59,1
188182,68,29,39,60,1
188207,161,10,151,1,4
188207,161,10,151,12,3
188207,84,4,80,21,4
188207,84,4,80,32,3
188207,77,6,71,41,4
188207,77,6,71,52,3
188216,530,237,293,1,4
188216,530,237,293,2,1
188216,519,233,286,3,1
188216,134,66,68,4,1
188216,385,167,218,5,1
188216,11,4,7,11,1
188216,48,19,29,19,1
188216,337,148,189,20,1
188216,464,222,242,21,4
188216,464,222,242,22,1
188216,460,220,240,23,1
188216,123,65,58,24,1
188216,337,155,182,25,1
188216,4,2,2,31,1
188216,43,18,25,39,1
188216,294,137,157,40,1
188216,66,15,51,41,4
188216,66,15,51,42,1
188216,59,13,46,43,1
188216,11,1,10,44,1
188216,48,12,36,45,1
188216,7,2,5,51,1
188216,5,1,4,59,1
188216,43,11,32,60,1
188225,1802,733,1069,1,4
188225,1802,733,1069,2,1
188225,941,357,584,3,1
188225,128,61,67,4,1
188225,813,296,517,5,1
188225,861,376,485,11,1
188225,22,11,11,19,1
188225,791,285,506,20,1
188225,522,214,308,21,4
188225,522,214,308,22,1
188225,504,206,298,23,1
188225,101,48,53,24,1
188225,403,158,245,25,1
188225,18,8,10,31,1
188225,14,6,8,39,1
188225,389,152,237,40,1
188225,1280,519,761,41,4
188225,1280,519,761,42,1
188225,437,151,286,43,1
188225,27,13,14,44,1
188225,410,138,272,45,1
188225,843,368,475,51,1
188225,8,5,3,59,1
188225,402,133,269,60,1
188261,697,439,258,1,4
188261,697,439,258,2,1
188261,598,391,207,3,1
188261,61,43,18,4,1
188261,537,348,189,5,1
188261,99,48,51,11,1
188261,39,19,20,19,1
188261,498,329,169,20,1
188261,231,154,77,21,4
188261,231,154,77,22,1
188261,211,145,66,23,1
188261,55,38,17,24,1
188261,156,107,49,25,1
188261,20,9,11,31,1
188261,27,14,13,39,1
188261,129,93,36,40,1
188261,466,285,181,41,4
188261,466,285,181,42,1
188261,387,246,141,43,1
188261,6,5,1,44,1
188261,381,241,140,45,1
188261,79,39,40,51,1
188261,12,5,7,59,1
188261,369,236,133,60,1
188289,76,20,56,1,4
188289,76,20,56,2,1
188289,76,20,56,3,1
188289,26,6,20,4,1
188289,50,14,36,5,1
188289,50,14,36,20,1
188289,67,12,55,21,4
188289,67,12,55,22,1
188289,67,12,55,23,1
188289,21,2,19,24,1
188289,46,10,36,25,1
188289,46,10,36,40,1
188289,9,8,1,41,4
188289,9,8,1,42,1
188289,9,8,1,43,1
188289,5,4,1,44,1
188289,4,4,0,45,1
188289,4,4,0,60,1
188304,3560,1375,2185,1,4
188304,2849,1122,1727,2,1
188304,2166,810,1356,3,1
188304,403,198,205,4,1
188304,1763,612,1151,5,1
188304,683,312,371,11,1
188304,711,253,458,12,3
188304,204,89,115,19,1
188304,1559,523,1036,20,1
188304,1669,675,994,21,4
188304,1510,627,883,22,1
188304,1498,618,880,23,1
188304,342,169,173,24,1
188304,1156,449,707,25,1
188304,12,9,3,31,1
188304,159,48,111,32,3
188304,119,59,60,39,1
188304,1037,390,647,40,1
188304,1891,700,1191,41,4
188304,1339,495,844,42,1
188304,668,192,476,43,1
188304,61,29,32,44,1
188304,607,163,444,45,1
188304,671,303,368,51,1
188304,552,205,347,52,3
188304,85,30,55,59,1
188304,522,133,389,60,1
188340,1741,1524,217,1,4
188340,1724,1511,213,2,1
188340,1721,1509,212,3,1
188340,302,270,32,4,1
188340,1419,1239,180,5,1
188340,3,2,1,11,1
188340,17,13,4,12,3
188340,183,168,15,19,1
188340,1236,1071,165,20,1
188340,1308,1140,168,21,4
188340,1308,1140,168,22,1
188340,1308,1140,168,23,1
188340,278,246,32,24,1
188340,1030,894,136,25,1
188340,168,154,14,39,1
188340,862,740,122,40,1
188340,433,384,49,41,4
188340,416,371,45,42,1
188340,413,369,44,43,1
188340,24,24,0,44,1
188340,389,345,44,45,1
188340,3,2,1,51,1
188340,17,13,4,52,3
188340,15,14,1,59,1
188340,374,331,43,60,1
188429,7645,2068,5577,1,4
188429,5040,1539,3501,2,1
188429,5000,1527,3473,3,1
188429,918,300,618,4,1
188429,4082,1227,2855,5,1
188429,40,12,28,11,1
188429,2605,529,2076,12,3
188429,510,136,374,19,1
188429,3572,1091,2481,20,1
188429,6034,1693,4341,21,4
188429,4531,1394,3137,22,1
188429,4524,1392,3132,23,1
188429,903,295,608,24,1
188429,3621,1097,2524,25,1
188429,7,2,5,31,1
188429,1503,299,1204,32,3
188429,429,117,312,39,1
188429,3192,980,2212,40,1
188429,1611,375,1236,41,4
188429,509,145,364,42,1
188429,476,135,341,43,1
188429,15,5,10,44,1
188429,461,130,331,45,1
188429,33,10,23,51,1
188429,1102,230,872,52,3
188429,81,19,62,59,1
188429,380,111,269,60,1
188438,4230,1799,2431,1,4
188438,4230,1799,2431,2,1
188438,3614,1558,2056,3,1
188438,1087,537,550,4,1
188438,2527,1021,1506,5,1
188438,616,241,375,11,1
188438,248,119,129,19,1
188438,2279,902,1377,20,1
188438,2588,1196,1392,21,4
188438,2588,1196,1392,22,1
188438,2573,1192,1381,23,1
188438,989,487,502,24,1
188438,1584,705,879,25,1
188438,15,4,11,31,1
188438,184,91,93,39,1
188438,1400,614,786,40,1
188438,1642,603,1039,41,4
188438,1642,603,1039,42,1
188438,1041,366,675,43,1
188438,98,50,48,44,1
188438,943,316,627,45,1
188438,601,237,364,51,1
188438,64,28,36,59,1
188438,879,288,591,60,1
188465,557,357,200,1,4
188465,557,357,200,2,1
188465,551,355,196,3,1
188465,223,148,75,4,1
188465,328,207,121,5,1
188465,6,2,4,11,1
188465,67,51,16,19,1
188465,261,156,105,20,1
188465,532,346,186,21,4
188465,532,346,186,22,1
188465,528,345,183,23,1
188465,222,148,74,24,1
188465,306,197,109,25,1
188465,4,1,3,31,1
188465,67,51,16,39,1
188465,239,146,93,40,1
188465,25,11,14,41,4
188465,25,11,14,42,1
188465,23,10,13,43,1
188465,1,0,1,44,1
188465,22,10,12,45,1
188465,2,1,1,51,1
188465,22,10,12,60,1
188517,580,128,452,1,4
188517,580,128,452,2,1
188517,568,124,444,3,1
188517,64,20,44,4,1
188517,504,104,400,5,1
188517,12,4,8,11,1
188517,90,27,63,19,1
188517,414,77,337,20,1
188517,346,82,264,21,4
188517,346,82,264,22,1
188517,346,82,264,23,1
188517,62,18,44,24,1
188517,284,64,220,25,1
188517,83,26,57,39,1
188517,201,38,163,40,1
188517,234,46,188,41,4
188517,234,46,188,42,1
188517,222,42,180,43,1
188517,2,2,0,44,1
188517,220,40,180,45,1
188517,12,4,8,51,1
188517,7,1,6,59,1
188517,213,39,174,60,1
188526,1639,658,981,1,4
188526,1078,427,651,2,1
188526,1075,427,648,3,1
188526,243,88,155,4,1
188526,832,339,493,5,1
188526,3,0,3,11,1
188526,561,231,330,12,3
188526,125,45,80,19,1
188526,707,294,413,20,1
188526,1599,644,955,21,4
188526,1059,421,638,22,1
188526,1057,421,636,23,1
188526,243,88,155,24,1
188526,814,333,481,25,1
188526,2,0,2,31,1
188526,540,223,317,32,3
188526,113,41,72,39,1
188526,701,292,409,40,1
188526,40,14,26,41,4
188526,19,6,13,42,1
188526,18,6,12,43,1
188526,18,6,12,45,1
188526,1,0,1,51,1
188526,21,8,13,52,3
188526,12,4,8,59,1
188526,6,2,4,60,1
188535,594,299,295,1,4
188535,594,299,295,12,3
188535,538,279,259,21,4
188535,538,279,259,32,3
188535,56,20,36,41,4
188535,56,20,36,52,3
188580,830,381,449,1,4
188580,830,381,449,12,3
188580,830,381,449,21,4
188580,830,381,449,32,3
188641,2431,1120,1311,1,4
188641,1960,963,997,2,1
188641,1905,944,961,3,1
188641,535,300,235,4,1
188641,1370,644,726,5,1
188641,55,19,36,11,1
188641,471,157,314,12,3
188641,49,25,24,19,1
188641,1321,619,702,20,1
188641,2079,1009,1070,21,4
188641,1909,939,970,22,1
188641,1884,931,953,23,1
188641,535,300,235,24,1
188641,1349,631,718,25,1
188641,25,8,17,31,1
188641,170,70,100,32,3
188641,45,23,22,39,1
188641,1304,608,696,40,1
188641,352,111,241,41,4
188641,51,24,27,42,1
188641,21,13,8,43,1
188641,21,13,8,45,1
188641,30,11,19,51,1
188641,301,87,214,52,3
188641,4,2,2,59,1
188641,17,11,6,60,1
188650,742,72,670,1,4
188650,742,72,670,2,1
188650,742,72,670,3,1
188650,303,22,281,4,1
188650,439,50,389,5,1
188650,439,50,389,20,1
188650,574,56,518,21,4
188650,574,56,518,22,1
188650,574,56,518,23,1
188650,234,17,217,24,1
188650,340,39,301,25,1
188650,340,39,301,40,1
188650,168,16,152,41,4
188650,168,16,152,42,1
188650,168,16,152,43,1
188650,69,5,64,44,1
188650,99,11,88,45,1
188650,99,11,88,60,1
188669,91,13,78,1,4
188669,91,13,78,2,1
188669,91,13,78,3,1
188669,27,3,24,4,1
188669,64,10,54,5,1
188669,64,10,54,20,1
188669,91,13,78,21,4
188669,91,13,78,22,1
188669,91,13,78,23,1
188669,27,3,24,24,1
188669,64,10,54,25,1
188669,64,10,54,40,1
188678,216,74,142,1,4
188678,216,74,142,2,1
188678,216,74,142,3,1
188678,99,37,62,4,1
188678,117,37,80,5,1
188678,40,11,29,19,1
188678,77,26,51,20,1
188678,216,74,142,21,4
188678,216,74,142,22,1
188678,216,74,142,23,1
188678,99,37,62,24,1
188678,117,37,80,25,1
188678,40,11,29,39,1
188678,77,26,51,40,1
188687,408,185,223,1,4
188687,408,185,223,2,1
188687,408,185,223,3,1
188687,37,14,23,4,1
188687,371,171,200,5,1
188687,114,56,58,19,1
188687,257,115,142,20,1
188687,100,49,51,21,4
188687,100,49,51,22,1
188687,100,49,51,23,1
188687,20,5,15,24,1
188687,80,44,36,25,1
188687,39,21,18,39,1
188687,41,23,18,40,1
188687,308,136,172,41,4
188687,308,136,172,42,1
188687,308,136,172,43,1
188687,17,9,8,44,1
188687,291,127,164,45,1
188687,75,35,40,59,1
188687,216,92,124,60,1
188696,230,26,204,1,4
188696,230,26,204,2,1
188696,230,26,204,3,1
188696,139,18,121,4,1
188696,91,8,83,5,1
188696,91,8,83,20,1
188696,230,26,204,21,4
188696,230,26,204,22,1
188696,230,26,204,23,1
188696,139,18,121,24,1
188696,91,8,83,25,1
188696,91,8,83,40,1
188854,1365,447,918,1,4
188854,1365,447,918,2,1
188854,1365,447,918,3,1
188854,462,128,334,4,1
188854,903,319,584,5,1
188854,11,3,8,19,1
188854,892,316,576,20,1
188854,1365,447,918,21,4
188854,1365,447,918,22,1
188854,1365,447,918,23,1
188854,462,128,334,24,1
188854,903,319,584,25,1
188854,11,3,8,39,1
188854,892,316,576,40,1
188890,1292,1272,20,1,4
188890,1292,1272,20,2,1
188890,1292,1272,20,3,1
188890,1274,1254,20,4,1
188890,18,18,0,5,1
188890,18,18,0,20,1
188890,976,959,17,21,4
188890,976,959,17,22,1
188890,976,959,17,23,1
188890,965,948,17,24,1
188890,11,11,0,25,1
188890,11,11,0,40,1
188890,316,313,3,41,4
188890,316,313,3,42,1
188890,316,313,3,43,1
188890,309,306,3,44,1
188890,7,7,0,45,1
188890,7,7,0,60,1
188915,79,8,71,1,4
188915,79,8,71,2,1
188915,79,8,71,3,1
188915,9,2,7,4,1
188915,70,6,64,5,1
188915,70,6,64,20,1
188915,76,8,68,21,4
188915,76,8,68,22,1
188915,76,8,68,23,1
188915,9,2,7,24,1
188915,67,6,61,25,1
188915,67,6,61,40,1
188915,3,0,3,41,4
188915,3,0,3,42,1
188915,3,0,3,43,1
188915,3,0,3,45,1
188915,3,0,3,60,1
188942,106,0,106,1,4
188942,106,0,106,2,1
188942,106,0,106,3,1
188942,26,0,26,4,1
188942,80,0,80,5,1
188942,80,0,80,20,1
188942,106,0,106,21,4
188942,106,0,106,22,1
188942,106,0,106,23,1
188942,26,0,26,24,1
188942,80,0,80,25,1
188942,80,0,80,40,1
188988,270,91,179,1,4
188988,270,91,179,2,1
188988,270,91,179,3,1
188988,91,31,60,4,1
188988,179,60,119,5,1
188988,179,60,119,20,1
188988,270,91,179,21,4
188988,270,91,179,22,1
188988,270,91,179,23,1
188988,91,31,60,24,1
188988,179,60,119,25,1
188988,179,60,119,40,1
189015,846,110,736,1,4
189015,846,110,736,12,3
189015,355,43,312,21,4
189015,355,43,312,32,3
189015,491,67,424,41,4
189015,491,67,424,52,3
189088,2355,1028,1327,1,4
189088,2014,892,1122,2,1
189088,1957,866,1091,3,1
189088,489,229,260,4,1
189088,1468,637,831,5,1
189088,57,26,31,11,1
189088,341,136,205,12,3
189088,65,27,38,19,1
189088,1403,610,793,20,1
189088,2229,969,1260,21,4
189088,1916,845,1071,22,1
189088,1896,840,1056,23,1
189088,489,229,260,24,1
189088,1407,611,796,25,1
189088,20,5,15,31,1
189088,313,124,189,32,3
189088,65,27,38,39,1
189088,1342,584,758,40,1
189088,126,59,67,41,4
189088,98,47,51,42,1
189088,61,26,35,43,1
189088,61,26,35,45,1
189088,37,21,16,51,1
189088,28,12,16,52,3
189088,61,26,35,60,1
189097,2489,0,2489,1,4
189097,2489,0,2489,2,1
189097,2486,0,2486,3,1
189097,580,0,580,4,1
189097,1906,0,1906,5,1
189097,3,0,3,11,1
189097,70,0,70,19,1
189097,1836,0,1836,20,1
189097,2463,0,2463,21,4
189097,2463,0,2463,22,1
189097,2460,0,2460,23,1
189097,576,0,576,24,1
189097,1884,0,1884,25,1
189097,3,0,3,31,1
189097,70,0,70,39,1
189097,1814,0,1814,40,1
189097,26,0,26,41,4
189097,26,0,26,42,1
189097,26,0,26,43,1
189097,4,0,4,44,1
189097,22,0,22,45,1
189097,22,0,22,60,1
189219,265,264,1,1,4
189219,265,264,1,2,1
189219,265,264,1,3,1
189219,113,113,0,4,1
189219,152,151,1,5,1
189219,152,151,1,20,1
189219,265,264,1,21,4
189219,265,264,1,22,1
189219,265,264,1,23,1
189219,113,113,0,24,1
189219,152,151,1,25,1
189219,152,151,1,40,1
189228,4596,1644,2952,1,4
189228,4596,1644,2952,2,1
189228,4551,1628,2923,3,1
189228,737,306,431,4,1
189228,3814,1322,2492,5,1
189228,45,16,29,11,1
189228,502,151,351,19,1
189228,3312,1171,2141,20,1
189228,4058,1484,2574,21,4
189228,4058,1484,2574,22,1
189228,4026,1474,2552,23,1
189228,704,294,410,24,1
189228,3322,1180,2142,25,1
189228,32,10,22,31,1
189228,479,145,334,39,1
189228,2843,1035,1808,40,1
189228,538,160,378,41,4
189228,538,160,378,42,1
189228,525,154,371,43,1
189228,33,12,21,44,1
189228,492,142,350,45,1
189228,13,6,7,51,1
189228,23,6,17,59,1
189228,469,136,333,60,1
189264,47,47,0,1,4
189264,47,47,0,2,1
189264,47,47,0,3,1
189264,9,9,0,4,1
189264,38,38,0,5,1
189264,12,12,0,19,1
189264,26,26,0,20,1
189264,47,47,0,21,4
189264,47,47,0,22,1
189264,47,47,0,23,1
189264,9,9,0,24,1
189264,38,38,0,25,1
189264,12,12,0,39,1
189264,26,26,0,40,1
189273,55,55,0,1,4
189273,49,49,0,2,1
189273,49,49,0,3,1
189273,18,18,0,4,1
189273,31,31,0,5,1
189273,6,6,0,12,3
189273,8,8,0,19,1
189273,23,23,0,20,1
189273,55,55,0,21,4
189273,49,49,0,22,1
189273,49,49,0,23,1
189273,18,18,0,24,1
189273,31,31,0,25,1
189273,6,6,0,32,3
189273,8,8,0,39,1
189273,23,23,0,40,1
189282,269,42,227,1,4
189282,269,42,227,2,1
189282,269,42,227,3,1
189282,5,2,3,4,1
189282,264,40,224,5,1
189282,105,9,96,19,1
189282,159,31,128,20,1
189282,24,6,18,21,4
189282,24,6,18,22,1
189282,24,6,18,23,1
189282,2,0,2,24,1
189282,22,6,16,25,1
189282,6,2,4,39,1
189282,16,4,12,40,1
189282,245,36,209,41,4
189282,245,36,209,42,1
189282,245,36,209,43,1
189282,3,2,1,44,1
189282,242,34,208,45,1
189282,99,7,92,59,1
189282,143,27,116,60,1
189404,200,10,190,1,4
189404,200,10,190,2,1
189404,200,10,190,3,1
189404,9,0,9,4,1
189404,191,10,181,5,1
189404,191,10,181,20,1
189404,142,9,133,21,4
189404,142,9,133,22,1
189404,142,9,133,23,1
189404,7,0,7,24,1
189404,135,9,126,25,1
189404,135,9,126,40,1
189404,58,1,57,41,4
189404,58,1,57,42,1
189404,58,1,57,43,1
189404,2,0,2,44,1
189404,56,1,55,45,1
189404,56,1,55,60,1
189413,1118,255,863,1,4
189413,1050,243,807,2,1
189413,1050,243,807,3,1
189413,220,53,167,4,1
189413,830,190,640,5,1
189413,68,12,56,12,3
189413,101,21,80,19,1
189413,729,169,560,20,1
189413,1118,255,863,21,4
189413,1050,243,807,22,1
189413,1050,243,807,23,1
189413,220,53,167,24,1
189413,830,190,640,25,1
189413,68,12,56,32,3
189413,101,21,80,39,1
189413,729,169,560,40,1
189422,796,302,494,1,4
189422,796,302,494,2,1
189422,675,243,432,3,1
189422,179,76,103,4,1
189422,496,167,329,5,1
189422,121,59,62,11,1
189422,41,15,26,19,1
189422,455,152,303,20,1
189422,635,226,409,21,4
189422,635,226,409,22,1
189422,635,226,409,23,1
189422,177,75,102,24,1
189422,458,151,307,25,1
189422,41,15,26,39,1
189422,417,136,281,40,1
189422,161,76,85,41,4
189422,161,76,85,42,1
189422,40,17,23,43,1
189422,2,1,1,44,1
189422,38,16,22,45,1
189422,121,59,62,51,1
189422,38,16,22,60,1
189459,1886,664,1222,1,4
189459,1886,664,1222,2,1
189459,1885,664,1221,3,1
189459,217,92,125,4,1
189459,1668,572,1096,5,1
189459,1,0,1,11,1
189459,231,32,199,19,1
189459,1437,540,897,20,1
189459,1459,536,923,21,4
189459,1459,536,923,22,1
189459,1459,536,923,23,1
189459,200,87,113,24,1
189459,1259,449,810,25,1
189459,163,25,138,39,1
189459,1096,424,672,40,1
189459,427,128,299,41,4
189459,427,128,299,42,1
189459,426,128,298,43,1
189459,17,5,12,44,1
189459,409,123,286,45,1
189459,1,0,1,51,1
189459,68,7,61,59,1
189459,341,116,225,60,1
189468,144,2,142,1,4
189468,144,2,142,2,1
189468,144,2,142,3,1
189468,61,1,60,4,1
189468,83,1,82,5,1
189468,83,1,82,20,1
189468,111,2,109,21,4
189468,111,2,109,22,1
189468,111,2,109,23,1
189468,57,1,56,24,1
189468,54,1,53,25,1
189468,54,1,53,40,1
189468,33,0,33,41,4
189468,33,0,33,42,1
189468,33,0,33,43,1
189468,4,0,4,44,1
189468,29,0,29,45,1
189468,29,0,29,60,1
189477,194,6,188,1,4
189477,194,6,188,2,1
189477,194,6,188,3,1
189477,107,4,103,4,1
189477,87,2,85,5,1
189477,87,2,85,20,1
189477,96,3,93,21,4
189477,96,3,93,22,1
189477,96,3,93,23,1
189477,54,2,52,24,1
189477,42,1,41,25,1
189477,42,1,41,40,1
189477,98,3,95,41,4
189477,98,3,95,42,1
189477,98,3,95,43,1
189477,53,2,51,44,1
189477,45,1,44,45,1
189477,45,1,44,60,1
189501,1135,628,507,1,4
189501,1135,628,507,12,3
189501,915,497,418,21,4
189501,915,497,418,32,3
189501,220,131,89,41,4
189501,220,131,89,52,3
189547,5894,2561,3333,1,4
189547,5894,2561,3333,2,1
189547,5425,2380,3045,3,1
189547,1538,743,795,4,1
189547,3887,1637,2250,5,1
189547,469,181,288,11,1
189547,342,136,206,19,1
189547,3545,1501,2044,20,1
189547,4192,1935,2257,21,4
189547,4192,1935,2257,22,1
189547,4131,1911,2220,23,1
189547,1433,704,729,24,1
189547,2698,1207,1491,25,1
189547,61,24,37,31,1
189547,249,108,141,39,1
189547,2449,1099,1350,40,1
189547,1702,626,1076,41,4
189547,1702,626,1076,42,1
189547,1294,469,825,43,1
189547,105,39,66,44,1
189547,1189,430,759,45,1
189547,408,157,251,51,1
189547,93,28,65,59,1
189547,1096,402,694,60,1
189556,413,91,322,1,4
189556,413,91,322,2,1
189556,400,87,313,3,1
189556,41,12,29,4,1
189556,359,75,284,5,1
189556,13,4,9,11,1
189556,77,18,59,19,1
189556,282,57,225,20,1
189556,246,46,200,21,4
189556,246,46,200,22,1
189556,246,46,200,23,1
189556,37,9,28,24,1
189556,209,37,172,25,1
189556,58,13,45,39,1
189556,151,24,127,40,1
189556,167,45,122,41,4
189556,167,45,122,42,1
189556,154,41,113,43,1
189556,4,3,1,44,1
189556,150,38,112,45,1
189556,13,4,9,51,1
189556,19,5,14,59,1
189556,131,33,98,60,1
189565,452,112,340,1,4
189565,452,112,340,2,1
189565,444,109,335,3,1
189565,44,14,30,4,1
189565,400,95,305,5,1
189565,8,3,5,11,1
189565,65,16,49,19,1
189565,335,79,256,20,1
189565,295,78,217,21,4
189565,295,78,217,22,1
189565,295,78,217,23,1
189565,41,14,27,24,1
189565,254,64,190,25,1
189565,59,16,43,39,1
189565,195,48,147,40,1
189565,157,34,123,41,4
189565,157,34,123,42,1
189565,149,31,118,43,1
189565,3,0,3,44,1
189565,146,31,115,45,1
189565,8,3,5,51,1
189565,6,0,6,59,1
189565,140,31,109,60,1
189574,522,163,359,1,4
189574,522,163,359,2,1
189574,520,162,358,3,1
189574,94,32,62,4,1
189574,426,130,296,5,1
189574,2,1,1,11,1
189574,82,35,47,19,1
189574,344,95,249,20,1
189574,392,127,265,21,4
189574,392,127,265,22,1
189574,392,127,265,23,1
189574,93,31,62,24,1
189574,299,96,203,25,1
189574,75,32,43,39,1
189574,224,64,160,40,1
189574,130,36,94,41,4
189574,130,36,94,42,1
189574,128,35,93,43,1
189574,1,1,0,44,1
189574,127,34,93,45,1
189574,2,1,1,51,1
189574,7,3,4,59,1
189574,120,31,89,60,1
189583,740,206,534,1,4
189583,740,206,534,2,1
189583,716,194,522,3,1
189583,89,30,59,4,1
189583,627,164,463,5,1
189583,24,12,12,11,1
189583,116,38,78,19,1
189583,511,126,385,20,1
189583,449,125,324,21,4
189583,449,125,324,22,1
189583,449,125,324,23,1
189583,75,25,50,24,1
189583,374,100,274,25,1
189583,100,33,67,39,1
189583,274,67,207,40,1
189583,291,81,210,41,4
189583,291,81,210,42,1
189583,267,69,198,43,1
189583,14,5,9,44,1
189583,253,64,189,45,1
189583,24,12,12,51,1
189583,16,5,11,59,1
189583,237,59,178,60,1
189592,389,89,300,1,4
189592,389,89,300,2,1
189592,381,88,293,3,1
189592,51,24,27,4,1
189592,330,64,266,5,1
189592,8,1,7,11,1
189592,80,16,64,19,1
189592,250,48,202,20,1
189592,268,67,201,21,4
189592,268,67,201,22,1
189592,268,67,201,23,1
189592,46,22,24,24,1
189592,222,45,177,25,1
189592,65,13,52,39,1
189592,157,32,125,40,1
189592,121,22,99,41,4
189592,121,22,99,42,1
189592,113,21,92,43,1
189592,5,2,3,44,1
189592,108,19,89,45,1
189592,8,1,7,51,1
189592,15,3,12,59,1
189592,93,16,77,60,1
189653,56,2,54,1,4
189653,56,2,54,2,1
189653,56,2,54,3,1
189653,4,1,3,4,1
189653,52,1,51,5,1
189653,9,0,9,19,1
189653,43,1,42,20,1
189653,29,2,27,21,4
189653,29,2,27,22,1
189653,29,2,27,23,1
189653,4,1,3,24,1
189653,25,1,24,25,1
189653,8,0,8,39,1
189653,17,1,16,40,1
189653,27,0,27,41,4
189653,27,0,27,42,1
189653,27,0,27,43,1
189653,27,0,27,45,1
189653,1,0,1,59,1
189653,26,0,26,60,1
189705,4537,2078,2459,1,4
189705,3084,1533,1551,2,1
189705,2858,1347,1511,3,1
189705,682,319,363,4,1
189705,2176,1028,1148,5,1
189705,226,186,40,11,1
189705,1453,545,908,12,3
189705,119,62,57,19,1
189705,2057,966,1091,20,1
189705,3443,1557,1886,21,4
189705,2825,1328,1497,22,1
189705,2800,1317,1483,23,1
189705,680,319,361,24,1
189705,2120,998,1122,25,1
189705,25,11,14,31,1
189705,618,229,389,32,3
189705,116,60,56,39,1
189705,2004,938,1066,40,1
189705,1094,521,573,41,4
189705,259,205,54,42,1
189705,58,30,28,43,1
189705,2,0,2,44,1
189705,56,30,26,45,1
189705,201,175,26,51,1
189705,835,316,519,52,3
189705,3,2,1,59,1
189705,53,28,25,60,1
189714,238,6,232,1,4
189714,238,6,232,2,1
189714,238,6,232,3,1
189714,42,3,39,4,1
189714,196,3,193,5,1
189714,196,3,193,20,1
189714,181,4,177,21,4
189714,181,4,177,22,1
189714,181,4,177,23,1
189714,33,2,31,24,1
189714,148,2,146,25,1
189714,148,2,146,40,1
189714,57,2,55,41,4
189714,57,2,55,42,1
189714,57,2,55,43,1
189714,9,1,8,44,1
189714,48,1,47,45,1
189714,48,1,47,60,1
189811,592,85,507,1,4
189811,592,85,507,2,1
189811,592,85,507,3,1
189811,33,9,24,4,1
189811,559,76,483,5,1
189811,136,22,114,19,1
189811,423,54,369,20,1
189811,287,46,241,21,4
189811,287,46,241,22,1
189811,287,46,241,23,1
189811,29,7,22,24,1
189811,258,39,219,25,1
189811,53,11,42,39,1
189811,205,28,177,40,1
189811,305,39,266,41,4
189811,305,39,266,42,1
189811,305,39,266,43,1
189811,4,2,2,44,1
189811,301,37,264,45,1
189811,83,11,72,59,1
189811,218,26,192,60,1
189839,4410,1692,2718,1,4
189839,4410,1692,2718,2,1
189839,2982,1121,1861,3,1
189839,686,294,392,4,1
189839,2296,827,1469,5,1
189839,1428,571,857,11,1
189839,331,123,208,19,1
189839,1965,704,1261,20,1
189839,2235,865,1370,21,4
189839,2235,865,1370,22,1
189839,2223,857,1366,23,1
189839,615,259,356,24,1
189839,1608,598,1010,25,1
189839,12,8,4,31,1
189839,255,101,154,39,1
189839,1353,497,856,40,1
189839,2175,827,1348,41,4
189839,2175,827,1348,42,1
189839,759,264,495,43,1
189839,71,35,36,44,1
189839,688,229,459,45,1
189839,1416,563,853,51,1
189839,76,22,54,59,1
189839,612,207,405,60,1
189848,1077,297,780,1,4
189848,1077,297,780,2,1
189848,1031,283,748,3,1
189848,345,91,254,4,1
189848,686,192,494,5,1
189848,46,14,32,11,1
189848,36,14,22,19,1
189848,650,178,472,20,1
189848,937,261,676,21,4
189848,937,261,676,22,1
189848,937,261,676,23,1
189848,345,91,254,24,1
189848,592,170,422,25,1
189848,36,14,22,39,1
189848,556,156,400,40,1
189848,140,36,104,41,4
189848,140,36,104,42,1
189848,94,22,72,43,1
189848,94,22,72,45,1
189848,46,14,32,51,1
189848,94,22,72,60,1
189857,731,731,0,1,4
189857,650,650,0,2,1
189857,650,650,0,3,1
189857,92,92,0,4,1
189857,558,558,0,5,1
189857,81,81,0,12,3
189857,286,286,0,19,1
189857,272,272,0,20,1
189857,731,731,0,21,4
189857,650,650,0,22,1
189857,650,650,0,23,1
189857,92,92,0,24,1
189857,558,558,0,25,1
189857,81,81,0,32,3
189857,286,286,0,39,1
189857,272,272,0,40,1
189954,56,25,31,1,4
189954,56,25,31,2,1
189954,56,25,31,3,1
189954,15,9,6,4,1
189954,41,16,25,5,1
189954,41,16,25,20,1
189954,56,25,31,21,4
189954,56,25,31,22,1
189954,56,25,31,23,1
189954,15,9,6,24,1
189954,41,16,25,25,1
189954,41,16,25,40,1
189981,96,64,32,1,4
189981,96,64,32,12,3
189981,22,20,2,21,4
189981,22,20,2,32,3
189981,74,44,30,41,4
189981,74,44,30,52,3
190008,78,31,47,1,4
190008,78,31,47,2,1
190008,78,31,47,3,1
190008,14,5,9,4,1
190008,64,26,38,5,1
190008,64,26,38,20,1
190008,78,31,47,21,4
190008,78,31,47,22,1
190008,78,31,47,23,1
190008,14,5,9,24,1
190008,64,26,38,25,1
190008,64,26,38,40,1
190044,3726,2616,1110,1,4
190044,3110,2229,881,2,1
190044,3060,2202,858,3,1
190044,757,522,235,4,1
190044,2303,1680,623,5,1
190044,50,27,23,11,1
190044,616,387,229,12,3
190044,131,107,24,19,1
190044,2172,1573,599,20,1
190044,3602,2529,1073,21,4
190044,3084,2214,870,22,1
190044,3049,2195,854,23,1
190044,757,522,235,24,1
190044,2292,1673,619,25,1
190044,35,19,16,31,1
190044,518,315,203,32,3
190044,131,107,24,39,1
190044,2161,1566,595,40,1
190044,124,87,37,41,4
190044,26,15,11,42,1
190044,11,7,4,43,1
190044,11,7,4,45,1
190044,15,8,7,51,1
190044,98,72,26,52,3
190044,11,7,4,60,1
190053,1990,950,1040,1,4
190053,1990,950,1040,2,1
190053,1315,628,687,3,1
190053,342,156,186,4,1
190053,973,472,501,5,1
190053,675,322,353,11,1
190053,107,62,45,19,1
190053,866,410,456,20,1
190053,1092,559,533,21,4
190053,1092,559,533,22,1
190053,983,490,493,23,1
190053,321,148,173,24,1
190053,662,342,320,25,1
190053,109,69,40,31,1
190053,82,50,32,39,1
190053,580,292,288,40,1
190053,898,391,507,41,4
190053,898,391,507,42,1
190053,332,138,194,43,1
190053,21,8,13,44,1
190053,311,130,181,45,1
190053,566,253,313,51,1
190053,25,12,13,59,1
190053,286,118,168,60,1
190071,79,12,67,1,4
190071,79,12,67,2,1
190071,79,12,67,3,1
190071,79,12,67,5,1
190071,29,3,26,19,1
190071,50,9,41,20,1
190071,10,3,7,21,4
190071,10,3,7,22,1
190071,10,3,7,23,1
190071,10,3,7,25,1
190071,10,3,7,40,1
190071,69,9,60,41,4
190071,69,9,60,42,1
190071,69,9,60,43,1
190071,69,9,60,45,1
190071,29,3,26,59,1
190071,40,6,34,60,1
190080,87,39,48,1,4
190080,87,39,48,12,3
190080,59,30,29,21,4
190080,59,30,29,32,3
190080,28,9,19,41,4
190080,28,9,19,52,3
190099,2900,1297,1603,1,4
190099,2890,1293,1597,2,1
190099,2872,1287,1585,3,1
190099,759,319,440,4,1
190099,2113,968,1145,5,1
190099,18,6,12,11,1
190099,10,4,6,12,3
190099,7,3,4,19,1
190099,2106,965,1141,20,1
190099,2877,1289,1588,21,4
190099,2871,1287,1584,22,1
190099,2871,1287,1584,23,1
190099,759,319,440,24,1
190099,2112,968,1144,25,1
190099,6,2,4,32,3
190099,7,3,4,39,1
190099,2105,965,1140,40,1
190099,23,8,15,41,4
190099,19,6,13,42,1
190099,1,0,1,43,1
190099,1,0,1,45,1
190099,18,6,12,51,1
190099,4,2,2,52,3
190099,1,0,1,60,1
190114,1255,379,876,1,4
190114,911,266,645,2,1
190114,911,266,645,3,1
190114,115,30,85,4,1
190114,796,236,560,5,1
190114,344,113,231,12,3
190114,137,29,108,19,1
190114,659,207,452,20,1
190114,1164,342,822,21,4
190114,851,246,605,22,1
190114,851,246,605,23,1
190114,113,29,84,24,1
190114,738,217,521,25,1
190114,313,96,217,32,3
190114,129,27,102,39,1
190114,609,190,419,40,1
190114,91,37,54,41,4
190114,60,20,40,42,1
190114,60,20,40,43,1
190114,2,1,1,44,1
190114,58,19,39,45,1
190114,31,17,14,52,3
190114,8,2,6,59,1
190114,50,17,33,60,1
190150,26957,13303,13654,1,4
190150,7970,4185,3785,2,1
190150,7970,4185,3785,3,1
190150,1509,737,772,4,1
190150,6461,3448,3013,5,1
190150,18987,9118,9869,12,3
190150,571,364,207,19,1
190150,5890,3084,2806,20,1
190150,22731,11243,11488,21,4
190150,7374,3881,3493,22,1
190150,7374,3881,3493,23,1
190150,1476,719,757,24,1
190150,5898,3162,2736,25,1
190150,15357,7362,7995,32,3
190150,491,325,166,39,1
190150,5407,2837,2570,40,1
190150,4226,2060,2166,41,4
190150,596,304,292,42,1
190150,596,304,292,43,1
190150,33,18,15,44,1
190150,563,286,277,45,1
190150,3630,1756,1874,52,3
190150,80,39,41,59,1
190150,483,247,236,60,1
190169,2118,780,1338,1,4
190169,2118,780,1338,2,1
190169,1549,550,999,3,1
190169,403,167,236,4,1
190169,1146,383,763,5,1
190169,569,230,339,11,1
190169,129,39,90,19,1
190169,1017,344,673,20,1
190169,964,413,551,21,4
190169,964,413,551,22,1
190169,963,413,550,23,1
190169,339,138,201,24,1
190169,624,275,349,25,1
190169,1,0,1,31,1
190169,71,30,41,39,1
190169,553,245,308,40,1
190169,1154,367,787,41,4
190169,1154,367,787,42,1
190169,586,137,449,43,1
190169,64,29,35,44,1
190169,522,108,414,45,1
190169,568,230,338,51,1
190169,58,9,49,59,1
190169,464,99,365,60,1
190239,215,7,208,1,4
190239,215,7,208,2,1
190239,215,7,208,3,1
190239,61,2,59,4,1
190239,154,5,149,5,1
190239,154,5,149,20,1
190239,156,6,150,21,4
190239,156,6,150,22,1
190239,156,6,150,23,1
190239,44,2,42,24,1
190239,112,4,108,25,1
190239,112,4,108,40,1
190239,59,1,58,41,4
190239,59,1,58,42,1
190239,59,1,58,43,1
190239,17,0,17,44,1
190239,42,1,41,45,1
190239,42,1,41,60,1
190248,953,305,648,1,4
190248,887,292,595,2,1
190248,856,283,573,3,1
190248,153,56,97,4,1
190248,703,227,476,5,1
190248,31,9,22,11,1
190248,66,13,53,12,3
190248,34,11,23,19,1
190248,669,216,453,20,1
190248,868,286,582,21,4
190248,812,275,537,22,1
190248,810,273,537,23,1
190248,153,56,97,24,1
190248,657,217,440,25,1
190248,2,2,0,31,1
190248,56,11,45,32,3
190248,34,11,23,39,1
190248,623,206,417,40,1
190248,85,19,66,41,4
190248,75,17,58,42,1
190248,46,10,36,43,1
190248,46,10,36,45,1
190248,29,7,22,51,1
190248,10,2,8,52,3
190248,46,10,36,60,1
190293,124,11,113,1,4
190293,124,11,113,2,1
190293,124,11,113,3,1
190293,5,0,5,4,1
190293,119,11,108,5,1
190293,119,11,108,20,1
190293,83,11,72,21,4
190293,83,11,72,22,1
190293,83,11,72,23,1
190293,4,0,4,24,1
190293,79,11,68,25,1
190293,79,11,68,40,1
190293,41,0,41,41,4
190293,41,0,41,42,1
190293,41,0,41,43,1
190293,1,0,1,44,1
190293,40,0,40,45,1
190293,40,0,40,60,1
190309,36,1,35,1,4
190309,36,1,35,2,1
190309,36,1,35,3,1
190309,1,0,1,4,1
190309,35,1,34,5,1
190309,35,1,34,20,1
190309,36,1,35,21,4
190309,36,1,35,22,1
190309,36,1,35,23,1
190309,1,0,1,24,1
190309,35,1,34,25,1
190309,35,1,34,40,1
190318,332,8,324,1,4
190318,332,8,324,2,1
190318,332,8,324,3,1
190318,48,1,47,4,1
190318,284,7,277,5,1
190318,284,7,277,20,1
190318,208,6,202,21,4
190318,208,6,202,22,1
190318,208,6,202,23,1
190318,38,0,38,24,1
190318,170,6,164,25,1
190318,170,6,164,40,1
190318,124,2,122,41,4
190318,124,2,122,42,1
190318,124,2,122,43,1
190318,10,1,9,44,1
190318,114,1,113,45,1
190318,114,1,113,60,1
190372,920,593,327,1,4
190372,868,557,311,2,1
190372,851,547,304,3,1
190372,178,117,61,4,1
190372,673,430,243,5,1
190372,17,10,7,11,1
190372,52,36,16,12,3
190372,31,15,16,19,1
190372,642,415,227,20,1
190372,903,582,321,21,4
190372,863,556,307,22,1
190372,850,547,303,23,1
190372,178,117,61,24,1
190372,672,430,242,25,1
190372,13,9,4,31,1
190372,40,26,14,32,3
190372,31,15,16,39,1
190372,641,415,226,40,1
190372,17,11,6,41,4
190372,5,1,4,42,1
190372,1,0,1,43,1
190372,1,0,1,45,1
190372,4,1,3,51,1
190372,12,10,2,52,3
190372,1,0,1,60,1
190415,21593,11074,10519,1,4
190415,14393,7050,7343,2,1
190415,14309,7010,7299,3,1
190415,3223,1581,1642,4,1
190415,11086,5429,5657,5,1
190415,84,40,44,11,1
190415,7200,4024,3176,12,3
190415,542,284,258,19,1
190415,10544,5145,5399,20,1
190415,21528,11045,10483,21,4
190415,14380,7048,7332,22,1
190415,14296,7008,7288,23,1
190415,3223,1581,1642,24,1
190415,11073,5427,5646,25,1
190415,84,40,44,31,1
190415,7148,3997,3151,32,3
190415,541,283,258,39,1
190415,10532,5144,5388,40,1
190415,65,29,36,41,4
190415,13,2,11,42,1
190415,13,2,11,43,1
190415,13,2,11,45,1
190415,52,27,25,52,3
190415,1,1,0,59,1
190415,12,1,11,60,1
190424,1043,478,565,1,4
190424,1043,478,565,12,3
190424,1015,467,548,21,4
190424,1015,467,548,32,3
190424,28,11,17,41,4
190424,28,11,17,52,3
190442,4929,2048,2881,1,4
190442,4929,2048,2881,2,1
190442,3229,1341,1888,3,1
190442,1011,450,561,4,1
190442,2218,891,1327,5,1
190442,1700,707,993,11,1
190442,183,77,106,19,1
190442,2035,814,1221,20,1
190442,2375,1055,1320,21,4
190442,2375,1055,1320,22,1
190442,2262,1009,1253,23,1
190442,916,407,509,24,1
190442,1346,602,744,25,1
190442,113,46,67,31,1
190442,129,61,68,39,1
190442,1217,541,676,40,1
190442,2554,993,1561,41,4
190442,2554,993,1561,42,1
190442,967,332,635,43,1
190442,95,43,52,44,1
190442,872,289,583,45,1
190442,1587,661,926,51,1
190442,54,16,38,59,1
190442,818,273,545,60,1
190451,336,36,300,1,4
190451,336,36,300,2,1
190451,336,36,300,3,1
190451,18,2,16,4,1
190451,318,34,284,5,1
190451,318,34,284,20,1
190451,150,12,138,21,4
190451,150,12,138,22,1
190451,150,12,138,23,1
190451,12,1,11,24,1
190451,138,11,127,25,1
190451,138,11,127,40,1
190451,186,24,162,41,4
190451,186,24,162,42,1
190451,186,24,162,43,1
190451,6,1,5,44,1
190451,180,23,157,45,1
190451,180,23,157,60,1
190503,2814,1497,1317,1,4
190503,2814,1497,1317,2,1
190503,2814,1497,1317,3,1
190503,490,252,238,4,1
190503,2324,1245,1079,5,1
190503,219,121,98,19,1
190503,2105,1124,981,20,1
190503,2814,1497,1317,21,4
190503,2814,1497,1317,22,1
190503,2814,1497,1317,23,1
190503,490,252,238,24,1
190503,2324,1245,1079,25,1
190503,219,121,98,39,1
190503,2105,1124,981,40,1
190512,17505,8906,8599,1,4
190512,14082,7275,6807,2,1
190512,13698,7111,6587,3,1
190512,1254,708,546,4,1
190512,12444,6403,6041,5,1
190512,384,164,220,11,1
190512,3423,1631,1792,12,3
190512,1571,737,834,19,1
190512,10873,5666,5207,20,1
190512,11222,5914,5308,21,4
190512,10396,5529,4867,22,1
190512,10393,5528,4865,23,1
190512,1245,702,543,24,1
190512,9148,4826,4322,25,1
190512,3,1,2,31,1
190512,826,385,441,32,3
190512,1214,582,632,39,1
190512,7934,4244,3690,40,1
190512,6283,2992,3291,41,4
190512,3686,1746,1940,42,1
190512,3305,1583,1722,43,1
190512,9,6,3,44,1
190512,3296,1577,1719,45,1
190512,381,163,218,51,1
190512,2597,1246,1351,52,3
190512,357,155,202,59,1
190512,2939,1422,1517,60,1
190521,24186,10333,13853,1,4
190521,24186,10333,13853,2,1
190521,23658,10149,13509,3,1
190521,5403,2420,2983,4,1
190521,18255,7729,10526,5,1
190521,528,184,344,11,1
190521,1073,382,691,19,1
190521,17182,7347,9835,20,1
190521,15889,6990,8899,21,4
190521,15889,6990,8899,22,1
190521,15872,6982,8890,23,1
190521,4528,2019,2509,24,1
190521,11344,4963,6381,25,1
190521,17,8,9,31,1
190521,692,264,428,39,1
190521,10652,4699,5953,40,1
190521,8297,3343,4954,41,4
190521,8297,3343,4954,42,1
190521,7786,3167,4619,43,1
190521,875,401,474,44,1
190521,6911,2766,4145,45,1
190521,511,176,335,51,1
190521,381,118,263,59,1
190521,6530,2648,3882,60,1
190530,11368,4860,6508,1,4
190530,11368,4860,6508,2,1
190530,10577,4542,6035,3,1
190530,1842,904,938,4,1
190530,8735,3638,5097,5,1
190530,791,318,473,11,1
190530,1095,455,640,19,1
190530,7640,3183,4457,20,1
190530,6598,2946,3652,21,4
190530,6598,2946,3652,22,1
190530,6590,2939,3651,23,1
190530,1638,801,837,24,1
190530,4952,2138,2814,25,1
190530,8,7,1,31,1
190530,790,347,443,39,1
190530,4162,1791,2371,40,1
190530,4770,1914,2856,41,4
190530,4770,1914,2856,42,1
190530,3987,1603,2384,43,1
190530,204,103,101,44,1
190530,3783,1500,2283,45,1
190530,783,311,472,51,1
190530,305,108,197,59,1
190530,3478,1392,2086,60,1
190549,17004,6697,10307,1,4
190549,13596,5568,8028,2,1
190549,12625,5203,7422,3,1
190549,1193,514,679,4,1
190549,11432,4689,6743,5,1
190549,971,365,606,11,1
190549,3408,1129,2279,12,3
190549,1946,804,1142,19,1
190549,9486,3885,5601,20,1
190549,10061,4140,5921,21,4
190549,9543,3987,5556,22,1
190549,9464,3958,5506,23,1
190549,1183,509,674,24,1
190549,8281,3449,4832,25,1
190549,79,29,50,31,1
190549,518,153,365,32,3
190549,1550,650,900,39,1
190549,6731,2799,3932,40,1
190549,6943,2557,4386,41,4
190549,4053,1581,2472,42,1
190549,3161,1245,1916,43,1
190549,10,5,5,44,1
190549,3151,1240,1911,45,1
190549,892,336,556,51,1
190549,2890,976,1914,52,3
190549,396,154,242,59,1
190549,2755,1086,1669,60,1
190558,14441,6234,8207,1,4
190558,13465,6000,7465,2,1
190558,12974,5764,7210,3,1
190558,2807,1271,1536,4,1
190558,10167,4493,5674,5,1
190558,491,236,255,11,1
190558,976,234,742,12,3
190558,562,230,332,19,1
190558,9605,4263,5342,20,1
190558,9900,4477,5423,21,4
190558,9784,4450,5334,22,1
190558,9758,4436,5322,23,1
190558,2630,1192,1438,24,1
190558,7128,3244,3884,25,1
190558,26,14,12,31,1
190558,116,27,89,32,3
190558,383,173,210,39,1
190558,6745,3071,3674,40,1
190558,4541,1757,2784,41,4
190558,3681,1550,2131,42,1
190558,3216,1328,1888,43,1
190558,177,79,98,44,1
190558,3039,1249,1790,45,1
190558,465,222,243,51,1
190558,860,207,653,52,3
190558,179,57,122,59,1
190558,2860,1192,1668,60,1
190567,15331,7221,8110,1,4
190567,12501,6028,6473,2,1
190567,11820,5725,6095,3,1
190567,1444,717,727,4,1
190567,10376,5008,5368,5,1
190567,681,303,378,11,1
190567,2830,1193,1637,12,3
190567,1295,600,695,19,1
190567,9081,4408,4673,20,1
190567,9721,4603,5118,21,4
190567,9274,4391,4883,22,1
190567,9202,4360,4842,23,1
190567,1431,710,721,24,1
190567,7771,3650,4121,25,1
190567,72,31,41,31,1
190567,447,212,235,32,3
190567,983,457,526,39,1
190567,6788,3193,3595,40,1
190567,5610,2618,2992,41,4
190567,3227,1637,1590,42,1
190567,2618,1365,1253,43,1
190567,13,7,6,44,1
190567,2605,1358,1247,45,1
190567,609,272,337,51,1
190567,2383,981,1402,52,3
190567,312,143,169,59,1
190567,2293,1215,1078,60,1
190576,6736,2608,4128,1,4
190576,1347,428,919,2,1
190576,1112,347,765,3,1
190576,1112,347,765,5,1
190576,235,81,154,11,1
190576,5389,2180,3209,12,3
190576,325,100,225,19,1
190576,787,247,540,20,1
190576,4454,1845,2609,21,4
190576,296,85,211,22,1
190576,293,83,210,23,1
190576,293,83,210,25,1
190576,3,2,1,31,1
190576,4158,1760,2398,32,3
190576,101,25,76,39,1
190576,192,58,134,40,1
190576,2282,763,1519,41,4
190576,1051,343,708,42,1
190576,819,264,555,43,1
190576,819,264,555,45,1
190576,232,79,153,51,1
190576,1231,420,811,52,3
190576,224,75,149,59,1
190576,595,189,406,60,1
190585,7006,2405,4601,1,4
190585,7006,2405,4601,2,1
190585,6438,2209,4229,3,1
190585,1237,521,716,4,1
190585,5201,1688,3513,5,1
190585,568,196,372,11,1
190585,633,216,417,19,1
190585,4568,1472,3096,20,1
190585,4026,1428,2598,21,4
190585,4026,1428,2598,22,1
190585,4003,1420,2583,23,1
190585,1118,469,649,24,1
190585,2885,951,1934,25,1
190585,23,8,15,31,1
190585,437,158,279,39,1
190585,2448,793,1655,40,1
190585,2980,977,2003,41,4
190585,2980,977,2003,42,1
190585,2435,789,1646,43,1
190585,119,52,67,44,1
190585,2316,737,1579,45,1
190585,545,188,357,51,1
190585,196,58,138,59,1
190585,2120,679,1441,60,1
190594,23019,7396,15623,1,4
190594,16689,5890,10799,2,1
190594,15697,5538,10159,3,1
190594,1976,765,1211,4,1
190594,13721,4773,8948,5,1
190594,992,352,640,11,1
190594,6330,1506,4824,12,3
190594,1885,606,1279,19,1
190594,11836,4167,7669,20,1
190594,13087,4473,8614,21,4
190594,11747,4189,7558,22,1
190594,11674,4160,7514,23,1
190594,1921,736,1185,24,1
190594,9753,3424,6329,25,1
190594,73,29,44,31,1
190594,1340,284,1056,32,3
190594,1284,426,858,39,1
190594,8469,2998,5471,40,1
190594,9932,2923,7009,41,4
190594,4942,1701,3241,42,1
190594,4023,1378,2645,43,1
190594,55,29,26,44,1
190594,3968,1349,2619,45,1
190594,919,323,596,51,1
190594,4990,1222,3768,52,3
190594,601,180,421,59,1
190594,3367,1169,2198,60,1
190600,15010,6437,8573,1,4
190600,13217,5781,7436,2,1
190600,12838,5639,7199,3,1
190600,1861,892,969,4,1
190600,10977,4747,6230,5,1
190600,379,142,237,11,1
190600,1793,656,1137,12,3
190600,1723,763,960,19,1
190600,9254,3984,5270,20,1
190600,10764,4648,6116,21,4
190600,10374,4531,5843,22,1
190600,10370,4531,5839,23,1
190600,1850,888,962,24,1
190600,8520,3643,4877,25,1
190600,4,0,4,31,1
190600,390,117,273,32,3
190600,1442,625,817,39,1
190600,7078,3018,4060,40,1
190600,4246,1789,2457,41,4
190600,2843,1250,1593,42,1
190600,2468,1108,1360,43,1
190600,11,4,7,44,1
190600,2457,1104,1353,45,1
190600,375,142,233,51,1
190600,1403,539,864,52,3
190600,281,138,143,59,1
190600,2176,966,1210,60,1
190619,18634,8404,10230,1,4
190619,18634,8404,10230,2,1
190619,14381,6512,7869,3,1
190619,2647,1325,1322,4,1
190619,11734,5187,6547,5,1
190619,4253,1892,2361,11,1
190619,1692,734,958,19,1
190619,10042,4453,5589,20,1
190619,10734,4916,5818,21,4
190619,10734,4916,5818,22,1
190619,10655,4871,5784,23,1
190619,2534,1271,1263,24,1
190619,8121,3600,4521,25,1
190619,79,45,34,31,1
190619,1349,597,752,39,1
190619,6772,3003,3769,40,1
190619,7900,3488,4412,41,4
190619,7900,3488,4412,42,1
190619,3726,1641,2085,43,1
190619,113,54,59,44,1
190619,3613,1587,2026,45,1
190619,4174,1847,2327,51,1
190619,343,137,206,59,1
190619,3270,1450,1820,60,1
190628,19564,8363,11201,1,4
190628,19564,8363,11201,2,1
190628,16821,7082,9739,3,1
190628,3008,1349,1659,4,1
190628,13813,5733,8080,5,1
190628,2743,1281,1462,11,1
190628,1702,690,1012,19,1
190628,12111,5043,7068,20,1
190628,10455,4531,5924,21,4
190628,10455,4531,5924,22,1
190628,10360,4485,5875,23,1
190628,2530,1135,1395,24,1
190628,7830,3350,4480,25,1
190628,95,46,49,31,1
190628,1174,511,663,39,1
190628,6656,2839,3817,40,1
190628,9109,3832,5277,41,4
190628,9109,3832,5277,42,1
190628,6461,2597,3864,43,1
190628,478,214,264,44,1
190628,5983,2383,3600,45,1
190628,2648,1235,1413,51,1
190628,528,179,349,59,1
190628,5455,2204,3251,60,1
190637,12085,3683,8402,1,4
190637,9886,3133,6753,2,1
190637,9020,2849,6171,3,1
190637,588,220,368,4,1
190637,8432,2629,5803,5,1
190637,866,284,582,11,1
190637,2199,550,1649,12,3
190637,1712,497,1215,19,1
190637,6720,2132,4588,20,1
190637,5916,1962,3954,21,4
190637,5643,1886,3757,22,1
190637,5625,1880,3745,23,1
190637,582,215,367,24,1
190637,5043,1665,3378,25,1
190637,18,6,12,31,1
190637,273,76,197,32,3
190637,1145,344,801,39,1
190637,3898,1321,2577,40,1
190637,6169,1721,4448,41,4
190637,4243,1247,2996,42,1
190637,3395,969,2426,43,1
190637,6,5,1,44,1
190637,3389,964,2425,45,1
190637,848,278,570,51,1
190637,1926,474,1452,52,3
190637,567,153,414,59,1
190637,2822,811,2011,60,1
190646,6477,1706,4771,1,4
190646,6477,1706,4771,2,1
190646,6085,1600,4485,3,1
190646,1045,338,707,4,1
190646,5040,1262,3778,5,1
190646,392,106,286,11,1
190646,559,133,426,19,1
190646,4481,1129,3352,20,1
190646,4267,1200,3067,21,4
190646,4267,1200,3067,22,1
190646,4200,1179,3021,23,1
190646,993,318,675,24,1
190646,3207,861,2346,25,1
190646,67,21,46,31,1
190646,362,102,260,39,1
190646,2845,759,2086,40,1
190646,2210,506,1704,41,4
190646,2210,506,1704,42,1
190646,1885,421,1464,43,1
190646,52,20,32,44,1
190646,1833,401,1432,45,1
190646,325,85,240,51,1
190646,197,31,166,59,1
190646,1636,370,1266,60,1
190655,16860,9373,7487,1,4
190655,16860,9373,7487,2,1
190655,15917,8919,6998,3,1
190655,3353,2093,1260,4,1
190655,12564,6826,5738,5,1
190655,943,454,489,11,1
190655,1275,573,702,19,1
190655,11289,6253,5036,20,1
190655,10318,6157,4161,21,4
190655,10318,6157,4161,22,1
190655,10217,6078,4139,23,1
190655,3119,1937,1182,24,1
190655,7098,4141,2957,25,1
190655,101,79,22,31,1
190655,676,345,331,39,1
190655,6422,3796,2626,40,1
190655,6542,3216,3326,41,4
190655,6542,3216,3326,42,1
190655,5700,2841,2859,43,1
190655,234,156,78,44,1
190655,5466,2685,2781,45,1
190655,842,375,467,51,1
190655,599,228,371,59,1
190655,4867,2457,2410,60,1
190664,18974,7720,11254,1,4
190664,15351,6687,8664,2,1
190664,14424,6359,8065,3,1
190664,1364,632,732,4,1
190664,13060,5727,7333,5,1
190664,927,328,599,11,1
190664,3623,1033,2590,12,3
190664,2177,947,1230,19,1
190664,10883,4780,6103,20,1
190664,11249,4899,6350,21,4
190664,10769,4775,5994,22,1
190664,10755,4771,5984,23,1
190664,1350,622,728,24,1
190664,9405,4149,5256,25,1
190664,14,4,10,31,1
190664,480,124,356,32,3
190664,1641,726,915,39,1
190664,7764,3423,4341,40,1
190664,7725,2821,4904,41,4
190664,4582,1912,2670,42,1
190664,3669,1588,2081,43,1
190664,14,10,4,44,1
190664,3655,1578,2077,45,1
190664,913,324,589,51,1
190664,3143,909,2234,52,3
190664,536,221,315,59,1
190664,3119,1357,1762,60,1
190673,16291,7495,8796,1,4
190673,16291,7495,8796,2,1
190673,14354,6681,7673,3,1
190673,3396,1708,1688,4,1
190673,10958,4973,5985,5,1
190673,1937,814,1123,11,1
190673,899,397,502,19,1
190673,10059,4576,5483,20,1
190673,9626,4625,5001,21,4
190673,9626,4625,5001,22,1
190673,9585,4604,4981,23,1
190673,3055,1544,1511,24,1
190673,6530,3060,3470,25,1
190673,41,21,20,31,1
190673,551,251,300,39,1
190673,5979,2809,3170,40,1
190673,6665,2870,3795,41,4
190673,6665,2870,3795,42,1
190673,4769,2077,2692,43,1
190673,341,164,177,44,1
190673,4428,1913,2515,45,1
190673,1896,793,1103,51,1
190673,348,146,202,59,1
190673,4080,1767,2313,60,1
190682,383,151,232,1,4
190682,383,151,232,12,3
190682,380,150,230,21,4
190682,380,150,230,32,3
190682,3,1,2,41,4
190682,3,1,2,52,3
190691,8307,2889,5418,1,4
190691,8261,2883,5378,2,1
190691,7361,2526,4835,3,1
190691,994,370,624,4,1
190691,6367,2156,4211,5,1
190691,900,357,543,11,1
190691,46,6,40,12,3
190691,760,259,501,19,1
190691,5607,1897,3710,20,1
190691,5199,1827,3372,21,4
190691,5153,1821,3332,22,1
190691,5104,1801,3303,23,1
190691,955,351,604,24,1
190691,4149,1450,2699,25,1
190691,49,20,29,31,1
190691,46,6,40,32,3
190691,491,189,302,39,1
190691,3658,1261,2397,40,1
190691,3108,1062,2046,41,4
190691,3108,1062,2046,42,1
190691,2257,725,1532,43,1
190691,39,19,20,44,1
190691,2218,706,1512,45,1
190691,851,337,514,51,1
190691,269,70,199,59,1
190691,1949,636,1313,60,1
190707,23,4,19,1,4
190707,23,4,19,2,1
190707,23,4,19,3,1
190707,9,1,8,4,1
190707,14,3,11,5,1
190707,14,3,11,20,1
190707,23,4,19,21,4
190707,23,4,19,22,1
190707,23,4,19,23,1
190707,9,1,8,24,1
190707,14,3,11,25,1
190707,14,3,11,40,1
190716,3150,961,2189,1,4
190716,2023,548,1475,2,1
190716,1855,493,1362,3,1
190716,251,65,186,4,1
190716,1604,428,1176,5,1
190716,168,55,113,11,1
190716,1127,413,714,12,3
190716,220,61,159,19,1
190716,1384,367,1017,20,1
190716,2401,764,1637,21,4
190716,1614,435,1179,22,1
190716,1614,435,1179,23,1
190716,251,65,186,24,1
190716,1363,370,993,25,1
190716,787,329,458,32,3
190716,186,52,134,39,1
190716,1177,318,859,40,1
190716,749,197,552,41,4
190716,409,113,296,42,1
190716,241,58,183,43,1
190716,241,58,183,45,1
190716,168,55,113,51,1
190716,340,84,256,52,3
190716,34,9,25,59,1
190716,207,49,158,60,1
190725,2871,746,2125,1,4
190725,2156,585,1571,2,1
190725,1971,534,1437,3,1
190725,411,108,303,4,1
190725,1560,426,1134,5,1
190725,185,51,134,11,1
190725,715,161,554,12,3
190725,319,106,213,19,1
190725,1241,320,921,20,1
190725,2231,628,1603,21,4
190725,1720,500,1220,22,1
190725,1719,499,1220,23,1
190725,409,107,302,24,1
190725,1310,392,918,25,1
190725,1,1,0,31,1
190725,511,128,383,32,3
190725,244,99,145,39,1
190725,1066,293,773,40,1
190725,640,118,522,41,4
190725,436,85,351,42,1
190725,252,35,217,43,1
190725,2,1,1,44,1
190725,250,34,216,45,1
190725,184,50,134,51,1
190725,204,33,171,52,3
190725,75,7,68,59,1
190725,175,27,148,60,1
190752,57,57,0,1,4
190752,57,57,0,2,1
190752,57,57,0,3,1
190752,12,12,0,4,1
190752,45,45,0,5,1
190752,5,5,0,19,1
190752,40,40,0,20,1
190752,57,57,0,21,4
190752,57,57,0,22,1
190752,57,57,0,23,1
190752,12,12,0,24,1
190752,45,45,0,25,1
190752,5,5,0,39,1
190752,40,40,0,40,1
190761,1998,689,1309,1,4
190761,1527,526,1001,2,1
190761,1505,518,987,3,1
190761,286,132,154,4,1
190761,1219,386,833,5,1
190761,22,8,14,11,1
190761,471,163,308,12,3
190761,109,33,76,19,1
190761,1110,353,757,20,1
190761,1441,504,937,21,4
190761,1280,461,819,22,1
190761,1280,461,819,23,1
190761,286,132,154,24,1
190761,994,329,665,25,1
190761,161,43,118,32,3
190761,89,29,60,39,1
190761,905,300,605,40,1
190761,557,185,372,41,4
190761,247,65,182,42,1
190761,225,57,168,43,1
190761,225,57,168,45,1
190761,22,8,14,51,1
190761,310,120,190,52,3
190761,20,4,16,59,1
190761,205,53,152,60,1
190770,3198,1398,1800,1,4
190770,2314,1023,1291,2,1
190770,1708,784,924,3,1
190770,247,129,118,4,1
190770,1461,655,806,5,1
190770,606,239,367,11,1
190770,884,375,509,12,3
190770,139,66,73,19,1
190770,1322,589,733,20,1
190770,1737,831,906,21,4
190770,1455,696,759,22,1
190770,1440,688,752,23,1
190770,236,124,112,24,1
190770,1204,564,640,25,1
190770,15,8,7,31,1
190770,282,135,147,32,3
190770,121,57,64,39,1
190770,1083,507,576,40,1
190770,1461,567,894,41,4
190770,859,327,532,42,1
190770,268,96,172,43,1
190770,11,5,6,44,1
190770,257,91,166,45,1
190770,591,231,360,51,1
190770,602,240,362,52,3
190770,18,9,9,59,1
190770,239,82,157,60,1
190840,10232,4690,5542,1,4
190840,10232,4690,5542,2,1
190840,7228,3357,3871,3,1
190840,2114,1063,1051,4,1
190840,5114,2294,2820,5,1
190840,3004,1333,1671,11,1
190840,326,157,169,19,1
190840,4788,2137,2651,20,1
190840,4893,2389,2504,21,4
190840,4893,2389,2504,22,1
190840,4817,2363,2454,23,1
190840,1941,983,958,24,1
190840,2876,1380,1496,25,1
190840,76,26,50,31,1
190840,265,129,136,39,1
190840,2611,1251,1360,40,1
190840,5339,2301,3038,41,4
190840,5339,2301,3038,42,1
190840,2411,994,1417,43,1
190840,173,80,93,44,1
190840,2238,914,1324,45,1
190840,2928,1307,1621,51,1
190840,61,28,33,59,1
190840,2177,886,1291,60,1
190956,123,21,102,1,4
190956,123,21,102,2,1
190956,123,21,102,3,1
190956,2,0,2,4,1
190956,121,21,100,5,1
190956,121,21,100,20,1
190956,38,4,34,21,4
190956,38,4,34,22,1
190956,38,4,34,23,1
190956,1,0,1,24,1
190956,37,4,33,25,1
190956,37,4,33,40,1
190956,85,17,68,41,4
190956,85,17,68,42,1
190956,85,17,68,43,1
190956,1,0,1,44,1
190956,84,17,67,45,1
190956,84,17,67,60,1
190974,431,76,355,1,4
190974,431,76,355,2,1
190974,431,76,355,3,1
190974,41,7,34,4,1
190974,390,69,321,5,1
190974,97,26,71,19,1
190974,293,43,250,20,1
190974,346,60,286,21,4
190974,346,60,286,22,1
190974,346,60,286,23,1
190974,36,5,31,24,1
190974,310,55,255,25,1
190974,81,22,59,39,1
190974,229,33,196,40,1
190974,85,16,69,41,4
190974,85,16,69,42,1
190974,85,16,69,43,1
190974,5,2,3,44,1
190974,80,14,66,45,1
190974,16,4,12,59,1
190974,64,10,54,60,1
190983,1542,432,1110,1,4
190983,1408,399,1009,2,1
190983,1315,375,940,3,1
190983,318,82,236,4,1
190983,997,293,704,5,1
190983,93,24,69,11,1
190983,134,33,101,12,3
190983,34,12,22,19,1
190983,963,281,682,20,1
190983,1200,348,852,21,4
190983,1188,347,841,22,1
190983,1154,333,821,23,1
190983,318,82,236,24,1
190983,836,251,585,25,1
190983,34,14,20,31,1
190983,12,1,11,32,3
190983,34,12,22,39,1
190983,802,239,563,40,1
190983,342,84,258,41,4
190983,220,52,168,42,1
190983,161,42,119,43,1
190983,161,42,119,45,1
190983,59,10,49,51,1
190983,122,32,90,52,3
190983,161,42,119,60,1
191083,13649,6777,6872,1,4
191083,13649,6777,6872,2,1
191083,11376,5652,5724,3,1
191083,2968,1663,1305,4,1
191083,8408,3989,4419,5,1
191083,2273,1125,1148,11,1
191083,801,355,446,19,1
191083,7607,3634,3973,20,1
191083,9039,4617,4422,21,4
191083,9039,4617,4422,22,1
191083,8900,4527,4373,23,1
191083,2676,1497,1179,24,1
191083,6224,3030,3194,25,1
191083,139,90,49,31,1
191083,639,298,341,39,1
191083,5585,2732,2853,40,1
191083,4610,2160,2450,41,4
191083,4610,2160,2450,42,1
191083,2476,1125,1351,43,1
191083,292,166,126,44,1
191083,2184,959,1225,45,1
191083,2134,1035,1099,51,1
191083,162,57,105,59,1
191083,2022,902,1120,60,1
191126,9755,1503,8252,1,4
191126,9566,1468,8098,2,1
191126,8058,1162,6896,3,1
191126,1304,152,1152,4,1
191126,6754,1010,5744,5,1
191126,1508,306,1202,11,1
191126,189,35,154,12,3
191126,1012,154,858,19,1
191126,5742,856,4886,20,1
191126,7377,1052,6325,21,4
191126,7257,1024,6233,22,1
191126,7173,1009,6164,23,1
191126,1279,146,1133,24,1
191126,5894,863,5031,25,1
191126,84,15,69,31,1
191126,120,28,92,32,3
191126,906,138,768,39,1
191126,4988,725,4263,40,1
191126,2378,451,1927,41,4
191126,2309,444,1865,42,1
191126,885,153,732,43,1
191126,25,6,19,44,1
191126,860,147,713,45,1
191126,1424,291,1133,51,1
191126,69,7,62,52,3
191126,106,16,90,59,1
191126,754,131,623,60,1
191199,6389,2700,3689,1,4
191199,6389,2700,3689,2,1
191199,4412,1922,2490,3,1
191199,1449,707,742,4,1
191199,2963,1215,1748,5,1
191199,1977,778,1199,11,1
191199,254,90,164,19,1
191199,2709,1125,1584,20,1
191199,3404,1580,1824,21,4
191199,3404,1580,1824,22,1
191199,3382,1575,1807,23,1
191199,1340,663,677,24,1
191199,2042,912,1130,25,1
191199,22,5,17,31,1
191199,191,75,116,39,1
191199,1851,837,1014,40,1
191199,2985,1120,1865,41,4
191199,2985,1120,1865,42,1
191199,1030,347,683,43,1
191199,109,44,65,44,1
191199,921,303,618,45,1
191199,1955,773,1182,51,1
191199,63,15,48,59,1
191199,858,288,570,60,1
191205,796,550,246,1,4
191205,760,524,236,2,1
191205,740,515,225,3,1
191205,152,102,50,4,1
191205,588,413,175,5,1
191205,20,9,11,11,1
191205,36,26,10,12,3
191205,63,47,16,19,1
191205,525,366,159,20,1
191205,739,515,224,21,4
191205,722,503,219,22,1
191205,722,503,219,23,1
191205,150,100,50,24,1
191205,572,403,169,25,1
191205,17,12,5,32,3
191205,60,44,16,39,1
191205,512,359,153,40,1
191205,57,35,22,41,4
191205,38,21,17,42,1
191205,18,12,6,43,1
191205,2,2,0,44,1
191205,16,10,6,45,1
191205,20,9,11,51,1
191205,19,14,5,52,3
191205,3,3,0,59,1
191205,13,7,6,60,1
191241,15097,6412,8685,1,4
191241,8345,3850,4495,2,1
191241,8193,3779,4414,3,1
191241,1967,886,1081,4,1
191241,6226,2893,3333,5,1
191241,152,71,81,11,1
191241,6752,2562,4190,12,3
191241,339,158,181,19,1
191241,5887,2735,3152,20,1
191241,12015,5210,6805,21,4
191241,7694,3557,4137,22,1
191241,7662,3544,4118,23,1
191241,1944,875,1069,24,1
191241,5718,2669,3049,25,1
191241,32,13,19,31,1
191241,4321,1653,2668,32,3
191241,261,125,136,39,1
191241,5457,2544,2913,40,1
191241,3082,1202,1880,41,4
191241,651,293,358,42,1
191241,531,235,296,43,1
191241,23,11,12,44,1
191241,508,224,284,45,1
191241,120,58,62,51,1
191241,2431,909,1522,52,3
191241,78,33,45,59,1
191241,430,191,239,60,1
191287,475,205,270,1,4
191287,475,205,270,2,1
191287,475,205,270,3,1
191287,230,116,114,4,1
191287,245,89,156,5,1
191287,245,89,156,20,1
191287,261,106,155,21,4
191287,261,106,155,22,1
191287,261,106,155,23,1
191287,123,59,64,24,1
191287,138,47,91,25,1
191287,138,47,91,40,1
191287,214,99,115,41,4
191287,214,99,115,42,1
191287,214,99,115,43,1
191287,107,57,50,44,1
191287,107,42,65,45,1
191287,107,42,65,60,1
191302,2781,1194,1587,1,4
191302,2781,1194,1587,2,1
191302,2220,950,1270,3,1
191302,679,350,329,4,1
191302,1541,600,941,5,1
191302,561,244,317,11,1
191302,49,19,30,19,1
191302,1492,581,911,20,1
191302,1724,814,910,21,4
191302,1724,814,910,22,1
191302,1689,794,895,23,1
191302,623,331,292,24,1
191302,1066,463,603,25,1
191302,35,20,15,31,1
191302,39,17,22,39,1
191302,1027,446,581,40,1
191302,1057,380,677,41,4
191302,1057,380,677,42,1
191302,531,156,375,43,1
191302,56,19,37,44,1
191302,475,137,338,45,1
191302,526,224,302,51,1
191302,10,2,8,59,1
191302,465,135,330,60,1
191311,193,67,126,1,4
191311,193,67,126,2,1
191311,193,67,126,3,1
191311,124,47,77,4,1
191311,69,20,49,5,1
191311,69,20,49,20,1
191311,193,67,126,21,4
191311,193,67,126,22,1
191311,193,67,126,23,1
191311,124,47,77,24,1
191311,69,20,49,25,1
191311,69,20,49,40,1
191320,81,37,44,1,4
191320,81,37,44,12,3
191320,46,26,20,21,4
191320,46,26,20,32,3
191320,35,11,24,41,4
191320,35,11,24,52,3
191339,7079,2534,4545,1,4
191339,7079,2534,4545,2,1
191339,4190,1414,2776,3,1
191339,1153,454,699,4,1
191339,3037,960,2077,5,1
191339,2889,1120,1769,11,1
191339,396,121,275,19,1
191339,2641,839,1802,20,1
191339,3326,1182,2144,21,4
191339,3326,1182,2144,22,1
191339,3102,1109,1993,23,1
191339,1068,426,642,24,1
191339,2034,683,1351,25,1
191339,224,73,151,31,1
191339,264,93,171,39,1
191339,1770,590,1180,40,1
191339,3753,1352,2401,41,4
191339,3753,1352,2401,42,1
191339,1088,305,783,43,1
191339,85,28,57,44,1
191339,1003,277,726,45,1
191339,2665,1047,1618,51,1
191339,132,28,104,59,1
191339,871,249,622,60,1
191515,1926,938,988,1,4
191515,1926,938,988,2,1
191515,1909,930,979,3,1
191515,491,242,249,4,1
191515,1418,688,730,5,1
191515,17,8,9,11,1
191515,5,4,1,19,1
191515,1413,684,729,20,1
191515,1905,926,979,21,4
191515,1905,926,979,22,1
191515,1904,926,978,23,1
191515,491,242,249,24,1
191515,1413,684,729,25,1
191515,1,0,1,31,1
191515,5,4,1,39,1
191515,1408,680,728,40,1
191515,21,12,9,41,4
191515,21,12,9,42,1
191515,5,4,1,43,1
191515,5,4,1,45,1
191515,16,8,8,51,1
191515,5,4,1,60,1
191533,1618,656,962,1,4
191533,1618,656,962,2,1
191533,1607,654,953,3,1
191533,528,219,309,4,1
191533,1079,435,644,5,1
191533,11,2,9,11,1
191533,36,14,22,19,1
191533,1043,421,622,20,1
191533,1579,645,934,21,4
191533,1579,645,934,22,1
191533,1576,645,931,23,1
191533,528,219,309,24,1
191533,1048,426,622,25,1
191533,3,0,3,31,1
191533,36,14,22,39,1
191533,1012,412,600,40,1
191533,39,11,28,41,4
191533,39,11,28,42,1
191533,31,9,22,43,1
191533,31,9,22,45,1
191533,8,2,6,51,1
191533,31,9,22,60,1
191597,396,52,344,1,4
191597,396,52,344,2,1
191597,393,52,341,3,1
191597,7,2,5,4,1
191597,386,50,336,5,1
191597,3,0,3,11,1
191597,386,50,336,20,1
191597,220,28,192,21,4
191597,220,28,192,22,1
191597,220,28,192,23,1
191597,6,1,5,24,1
191597,214,27,187,25,1
191597,214,27,187,40,1
191597,176,24,152,41,4
191597,176,24,152,42,1
191597,173,24,149,43,1
191597,1,1,0,44,1
191597,172,23,149,45,1
191597,3,0,3,51,1
191597,172,23,149,60,1
191612,3212,1219,1993,1,4
191612,3212,1219,1993,2,1
191612,2436,933,1503,3,1
191612,718,293,425,4,1
191612,1718,640,1078,5,1
191612,776,286,490,11,1
191612,197,66,131,19,1
191612,1521,574,947,20,1
191612,2079,844,1235,21,4
191612,2079,844,1235,22,1
191612,2031,824,1207,23,1
191612,684,287,397,24,1
191612,1347,537,810,25,1
191612,48,20,28,31,1
191612,160,60,100,39,1
191612,1187,477,710,40,1
191612,1133,375,758,41,4
191612,1133,375,758,42,1
191612,405,109,296,43,1
191612,34,6,28,44,1
191612,371,103,268,45,1
191612,728,266,462,51,1
191612,37,6,31,59,1
191612,334,97,237,60,1
191621,1070,479,591,1,4
191621,1020,458,562,2,1
191621,991,449,542,3,1
191621,188,82,106,4,1
191621,803,367,436,5,1
191621,29,9,20,11,1
191621,50,21,29,12,3
191621,113,51,62,19,1
191621,690,316,374,20,1
191621,928,424,504,21,4
191621,884,406,478,22,1
191621,884,406,478,23,1
191621,188,82,106,24,1
191621,696,324,372,25,1
191621,44,18,26,32,3
191621,97,45,52,39,1
191621,599,279,320,40,1
191621,142,55,87,41,4
191621,136,52,84,42,1
191621,107,43,64,43,1
191621,107,43,64,45,1
191621,29,9,20,51,1
191621,6,3,3,52,3
191621,16,6,10,59,1
191621,91,37,54,60,1
191630,2372,1089,1283,1,4
191630,2368,1089,1279,2,1
191630,2311,1047,1264,3,1
191630,638,294,344,4,1
191630,1673,753,920,5,1
191630,57,42,15,11,1
191630,4,0,4,12,3
191630,15,7,8,19,1
191630,1658,746,912,20,1
191630,2328,1048,1280,21,4
191630,2324,1048,1276,22,1
191630,2307,1043,1264,23,1
191630,638,294,344,24,1
191630,1669,749,920,25,1
191630,17,5,12,31,1
191630,4,0,4,32,3
191630,15,7,8,39,1
191630,1654,742,912,40,1
191630,44,41,3,41,4
191630,44,41,3,42,1
191630,4,4,0,43,1
191630,4,4,0,45,1
191630,40,37,3,51,1
191630,4,4,0,60,1
191649,10928,4843,6085,1,4
191649,6826,3192,3634,2,1
191649,6748,3136,3612,3,1
191649,1616,741,875,4,1
191649,5132,2395,2737,5,1
191649,78,56,22,11,1
191649,4102,1651,2451,12,3
191649,433,229,204,19,1
191649,4699,2166,2533,20,1
191649,9383,4198,5185,21,4
191649,6378,2947,3431,22,1
191649,6361,2940,3421,23,1
191649,1612,738,874,24,1
191649,4749,2202,2547,25,1
191649,17,7,10,31,1
191649,3005,1251,1754,32,3
191649,387,209,178,39,1
191649,4362,1993,2369,40,1
191649,1545,645,900,41,4
191649,448,245,203,42,1
191649,387,196,191,43,1
191649,4,3,1,44,1
191649,383,193,190,45,1
191649,61,49,12,51,1
191649,1097,400,697,52,3
191649,46,20,26,59,1
191649,337,173,164,60,1
191676,1100,397,703,1,4
191676,1081,385,696,2,1
191676,1047,371,676,3,1
191676,223,81,142,4,1
191676,824,290,534,5,1
191676,34,14,20,11,1
191676,19,12,7,12,3
191676,70,31,39,19,1
191676,754,259,495,20,1
191676,1032,369,663,21,4
191676,1023,363,660,22,1
191676,1023,363,660,23,1
191676,223,81,142,24,1
191676,800,282,518,25,1
191676,9,6,3,32,3
191676,70,31,39,39,1
191676,730,251,479,40,1
191676,68,28,40,41,4
191676,58,22,36,42,1
191676,24,8,16,43,1
191676,24,8,16,45,1
191676,34,14,20,51,1
191676,10,6,4,52,3
191676,24,8,16,60,1
191719,12841,6773,6068,1,4
191719,12841,6773,6068,2,1
191719,9017,4846,4171,3,1
191719,2294,1379,915,4,1
191719,6723,3467,3256,5,1
191719,3824,1927,1897,11,1
191719,932,486,446,19,1
191719,5791,2981,2810,20,1
191719,6832,3939,2893,21,4
191719,6832,3939,2893,22,1
191719,6545,3749,2796,23,1
191719,2088,1267,821,24,1
191719,4457,2482,1975,25,1
191719,287,190,97,31,1
191719,757,406,351,39,1
191719,3700,2076,1624,40,1
191719,6009,2834,3175,41,4
191719,6009,2834,3175,42,1
191719,2472,1097,1375,43,1
191719,206,112,94,44,1
191719,2266,985,1281,45,1
191719,3537,1737,1800,51,1
191719,175,80,95,59,1
191719,2091,905,1186,60,1
191728,964,172,792,1,4
191728,964,172,792,2,1
191728,964,172,792,3,1
191728,374,56,318,4,1
191728,590,116,474,5,1
191728,590,116,474,20,1
191728,618,113,505,21,4
191728,618,113,505,22,1
191728,618,113,505,23,1
191728,262,37,225,24,1
191728,356,76,280,25,1
191728,356,76,280,40,1
191728,346,59,287,41,4
191728,346,59,287,42,1
191728,346,59,287,43,1
191728,112,19,93,44,1
191728,234,40,194,45,1
191728,234,40,194,60,1
191764,103,91,12,1,4
191764,103,91,12,2,1
191764,85,73,12,3,1
191764,10,8,2,4,1
191764,75,65,10,5,1
191764,18,18,0,11,1
191764,12,10,2,19,1
191764,63,55,8,20,1
191764,43,35,8,21,4
191764,43,35,8,22,1
191764,43,35,8,23,1
191764,10,8,2,24,1
191764,33,27,6,25,1
191764,10,8,2,39,1
191764,23,19,4,40,1
191764,60,56,4,41,4
191764,60,56,4,42,1
191764,42,38,4,43,1
191764,42,38,4,45,1
191764,18,18,0,51,1
191764,2,2,0,59,1
191764,40,36,4,60,1
191834,490,438,52,1,4
191834,490,438,52,2,1
191834,490,438,52,3,1
191834,264,241,23,4,1
191834,226,197,29,5,1
191834,226,197,29,20,1
191834,431,384,47,21,4
191834,431,384,47,22,1
191834,431,384,47,23,1
191834,232,211,21,24,1
191834,199,173,26,25,1
191834,199,173,26,40,1
191834,59,54,5,41,4
191834,59,54,5,42,1
191834,59,54,5,43,1
191834,32,30,2,44,1
191834,27,24,3,45,1
191834,27,24,3,60,1
191931,4241,1897,2344,1,4
191931,3539,1616,1923,2,1
191931,3166,1444,1722,3,1
191931,922,416,506,4,1
191931,2244,1028,1216,5,1
191931,373,172,201,11,1
191931,702,281,421,12,3
191931,117,68,49,19,1
191931,2127,960,1167,20,1
191931,3389,1520,1869,21,4
191931,3110,1410,1700,22,1
191931,3106,1406,1700,23,1
191931,922,416,506,24,1
191931,2184,990,1194,25,1
191931,4,4,0,31,1
191931,279,110,169,32,3
191931,115,67,48,39,1
191931,2069,923,1146,40,1
191931,852,377,475,41,4
191931,429,206,223,42,1
191931,60,38,22,43,1
191931,60,38,22,45,1
191931,369,168,201,51,1
191931,423,171,252,52,3
191931,2,1,1,59,1
191931,58,37,21,60,1
191940,76,7,69,1,4
191940,76,7,69,2,1
191940,76,7,69,3,1
191940,76,7,69,5,1
191940,76,7,69,20,1
191940,60,4,56,21,4
191940,60,4,56,22,1
191940,60,4,56,23,1
191940,60,4,56,25,1
191940,60,4,56,40,1
191940,16,3,13,41,4
191940,16,3,13,42,1
191940,16,3,13,43,1
191940,16,3,13,45,1
191940,16,3,13,60,1
191959,95,86,9,1,4
191959,95,86,9,2,1
191959,95,86,9,3,1
191959,37,30,7,4,1
191959,58,56,2,5,1
191959,58,56,2,20,1
191959,95,86,9,21,4
191959,95,86,9,22,1
191959,95,86,9,23,1
191959,37,30,7,24,1
191959,58,56,2,25,1
191959,58,56,2,40,1
191968,6723,2865,3858,1,4
191968,6234,2725,3509,2,1
191968,6202,2712,3490,3,1
191968,1789,748,1041,4,1
191968,4413,1964,2449,5,1
191968,32,13,19,11,1
191968,489,140,349,12,3
191968,140,67,73,19,1
191968,4273,1897,2376,20,1
191968,6562,2789,3773,21,4
191968,6131,2670,3461,22,1
191968,6122,2667,3455,23,1
191968,1789,748,1041,24,1
191968,4333,1919,2414,25,1
191968,9,3,6,31,1
191968,431,119,312,32,3
191968,139,67,72,39,1
191968,4194,1852,2342,40,1
191968,161,76,85,41,4
191968,103,55,48,42,1
191968,80,45,35,43,1
191968,80,45,35,45,1
191968,23,10,13,51,1
191968,58,21,37,52,3
191968,1,0,1,59,1
191968,79,45,34,60,1
191986,5178,2160,3018,1,4
191986,5178,2160,3018,2,1
191986,3381,1371,2010,3,1
191986,1034,464,570,4,1
191986,2347,907,1440,5,1
191986,1797,789,1008,11,1
191986,269,97,172,19,1
191986,2078,810,1268,20,1
191986,2764,1209,1555,21,4
191986,2764,1209,1555,22,1
191986,2627,1150,1477,23,1
191986,968,443,525,24,1
191986,1659,707,952,25,1
191986,137,59,78,31,1
191986,212,83,129,39,1
191986,1447,624,823,40,1
191986,2414,951,1463,41,4
191986,2414,951,1463,42,1
191986,754,221,533,43,1
191986,66,21,45,44,1
191986,688,200,488,45,1
191986,1660,730,930,51,1
191986,57,14,43,59,1
191986,631,186,445,60,1
192004,275,84,191,1,4
192004,275,84,191,2,1
192004,275,84,191,3,1
192004,68,23,45,4,1
192004,207,61,146,5,1
192004,45,12,33,19,1
192004,162,49,113,20,1
192004,269,83,186,21,4
192004,269,83,186,22,1
192004,269,83,186,23,1
192004,68,23,45,24,1
192004,201,60,141,25,1
192004,44,12,32,39,1
192004,157,48,109,40,1
192004,6,1,5,41,4
192004,6,1,5,42,1
192004,6,1,5,43,1
192004,6,1,5,45,1
192004,1,0,1,59,1
192004,5,1,4,60,1
192022,3931,1493,2438,1,4
192022,3931,1493,2438,2,1
192022,3148,1176,1972,3,1
192022,832,372,460,4,1
192022,2316,804,1512,5,1
192022,783,317,466,11,1
192022,289,96,193,19,1
192022,2027,708,1319,20,1
192022,2234,892,1342,21,4
192022,2234,892,1342,22,1
192022,2216,887,1329,23,1
192022,698,307,391,24,1
192022,1518,580,938,25,1
192022,18,5,13,31,1
192022,182,64,118,39,1
192022,1336,516,820,40,1
192022,1697,601,1096,41,4
192022,1697,601,1096,42,1
192022,932,289,643,43,1
192022,134,65,69,44,1
192022,798,224,574,45,1
192022,765,312,453,51,1
192022,107,32,75,59,1
192022,691,192,499,60,1
192040,446,197,249,1,4
192040,163,73,90,2,1
192040,161,71,90,3,1
192040,33,15,18,4,1
192040,128,56,72,5,1
192040,2,2,0,11,1
192040,283,124,159,12,3
192040,2,1,1,19,1
192040,126,55,71,20,1
192040,314,137,177,21,4
192040,156,69,87,22,1
192040,156,69,87,23,1
192040,33,15,18,24,1
192040,123,54,69,25,1
192040,158,68,90,32,3
192040,2,1,1,39,1
192040,121,53,68,40,1
192040,132,60,72,41,4
192040,7,4,3,42,1
192040,5,2,3,43,1
192040,5,2,3,45,1
192040,2,2,0,51,1
192040,125,56,69,52,3
192040,5,2,3,60,1
192110,927,515,412,1,4
192110,581,324,257,2,1
192110,498,275,223,3,1
192110,109,58,51,4,1
192110,389,217,172,5,1
192110,83,49,34,11,1
192110,346,191,155,12,3
192110,11,5,6,19,1
192110,378,212,166,20,1
192110,826,453,373,21,4
192110,498,275,223,22,1
192110,498,275,223,23,1
192110,109,58,51,24,1
192110,389,217,172,25,1
192110,328,178,150,32,3
192110,11,5,6,39,1
192110,378,212,166,40,1
192110,101,62,39,41,4
192110,83,49,34,42,1
192110,83,49,34,51,1
192110,18,13,5,52,3
192156,274,18,256,1,4
192156,274,18,256,2,1
192156,274,18,256,3,1
192156,65,6,59,4,1
192156,209,12,197,5,1
192156,15,0,15,19,1
192156,194,12,182,20,1
192156,243,16,227,21,4
192156,243,16,227,22,1
192156,243,16,227,23,1
192156,64,5,59,24,1
192156,179,11,168,25,1
192156,14,0,14,39,1
192156,165,11,154,40,1
192156,31,2,29,41,4
192156,31,2,29,42,1
192156,31,2,29,43,1
192156,1,1,0,44,1
192156,30,1,29,45,1
192156,1,0,1,59,1
192156,29,1,28,60,1
192165,120,120,0,1,4
192165,120,120,0,2,1
192165,120,120,0,3,1
192165,44,44,0,4,1
192165,76,76,0,5,1
192165,76,76,0,20,1
192165,120,120,0,21,4
192165,120,120,0,22,1
192165,120,120,0,23,1
192165,44,44,0,24,1
192165,76,76,0,25,1
192165,76,76,0,40,1
192192,2036,470,1566,1,4
192192,1830,429,1401,2,1
192192,1830,429,1401,3,1
192192,241,64,177,4,1
192192,1589,365,1224,5,1
192192,206,41,165,12,3
192192,328,56,272,19,1
192192,1261,309,952,20,1
192192,1658,423,1235,21,4
192192,1514,392,1122,22,1
192192,1514,392,1122,23,1
192192,240,64,176,24,1
192192,1274,328,946,25,1
192192,144,31,113,32,3
192192,222,48,174,39,1
192192,1052,280,772,40,1
192192,378,47,331,41,4
192192,316,37,279,42,1
192192,316,37,279,43,1
192192,1,0,1,44,1
192192,315,37,278,45,1
192192,62,10,52,52,3
192192,106,8,98,59,1
192192,209,29,180,60,1
192271,1647,116,1531,1,4
192271,1513,106,1407,2,1
192271,1508,106,1402,3,1
192271,296,19,277,4,1
192271,1212,87,1125,5,1
192271,5,0,5,11,1
192271,134,10,124,12,3
192271,154,16,138,19,1
192271,1058,71,987,20,1
192271,1524,107,1417,21,4
192271,1422,101,1321,22,1
192271,1418,101,1317,23,1
192271,295,19,276,24,1
192271,1123,82,1041,25,1
192271,4,0,4,31,1
192271,102,6,96,32,3
192271,145,16,129,39,1
192271,978,66,912,40,1
192271,123,9,114,41,4
192271,91,5,86,42,1
192271,90,5,85,43,1
192271,1,0,1,44,1
192271,89,5,84,45,1
192271,1,0,1,51,1
192271,32,4,28,52,3
192271,9,0,9,59,1
192271,80,5,75,60,1
192323,3319,1327,1992,1,4
192323,2785,1153,1632,2,1
192323,2619,1112,1507,3,1
192323,622,257,365,4,1
192323,1997,855,1142,5,1
192323,166,41,125,11,1
192323,534,174,360,12,3
192323,169,79,90,19,1
192323,1828,776,1052,20,1
192323,2538,1094,1444,21,4
192323,2401,1050,1351,22,1
192323,2394,1047,1347,23,1
192323,622,257,365,24,1
192323,1772,790,982,25,1
192323,7,3,4,31,1
192323,137,44,93,32,3
192323,139,66,73,39,1
192323,1633,724,909,40,1
192323,781,233,548,41,4
192323,384,103,281,42,1
192323,225,65,160,43,1
192323,225,65,160,45,1
192323,159,38,121,51,1
192323,397,130,267,52,3
192323,30,13,17,59,1
192323,195,52,143,60,1
192439,8483,2499,5984,1,4
192439,5006,1492,3514,2,1
192439,4905,1464,3441,3,1
192439,877,322,555,4,1
192439,4028,1142,2886,5,1
192439,101,28,73,11,1
192439,3477,1007,2470,12,3
192439,679,184,495,19,1
192439,3349,958,2391,20,1
192439,6261,1970,4291,21,4
192439,4195,1315,2880,22,1
192439,4192,1314,2878,23,1
192439,864,316,548,24,1
192439,3328,998,2330,25,1
192439,3,1,2,31,1
192439,2066,655,1411,32,3
192439,516,154,362,39,1
192439,2812,844,1968,40,1
192439,2222,529,1693,41,4
192439,811,177,634,42,1
192439,713,150,563,43,1
192439,13,6,7,44,1
192439,700,144,556,45,1
192439,98,27,71,51,1
192439,1411,352,1059,52,3
192439,163,30,133,59,1
192439,537,114,423,60,1
192448,10599,4089,6510,1,4
192448,7983,3381,4602,2,1
192448,4067,1591,2476,3,1
192448,659,271,388,4,1
192448,3408,1320,2088,5,1
192448,3916,1790,2126,11,1
192448,2616,708,1908,12,3
192448,437,159,278,19,1
192448,2971,1161,1810,20,1
192448,4824,1791,3033,21,4
192448,3661,1457,2204,22,1
192448,3620,1442,2178,23,1
192448,631,254,377,24,1
192448,2989,1188,1801,25,1
192448,41,15,26,31,1
192448,1163,334,829,32,3
192448,365,144,221,39,1
192448,2624,1044,1580,40,1
192448,5775,2298,3477,41,4
192448,4322,1924,2398,42,1
192448,447,149,298,43,1
192448,28,17,11,44,1
192448,419,132,287,45,1
192448,3875,1775,2100,51,1
192448,1453,374,1079,52,3
192448,72,15,57,59,1
192448,347,117,230,60,1
192484,147,4,143,1,4
192484,147,4,143,2,1
192484,147,4,143,3,1
192484,26,0,26,4,1
192484,121,4,117,5,1
192484,121,4,117,20,1
192484,100,3,97,21,4
192484,100,3,97,22,1
192484,100,3,97,23,1
192484,25,0,25,24,1
192484,75,3,72,25,1
192484,75,3,72,40,1
192484,47,1,46,41,4
192484,47,1,46,42,1
192484,47,1,46,43,1
192484,1,0,1,44,1
192484,46,1,45,45,1
192484,46,1,45,60,1
192509,446,120,326,1,4
192509,446,120,326,2,1
192509,416,115,301,3,1
192509,85,27,58,4,1
192509,331,88,243,5,1
192509,30,5,25,11,1
192509,32,6,26,19,1
192509,299,82,217,20,1
192509,311,104,207,21,4
192509,311,104,207,22,1
192509,311,104,207,23,1
192509,82,27,55,24,1
192509,229,77,152,25,1
192509,22,5,17,39,1
192509,207,72,135,40,1
192509,135,16,119,41,4
192509,135,16,119,42,1
192509,105,11,94,43,1
192509,3,0,3,44,1
192509,102,11,91,45,1
192509,30,5,25,51,1
192509,10,1,9,59,1
192509,92,10,82,60,1
192554,259,48,211,1,4
192554,259,48,211,12,3
192554,94,25,69,21,4
192554,94,25,69,32,3
192554,165,23,142,41,4
192554,165,23,142,52,3
192563,270,39,231,1,4
192563,23,9,14,2,1
192563,23,9,14,3,1
192563,23,9,14,5,1
192563,247,30,217,12,3
192563,7,3,4,19,1
192563,16,6,10,20,1
192563,130,21,109,21,4
192563,15,8,7,22,1
192563,15,8,7,23,1
192563,15,8,7,25,1
192563,115,13,102,32,3
192563,6,3,3,39,1
192563,9,5,4,40,1
192563,140,18,122,41,4
192563,8,1,7,42,1
192563,8,1,7,43,1
192563,8,1,7,45,1
192563,132,17,115,52,3
192563,1,0,1,59,1
192563,7,1,6,60,1
192624,148,148,0,1,4
192624,148,148,0,2,1
192624,148,148,0,3,1
192624,27,27,0,4,1
192624,121,121,0,5,1
192624,17,17,0,19,1
192624,104,104,0,20,1
192624,148,148,0,21,4
192624,148,148,0,22,1
192624,148,148,0,23,1
192624,27,27,0,24,1
192624,121,121,0,25,1
192624,17,17,0,39,1
192624,104,104,0,40,1
192688,782,77,705,1,4
192688,782,77,705,2,1
192688,782,77,705,3,1
192688,208,17,191,4,1
192688,574,60,514,5,1
192688,58,6,52,19,1
192688,516,54,462,20,1
192688,777,75,702,21,4
192688,777,75,702,22,1
192688,777,75,702,23,1
192688,206,16,190,24,1
192688,571,59,512,25,1
192688,58,6,52,39,1
192688,513,53,460,40,1
192688,5,2,3,41,4
192688,5,2,3,42,1
192688,5,2,3,43,1
192688,2,1,1,44,1
192688,3,1,2,45,1
192688,3,1,2,60,1
192703,3883,2110,1773,1,4
192703,3403,1889,1514,2,1
192703,3403,1889,1514,3,1
192703,757,400,357,4,1
192703,2646,1489,1157,5,1
192703,480,221,259,12,3
192703,155,81,74,19,1
192703,2491,1408,1083,20,1
192703,3392,1829,1563,21,4
192703,3195,1741,1454,22,1
192703,3195,1741,1454,23,1
192703,755,398,357,24,1
192703,2440,1343,1097,25,1
192703,197,88,109,32,3
192703,134,68,66,39,1
192703,2306,1275,1031,40,1
192703,491,281,210,41,4
192703,208,148,60,42,1
192703,208,148,60,43,1
192703,2,2,0,44,1
192703,206,146,60,45,1
192703,283,133,150,52,3
192703,21,13,8,59,1
192703,185,133,52,60,1
192712,885,391,494,1,4
192712,377,158,219,2,1
192712,377,158,219,3,1
192712,81,32,49,4,1
192712,296,126,170,5,1
192712,508,233,275,12,3
192712,22,12,10,19,1
192712,274,114,160,20,1
192712,882,389,493,21,4
192712,376,157,219,22,1
192712,376,157,219,23,1
192712,81,32,49,24,1
192712,295,125,170,25,1
192712,506,232,274,32,3
192712,22,12,10,39,1
192712,273,113,160,40,1
192712,3,2,1,41,4
192712,1,1,0,42,1
192712,1,1,0,43,1
192712,1,1,0,45,1
192712,2,1,1,52,3
192712,1,1,0,60,1
192749,2750,945,1805,1,4
192749,1719,619,1100,2,1
192749,1671,602,1069,3,1
192749,480,168,312,4,1
192749,1191,434,757,5,1
192749,48,17,31,11,1
192749,1031,326,705,12,3
192749,59,28,31,19,1
192749,1132,406,726,20,1
192749,1900,680,1220,21,4
192749,1611,579,1032,22,1
192749,1611,579,1032,23,1
192749,475,164,311,24,1
192749,1136,415,721,25,1
192749,289,101,188,32,3
192749,51,23,28,39,1
192749,1085,392,693,40,1
192749,850,265,585,41,4
192749,108,40,68,42,1
192749,60,23,37,43,1
192749,5,4,1,44,1
192749,55,19,36,45,1
192749,48,17,31,51,1
192749,742,225,517,52,3
192749,8,5,3,59,1
192749,47,14,33,60,1
192785,880,95,785,1,4
192785,880,95,785,2,1
192785,866,93,773,3,1
192785,53,10,43,4,1
192785,813,83,730,5,1
192785,14,2,12,11,1
192785,205,26,179,19,1
192785,608,57,551,20,1
192785,190,22,168,21,4
192785,190,22,168,22,1
192785,190,22,168,23,1
192785,29,5,24,24,1
192785,161,17,144,25,1
192785,56,6,50,39,1
192785,105,11,94,40,1
192785,690,73,617,41,4
192785,690,73,617,42,1
192785,676,71,605,43,1
192785,24,5,19,44,1
192785,652,66,586,45,1
192785,14,2,12,51,1
192785,149,20,129,59,1
192785,503,46,457,60,1
192800,32,6,26,1,4
192800,32,6,26,2,1
192800,32,6,26,3,1
192800,1,0,1,4,1
192800,31,6,25,5,1
192800,31,6,25,20,1
192800,32,6,26,21,4
192800,32,6,26,22,1
192800,32,6,26,23,1
192800,1,0,1,24,1
192800,31,6,25,25,1
192800,31,6,25,40,1
192819,6365,2663,3702,1,4
192819,5566,2295,3271,2,1
192819,5295,2178,3117,3,1
192819,1149,466,683,4,1
192819,4146,1712,2434,5,1
192819,271,117,154,11,1
192819,799,368,431,12,3
192819,149,65,84,19,1
192819,3997,1647,2350,20,1
192819,5121,2091,3030,21,4
192819,4924,2028,2896,22,1
192819,4918,2027,2891,23,1
192819,1149,466,683,24,1
192819,3769,1561,2208,25,1
192819,6,1,5,31,1
192819,197,63,134,32,3
192819,149,65,84,39,1
192819,3620,1496,2124,40,1
192819,1244,572,672,41,4
192819,642,267,375,42,1
192819,377,151,226,43,1
192819,377,151,226,45,1
192819,265,116,149,51,1
192819,602,305,297,52,3
192819,377,151,226,60,1
192828,44,7,37,1,4
192828,44,7,37,2,1
192828,44,7,37,3,1
192828,32,7,25,4,1
192828,12,0,12,5,1
192828,12,0,12,20,1
192828,33,6,27,21,4
192828,33,6,27,22,1
192828,33,6,27,23,1
192828,23,6,17,24,1
192828,10,0,10,25,1
192828,10,0,10,40,1
192828,11,1,10,41,4
192828,11,1,10,42,1
192828,11,1,10,43,1
192828,9,1,8,44,1
192828,2,0,2,45,1
192828,2,0,2,60,1
192864,1833,419,1414,1,4
192864,1833,419,1414,2,1
192864,1783,402,1381,3,1
192864,418,101,317,4,1
192864,1365,301,1064,5,1
192864,50,17,33,11,1
192864,124,30,94,19,1
192864,1241,271,970,20,1
192864,1593,386,1207,21,4
192864,1593,386,1207,22,1
192864,1583,378,1205,23,1
192864,397,101,296,24,1
192864,1186,277,909,25,1
192864,10,8,2,31,1
192864,117,30,87,39,1
192864,1069,247,822,40,1
192864,240,33,207,41,4
192864,240,33,207,42,1
192864,200,24,176,43,1
192864,21,0,21,44,1
192864,179,24,155,45,1
192864,40,9,31,51,1
192864,7,0,7,59,1
192864,172,24,148,60,1
192925,2390,730,1660,1,4
192925,1727,576,1151,2,1
192925,1716,575,1141,3,1
192925,443,146,297,4,1
192925,1273,429,844,5,1
192925,11,1,10,11,1
192925,663,154,509,12,3
192925,178,48,130,19,1
192925,1095,381,714,20,1
192925,2185,681,1504,21,4
192925,1585,544,1041,22,1
192925,1575,543,1032,23,1
192925,436,142,294,24,1
192925,1139,401,738,25,1
192925,10,1,9,31,1
192925,600,137,463,32,3
192925,168,45,123,39,1
192925,971,356,615,40,1
192925,205,49,156,41,4
192925,142,32,110,42,1
192925,141,32,109,43,1
192925,7,4,3,44,1
192925,134,28,106,45,1
192925,1,0,1,51,1
192925,63,17,46,52,3
192925,10,3,7,59,1
192925,124,25,99,60,1
192961,123,22,101,1,4
192961,123,22,101,2,1
192961,123,22,101,3,1
192961,1,0,1,4,1
192961,122,22,100,5,1
192961,33,8,25,19,1
192961,89,14,75,20,1
192961,12,3,9,21,4
192961,12,3,9,22,1
192961,12,3,9,23,1
192961,1,0,1,24,1
192961,11,3,8,25,1
192961,7,2,5,39,1
192961,4,1,3,40,1
192961,111,19,92,41,4
192961,111,19,92,42,1
192961,111,19,92,43,1
192961,111,19,92,45,1
192961,26,6,20,59,1
192961,85,13,72,60,1
192970,15,7,8,1,4
192970,15,7,8,2,1
192970,15,7,8,3,1
192970,15,7,8,5,1
192970,15,7,8,20,1
192970,15,7,8,21,4
192970,15,7,8,22,1
192970,15,7,8,23,1
192970,15,7,8,25,1
192970,15,7,8,40,1
193016,11648,3182,8466,1,4
193016,8154,2497,5657,2,1
193016,6897,2076,4821,3,1
193016,834,244,590,4,1
193016,6063,1832,4231,5,1
193016,1257,421,836,11,1
193016,3494,685,2809,12,3
193016,1003,268,735,19,1
193016,5060,1564,3496,20,1
193016,7017,2039,4978,21,4
193016,5547,1729,3818,22,1
193016,5447,1694,3753,23,1
193016,823,241,582,24,1
193016,4624,1453,3171,25,1
193016,100,35,65,31,1
193016,1470,310,1160,32,3
193016,841,229,612,39,1
193016,3783,1224,2559,40,1
193016,4631,1143,3488,41,4
193016,2607,768,1839,42,1
193016,1450,382,1068,43,1
193016,11,3,8,44,1
193016,1439,379,1060,45,1
193016,1157,386,771,51,1
193016,2024,375,1649,52,3
193016,162,39,123,59,1
193016,1277,340,937,60,1
193052,279,279,0,1,4
193052,207,207,0,2,1
193052,207,207,0,3,1
193052,17,17,0,4,1
193052,190,190,0,5,1
193052,72,72,0,12,3
193052,102,102,0,19,1
193052,88,88,0,20,1
193052,276,276,0,21,4
193052,206,206,0,22,1
193052,206,206,0,23,1
193052,17,17,0,24,1
193052,189,189,0,25,1
193052,70,70,0,32,3
193052,102,102,0,39,1
193052,87,87,0,40,1
193052,3,3,0,41,4
193052,1,1,0,42,1
193052,1,1,0,43,1
193052,1,1,0,45,1
193052,2,2,0,52,3
193052,1,1,0,60,1
193061,36,36,0,1,4
193061,33,33,0,2,1
193061,33,33,0,3,1
193061,4,4,0,4,1
193061,29,29,0,5,1
193061,3,3,0,12,3
193061,1,1,0,19,1
193061,28,28,0,20,1
193061,36,36,0,21,4
193061,33,33,0,22,1
193061,33,33,0,23,1
193061,4,4,0,24,1
193061,29,29,0,25,1
193061,3,3,0,32,3
193061,1,1,0,39,1
193061,28,28,0,40,1
193070,80,80,0,1,4
193070,50,50,0,2,1
193070,50,50,0,3,1
193070,12,12,0,4,1
193070,38,38,0,5,1
193070,30,30,0,12,3
193070,38,38,0,20,1
193070,80,80,0,21,4
193070,50,50,0,22,1
193070,50,50,0,23,1
193070,12,12,0,24,1
193070,38,38,0,25,1
193070,30,30,0,32,3
193070,38,38,0,40,1
193122,180,26,154,1,4
193122,180,26,154,2,1
193122,180,26,154,3,1
193122,141,22,119,4,1
193122,39,4,35,5,1
193122,39,4,35,20,1
193122,53,8,45,21,4
193122,53,8,45,22,1
193122,53,8,45,23,1
193122,39,7,32,24,1
193122,14,1,13,25,1
193122,14,1,13,40,1
193122,127,18,109,41,4
193122,127,18,109,42,1
193122,127,18,109,43,1
193122,102,15,87,44,1
193122,25,3,22,45,1
193122,25,3,22,60,1
193186,103,2,101,1,4
193186,103,2,101,2,1
193186,103,2,101,3,1
193186,36,1,35,4,1
193186,67,1,66,5,1
193186,67,1,66,20,1
193186,45,2,43,21,4
193186,45,2,43,22,1
193186,45,2,43,23,1
193186,24,1,23,24,1
193186,21,1,20,25,1
193186,21,1,20,40,1
193186,58,0,58,41,4
193186,58,0,58,42,1
193186,58,0,58,43,1
193186,12,0,12,44,1
193186,46,0,46,45,1
193186,46,0,46,60,1
193201,904,134,770,1,4
193201,904,134,770,2,1
193201,902,134,768,3,1
193201,202,32,170,4,1
193201,700,102,598,5,1
193201,2,0,2,11,1
193201,12,1,11,19,1
193201,688,101,587,20,1
193201,899,134,765,21,4
193201,899,134,765,22,1
193201,899,134,765,23,1
193201,202,32,170,24,1
193201,697,102,595,25,1
193201,12,1,11,39,1
193201,685,101,584,40,1
193201,5,0,5,41,4
193201,5,0,5,42,1
193201,3,0,3,43,1
193201,3,0,3,45,1
193201,2,0,2,51,1
193201,3,0,3,60,1
193247,224,224,0,1,4
193247,160,160,0,2,1
193247,160,160,0,3,1
193247,34,34,0,4,1
193247,126,126,0,5,1
193247,64,64,0,12,3
193247,12,12,0,19,1
193247,114,114,0,20,1
193247,224,224,0,21,4
193247,160,160,0,22,1
193247,160,160,0,23,1
193247,34,34,0,24,1
193247,126,126,0,25,1
193247,64,64,0,32,3
193247,12,12,0,39,1
193247,114,114,0,40,1
193265,103,99,4,1,4
193265,103,99,4,2,1
193265,103,99,4,3,1
193265,68,66,2,4,1
193265,35,33,2,5,1
193265,35,33,2,20,1
193265,73,70,3,21,4
193265,73,70,3,22,1
193265,73,70,3,23,1
193265,51,49,2,24,1
193265,22,21,1,25,1
193265,22,21,1,40,1
193265,30,29,1,41,4
193265,30,29,1,42,1
193265,30,29,1,43,1
193265,17,17,0,44,1
193265,13,12,1,45,1
193265,13,12,1,60,1
193283,7433,3480,3953,1,4
193283,7433,3480,3953,2,1
193283,5829,2734,3095,3,1
193283,1577,834,743,4,1
193283,4252,1900,2352,5,1
193283,1604,746,858,11,1
193283,334,153,181,19,1
193283,3918,1747,2171,20,1
193283,4616,2283,2333,21,4
193283,4616,2283,2333,22,1
193283,4563,2252,2311,23,1
193283,1474,794,680,24,1
193283,3089,1458,1631,25,1
193283,53,31,22,31,1
193283,263,128,135,39,1
193283,2826,1330,1496,40,1
193283,2817,1197,1620,41,4
193283,2817,1197,1620,42,1
193283,1266,482,784,43,1
193283,103,40,63,44,1
193283,1163,442,721,45,1
193283,1551,715,836,51,1
193283,71,25,46,59,1
193283,1092,417,675,60,1
193292,4455,1108,3347,1,4
193292,3375,880,2495,2,1
193292,3322,867,2455,3,1
193292,501,165,336,4,1
193292,2821,702,2119,5,1
193292,53,13,40,11,1
193292,1080,228,852,12,3
193292,384,93,291,19,1
193292,2437,609,1828,20,1
193292,2903,809,2094,21,4
193292,2693,754,1939,22,1
193292,2689,751,1938,23,1
193292,495,164,331,24,1
193292,2194,587,1607,25,1
193292,4,3,1,31,1
193292,210,55,155,32,3
193292,293,74,219,39,1
193292,1901,513,1388,40,1
193292,1552,299,1253,41,4
193292,682,126,556,42,1
193292,633,116,517,43,1
193292,6,1,5,44,1
193292,627,115,512,45,1
193292,49,10,39,51,1
193292,870,173,697,52,3
193292,91,19,72,59,1
193292,536,96,440,60,1
193308,7215,2585,4630,1,4
193308,6794,2456,4338,2,1
193308,6426,2314,4112,3,1
193308,1208,534,674,4,1
193308,5218,1780,3438,5,1
193308,368,142,226,11,1
193308,421,129,292,12,3
193308,2391,777,1614,19,1
193308,2827,1003,1824,20,1
193308,5106,1954,3152,21,4
193308,4895,1881,3014,22,1
193308,4893,1879,3014,23,1
193308,1107,495,612,24,1
193308,3786,1384,2402,25,1
193308,2,2,0,31,1
193308,211,73,138,32,3
193308,1673,588,1085,39,1
193308,2113,796,1317,40,1
193308,2109,631,1478,41,4
193308,1899,575,1324,42,1
193308,1533,435,1098,43,1
193308,101,39,62,44,1
193308,1432,396,1036,45,1
193308,366,140,226,51,1
193308,210,56,154,52,3
193308,718,189,529,59,1
193308,714,207,507,60,1
193326,16458,7637,8821,1,4
193326,16458,7637,8821,2,1
193326,15054,6908,8146,3,1
193326,3794,1891,1903,4,1
193326,11260,5017,6243,5,1
193326,1404,729,675,11,1
193326,934,417,517,19,1
193326,10326,4600,5726,20,1
193326,10260,4921,5339,21,4
193326,10260,4921,5339,22,1
193326,10254,4917,5337,23,1
193326,3354,1684,1670,24,1
193326,6900,3233,3667,25,1
193326,6,4,2,31,1
193326,684,316,368,39,1
193326,6216,2917,3299,40,1
193326,6198,2716,3482,41,4
193326,6198,2716,3482,42,1
193326,4800,1991,2809,43,1
193326,440,207,233,44,1
193326,4360,1784,2576,45,1
193326,1398,725,673,51,1
193326,250,101,149,59,1
193326,4110,1683,2427,60,1
193353,2556,754,1802,1,4
193353,2203,659,1544,2,1
193353,2155,623,1532,3,1
193353,449,130,319,4,1
193353,1706,493,1213,5,1
193353,48,36,12,11,1
193353,353,95,258,12,3
193353,199,53,146,19,1
193353,1507,440,1067,20,1
193353,1811,570,1241,21,4
193353,1742,538,1204,22,1
193353,1739,537,1202,23,1
193353,448,129,319,24,1
193353,1291,408,883,25,1
193353,3,1,2,31,1
193353,69,32,37,32,3
193353,128,41,87,39,1
193353,1163,367,796,40,1
193353,745,184,561,41,4
193353,461,121,340,42,1
193353,416,86,330,43,1
193353,1,1,0,44,1
193353,415,85,330,45,1
193353,45,35,10,51,1
193353,284,63,221,52,3
193353,71,12,59,59,1
193353,344,73,271,60,1
193380,130,26,104,1,4
193380,130,26,104,2,1
193380,130,26,104,3,1
193380,130,26,104,5,1
193380,31,7,24,19,1
193380,99,19,80,20,1
193380,3,0,3,21,4
193380,3,0,3,22,1
193380,3,0,3,23,1
193380,3,0,3,25,1
193380,1,0,1,39,1
193380,2,0,2,40,1
193380,127,26,101,41,4
193380,127,26,101,42,1
193380,127,26,101,43,1
193380,127,26,101,45,1
193380,30,7,23,59,1
193380,97,19,78,60,1
193399,1938,520,1418,1,4
193399,1669,466,1203,2,1
193399,1635,461,1174,3,1
193399,386,114,272,4,1
193399,1249,347,902,5,1
193399,34,5,29,11,1
193399,269,54,215,12,3
193399,98,32,66,19,1
193399,1151,315,836,20,1
193399,1539,456,1083,21,4
193399,1489,439,1050,22,1
193399,1489,439,1050,23,1
193399,386,114,272,24,1
193399,1103,325,778,25,1
193399,50,17,33,32,3
193399,97,31,66,39,1
193399,1006,294,712,40,1
193399,399,64,335,41,4
193399,180,27,153,42,1
193399,146,22,124,43,1
193399,146,22,124,45,1
193399,34,5,29,51,1
193399,219,37,182,52,3
193399,1,1,0,59,1
193399,145,21,124,60,1
193405,1090,512,578,1,4
193405,1090,512,578,12,3
193405,1090,512,578,21,4
193405,1090,512,578,32,3
193478,23318,11640,11678,1,4
193478,23318,11640,11678,2,1
193478,21051,10719,10332,3,1
193478,4762,2614,2148,4,1
193478,16289,8105,8184,5,1
193478,2267,921,1346,11,1
193478,1625,810,815,19,1
193478,14664,7295,7369,20,1
193478,14209,7485,6724,21,4
193478,14209,7485,6724,22,1
193478,13588,7188,6400,23,1
193478,4134,2283,1851,24,1
193478,9454,4905,4549,25,1
193478,621,297,324,31,1
193478,1122,603,519,39,1
193478,8332,4302,4030,40,1
193478,9109,4155,4954,41,4
193478,9109,4155,4954,42,1
193478,7463,3531,3932,43,1
193478,628,331,297,44,1
193478,6835,3200,3635,45,1
193478,1646,624,1022,51,1
193478,503,207,296,59,1
193478,6332,2993,3339,60,1
193584,2823,716,2107,1,4
193584,2034,548,1486,2,1
193584,1995,530,1465,3,1
193584,423,112,311,4,1
193584,1572,418,1154,5,1
193584,39,18,21,11,1
193584,789,168,621,12,3
193584,168,49,119,19,1
193584,1404,369,1035,20,1
193584,2293,592,1701,21,4
193584,1901,511,1390,22,1
193584,1890,503,1387,23,1
193584,423,112,311,24,1
193584,1467,391,1076,25,1
193584,11,8,3,31,1
193584,392,81,311,32,3
193584,160,47,113,39,1
193584,1307,344,963,40,1
193584,530,124,406,41,4
193584,133,37,96,42,1
193584,105,27,78,43,1
193584,105,27,78,45,1
193584,28,10,18,51,1
193584,397,87,310,52,3
193584,8,2,6,59,1
193584,97,25,72,60,1
193609,87,40,47,1,4
193609,87,40,47,2,1
193609,87,40,47,3,1
193609,17,5,12,4,1
193609,70,35,35,5,1
193609,70,35,35,20,1
193609,87,40,47,21,4
193609,87,40,47,22,1
193609,87,40,47,23,1
193609,17,5,12,24,1
193609,70,35,35,25,1
193609,70,35,35,40,1
193645,3966,419,3547,1,4
193645,3225,335,2890,2,1
193645,3207,333,2874,3,1
193645,492,64,428,4,1
193645,2715,269,2446,5,1
193645,18,2,16,11,1
193645,741,84,657,12,3
193645,236,25,211,19,1
193645,2479,244,2235,20,1
193645,2865,300,2565,21,4
193645,2755,286,2469,22,1
193645,2753,285,2468,23,1
193645,473,62,411,24,1
193645,2280,223,2057,25,1
193645,2,1,1,31,1
193645,110,14,96,32,3
193645,183,18,165,39,1
193645,2097,205,1892,40,1
193645,1101,119,982,41,4
193645,470,49,421,42,1
193645,454,48,406,43,1
193645,19,2,17,44,1
193645,435,46,389,45,1
193645,16,1,15,51,1
193645,631,70,561,52,3
193645,53,7,46,59,1
193645,382,39,343,60,1
193654,10301,3172,7129,1,4
193654,6777,1890,4887,2,1
193654,6581,1820,4761,3,1
193654,1038,295,743,4,1
193654,5543,1525,4018,5,1
193654,196,70,126,11,1
193654,3524,1282,2242,12,3
193654,965,246,719,19,1
193654,4578,1279,3299,20,1
193654,8415,2578,5837,21,4
193654,5878,1628,4250,22,1
193654,5806,1605,4201,23,1
193654,996,282,714,24,1
193654,4810,1323,3487,25,1
193654,72,23,49,31,1
193654,2537,950,1587,32,3
193654,861,225,636,39,1
193654,3949,1098,2851,40,1
193654,1886,594,1292,41,4
193654,899,262,637,42,1
193654,775,215,560,43,1
193654,42,13,29,44,1
193654,733,202,531,45,1
193654,124,47,77,51,1
193654,987,332,655,52,3
193654,104,21,83,59,1
193654,629,181,448,60,1
193672,58,48,10,1,4
193672,58,48,10,2,1
193672,58,48,10,3,1
193672,25,21,4,4,1
193672,33,27,6,5,1
193672,33,27,6,20,1
193672,58,48,10,21,4
193672,58,48,10,22,1
193672,58,48,10,23,1
193672,25,21,4,24,1
193672,33,27,6,25,1
193672,33,27,6,40,1
193751,923,480,443,1,4
193751,923,480,443,12,3
193751,723,402,321,21,4
193751,723,402,321,32,3
193751,200,78,122,41,4
193751,200,78,122,52,3
193760,820,281,539,1,4
193760,820,281,539,2,1
193760,820,281,539,3,1
193760,239,92,147,4,1
193760,581,189,392,5,1
193760,581,189,392,20,1
193760,605,202,403,21,4
193760,605,202,403,22,1
193760,605,202,403,23,1
193760,160,65,95,24,1
193760,445,137,308,25,1
193760,445,137,308,40,1
193760,215,79,136,41,4
193760,215,79,136,42,1
193760,215,79,136,43,1
193760,79,27,52,44,1
193760,136,52,84,45,1
193760,136,52,84,60,1
193788,247,125,122,1,4
193788,247,125,122,2,1
193788,247,125,122,3,1
193788,105,52,53,4,1
193788,142,73,69,5,1
193788,142,73,69,20,1
193788,229,119,110,21,4
193788,229,119,110,22,1
193788,229,119,110,23,1
193788,89,46,43,24,1
193788,140,73,67,25,1
193788,140,73,67,40,1
193788,18,6,12,41,4
193788,18,6,12,42,1
193788,18,6,12,43,1
193788,16,6,10,44,1
193788,2,0,2,45,1
193788,2,0,2,60,1
193821,1261,624,637,1,4
193821,1261,624,637,12,3
193821,854,421,433,21,4
193821,854,421,433,32,3
193821,407,203,204,41,4
193821,407,203,204,52,3
193830,1427,611,816,1,4
193830,1427,611,816,12,3
193830,1139,517,622,21,4
193830,1139,517,622,32,3
193830,288,94,194,41,4
193830,288,94,194,52,3
193858,328,20,308,1,4
193858,328,20,308,2,1
193858,328,20,308,3,1
193858,171,9,162,4,1
193858,157,11,146,5,1
193858,157,11,146,20,1
193858,328,20,308,21,4
193858,328,20,308,22,1
193858,328,20,308,23,1
193858,171,9,162,24,1
193858,157,11,146,25,1
193858,157,11,146,40,1
193894,396,200,196,1,4
193894,396,200,196,12,3
193894,198,97,101,21,4
193894,198,97,101,32,3
193894,198,103,95,41,4
193894,198,103,95,52,3
193900,44599,18619,25980,1,4
193900,22615,9066,13549,2,1
193900,22172,8889,13283,3,1
193900,5207,2083,3124,4,1
193900,16965,6806,10159,5,1
193900,443,177,266,11,1
193900,21984,9553,12431,12,3
193900,891,276,615,19,1
193900,16074,6530,9544,20,1
193900,35096,14395,20701,21,4
193900,21365,8567,12798,22,1
193900,21081,8463,12618,23,1
193900,5168,2067,3101,24,1
193900,15913,6396,9517,25,1
193900,284,104,180,31,1
193900,13731,5828,7903,32,3
193900,772,242,530,39,1
193900,15141,6154,8987,40,1
193900,9503,4224,5279,41,4
193900,1250,499,751,42,1
193900,1091,426,665,43,1
193900,39,16,23,44,1
193900,1052,410,642,45,1
193900,159,73,86,51,1
193900,8253,3725,4528,52,3
193900,119,34,85,59,1
193900,933,376,557,60,1
193946,6630,2842,3788,1,4
193946,6630,2842,3788,2,1
193946,5297,2248,3049,3,1
193946,1504,705,799,4,1
193946,3793,1543,2250,5,1
193946,1333,594,739,11,1
193946,467,192,275,19,1
193946,3326,1351,1975,20,1
193946,4178,1881,2297,21,4
193946,4178,1881,2297,22,1
193946,4138,1857,2281,23,1
193946,1397,658,739,24,1
193946,2741,1199,1542,25,1
193946,40,24,16,31,1
193946,344,153,191,39,1
193946,2397,1046,1351,40,1
193946,2452,961,1491,41,4
193946,2452,961,1491,42,1
193946,1159,391,768,43,1
193946,107,47,60,44,1
193946,1052,344,708,45,1
193946,1293,570,723,51,1
193946,123,39,84,59,1
193946,929,305,624,60,1
193973,4056,1588,2468,1,4
193973,2896,1211,1685,2,1
193973,2841,1181,1660,3,1
193973,700,294,406,4,1
193973,2141,887,1254,5,1
193973,55,30,25,11,1
193973,1160,377,783,12,3
193973,610,258,352,19,1
193973,1531,629,902,20,1
193973,3342,1356,1986,21,4
193973,2719,1149,1570,22,1
193973,2709,1146,1563,23,1
193973,698,294,404,24,1
193973,2011,852,1159,25,1
193973,10,3,7,31,1
193973,623,207,416,32,3
193973,517,237,280,39,1
193973,1494,615,879,40,1
193973,714,232,482,41,4
193973,177,62,115,42,1
193973,132,35,97,43,1
193973,2,0,2,44,1
193973,130,35,95,45,1
193973,45,27,18,51,1
193973,537,170,367,52,3
193973,93,21,72,59,1
193973,37,14,23,60,1
193991,43,3,40,1,4
193991,43,3,40,2,1
193991,43,3,40,3,1
193991,30,3,27,4,1
193991,13,0,13,5,1
193991,13,0,13,20,1
193991,43,3,40,21,4
193991,43,3,40,22,1
193991,43,3,40,23,1
193991,30,3,27,24,1
193991,13,0,13,25,1
193991,13,0,13,40,1
194028,2088,803,1285,1,4
194028,2088,803,1285,2,1
194028,1021,367,654,3,1
194028,395,143,252,4,1
194028,626,224,402,5,1
194028,1067,436,631,11,1
194028,116,29,87,19,1
194028,510,195,315,20,1
194028,951,347,604,21,4
194028,951,347,604,22,1
194028,870,318,552,23,1
194028,359,129,230,24,1
194028,511,189,322,25,1
194028,81,29,52,31,1
194028,94,20,74,39,1
194028,417,169,248,40,1
194028,1137,456,681,41,4
194028,1137,456,681,42,1
194028,151,49,102,43,1
194028,36,14,22,44,1
194028,115,35,80,45,1
194028,986,407,579,51,1
194028,22,9,13,59,1
194028,93,26,67,60,1
194073,382,206,176,1,4
194073,382,206,176,12,3
194073,380,204,176,21,4
194073,380,204,176,32,3
194073,2,2,0,41,4
194073,2,2,0,52,3
194091,7545,4320,3225,1,4
194091,4456,2793,1663,2,1
194091,4307,2708,1599,3,1
194091,838,551,287,4,1
194091,3469,2157,1312,5,1
194091,149,85,64,11,1
194091,3089,1527,1562,12,3
194091,396,216,180,19,1
194091,3073,1941,1132,20,1
194091,6028,3455,2573,21,4
194091,3704,2308,1396,22,1
194091,3637,2266,1371,23,1
194091,778,508,270,24,1
194091,2859,1758,1101,25,1
194091,67,42,25,31,1
194091,2324,1147,1177,32,3
194091,340,186,154,39,1
194091,2519,1572,947,40,1
194091,1517,865,652,41,4
194091,752,485,267,42,1
194091,670,442,228,43,1
194091,60,43,17,44,1
194091,610,399,211,45,1
194091,82,43,39,51,1
194091,765,380,385,52,3
194091,56,30,26,59,1
194091,554,369,185,60,1
194116,589,82,507,1,4
194116,451,55,396,2,1
194116,394,49,345,3,1
194116,32,2,30,4,1
194116,362,47,315,5,1
194116,57,6,51,11,1
194116,138,27,111,12,3
194116,67,10,57,19,1
194116,295,37,258,20,1
194116,295,49,246,21,4
194116,158,23,135,22,1
194116,158,23,135,23,1
194116,21,1,20,24,1
194116,137,22,115,25,1
194116,137,26,111,32,3
194116,14,5,9,39,1
194116,123,17,106,40,1
194116,294,33,261,41,4
194116,293,32,261,42,1
194116,236,26,210,43,1
194116,11,1,10,44,1
194116,225,25,200,45,1
194116,57,6,51,51,1
194116,1,1,0,52,3
194116,53,5,48,59,1
194116,172,20,152,60,1
194161,3082,1272,1810,1,4
194161,1831,721,1110,2,1
194161,1818,720,1098,3,1
194161,265,118,147,4,1
194161,1553,602,951,5,1
194161,13,1,12,11,1
194161,1251,551,700,12,3
194161,226,87,139,19,1
194161,1327,515,812,20,1
194161,2033,837,1196,21,4
194161,1515,600,915,22,1
194161,1513,599,914,23,1
194161,249,110,139,24,1
194161,1264,489,775,25,1
194161,2,1,1,31,1
194161,518,237,281,32,3
194161,193,72,121,39,1
194161,1071,417,654,40,1
194161,1049,435,614,41,4
194161,316,121,195,42,1
194161,305,121,184,43,1
194161,16,8,8,44,1
194161,289,113,176,45,1
194161,11,0,11,51,1
194161,733,314,419,52,3
194161,33,15,18,59,1
194161,256,98,158,60,1
194189,94,94,0,1,4
194189,94,94,0,2,1
194189,94,94,0,3,1
194189,1,1,0,4,1
194189,93,93,0,5,1
194189,2,2,0,19,1
194189,91,91,0,20,1
194189,94,94,0,21,4
194189,94,94,0,22,1
194189,94,94,0,23,1
194189,1,1,0,24,1
194189,93,93,0,25,1
194189,2,2,0,39,1
194189,91,91,0,40,1
194222,12834,6192,6642,1,4
194222,12834,6192,6642,2,1
194222,8664,4317,4347,3,1
194222,2476,1312,1164,4,1
194222,6188,3005,3183,5,1
194222,4170,1875,2295,11,1
194222,490,256,234,19,1
194222,5698,2749,2949,20,1
194222,6540,3379,3161,21,4
194222,6540,3379,3161,22,1
194222,6416,3313,3103,23,1
194222,2239,1200,1039,24,1
194222,4177,2113,2064,25,1
194222,124,66,58,31,1
194222,380,202,178,39,1
194222,3797,1911,1886,40,1
194222,6294,2813,3481,41,4
194222,6294,2813,3481,42,1
194222,2248,1004,1244,43,1
194222,237,112,125,44,1
194222,2011,892,1119,45,1
194222,4046,1809,2237,51,1
194222,110,54,56,59,1
194222,1901,838,1063,60,1
194240,7029,2906,4123,1,4
194240,7029,2906,4123,2,1
194240,5580,2306,3274,3,1
194240,1432,656,776,4,1
194240,4148,1650,2498,5,1
194240,1449,600,849,11,1
194240,390,149,241,19,1
194240,3758,1501,2257,20,1
194240,3338,1523,1815,21,4
194240,3338,1523,1815,22,1
194240,3301,1510,1791,23,1
194240,1193,548,645,24,1
194240,2108,962,1146,25,1
194240,37,13,24,31,1
194240,238,99,139,39,1
194240,1870,863,1007,40,1
194240,3691,1383,2308,41,4
194240,3691,1383,2308,42,1
194240,2279,796,1483,43,1
194240,239,108,131,44,1
194240,2040,688,1352,45,1
194240,1412,587,825,51,1
194240,152,50,102,59,1
194240,1888,638,1250,60,1
194259,37,6,31,1,4
194259,37,6,31,2,1
194259,37,6,31,3,1
194259,9,1,8,4,1
194259,28,5,23,5,1
194259,28,5,23,20,1
194259,37,6,31,21,4
194259,37,6,31,22,1
194259,37,6,31,23,1
194259,9,1,8,24,1
194259,28,5,23,25,1
194259,28,5,23,40,1
194310,12624,4986,7638,1,4
194310,8289,3398,4891,2,1
194310,7883,3221,4662,3,1
194310,1804,675,1129,4,1
194310,6079,2546,3533,5,1
194310,406,177,229,11,1
194310,4335,1588,2747,12,3
194310,530,229,301,19,1
194310,5549,2317,3232,20,1
194310,9148,3551,5597,21,4
194310,7116,2825,4291,22,1
194310,7079,2811,4268,23,1
194310,1758,652,1106,24,1
194310,5321,2159,3162,25,1
194310,37,14,23,31,1
194310,2032,726,1306,32,3
194310,423,188,235,39,1
194310,4898,1971,2927,40,1
194310,3476,1435,2041,41,4
194310,1173,573,600,42,1
194310,804,410,394,43,1
194310,46,23,23,44,1
194310,758,387,371,45,1
194310,369,163,206,51,1
194310,2303,862,1441,52,3
194310,107,41,66,59,1
194310,651,346,305,60,1
194392,981,646,335,1,4
194392,981,646,335,2,1
194392,978,644,334,3,1
194392,240,157,83,4,1
194392,738,487,251,5,1
194392,3,2,1,11,1
194392,57,33,24,19,1
194392,681,454,227,20,1
194392,969,637,332,21,4
194392,969,637,332,22,1
194392,969,637,332,23,1
194392,240,157,83,24,1
194392,729,480,249,25,1
194392,57,33,24,39,1
194392,672,447,225,40,1
194392,12,9,3,41,4
194392,12,9,3,42,1
194392,9,7,2,43,1
194392,9,7,2,45,1
194392,3,2,1,51,1
194392,9,7,2,60,1
194435,111,7,104,1,4
194435,111,7,104,2,1
194435,111,7,104,3,1
194435,5,0,5,4,1
194435,106,7,99,5,1
194435,106,7,99,20,1
194435,70,6,64,21,4
194435,70,6,64,22,1
194435,70,6,64,23,1
194435,4,0,4,24,1
194435,66,6,60,25,1
194435,66,6,60,40,1
194435,41,1,40,41,4
194435,41,1,40,42,1
194435,41,1,40,43,1
194435,1,0,1,44,1
194435,40,1,39,45,1
194435,40,1,39,60,1
194499,726,145,581,1,4
194499,726,145,581,2,1
194499,726,145,581,3,1
194499,228,45,183,4,1
194499,498,100,398,5,1
194499,68,13,55,19,1
194499,430,87,343,20,1
194499,726,145,581,21,4
194499,726,145,581,22,1
194499,726,145,581,23,1
194499,228,45,183,24,1
194499,498,100,398,25,1
194499,68,13,55,39,1
194499,430,87,343,40,1
194541,4890,3603,1287,1,4
194541,2155,1642,513,2,1
194541,2078,1595,483,3,1
194541,451,334,117,4,1
194541,1627,1261,366,5,1
194541,77,47,30,11,1
194541,2735,1961,774,12,3
194541,131,101,30,19,1
194541,1496,1160,336,20,1
194541,4008,2942,1066,21,4
194541,2033,1555,478,22,1
194541,2007,1537,470,23,1
194541,451,334,117,24,1
194541,1556,1203,353,25,1
194541,26,18,8,31,1
194541,1975,1387,588,32,3
194541,125,97,28,39,1
194541,1431,1106,325,40,1
194541,882,661,221,41,4
194541,122,87,35,42,1
194541,71,58,13,43,1
194541,71,58,13,45,1
194541,51,29,22,51,1
194541,760,574,186,52,3
194541,6,4,2,59,1
194541,65,54,11,60,1
194569,395,211,184,1,4
194569,395,211,184,2,1
194569,247,146,101,3,1
194569,39,17,22,4,1
194569,208,129,79,5,1
194569,148,65,83,11,1
194569,30,16,14,19,1
194569,178,113,65,20,1
194569,231,127,104,21,4
194569,231,127,104,22,1
194569,214,121,93,23,1
194569,38,16,22,24,1
194569,176,105,71,25,1
194569,17,6,11,31,1
194569,27,14,13,39,1
194569,149,91,58,40,1
194569,164,84,80,41,4
194569,164,84,80,42,1
194569,33,25,8,43,1
194569,1,1,0,44,1
194569,32,24,8,45,1
194569,131,59,72,51,1
194569,3,2,1,59,1
194569,29,22,7,60,1
194578,4793,1522,3271,1,4
194578,3311,1100,2211,2,1
194578,3247,1077,2170,3,1
194578,716,205,511,4,1
194578,2531,872,1659,5,1
194578,64,23,41,11,1
194578,1482,422,1060,12,3
194578,164,55,109,19,1
194578,2367,817,1550,20,1
194578,4514,1417,3097,21,4
194578,3202,1041,2161,22,1
194578,3145,1022,2123,23,1
194578,712,202,510,24,1
194578,2433,820,1613,25,1
194578,57,19,38,31,1
194578,1312,376,936,32,3
194578,158,53,105,39,1
194578,2275,767,1508,40,1
194578,279,105,174,41,4
194578,109,59,50,42,1
194578,102,55,47,43,1
194578,4,3,1,44,1
194578,98,52,46,45,1
194578,7,4,3,51,1
194578,170,46,124,52,3
194578,6,2,4,59,1
194578,92,50,42,60,1
194611,884,274,610,1,4
194611,884,274,610,2,1
194611,884,274,610,3,1
194611,240,77,163,4,1
194611,644,197,447,5,1
194611,644,197,447,20,1
194611,875,271,604,21,4
194611,875,271,604,22,1
194611,875,271,604,23,1
194611,239,76,163,24,1
194611,636,195,441,25,1
194611,636,195,441,40,1
194611,9,3,6,41,4
194611,9,3,6,42,1
194611,9,3,6,43,1
194611,1,1,0,44,1
194611,8,2,6,45,1
194611,8,2,6,60,1
194657,258,258,0,1,4
194657,166,166,0,2,1
194657,164,164,0,3,1
194657,44,44,0,4,1
194657,120,120,0,5,1
194657,2,2,0,11,1
194657,92,92,0,12,3
194657,8,8,0,19,1
194657,112,112,0,20,1
194657,258,258,0,21,4
194657,166,166,0,22,1
194657,164,164,0,23,1
194657,44,44,0,24,1
194657,120,120,0,25,1
194657,2,2,0,31,1
194657,92,92,0,32,3
194657,8,8,0,39,1
194657,112,112,0,40,1
194666,316,316,0,1,4
194666,263,263,0,2,1
194666,263,263,0,3,1
194666,36,36,0,4,1
194666,227,227,0,5,1
194666,53,53,0,12,3
194666,25,25,0,19,1
194666,202,202,0,20,1
194666,316,316,0,21,4
194666,263,263,0,22,1
194666,263,263,0,23,1
194666,36,36,0,24,1
194666,227,227,0,25,1
194666,53,53,0,32,3
194666,25,25,0,39,1
194666,202,202,0,40,1
194675,43,43,0,1,4
194675,30,30,0,2,1
194675,30,30,0,3,1
194675,6,6,0,4,1
194675,24,24,0,5,1
194675,13,13,0,12,3
194675,24,24,0,20,1
194675,43,43,0,21,4
194675,30,30,0,22,1
194675,30,30,0,23,1
194675,6,6,0,24,1
194675,24,24,0,25,1
194675,13,13,0,32,3
194675,24,24,0,40,1
194693,47,47,0,1,4
194693,47,47,0,2,1
194693,47,47,0,3,1
194693,14,14,0,4,1
194693,33,33,0,5,1
194693,33,33,0,20,1
194693,47,47,0,21,4
194693,47,47,0,22,1
194693,47,47,0,23,1
194693,14,14,0,24,1
194693,33,33,0,25,1
194693,33,33,0,40,1
194718,34,34,0,1,4
194718,30,30,0,2,1
194718,30,30,0,3,1
194718,7,7,0,4,1
194718,23,23,0,5,1
194718,4,4,0,12,3
194718,5,5,0,19,1
194718,18,18,0,20,1
194718,34,34,0,21,4
194718,30,30,0,22,1
194718,30,30,0,23,1
194718,7,7,0,24,1
194718,23,23,0,25,1
194718,4,4,0,32,3
194718,5,5,0,39,1
194718,18,18,0,40,1
194736,96,96,0,1,4
194736,96,96,0,2,1
194736,96,96,0,3,1
194736,96,96,0,5,1
194736,4,4,0,19,1
194736,92,92,0,20,1
194736,96,96,0,21,4
194736,96,96,0,22,1
194736,96,96,0,23,1
194736,96,96,0,25,1
194736,4,4,0,39,1
194736,92,92,0,40,1
194763,491,491,0,1,4
194763,269,269,0,2,1
194763,269,269,0,3,1
194763,107,107,0,4,1
194763,162,162,0,5,1
194763,222,222,0,12,3
194763,162,162,0,20,1
194763,491,491,0,21,4
194763,269,269,0,22,1
194763,269,269,0,23,1
194763,107,107,0,24,1
194763,162,162,0,25,1
194763,222,222,0,32,3
194763,162,162,0,40,1
194824,6714,4728,1986,1,4
194824,5452,3840,1612,2,1
194824,5379,3787,1592,3,1
194824,1411,975,436,4,1
194824,3968,2812,1156,5,1
194824,73,53,20,11,1
194824,1262,888,374,12,3
194824,126,88,38,19,1
194824,3842,2724,1118,20,1
194824,6565,4613,1952,21,4
194824,5423,3819,1604,22,1
194824,5377,3785,1592,23,1
194824,1411,975,436,24,1
194824,3966,2810,1156,25,1
194824,46,34,12,31,1
194824,1142,794,348,32,3
194824,126,88,38,39,1
194824,3840,2722,1118,40,1
194824,149,115,34,41,4
194824,29,21,8,42,1
194824,2,2,0,43,1
194824,2,2,0,45,1
194824,27,19,8,51,1
194824,120,94,26,52,3
194824,2,2,0,60,1
194879,193,36,157,1,4
194879,193,36,157,2,1
194879,193,36,157,3,1
194879,33,9,24,4,1
194879,160,27,133,5,1
194879,160,27,133,20,1
194879,150,30,120,21,4
194879,150,30,120,22,1
194879,150,30,120,23,1
194879,31,8,23,24,1
194879,119,22,97,25,1
194879,119,22,97,40,1
194879,43,6,37,41,4
194879,43,6,37,42,1
194879,43,6,37,43,1
194879,2,1,1,44,1
194879,41,5,36,45,1
194879,41,5,36,60,1
194958,1735,485,1250,1,4
194958,1315,394,921,2,1
194958,1302,390,912,3,1
194958,206,71,135,4,1
194958,1096,319,777,5,1
194958,13,4,9,11,1
194958,420,91,329,12,3
194958,97,31,66,19,1
194958,999,288,711,20,1
194958,1585,440,1145,21,4
194958,1225,368,857,22,1
194958,1223,368,855,23,1
194958,203,70,133,24,1
194958,1020,298,722,25,1
194958,2,0,2,31,1
194958,360,72,288,32,3
194958,83,29,54,39,1
194958,937,269,668,40,1
194958,150,45,105,41,4
194958,90,26,64,42,1
194958,79,22,57,43,1
194958,3,1,2,44,1
194958,76,21,55,45,1
194958,11,4,7,51,1
194958,60,19,41,52,3
194958,14,2,12,59,1
194958,62,19,43,60,1
194967,617,167,450,1,4
194967,617,167,450,2,1
194967,617,167,450,3,1
194967,1,0,1,4,1
194967,616,167,449,5,1
194967,84,24,60,19,1
194967,532,143,389,20,1
194967,408,104,304,21,4
194967,408,104,304,22,1
194967,408,104,304,23,1
194967,1,0,1,24,1
194967,407,104,303,25,1
194967,60,16,44,39,1
194967,347,88,259,40,1
194967,209,63,146,41,4
194967,209,63,146,42,1
194967,209,63,146,43,1
194967,209,63,146,45,1
194967,24,8,16,59,1
194967,185,55,130,60,1
195003,16583,11235,5348,1,4
195003,13880,9485,4395,2,1
195003,12587,8484,4103,3,1
195003,2784,1891,893,4,1
195003,9803,6593,3210,5,1
195003,1293,1001,292,11,1
195003,2703,1750,953,12,3
195003,597,350,247,19,1
195003,9206,6243,2963,20,1
195003,14119,9464,4655,21,4
195003,12106,8160,3946,22,1
195003,12084,8150,3934,23,1
195003,2768,1880,888,24,1
195003,9316,6270,3046,25,1
195003,22,10,12,31,1
195003,2013,1304,709,32,3
195003,561,327,234,39,1
195003,8755,5943,2812,40,1
195003,2464,1771,693,41,4
195003,1774,1325,449,42,1
195003,503,334,169,43,1
195003,16,11,5,44,1
195003,487,323,164,45,1
195003,1271,991,280,51,1
195003,690,446,244,52,3
195003,36,23,13,59,1
195003,451,300,151,60,1
195030,11020,5342,5678,1,4
195030,6177,2961,3216,2,1
195030,6047,2924,3123,3,1
195030,1472,738,734,4,1
195030,4575,2186,2389,5,1
195030,130,37,93,11,1
195030,4843,2381,2462,12,3
195030,107,45,62,19,1
195030,4468,2141,2327,20,1
195030,9284,4717,4567,21,4
195030,5837,2887,2950,22,1
195030,5819,2880,2939,23,1
195030,1472,738,734,24,1
195030,4347,2142,2205,25,1
195030,18,7,11,31,1
195030,3447,1830,1617,32,3
195030,107,45,62,39,1
195030,4240,2097,2143,40,1
195030,1736,625,1111,41,4
195030,340,74,266,42,1
195030,228,44,184,43,1
195030,228,44,184,45,1
195030,112,30,82,51,1
195030,1396,551,845,52,3
195030,228,44,184,60,1
195049,201,117,84,1,4
195049,201,117,84,12,3
195049,201,117,84,21,4
195049,201,117,84,32,3
195058,7652,3561,4091,1,4
195058,7652,3561,4091,2,1
195058,6568,3099,3469,3,1
195058,1575,832,743,4,1
195058,4993,2267,2726,5,1
195058,1084,462,622,11,1
195058,384,162,222,19,1
195058,4609,2105,2504,20,1
195058,4477,2343,2134,21,4
195058,4477,2343,2134,22,1
195058,4465,2337,2128,23,1
195058,1452,781,671,24,1
195058,3013,1556,1457,25,1
195058,12,6,6,31,1
195058,265,129,136,39,1
195058,2748,1427,1321,40,1
195058,3175,1218,1957,41,4
195058,3175,1218,1957,42,1
195058,2103,762,1341,43,1
195058,123,51,72,44,1
195058,1980,711,1269,45,1
195058,1072,456,616,51,1
195058,119,33,86,59,1
195058,1861,678,1183,60,1
195067,665,35,630,1,4
195067,665,35,630,2,1
195067,665,35,630,3,1
195067,206,8,198,4,1
195067,459,27,432,5,1
195067,459,27,432,20,1
195067,459,25,434,21,4
195067,459,25,434,22,1
195067,459,25,434,23,1
195067,162,5,157,24,1
195067,297,20,277,25,1
195067,297,20,277,40,1
195067,206,10,196,41,4
195067,206,10,196,42,1
195067,206,10,196,43,1
195067,44,3,41,44,1
195067,162,7,155,45,1
195067,162,7,155,60,1
195128,2832,549,2283,1,4
195128,1699,359,1340,2,1
195128,1661,345,1316,3,1
195128,297,49,248,4,1
195128,1364,296,1068,5,1
195128,38,14,24,11,1
195128,1133,190,943,12,3
195128,210,53,157,19,1
195128,1154,243,911,20,1
195128,1852,348,1504,21,4
195128,1446,290,1156,22,1
195128,1446,290,1156,23,1
195128,295,47,248,24,1
195128,1151,243,908,25,1
195128,406,58,348,32,3
195128,179,49,130,39,1
195128,972,194,778,40,1
195128,980,201,779,41,4
195128,253,69,184,42,1
195128,215,55,160,43,1
195128,2,2,0,44,1
195128,213,53,160,45,1
195128,38,14,24,51,1
195128,727,132,595,52,3
195128,31,4,27,59,1
195128,182,49,133,60,1
195155,98,35,63,1,4
195155,98,35,63,12,3
195155,2,1,1,21,4
195155,2,1,1,32,3
195155,96,34,62,41,4
195155,96,34,62,52,3
195164,2244,1057,1187,1,4
195164,1826,901,925,2,1
195164,1787,884,903,3,1
195164,438,230,208,4,1
195164,1349,654,695,5,1
195164,39,17,22,11,1
195164,418,156,262,12,3
195164,71,39,32,19,1
195164,1278,615,663,20,1
195164,2037,981,1056,21,4
195164,1780,883,897,22,1
195164,1767,878,889,23,1
195164,438,230,208,24,1
195164,1329,648,681,25,1
195164,13,5,8,31,1
195164,257,98,159,32,3
195164,70,38,32,39,1
195164,1259,610,649,40,1
195164,207,76,131,41,4
195164,46,18,28,42,1
195164,20,6,14,43,1
195164,20,6,14,45,1
195164,26,12,14,51,1
195164,161,58,103,52,3
195164,1,1,0,59,1
195164,19,5,14,60,1
195173,2819,1248,1571,1,4
195173,2764,1217,1547,2,1
195173,2725,1202,1523,3,1
195173,568,247,321,4,1
195173,2157,955,1202,5,1
195173,39,15,24,11,1
195173,55,31,24,12,3
195173,170,75,95,19,1
195173,1987,880,1107,20,1
195173,2481,1101,1380,21,4
195173,2456,1088,1368,22,1
195173,2454,1088,1366,23,1
195173,566,247,319,24,1
195173,1888,841,1047,25,1
195173,2,0,2,31,1
195173,25,13,12,32,3
195173,146,69,77,39,1
195173,1742,772,970,40,1
195173,338,147,191,41,4
195173,308,129,179,42,1
195173,271,114,157,43,1
195173,2,0,2,44,1
195173,269,114,155,45,1
195173,37,15,22,51,1
195173,30,18,12,52,3
195173,24,6,18,59,1
195173,245,108,137,60,1
195191,302,37,265,1,4
195191,302,37,265,2,1
195191,302,37,265,3,1
195191,7,1,6,4,1
195191,295,36,259,5,1
195191,93,10,83,19,1
195191,202,26,176,20,1
195191,150,20,130,21,4
195191,150,20,130,22,1
195191,150,20,130,23,1
195191,7,1,6,24,1
195191,143,19,124,25,1
195191,60,7,53,39,1
195191,83,12,71,40,1
195191,152,17,135,41,4
195191,152,17,135,42,1
195191,152,17,135,43,1
195191,152,17,135,45,1
195191,33,3,30,59,1
195191,119,14,105,60,1
195216,2506,1114,1392,1,4
195216,2414,1088,1326,2,1
195216,2391,1079,1312,3,1
195216,629,284,345,4,1
195216,1762,795,967,5,1
195216,23,9,14,11,1
195216,92,26,66,12,3
195216,25,15,10,19,1
195216,1737,780,957,20,1
195216,2410,1085,1325,21,4
195216,2397,1081,1316,22,1
195216,2391,1079,1312,23,1
195216,629,284,345,24,1
195216,1762,795,967,25,1
195216,6,2,4,31,1
195216,13,4,9,32,3
195216,25,15,10,39,1
195216,1737,780,957,40,1
195216,96,29,67,41,4
195216,17,7,10,42,1
195216,17,7,10,51,1
195216,79,22,57,52,3
195234,4542,1420,3122,1,4
195234,2891,969,1922,2,1
195234,2792,934,1858,3,1
195234,621,213,408,4,1
195234,2171,721,1450,5,1
195234,99,35,64,11,1
195234,1651,451,1200,12,3
195234,222,64,158,19,1
195234,1949,657,1292,20,1
195234,3303,1031,2272,21,4
195234,2664,887,1777,22,1
195234,2663,886,1777,23,1
195234,619,212,407,24,1
195234,2044,674,1370,25,1
195234,1,1,0,31,1
195234,639,144,495,32,3
195234,210,61,149,39,1
195234,1834,613,1221,40,1
195234,1239,389,850,41,4
195234,227,82,145,42,1
195234,129,48,81,43,1
195234,2,1,1,44,1
195234,127,47,80,45,1
195234,98,34,64,51,1
195234,1012,307,705,52,3
195234,12,3,9,59,1
195234,115,44,71,60,1
195243,1972,898,1074,1,4
195243,1801,844,957,2,1
195243,1279,597,682,3,1
195243,337,156,181,4,1
195243,942,441,501,5,1
195243,522,247,275,11,1
195243,171,54,117,12,3
195243,93,52,41,19,1
195243,849,389,460,20,1
195243,1307,597,710,21,4
195243,1259,585,674,22,1
195243,1229,567,662,23,1
195243,332,154,178,24,1
195243,897,413,484,25,1
195243,30,18,12,31,1
195243,48,12,36,32,3
195243,88,49,39,39,1
195243,809,364,445,40,1
195243,665,301,364,41,4
195243,542,259,283,42,1
195243,50,30,20,43,1
195243,5,2,3,44,1
195243,45,28,17,45,1
195243,492,229,263,51,1
195243,123,42,81,52,3
195243,5,3,2,59,1
195243,40,25,15,60,1
195289,163,20,143,1,4
195289,163,20,143,2,1
195289,163,20,143,3,1
195289,4,0,4,4,1
195289,159,20,139,5,1
195289,60,12,48,19,1
195289,99,8,91,20,1
195289,18,1,17,21,4
195289,18,1,17,22,1
195289,18,1,17,23,1
195289,2,0,2,24,1
195289,16,1,15,25,1
195289,6,1,5,39,1
195289,10,0,10,40,1
195289,145,19,126,41,4
195289,145,19,126,42,1
195289,145,19,126,43,1
195289,2,0,2,44,1
195289,143,19,124,45,1
195289,54,11,43,59,1
195289,89,8,81,60,1
195304,1782,462,1320,1,4
195304,1471,409,1062,2,1
195304,1402,395,1007,3,1
195304,427,117,310,4,1
195304,975,278,697,5,1
195304,69,14,55,11,1
195304,311,53,258,12,3
195304,37,15,22,19,1
195304,938,263,675,20,1
195304,1701,449,1252,21,4
195304,1441,402,1039,22,1
195304,1391,391,1000,23,1
195304,427,117,310,24,1
195304,964,274,690,25,1
195304,50,11,39,31,1
195304,260,47,213,32,3
195304,37,15,22,39,1
195304,927,259,668,40,1
195304,81,13,68,41,4
195304,30,7,23,42,1
195304,11,4,7,43,1
195304,11,4,7,45,1
195304,19,3,16,51,1
195304,51,6,45,52,3
195304,11,4,7,60,1
195322,6574,2958,3616,1,4
195322,6574,2958,3616,2,1
195322,3874,1733,2141,3,1
195322,1074,547,527,4,1
195322,2800,1186,1614,5,1
195322,2700,1225,1475,11,1
195322,398,181,217,19,1
195322,2402,1005,1397,20,1
195322,2747,1320,1427,21,4
195322,2747,1320,1427,22,1
195322,2671,1280,1391,23,1
195322,927,481,446,24,1
195322,1744,799,945,25,1
195322,76,40,36,31,1
195322,308,145,163,39,1
195322,1436,654,782,40,1
195322,3827,1638,2189,41,4
195322,3827,1638,2189,42,1
195322,1203,453,750,43,1
195322,147,66,81,44,1
195322,1056,387,669,45,1
195322,2624,1185,1439,51,1
195322,90,36,54,59,1
195322,966,351,615,60,1
195438,248,248,0,1,4
195438,190,190,0,2,1
195438,190,190,0,3,1
195438,16,16,0,4,1
195438,174,174,0,5,1
195438,58,58,0,12,3
195438,11,11,0,19,1
195438,163,163,0,20,1
195438,248,248,0,21,4
195438,190,190,0,22,1
195438,190,190,0,23,1
195438,16,16,0,24,1
195438,174,174,0,25,1
195438,58,58,0,32,3
195438,11,11,0,39,1
195438,163,163,0,40,1
195474,3207,1518,1689,1,4
195474,3151,1482,1669,2,1
195474,3102,1456,1646,3,1
195474,766,348,418,4,1
195474,2336,1108,1228,5,1
195474,49,26,23,11,1
195474,56,36,20,12,3
195474,132,67,65,19,1
195474,2204,1041,1163,20,1
195474,3059,1434,1625,21,4
195474,3007,1400,1607,22,1
195474,3005,1400,1605,23,1
195474,766,348,418,24,1
195474,2239,1052,1187,25,1
195474,2,0,2,31,1
195474,52,34,18,32,3
195474,118,61,57,39,1
195474,2121,991,1130,40,1
195474,148,84,64,41,4
195474,144,82,62,42,1
195474,97,56,41,43,1
195474,97,56,41,45,1
195474,47,26,21,51,1
195474,4,2,2,52,3
195474,14,6,8,59,1
195474,83,50,33,60,1
195492,22,10,12,1,4
195492,22,10,12,2,1
195492,22,10,12,3,1
195492,5,2,3,4,1
195492,17,8,9,5,1
195492,17,8,9,20,1
195492,20,10,10,21,4
195492,20,10,10,22,1
195492,20,10,10,23,1
195492,5,2,3,24,1
195492,15,8,7,25,1
195492,15,8,7,40,1
195492,2,0,2,41,4
195492,2,0,2,42,1
195492,2,0,2,43,1
195492,2,0,2,45,1
195492,2,0,2,60,1
195526,2702,1057,1645,1,4
195526,2684,1052,1632,2,1
195526,2646,1039,1607,3,1
195526,660,261,399,4,1
195526,1986,778,1208,5,1
195526,38,13,25,11,1
195526,18,5,13,12,3
195526,32,14,18,19,1
195526,1954,764,1190,20,1
195526,2647,1035,1612,21,4
195526,2647,1035,1612,22,1
195526,2633,1031,1602,23,1
195526,660,261,399,24,1
195526,1973,770,1203,25,1
195526,14,4,10,31,1
195526,32,14,18,39,1
195526,1941,756,1185,40,1
195526,55,22,33,41,4
195526,37,17,20,42,1
195526,13,8,5,43,1
195526,13,8,5,45,1
195526,24,9,15,51,1
195526,18,5,13,52,3
195526,13,8,5,60,1
195544,5354,1621,3733,1,4
195544,4529,1425,3104,2,1
195544,4408,1373,3035,3,1
195544,547,190,357,4,1
195544,3861,1183,2678,5,1
195544,121,52,69,11,1
195544,825,196,629,12,3
195544,499,180,319,19,1
195544,3362,1003,2359,20,1
195544,3699,1193,2506,21,4
195544,3591,1159,2432,22,1
195544,3566,1146,2420,23,1
195544,544,188,356,24,1
195544,3022,958,2064,25,1
195544,25,13,12,31,1
195544,108,34,74,32,3
195544,398,147,251,39,1
195544,2624,811,1813,40,1
195544,1655,428,1227,41,4
195544,938,266,672,42,1
195544,842,227,615,43,1
195544,3,2,1,44,1
195544,839,225,614,45,1
195544,96,39,57,51,1
195544,717,162,555,52,3
195544,101,33,68,59,1
195544,738,192,546,60,1
195580,81,69,12,1,4
195580,81,69,12,12,3
195580,68,58,10,21,4
195580,68,58,10,32,3
195580,13,11,2,41,4
195580,13,11,2,52,3
195623,15,11,4,1,4
195623,15,11,4,2,1
195623,15,11,4,3,1
195623,12,9,3,4,1
195623,3,2,1,5,1
195623,3,2,1,20,1
195623,4,2,2,21,4
195623,4,2,2,22,1
195623,4,2,2,23,1
195623,2,1,1,24,1
195623,2,1,1,25,1
195623,2,1,1,40,1
195623,11,9,2,41,4
195623,11,9,2,42,1
195623,11,9,2,43,1
195623,10,8,2,44,1
195623,1,1,0,45,1
195623,1,1,0,60,1
195687,159,22,137,1,4
195687,159,22,137,2,1
195687,159,22,137,3,1
195687,3,0,3,4,1
195687,156,22,134,5,1
195687,81,11,70,19,1
195687,75,11,64,20,1
195687,72,13,59,21,4
195687,72,13,59,22,1
195687,72,13,59,23,1
195687,3,0,3,24,1
195687,69,13,56,25,1
195687,49,9,40,39,1
195687,20,4,16,40,1
195687,87,9,78,41,4
195687,87,9,78,42,1
195687,87,9,78,43,1
195687,87,9,78,45,1
195687,32,2,30,59,1
195687,55,7,48,60,1
195702,13,3,10,1,4
195702,13,3,10,2,1
195702,13,3,10,3,1
195702,13,3,10,5,1
195702,13,3,10,20,1
195702,13,3,10,21,4
195702,13,3,10,22,1
195702,13,3,10,23,1
195702,13,3,10,25,1
195702,13,3,10,40,1
195720,3987,1541,2446,1,4
195720,2959,1186,1773,2,1
195720,2948,1181,1767,3,1
195720,521,210,311,4,1
195720,2427,971,1456,5,1
195720,11,5,6,11,1
195720,1028,355,673,12,3
195720,279,119,160,19,1
195720,2148,852,1296,20,1
195720,3350,1345,2005,21,4
195720,2738,1101,1637,22,1
195720,2737,1100,1637,23,1
195720,521,210,311,24,1
195720,2216,890,1326,25,1
195720,1,1,0,31,1
195720,612,244,368,32,3
195720,237,107,130,39,1
195720,1979,783,1196,40,1
195720,637,196,441,41,4
195720,221,85,136,42,1
195720,211,81,130,43,1
195720,211,81,130,45,1
195720,10,4,6,51,1
195720,416,111,305,52,3
195720,42,12,30,59,1
195720,169,69,100,60,1
195784,747,101,646,1,4
195784,747,101,646,2,1
195784,747,101,646,3,1
195784,90,11,79,4,1
195784,657,90,567,5,1
195784,126,18,108,19,1
195784,531,72,459,20,1
195784,557,67,490,21,4
195784,557,67,490,22,1
195784,557,67,490,23,1
195784,90,11,79,24,1
195784,467,56,411,25,1
195784,102,12,90,39,1
195784,365,44,321,40,1
195784,190,34,156,41,4
195784,190,34,156,42,1
195784,190,34,156,43,1
195784,190,34,156,45,1
195784,24,6,18,59,1
195784,166,28,138,60,1
195793,35,4,31,1,4
195793,35,4,31,2,1
195793,35,4,31,3,1
195793,1,0,1,4,1
195793,34,4,30,5,1
195793,34,4,30,20,1
195793,35,4,31,21,4
195793,35,4,31,22,1
195793,35,4,31,23,1
195793,1,0,1,24,1
195793,34,4,30,25,1
195793,34,4,30,40,1
195809,20729,9055,11674,1,4
195809,15773,7170,8603,2,1
195809,11147,5287,5860,3,1
195809,2794,1286,1508,4,1
195809,8353,4001,4352,5,1
195809,4626,1883,2743,11,1
195809,4956,1885,3071,12,3
195809,576,276,300,19,1
195809,7777,3725,4052,20,1
195809,13719,6320,7399,21,4
195809,10908,5164,5744,22,1
195809,10821,5128,5693,23,1
195809,2789,1281,1508,24,1
195809,8032,3847,4185,25,1
195809,87,36,51,31,1
195809,2811,1156,1655,32,3
195809,559,266,293,39,1
195809,7473,3581,3892,40,1
195809,7010,2735,4275,41,4
195809,4865,2006,2859,42,1
195809,326,159,167,43,1
195809,5,5,0,44,1
195809,321,154,167,45,1
195809,4539,1847,2692,51,1
195809,2145,729,1416,52,3
195809,17,10,7,59,1
195809,304,144,160,60,1
195845,614,73,541,1,4
195845,614,73,541,2,1
195845,558,70,488,3,1
195845,36,8,28,4,1
195845,522,62,460,5,1
195845,56,3,53,11,1
195845,80,11,69,19,1
195845,442,51,391,20,1
195845,343,48,295,21,4
195845,343,48,295,22,1
195845,335,47,288,23,1
195845,31,7,24,24,1
195845,304,40,264,25,1
195845,8,1,7,31,1
195845,53,7,46,39,1
195845,251,33,218,40,1
195845,271,25,246,41,4
195845,271,25,246,42,1
195845,223,23,200,43,1
195845,5,1,4,44,1
195845,218,22,196,45,1
195845,48,2,46,51,1
195845,27,4,23,59,1
195845,191,18,173,60,1
195933,795,324,471,1,4
195933,795,324,471,2,1
195933,795,324,471,3,1
195933,238,99,139,4,1
195933,557,225,332,5,1
195933,557,225,332,20,1
195933,532,232,300,21,4
195933,532,232,300,22,1
195933,532,232,300,23,1
195933,195,76,119,24,1
195933,337,156,181,25,1
195933,337,156,181,40,1
195933,263,92,171,41,4
195933,263,92,171,42,1
195933,263,92,171,43,1
195933,43,23,20,44,1
195933,220,69,151,45,1
195933,220,69,151,60,1
195988,1585,708,877,1,4
195988,1585,708,877,2,1
195988,1282,553,729,3,1
195988,391,193,198,4,1
195988,891,360,531,5,1
195988,303,155,148,11,1
195988,125,64,61,19,1
195988,766,296,470,20,1
195988,1019,478,541,21,4
195988,1019,478,541,22,1
195988,998,459,539,23,1
195988,367,187,180,24,1
195988,631,272,359,25,1
195988,21,19,2,31,1
195988,95,52,43,39,1
195988,536,220,316,40,1
195988,566,230,336,41,4
195988,566,230,336,42,1
195988,284,94,190,43,1
195988,24,6,18,44,1
195988,260,88,172,45,1
195988,282,136,146,51,1
195988,30,12,18,59,1
195988,230,76,154,60,1
196006,3555,2137,1418,1,4
196006,3555,2137,1418,2,1
196006,3494,2121,1373,3,1
196006,1101,725,376,4,1
196006,2393,1396,997,5,1
196006,61,16,45,11,1
196006,329,143,186,19,1
196006,2064,1253,811,20,1
196006,3222,2065,1157,21,4
196006,3222,2065,1157,22,1
196006,3218,2065,1153,23,1
196006,1094,724,370,24,1
196006,2124,1341,783,25,1
196006,4,0,4,31,1
196006,277,131,146,39,1
196006,1847,1210,637,40,1
196006,333,72,261,41,4
196006,333,72,261,42,1
196006,276,56,220,43,1
196006,7,1,6,44,1
196006,269,55,214,45,1
196006,57,16,41,51,1
196006,52,12,40,59,1
196006,217,43,174,60,1
196015,3512,1561,1951,1,4
196015,3512,1561,1951,2,1
196015,3354,1491,1863,3,1
196015,780,394,386,4,1
196015,2574,1097,1477,5,1
196015,158,70,88,11,1
196015,285,101,184,19,1
196015,2289,996,1293,20,1
196015,2938,1351,1587,21,4
196015,2938,1351,1587,22,1
196015,2938,1351,1587,23,1
196015,772,389,383,24,1
196015,2166,962,1204,25,1
196015,228,83,145,39,1
196015,1938,879,1059,40,1
196015,574,210,364,41,4
196015,574,210,364,42,1
196015,416,140,276,43,1
196015,8,5,3,44,1
196015,408,135,273,45,1
196015,158,70,88,51,1
196015,57,18,39,59,1
196015,351,117,234,60,1
196024,3308,1562,1746,1,4
196024,3308,1562,1746,2,1
196024,3206,1512,1694,3,1
196024,921,551,370,4,1
196024,2285,961,1324,5,1
196024,102,50,52,11,1
196024,313,105,208,19,1
196024,1972,856,1116,20,1
196024,2590,1398,1192,21,4
196024,2590,1398,1192,22,1
196024,2590,1398,1192,23,1
196024,918,549,369,24,1
196024,1672,849,823,25,1
196024,203,84,119,39,1
196024,1469,765,704,40,1
196024,718,164,554,41,4
196024,718,164,554,42,1
196024,616,114,502,43,1
196024,3,2,1,44,1
196024,613,112,501,45,1
196024,102,50,52,51,1
196024,110,21,89,59,1
196024,503,91,412,60,1
196033,2453,1174,1279,1,4
196033,2453,1174,1279,2,1
196033,2411,1160,1251,3,1
196033,775,376,399,4,1
196033,1636,784,852,5,1
196033,42,14,28,11,1
196033,193,101,92,19,1
196033,1443,683,760,20,1
196033,2267,1088,1179,21,4
196033,2267,1088,1179,22,1
196033,2264,1087,1177,23,1
196033,755,361,394,24,1
196033,1509,726,783,25,1
196033,3,1,2,31,1
196033,180,97,83,39,1
196033,1329,629,700,40,1
196033,186,86,100,41,4
196033,186,86,100,42,1
196033,147,73,74,43,1
196033,20,15,5,44,1
196033,127,58,69,45,1
196033,39,13,26,51,1
196033,13,4,9,59,1
196033,114,54,60,60,1
196042,8162,4696,3466,1,4
196042,8162,4696,3466,2,1
196042,7455,4359,3096,3,1
196042,1119,645,474,4,1
196042,6336,3714,2622,5,1
196042,707,337,370,11,1
196042,947,538,409,19,1
196042,5389,3176,2213,20,1
196042,6074,3651,2423,21,4
196042,6074,3651,2423,22,1
196042,5910,3541,2369,23,1
196042,1106,636,470,24,1
196042,4804,2905,1899,25,1
196042,164,110,54,31,1
196042,756,436,320,39,1
196042,4048,2469,1579,40,1
196042,2088,1045,1043,41,4
196042,2088,1045,1043,42,1
196042,1545,818,727,43,1
196042,13,9,4,44,1
196042,1532,809,723,45,1
196042,543,227,316,51,1
196042,191,102,89,59,1
196042,1341,707,634,60,1
196051,3028,1587,1441,1,4
196051,3028,1587,1441,2,1
196051,2849,1449,1400,3,1
196051,851,468,383,4,1
196051,1998,981,1017,5,1
196051,179,138,41,11,1
196051,201,96,105,19,1
196051,1797,885,912,20,1
196051,2668,1396,1272,21,4
196051,2668,1396,1272,22,1
196051,2667,1395,1272,23,1
196051,841,461,380,24,1
196051,1826,934,892,25,1
196051,1,1,0,31,1
196051,184,93,91,39,1
196051,1642,841,801,40,1
196051,360,191,169,41,4
196051,360,191,169,42,1
196051,182,54,128,43,1
196051,10,7,3,44,1
196051,172,47,125,45,1
196051,178,137,41,51,1
196051,17,3,14,59,1
196051,155,44,111,60,1
196060,17338,8400,8938,1,4
196060,12822,6645,6177,2,1
196060,12542,6499,6043,3,1
196060,2566,1375,1191,4,1
196060,9976,5124,4852,5,1
196060,280,146,134,11,1
196060,4516,1755,2761,12,3
196060,1387,716,671,19,1
196060,8589,4408,4181,20,1
196060,14398,7178,7220,21,4
196060,12055,6229,5826,22,1
196060,11968,6177,5791,23,1
196060,2564,1375,1189,24,1
196060,9404,4802,4602,25,1
196060,87,52,35,31,1
196060,2343,949,1394,32,3
196060,1316,670,646,39,1
196060,8088,4132,3956,40,1
196060,2940,1222,1718,41,4
196060,767,416,351,42,1
196060,574,322,252,43,1
196060,2,0,2,44,1
196060,572,322,250,45,1
196060,193,94,99,51,1
196060,2173,806,1367,52,3
196060,71,46,25,59,1
196060,501,276,225,60,1
196079,16077,8474,7603,1,4
196079,12997,6926,6071,2,1
196079,12940,6900,6040,3,1
196079,2633,1401,1232,4,1
196079,10307,5499,4808,5,1
196079,57,26,31,11,1
196079,3080,1548,1532,12,3
196079,1185,604,581,19,1
196079,9122,4895,4227,20,1
196079,14383,7644,6739,21,4
196079,12559,6687,5872,22,1
196079,12548,6681,5867,23,1
196079,2585,1367,1218,24,1
196079,9963,5314,4649,25,1
196079,11,6,5,31,1
196079,1824,957,867,32,3
196079,1165,598,567,39,1
196079,8798,4716,4082,40,1
196079,1694,830,864,41,4
196079,438,239,199,42,1
196079,392,219,173,43,1
196079,48,34,14,44,1
196079,344,185,159,45,1
196079,46,20,26,51,1
196079,1256,591,665,52,3
196079,20,6,14,59,1
196079,324,179,145,60,1
196088,29850,15804,14046,1,4
196088,19831,10773,9058,2,1
196088,19365,10577,8788,3,1
196088,3653,1996,1657,4,1
196088,15712,8581,7131,5,1
196088,466,196,270,11,1
196088,10019,5031,4988,12,3
196088,1924,1051,873,19,1
196088,13788,7530,6258,20,1
196088,24816,13393,11423,21,4
196088,18091,9945,8146,22,1
196088,17793,9836,7957,23,1
196088,3636,1986,1650,24,1
196088,14157,7850,6307,25,1
196088,298,109,189,31,1
196088,6725,3448,3277,32,3
196088,1759,975,784,39,1
196088,12398,6875,5523,40,1
196088,5034,2411,2623,41,4
196088,1740,828,912,42,1
196088,1572,741,831,43,1
196088,17,10,7,44,1
196088,1555,731,824,45,1
196088,168,87,81,51,1
196088,3294,1583,1711,52,3
196088,165,76,89,59,1
196088,1390,655,735,60,1
196097,24143,12210,11933,1,4
196097,15992,8603,7389,2,1
196097,15724,8483,7241,3,1
196097,2709,1592,1117,4,1
196097,13015,6891,6124,5,1
196097,268,120,148,11,1
196097,8151,3607,4544,12,3
196097,1527,708,819,19,1
196097,11488,6183,5305,20,1
196097,20044,10688,9356,21,4
196097,14892,8068,6824,22,1
196097,14690,7992,6698,23,1
196097,2708,1592,1116,24,1
196097,11982,6400,5582,25,1
196097,202,76,126,31,1
196097,5152,2620,2532,32,3
196097,1426,676,750,39,1
196097,10556,5724,4832,40,1
196097,4099,1522,2577,41,4
196097,1100,535,565,42,1
196097,1034,491,543,43,1
196097,1,0,1,44,1
196097,1033,491,542,45,1
196097,66,44,22,51,1
196097,2999,987,2012,52,3
196097,101,32,69,59,1
196097,932,459,473,60,1
196103,2229,1225,1004,1,4
196103,1702,966,736,2,1
196103,1694,962,732,3,1
196103,288,148,140,4,1
196103,1406,814,592,5,1
196103,8,4,4,11,1
196103,527,259,268,12,3
196103,226,160,66,19,1
196103,1180,654,526,20,1
196103,1966,1079,887,21,4
196103,1647,928,719,22,1
196103,1644,928,716,23,1
196103,288,148,140,24,1
196103,1356,780,576,25,1
196103,3,0,3,31,1
196103,319,151,168,32,3
196103,221,157,64,39,1
196103,1135,623,512,40,1
196103,263,146,117,41,4
196103,55,38,17,42,1
196103,50,34,16,43,1
196103,50,34,16,45,1
196103,5,4,1,51,1
196103,208,108,100,52,3
196103,5,3,2,59,1
196103,45,31,14,60,1
196112,2480,1346,1134,1,4
196112,1804,1059,745,2,1
196112,1714,1036,678,3,1
196112,275,217,58,4,1
196112,1439,819,620,5,1
196112,90,23,67,11,1
196112,676,287,389,12,3
196112,355,189,166,19,1
196112,1084,630,454,20,1
196112,1620,1043,577,21,4
196112,1425,949,476,22,1
196112,1417,945,472,23,1
196112,275,217,58,24,1
196112,1142,728,414,25,1
196112,8,4,4,31,1
196112,195,94,101,32,3
196112,314,181,133,39,1
196112,828,547,281,40,1
196112,860,303,557,41,4
196112,379,110,269,42,1
196112,297,91,206,43,1
196112,297,91,206,45,1
196112,82,19,63,51,1
196112,481,193,288,52,3
196112,41,8,33,59,1
196112,256,83,173,60,1
196121,8128,3542,4586,1,4
196121,7090,3201,3889,2,1
196121,7040,3179,3861,3,1
196121,1080,479,601,4,1
196121,5960,2700,3260,5,1
196121,50,22,28,11,1
196121,1038,341,697,12,3
196121,976,443,533,19,1
196121,4984,2257,2727,20,1
196121,6729,3041,3688,21,4
196121,6411,2928,3483,22,1
196121,6410,2928,3482,23,1
196121,1079,479,600,24,1
196121,5331,2449,2882,25,1
196121,1,0,1,31,1
196121,318,113,205,32,3
196121,868,413,455,39,1
196121,4463,2036,2427,40,1
196121,1399,501,898,41,4
196121,679,273,406,42,1
196121,630,251,379,43,1
196121,1,0,1,44,1
196121,629,251,378,45,1
196121,49,22,27,51,1
196121,720,228,492,52,3
196121,108,30,78,59,1
196121,521,221,300,60,1
196130,11091,4578,6513,1,4
196130,9355,4058,5297,2,1
196130,9190,3969,5221,3,1
196130,1324,597,727,4,1
196130,7866,3372,4494,5,1
196130,165,89,76,11,1
196130,1736,520,1216,12,3
196130,1060,474,586,19,1
196130,6806,2898,3908,20,1
196130,8799,3683,5116,21,4
196130,8293,3542,4751,22,1
196130,8272,3534,4738,23,1
196130,1320,595,725,24,1
196130,6952,2939,4013,25,1
196130,21,8,13,31,1
196130,506,141,365,32,3
196130,975,437,538,39,1
196130,5977,2502,3475,40,1
196130,2292,895,1397,41,4
196130,1062,516,546,42,1
196130,918,435,483,43,1
196130,4,2,2,44,1
196130,914,433,481,45,1
196130,144,81,63,51,1
196130,1230,379,851,52,3
196130,85,37,48,59,1
196130,829,396,433,60,1
196149,7110,3070,4040,1,4
196149,6400,2797,3603,2,1
196149,6394,2793,3601,3,1
196149,1207,484,723,4,1
196149,5187,2309,2878,5,1
196149,6,4,2,11,1
196149,710,273,437,12,3
196149,654,335,319,19,1
196149,4533,1974,2559,20,1
196149,6537,2828,3709,21,4
196149,6281,2736,3545,22,1
196149,6281,2736,3545,23,1
196149,1207,484,723,24,1
196149,5074,2252,2822,25,1
196149,256,92,164,32,3
196149,648,334,314,39,1
196149,4426,1918,2508,40,1
196149,573,242,331,41,4
196149,119,61,58,42,1
196149,113,57,56,43,1
196149,113,57,56,45,1
196149,6,4,2,51,1
196149,454,181,273,52,3
196149,6,1,5,59,1
196149,107,56,51,60,1
196158,5391,2348,3043,1,4
196158,5092,2280,2812,2,1
196158,5049,2260,2789,3,1
196158,1099,451,648,4,1
196158,3950,1809,2141,5,1
196158,43,20,23,11,1
196158,299,68,231,12,3
196158,431,242,189,19,1
196158,3519,1567,1952,20,1
196158,5149,2250,2899,21,4
196158,4945,2208,2737,22,1
196158,4940,2205,2735,23,1
196158,1096,449,647,24,1
196158,3844,1756,2088,25,1
196158,5,3,2,31,1
196158,204,42,162,32,3
196158,426,241,185,39,1
196158,3418,1515,1903,40,1
196158,242,98,144,41,4
196158,147,72,75,42,1
196158,109,55,54,43,1
196158,3,2,1,44,1
196158,106,53,53,45,1
196158,38,17,21,51,1
196158,95,26,69,52,3
196158,5,1,4,59,1
196158,101,52,49,60,1
196167,5644,2357,3287,1,4
196167,5504,2325,3179,2,1
196167,5463,2316,3147,3,1
196167,1132,460,672,4,1
196167,4331,1856,2475,5,1
196167,41,9,32,11,1
196167,140,32,108,12,3
196167,325,176,149,19,1
196167,4006,1680,2326,20,1
196167,5452,2282,3170,21,4
196167,5386,2264,3122,22,1
196167,5350,2258,3092,23,1
196167,1128,457,671,24,1
196167,4222,1801,2421,25,1
196167,36,6,30,31,1
196167,66,18,48,32,3
196167,317,172,145,39,1
196167,3905,1629,2276,40,1
196167,192,75,117,41,4
196167,118,61,57,42,1
196167,113,58,55,43,1
196167,4,3,1,44,1
196167,109,55,54,45,1
196167,5,3,2,51,1
196167,74,14,60,52,3
196167,8,4,4,59,1
196167,101,51,50,60,1
196176,7578,2753,4825,1,4
196176,6570,2457,4113,2,1
196176,6397,2399,3998,3,1
196176,1104,387,717,4,1
196176,5293,2012,3281,5,1
196176,173,58,115,11,1
196176,1008,296,712,12,3
196176,655,256,399,19,1
196176,4638,1756,2882,20,1
196176,6538,2389,4149,21,4
196176,6060,2251,3809,22,1
196176,6009,2233,3776,23,1
196176,1104,387,717,24,1
196176,4905,1846,3059,25,1
196176,51,18,33,31,1
196176,478,138,340,32,3
196176,615,238,377,39,1
196176,4290,1608,2682,40,1
196176,1040,364,676,41,4
196176,510,206,304,42,1
196176,388,166,222,43,1
196176,388,166,222,45,1
196176,122,40,82,51,1
196176,530,158,372,52,3
196176,40,18,22,59,1
196176,348,148,200,60,1
196185,6034,2356,3678,1,4
196185,5800,2304,3496,2,1
196185,5759,2286,3473,3,1
196185,1119,355,764,4,1
196185,4640,1931,2709,5,1
196185,41,18,23,11,1
196185,234,52,182,12,3
196185,508,245,263,19,1
196185,4132,1686,2446,20,1
196185,5808,2263,3545,21,4
196185,5675,2236,3439,22,1
196185,5662,2229,3433,23,1
196185,1119,355,764,24,1
196185,4543,1874,2669,25,1
196185,13,7,6,31,1
196185,133,27,106,32,3
196185,506,244,262,39,1
196185,4037,1630,2407,40,1
196185,226,93,133,41,4
196185,125,68,57,42,1
196185,97,57,40,43,1
196185,97,57,40,45,1
196185,28,11,17,51,1
196185,101,25,76,52,3
196185,2,1,1,59,1
196185,95,56,39,60,1
196194,8117,3873,4244,1,4
196194,7328,3553,3775,2,1
196194,7245,3511,3734,3,1
196194,1506,660,846,4,1
196194,5739,2851,2888,5,1
196194,83,42,41,11,1
196194,789,320,469,12,3
196194,795,450,345,19,1
196194,4944,2401,2543,20,1
196194,7306,3509,3797,21,4
196194,6954,3361,3593,22,1
196194,6951,3358,3593,23,1
196194,1504,659,845,24,1
196194,5447,2699,2748,25,1
196194,3,3,0,31,1
196194,352,148,204,32,3
196194,763,432,331,39,1
196194,4684,2267,2417,40,1
196194,811,364,447,41,4
196194,374,192,182,42,1
196194,294,153,141,43,1
196194,2,1,1,44,1
196194,292,152,140,45,1
196194,80,39,41,51,1
196194,437,172,265,52,3
196194,32,18,14,59,1
196194,260,134,126,60,1
196200,4042,1661,2381,1,4
196200,3707,1579,2128,2,1
196200,3683,1568,2115,3,1
196200,821,334,487,4,1
196200,2862,1234,1628,5,1
196200,24,11,13,11,1
196200,335,82,253,12,3
196200,254,118,136,19,1
196200,2608,1116,1492,20,1
196200,3817,1587,2230,21,4
196200,3596,1534,2062,22,1
196200,3595,1533,2062,23,1
196200,818,331,487,24,1
196200,2777,1202,1575,25,1
196200,1,1,0,31,1
196200,221,53,168,32,3
196200,247,116,131,39,1
196200,2530,1086,1444,40,1
196200,225,74,151,41,4
196200,111,45,66,42,1
196200,88,35,53,43,1
196200,3,3,0,44,1
196200,85,32,53,45,1
196200,23,10,13,51,1
196200,114,29,85,52,3
196200,7,2,5,59,1
196200,78,30,48,60,1
196219,4353,1937,2416,1,4
196219,4239,1884,2355,2,1
196219,4017,1756,2261,3,1
196219,775,322,453,4,1
196219,3242,1434,1808,5,1
196219,222,128,94,11,1
196219,114,53,61,12,3
196219,426,201,225,19,1
196219,2816,1233,1583,20,1
196219,3949,1737,2212,21,4
196219,3847,1692,2155,22,1
196219,3799,1663,2136,23,1
196219,773,321,452,24,1
196219,3026,1342,1684,25,1
196219,48,29,19,31,1
196219,102,45,57,32,3
196219,406,195,211,39,1
196219,2620,1147,1473,40,1
196219,404,200,204,41,4
196219,392,192,200,42,1
196219,218,93,125,43,1
196219,2,1,1,44,1
196219,216,92,124,45,1
196219,174,99,75,51,1
196219,12,8,4,52,3
196219,20,6,14,59,1
196219,196,86,110,60,1
196228,343,95,248,1,4
196228,343,95,248,12,3
196228,340,94,246,21,4
196228,340,94,246,32,3
196228,3,1,2,41,4
196228,3,1,2,52,3
196237,4367,1850,2517,1,4
196237,4161,1764,2397,2,1
196237,4045,1708,2337,3,1
196237,415,169,246,4,1
196237,3630,1539,2091,5,1
196237,116,56,60,11,1
196237,206,86,120,12,3
196237,706,299,407,19,1
196237,2924,1240,1684,20,1
196237,3657,1522,2135,21,4
196237,3558,1486,2072,22,1
196237,3529,1474,2055,23,1
196237,415,169,246,24,1
196237,3114,1305,1809,25,1
196237,29,12,17,31,1
196237,99,36,63,32,3
196237,626,266,360,39,1
196237,2488,1039,1449,40,1
196237,710,328,382,41,4
196237,603,278,325,42,1
196237,516,234,282,43,1
196237,516,234,282,45,1
196237,87,44,43,51,1
196237,107,50,57,52,3
196237,80,33,47,59,1
196237,436,201,235,60,1
196246,6051,2577,3474,1,4
196246,5639,2470,3169,2,1
196246,5494,2401,3093,3,1
196246,954,388,566,4,1
196246,4540,2013,2527,5,1
196246,145,69,76,11,1
196246,412,107,305,12,3
196246,612,274,338,19,1
196246,3928,1739,2189,20,1
196246,5458,2380,3078,21,4
196246,5186,2311,2875,22,1
196246,5145,2291,2854,23,1
196246,953,387,566,24,1
196246,4192,1904,2288,25,1
196246,41,20,21,31,1
196246,272,69,203,32,3
196246,553,262,291,39,1
196246,3639,1642,1997,40,1
196246,593,197,396,41,4
196246,453,159,294,42,1
196246,349,110,239,43,1
196246,1,1,0,44,1
196246,348,109,239,45,1
196246,104,49,55,51,1
196246,140,38,102,52,3
196246,59,12,47,59,1
196246,289,97,192,60,1
196255,1865,703,1162,1,4
196255,358,71,287,2,1
196255,346,68,278,3,1
196255,346,68,278,5,1
196255,12,3,9,11,1
196255,1507,632,875,12,3
196255,80,9,71,19,1
196255,266,59,207,20,1
196255,1367,597,770,21,4
196255,235,53,182,22,1
196255,235,53,182,23,1
196255,235,53,182,25,1
196255,1132,544,588,32,3
196255,42,5,37,39,1
196255,193,48,145,40,1
196255,498,106,392,41,4
196255,123,18,105,42,1
196255,111,15,96,43,1
196255,111,15,96,45,1
196255,12,3,9,51,1
196255,375,88,287,52,3
196255,38,4,34,59,1
196255,73,11,62,60,1
196264,11823,4455,7368,1,4
196264,10827,4108,6719,2,1
196264,9793,3702,6091,3,1
196264,373,195,178,4,1
196264,9420,3507,5913,5,1
196264,1034,406,628,11,1
196264,996,347,649,12,3
196264,1342,446,896,19,1
196264,8078,3061,5017,20,1
196264,4309,1323,2986,21,4
196264,4218,1286,2932,22,1
196264,4133,1245,2888,23,1
196264,188,65,123,24,1
196264,3945,1180,2765,25,1
196264,85,41,44,31,1
196264,91,37,54,32,3
196264,781,245,536,39,1
196264,3164,935,2229,40,1
196264,7514,3132,4382,41,4
196264,6609,2822,3787,42,1
196264,5660,2457,3203,43,1
196264,185,130,55,44,1
196264,5475,2327,3148,45,1
196264,949,365,584,51,1
196264,905,310,595,52,3
196264,561,201,360,59,1
196264,4914,2126,2788,60,1
196291,1755,1548,207,1,4
196291,1601,1430,171,2,1
196291,1565,1403,162,3,1
196291,330,291,39,4,1
196291,1235,1112,123,5,1
196291,36,27,9,11,1
196291,154,118,36,12,3
196291,91,83,8,19,1
196291,1144,1029,115,20,1
196291,1612,1438,174,21,4
196291,1517,1364,153,22,1
196291,1513,1360,153,23,1
196291,330,291,39,24,1
196291,1183,1069,114,25,1
196291,4,4,0,31,1
196291,95,74,21,32,3
196291,90,82,8,39,1
196291,1093,987,106,40,1
196291,143,110,33,41,4
196291,84,66,18,42,1
196291,52,43,9,43,1
196291,52,43,9,45,1
196291,32,23,9,51,1
196291,59,44,15,52,3
196291,1,1,0,59,1
196291,51,42,9,60,1
196307,1617,615,1002,1,4
196307,286,77,209,2,1
196307,284,76,208,3,1
196307,284,76,208,5,1
196307,2,1,1,11,1
196307,1331,538,793,12,3
196307,105,26,79,19,1
196307,179,50,129,20,1
196307,1272,555,717,21,4
196307,209,67,142,22,1
196307,209,67,142,23,1
196307,209,67,142,25,1
196307,1063,488,575,32,3
196307,92,24,68,39,1
196307,117,43,74,40,1
196307,345,60,285,41,4
196307,77,10,67,42,1
196307,75,9,66,43,1
196307,75,9,66,45,1
196307,2,1,1,51,1
196307,268,50,218,52,3
196307,13,2,11,59,1
196307,62,7,55,60,1
196389,848,283,565,1,4
196389,848,283,565,2,1
196389,848,283,565,3,1
196389,204,76,128,4,1
196389,644,207,437,5,1
196389,13,1,12,19,1
196389,631,206,425,20,1
196389,733,245,488,21,4
196389,733,245,488,22,1
196389,733,245,488,23,1
196389,172,56,116,24,1
196389,561,189,372,25,1
196389,13,1,12,39,1
196389,548,188,360,40,1
196389,115,38,77,41,4
196389,115,38,77,42,1
196389,115,38,77,43,1
196389,32,20,12,44,1
196389,83,18,65,45,1
196389,83,18,65,60,1
196413,21267,9789,11478,1,4
196413,15097,6755,8342,2,1
196413,14738,6618,8120,3,1
196413,3487,1552,1935,4,1
196413,11251,5066,6185,5,1
196413,359,137,222,11,1
196413,6170,3034,3136,12,3
196413,422,215,207,19,1
196413,10829,4851,5978,20,1
196413,19092,8790,10302,21,4
196413,14422,6448,7974,22,1
196413,14196,6385,7811,23,1
196413,3476,1545,1931,24,1
196413,10720,4840,5880,25,1
196413,226,63,163,31,1
196413,4670,2342,2328,32,3
196413,381,192,189,39,1
196413,10339,4648,5691,40,1
196413,2175,999,1176,41,4
196413,675,307,368,42,1
196413,542,233,309,43,1
196413,11,7,4,44,1
196413,531,226,305,45,1
196413,133,74,59,51,1
196413,1500,692,808,52,3
196413,41,23,18,59,1
196413,490,203,287,60,1
196431,321,321,0,1,4
196431,321,321,0,2,1
196431,321,321,0,3,1
196431,49,49,0,4,1
196431,272,272,0,5,1
196431,150,150,0,19,1
196431,122,122,0,20,1
196431,321,321,0,21,4
196431,321,321,0,22,1
196431,321,321,0,23,1
196431,49,49,0,24,1
196431,272,272,0,25,1
196431,150,150,0,39,1
196431,122,122,0,40,1
196440,24,24,0,1,4
196440,17,17,0,2,1
196440,17,17,0,3,1
196440,7,7,0,4,1
196440,10,10,0,5,1
196440,7,7,0,12,3
196440,1,1,0,19,1
196440,9,9,0,20,1
196440,23,23,0,21,4
196440,17,17,0,22,1
196440,17,17,0,23,1
196440,7,7,0,24,1
196440,10,10,0,25,1
196440,6,6,0,32,3
196440,1,1,0,39,1
196440,9,9,0,40,1
196440,1,1,0,41,4
196440,1,1,0,52,3
196468,5149,1232,3917,1,4
196468,5149,1232,3917,12,3
196468,3169,713,2456,21,4
196468,3169,713,2456,32,3
196468,1980,519,1461,41,4
196468,1980,519,1461,52,3
196477,3020,1873,1147,1,4
196477,3020,1873,1147,2,1
196477,3019,1872,1147,3,1
196477,562,398,164,4,1
196477,2457,1474,983,5,1
196477,1,1,0,11,1
196477,348,206,142,19,1
196477,2109,1268,841,20,1
196477,2640,1648,992,21,4
196477,2640,1648,992,22,1
196477,2640,1648,992,23,1
196477,553,390,163,24,1
196477,2087,1258,829,25,1
196477,336,201,135,39,1
196477,1751,1057,694,40,1
196477,380,225,155,41,4
196477,380,225,155,42,1
196477,379,224,155,43,1
196477,9,8,1,44,1
196477,370,216,154,45,1
196477,1,1,0,51,1
196477,12,5,7,59,1
196477,358,211,147,60,1
196565,5490,2464,3026,1,4
196565,5490,2464,3026,2,1
196565,3040,1317,1723,3,1
196565,886,441,445,4,1
196565,2154,876,1278,5,1
196565,2450,1147,1303,11,1
196565,295,130,165,19,1
196565,1859,746,1113,20,1
196565,2587,1185,1402,21,4
196565,2587,1185,1402,22,1
196565,2468,1139,1329,23,1
196565,841,422,419,24,1
196565,1627,717,910,25,1
196565,119,46,73,31,1
196565,225,106,119,39,1
196565,1402,611,791,40,1
196565,2903,1279,1624,41,4
196565,2903,1279,1624,42,1
196565,572,178,394,43,1
196565,45,19,26,44,1
196565,527,159,368,45,1
196565,2331,1101,1230,51,1
196565,70,24,46,59,1
196565,457,135,322,60,1
196583,180,180,0,1,4
196583,180,180,0,2,1
196583,180,180,0,3,1
196583,53,53,0,4,1
196583,127,127,0,5,1
196583,11,11,0,19,1
196583,116,116,0,20,1
196583,180,180,0,21,4
196583,180,180,0,22,1
196583,180,180,0,23,1
196583,53,53,0,24,1
196583,127,127,0,25,1
196583,11,11,0,39,1
196583,116,116,0,40,1
196592,13868,4106,9762,1,4
196592,6827,2103,4724,2,1
196592,6196,1990,4206,3,1
196592,764,164,600,4,1
196592,5432,1826,3606,5,1
196592,631,113,518,11,1
196592,7041,2003,5038,12,3
196592,725,296,429,19,1
196592,4707,1530,3177,20,1
196592,8105,2813,5292,21,4
196592,5139,1660,3479,22,1
196592,5108,1640,3468,23,1
196592,716,151,565,24,1
196592,4392,1489,2903,25,1
196592,31,20,11,31,1
196592,2966,1153,1813,32,3
196592,624,260,364,39,1
196592,3768,1229,2539,40,1
196592,5763,1293,4470,41,4
196592,1688,443,1245,42,1
196592,1088,350,738,43,1
196592,48,13,35,44,1
196592,1040,337,703,45,1
196592,600,93,507,51,1
196592,4075,850,3225,52,3
196592,101,36,65,59,1
196592,939,301,638,60,1
196653,1492,209,1283,1,4
196653,1492,209,1283,2,1
196653,1384,179,1205,3,1
196653,149,19,130,4,1
196653,1235,160,1075,5,1
196653,108,30,78,11,1
196653,294,43,251,19,1
196653,941,117,824,20,1
196653,675,89,586,21,4
196653,675,89,586,22,1
196653,675,89,586,23,1
196653,122,14,108,24,1
196653,553,75,478,25,1
196653,169,26,143,39,1
196653,384,49,335,40,1
196653,817,120,697,41,4
196653,817,120,697,42,1
196653,709,90,619,43,1
196653,27,5,22,44,1
196653,682,85,597,45,1
196653,108,30,78,51,1
196653,125,17,108,59,1
196653,557,68,489,60,1
196680,39897,17374,22523,1,4
196680,37440,16214,21226,2,1
196680,37440,16214,21226,3,1
196680,37440,16214,21226,5,1
196680,2457,1160,1297,12,3
196680,2976,1564,1412,19,1
196680,34464,14650,19814,20,1
196680,39897,17374,22523,41,4
196680,37440,16214,21226,42,1
196680,37440,16214,21226,43,1
196680,37440,16214,21226,45,1
196680,2457,1160,1297,52,3
196680,2976,1564,1412,59,1
196680,34464,14650,19814,60,1
196699,3615,1501,2114,1,4
196699,3615,1501,2114,2,1
196699,2234,912,1322,3,1
196699,653,312,341,4,1
196699,1581,600,981,5,1
196699,1381,589,792,11,1
196699,133,40,93,19,1
196699,1448,560,888,20,1
196699,1654,740,914,21,4
196699,1654,740,914,22,1
196699,1578,715,863,23,1
196699,583,292,291,24,1
196699,995,423,572,25,1
196699,76,25,51,31,1
196699,94,32,62,39,1
196699,901,391,510,40,1
196699,1961,761,1200,41,4
196699,1961,761,1200,42,1
196699,656,197,459,43,1
196699,70,20,50,44,1
196699,586,177,409,45,1
196699,1305,564,741,51,1
196699,39,8,31,59,1
196699,547,169,378,60,1
196857,1479,121,1358,1,4
196857,1479,121,1358,2,1
196857,1479,121,1358,3,1
196857,174,14,160,4,1
196857,1305,107,1198,5,1
196857,1305,107,1198,20,1
196857,1413,114,1299,21,4
196857,1413,114,1299,22,1
196857,1413,114,1299,23,1
196857,174,14,160,24,1
196857,1239,100,1139,25,1
196857,1239,100,1139,40,1
196857,66,7,59,41,4
196857,66,7,59,42,1
196857,66,7,59,43,1
196857,66,7,59,45,1
196857,66,7,59,60,1
196866,2246,1210,1036,1,4
196866,2246,1210,1036,2,1
196866,2206,1187,1019,3,1
196866,559,291,268,4,1
196866,1647,896,751,5,1
196866,40,23,17,11,1
196866,23,15,8,19,1
196866,1624,881,743,20,1
196866,2225,1199,1026,21,4
196866,2225,1199,1026,22,1
196866,2202,1185,1017,23,1
196866,559,291,268,24,1
196866,1643,894,749,25,1
196866,23,14,9,31,1
196866,23,15,8,39,1
196866,1620,879,741,40,1
196866,21,11,10,41,4
196866,21,11,10,42,1
196866,4,2,2,43,1
196866,4,2,2,45,1
196866,17,9,8,51,1
196866,4,2,2,60,1
196884,253,113,140,1,4
196884,253,113,140,12,3
196884,216,96,120,21,4
196884,216,96,120,32,3
196884,37,17,20,41,4
196884,37,17,20,52,3
197018,2071,2071,0,1,4
197018,1814,1814,0,2,1
197018,1814,1814,0,3,1
197018,512,512,0,4,1
197018,1302,1302,0,5,1
197018,257,257,0,12,3
197018,82,82,0,19,1
197018,1220,1220,0,20,1
197018,2071,2071,0,21,4
197018,1814,1814,0,22,1
197018,1814,1814,0,23,1
197018,512,512,0,24,1
197018,1302,1302,0,25,1
197018,257,257,0,32,3
197018,82,82,0,39,1
197018,1220,1220,0,40,1
197027,985,842,143,1,4
197027,958,819,139,2,1
197027,958,819,139,3,1
197027,218,178,40,4,1
197027,740,641,99,5,1
197027,27,23,4,12,3
197027,19,18,1,19,1
197027,721,623,98,20,1
197027,958,819,139,21,4
197027,958,819,139,22,1
197027,958,819,139,23,1
197027,218,178,40,24,1
197027,740,641,99,25,1
197027,19,18,1,39,1
197027,721,623,98,40,1
197027,27,23,4,41,4
197027,27,23,4,52,3
197036,4591,3829,762,1,4
197036,4591,3829,762,2,1
197036,4591,3829,762,3,1
197036,1176,991,185,4,1
197036,3415,2838,577,5,1
197036,3415,2838,577,20,1
197036,4591,3829,762,21,4
197036,4591,3829,762,22,1
197036,4591,3829,762,23,1
197036,1176,991,185,24,1
197036,3415,2838,577,25,1
197036,3415,2838,577,40,1
197045,4028,1595,2433,1,4
197045,2881,1129,1752,2,1
197045,2831,1113,1718,3,1
197045,488,248,240,4,1
197045,2343,865,1478,5,1
197045,50,16,34,11,1
197045,1147,466,681,12,3
197045,374,116,258,19,1
197045,1969,749,1220,20,1
197045,2444,1052,1392,21,4
197045,2230,982,1248,22,1
197045,2212,977,1235,23,1
197045,486,247,239,24,1
197045,1726,730,996,25,1
197045,18,5,13,31,1
197045,214,70,144,32,3
197045,230,77,153,39,1
197045,1496,653,843,40,1
197045,1584,543,1041,41,4
197045,651,147,504,42,1
197045,619,136,483,43,1
197045,2,1,1,44,1
197045,617,135,482,45,1
197045,32,11,21,51,1
197045,933,396,537,52,3
197045,144,39,105,59,1
197045,473,96,377,60,1
197081,324,66,258,1,4
197081,324,66,258,2,1
197081,275,58,217,3,1
197081,49,14,35,4,1
197081,226,44,182,5,1
197081,49,8,41,11,1
197081,42,7,35,19,1
197081,184,37,147,20,1
197081,222,47,175,21,4
197081,222,47,175,22,1
197081,222,47,175,23,1
197081,46,13,33,24,1
197081,176,34,142,25,1
197081,38,6,32,39,1
197081,138,28,110,40,1
197081,102,19,83,41,4
197081,102,19,83,42,1
197081,53,11,42,43,1
197081,3,1,2,44,1
197081,50,10,40,45,1
197081,49,8,41,51,1
197081,4,1,3,59,1
197081,46,9,37,60,1
197133,2477,1099,1378,1,4
197133,2477,1099,1378,2,1
197133,2436,1073,1363,3,1
197133,665,285,380,4,1
197133,1771,788,983,5,1
197133,41,26,15,11,1
197133,9,6,3,19,1
197133,1762,782,980,20,1
197133,2437,1075,1362,21,4
197133,2437,1075,1362,22,1
197133,2422,1068,1354,23,1
197133,662,285,377,24,1
197133,1760,783,977,25,1
197133,15,7,8,31,1
197133,9,6,3,39,1
197133,1751,777,974,40,1
197133,40,24,16,41,4
197133,40,24,16,42,1
197133,14,5,9,43,1
197133,3,0,3,44,1
197133,11,5,6,45,1
197133,26,19,7,51,1
197133,11,5,6,60,1
197142,465,156,309,1,4
197142,465,156,309,2,1
197142,456,154,302,3,1
197142,124,32,92,4,1
197142,332,122,210,5,1
197142,9,2,7,11,1
197142,78,27,51,19,1
197142,254,95,159,20,1
197142,356,124,232,21,4
197142,356,124,232,22,1
197142,356,124,232,23,1
197142,120,32,88,24,1
197142,236,92,144,25,1
197142,51,18,33,39,1
197142,185,74,111,40,1
197142,109,32,77,41,4
197142,109,32,77,42,1
197142,100,30,70,43,1
197142,4,0,4,44,1
197142,96,30,66,45,1
197142,9,2,7,51,1
197142,27,9,18,59,1
197142,69,21,48,60,1
197151,4338,1690,2648,1,4
197151,3636,1436,2200,2,1
197151,3469,1368,2101,3,1
197151,656,245,411,4,1
197151,2813,1123,1690,5,1
197151,167,68,99,11,1
197151,702,254,448,12,3
197151,277,119,158,19,1
197151,2536,1004,1532,20,1
197151,3945,1521,2424,21,4
197151,3349,1309,2040,22,1
197151,3325,1297,2028,23,1
197151,655,244,411,24,1
197151,2670,1053,1617,25,1
197151,24,12,12,31,1
197151,596,212,384,32,3
197151,275,119,156,39,1
197151,2395,934,1461,40,1
197151,393,169,224,41,4
197151,287,127,160,42,1
197151,144,71,73,43,1
197151,1,1,0,44,1
197151,143,70,73,45,1
197151,143,56,87,51,1
197151,106,42,64,52,3
197151,2,0,2,59,1
197151,141,70,71,60,1
197197,2245,768,1477,1,4
197197,1842,644,1198,2,1
197197,1830,639,1191,3,1
197197,430,163,267,4,1
197197,1400,476,924,5,1
197197,12,5,7,11,1
197197,403,124,279,12,3
197197,102,26,76,19,1
197197,1298,450,848,20,1
197197,1985,704,1281,21,4
197197,1765,621,1144,22,1
197197,1764,621,1143,23,1
197197,430,163,267,24,1
197197,1334,458,876,25,1
197197,1,0,1,31,1
197197,220,83,137,32,3
197197,97,24,73,39,1
197197,1237,434,803,40,1
197197,260,64,196,41,4
197197,77,23,54,42,1
197197,66,18,48,43,1
197197,66,18,48,45,1
197197,11,5,6,51,1
197197,183,41,142,52,3
197197,5,2,3,59,1
197197,61,16,45,60,1
197221,82,65,17,1,4
197221,82,65,17,2,1
197221,82,65,17,3,1
197221,26,22,4,4,1
197221,56,43,13,5,1
197221,56,43,13,20,1
197221,82,65,17,21,4
197221,82,65,17,22,1
197221,82,65,17,23,1
197221,26,22,4,24,1
197221,56,43,13,25,1
197221,56,43,13,40,1
197230,534,180,354,1,4
197230,534,180,354,2,1
197230,526,178,348,3,1
197230,161,55,106,4,1
197230,365,123,242,5,1
197230,8,2,6,11,1
197230,51,30,21,19,1
197230,314,93,221,20,1
197230,524,175,349,21,4
197230,524,175,349,22,1
197230,518,174,344,23,1
197230,161,55,106,24,1
197230,357,119,238,25,1
197230,6,1,5,31,1
197230,47,27,20,39,1
197230,310,92,218,40,1
197230,10,5,5,41,4
197230,10,5,5,42,1
197230,8,4,4,43,1
197230,8,4,4,45,1
197230,2,1,1,51,1
197230,4,3,1,59,1
197230,4,1,3,60,1
197285,1197,465,732,1,4
197285,1197,465,732,2,1
197285,1083,433,650,3,1
197285,239,118,121,4,1
197285,844,315,529,5,1
197285,114,32,82,11,1
197285,124,45,79,19,1
197285,720,270,450,20,1
197285,948,390,558,21,4
197285,948,390,558,22,1
197285,948,390,558,23,1
197285,232,116,116,24,1
197285,716,274,442,25,1
197285,101,40,61,39,1
197285,615,234,381,40,1
197285,249,75,174,41,4
197285,249,75,174,42,1
197285,135,43,92,43,1
197285,7,2,5,44,1
197285,128,41,87,45,1
197285,114,32,82,51,1
197285,23,5,18,59,1
197285,105,36,69,60,1
197294,13781,6605,7176,1,4
197294,13781,6605,7176,2,1
197294,12234,5990,6244,3,1
197294,2512,1337,1175,4,1
197294,9722,4653,5069,5,1
197294,1547,615,932,11,1
197294,806,363,443,19,1
197294,8916,4290,4626,20,1
197294,7640,3923,3717,21,4
197294,7640,3923,3717,22,1
197294,7434,3787,3647,23,1
197294,2070,1107,963,24,1
197294,5364,2680,2684,25,1
197294,206,136,70,31,1
197294,537,260,277,39,1
197294,4827,2420,2407,40,1
197294,6141,2682,3459,41,4
197294,6141,2682,3459,42,1
197294,4800,2203,2597,43,1
197294,442,230,212,44,1
197294,4358,1973,2385,45,1
197294,1341,479,862,51,1
197294,269,103,166,59,1
197294,4089,1870,2219,60,1
197337,116,7,109,1,4
197337,116,7,109,2,1
197337,116,7,109,3,1
197337,11,1,10,4,1
197337,105,6,99,5,1
197337,105,6,99,20,1
197337,70,5,65,21,4
197337,70,5,65,22,1
197337,70,5,65,23,1
197337,8,1,7,24,1
197337,62,4,58,25,1
197337,62,4,58,40,1
197337,46,2,44,41,4
197337,46,2,44,42,1
197337,46,2,44,43,1
197337,3,0,3,44,1
197337,43,2,41,45,1
197337,43,2,41,60,1
197522,476,129,347,1,4
197522,476,129,347,2,1
197522,476,129,347,3,1
197522,183,57,126,4,1
197522,293,72,221,5,1
197522,87,18,69,19,1
197522,206,54,152,20,1
197522,476,129,347,21,4
197522,476,129,347,22,1
197522,476,129,347,23,1
197522,183,57,126,24,1
197522,293,72,221,25,1
197522,87,18,69,39,1
197522,206,54,152,40,1
197531,562,263,299,1,4
197531,562,263,299,2,1
197531,562,263,299,3,1
197531,393,174,219,4,1
197531,169,89,80,5,1
197531,169,89,80,20,1
197531,562,263,299,21,4
197531,562,263,299,22,1
197531,562,263,299,23,1
197531,393,174,219,24,1
197531,169,89,80,25,1
197531,169,89,80,40,1
197601,119,119,0,1,4
197601,119,119,0,2,1
197601,119,119,0,3,1
197601,20,20,0,4,1
197601,99,99,0,5,1
197601,3,3,0,19,1
197601,96,96,0,20,1
197601,119,119,0,21,4
197601,119,119,0,22,1
197601,119,119,0,23,1
197601,20,20,0,24,1
197601,99,99,0,25,1
197601,3,3,0,39,1
197601,96,96,0,40,1
197610,164,164,0,1,4
197610,152,152,0,2,1
197610,152,152,0,3,1
197610,64,64,0,4,1
197610,88,88,0,5,1
197610,12,12,0,12,3
197610,7,7,0,19,1
197610,81,81,0,20,1
197610,164,164,0,21,4
197610,152,152,0,22,1
197610,152,152,0,23,1
197610,64,64,0,24,1
197610,88,88,0,25,1
197610,12,12,0,32,3
197610,7,7,0,39,1
197610,81,81,0,40,1
197647,153,153,0,1,4
197647,104,104,0,2,1
197647,104,104,0,3,1
197647,27,27,0,4,1
197647,77,77,0,5,1
197647,49,49,0,12,3
197647,7,7,0,19,1
197647,70,70,0,20,1
197647,142,142,0,21,4
197647,104,104,0,22,1
197647,104,104,0,23,1
197647,27,27,0,24,1
197647,77,77,0,25,1
197647,38,38,0,32,3
197647,7,7,0,39,1
197647,70,70,0,40,1
197647,11,11,0,41,4
197647,11,11,0,52,3
197674,250,250,0,1,4
197674,220,220,0,2,1
197674,220,220,0,3,1
197674,69,69,0,4,1
197674,151,151,0,5,1
197674,30,30,0,12,3
197674,4,4,0,19,1
197674,147,147,0,20,1
197674,250,250,0,21,4
197674,220,220,0,22,1
197674,220,220,0,23,1
197674,69,69,0,24,1
197674,151,151,0,25,1
197674,30,30,0,32,3
197674,4,4,0,39,1
197674,147,147,0,40,1
197692,95,95,0,1,4
197692,75,75,0,2,1
197692,75,75,0,3,1
197692,24,24,0,4,1
197692,51,51,0,5,1
197692,20,20,0,12,3
197692,51,51,0,20,1
197692,95,95,0,21,4
197692,75,75,0,22,1
197692,75,75,0,23,1
197692,24,24,0,24,1
197692,51,51,0,25,1
197692,20,20,0,32,3
197692,51,51,0,40,1
197708,6747,3212,3535,1,4
197708,2887,1517,1370,2,1
197708,2887,1517,1370,3,1
197708,862,467,395,4,1
197708,2025,1050,975,5,1
197708,3860,1695,2165,12,3
197708,28,16,12,19,1
197708,1997,1034,963,20,1
197708,5585,2674,2911,21,4
197708,2782,1433,1349,22,1
197708,2782,1433,1349,23,1
197708,860,465,395,24,1
197708,1922,968,954,25,1
197708,2803,1241,1562,32,3
197708,26,15,11,39,1
197708,1896,953,943,40,1
197708,1162,538,624,41,4
197708,105,84,21,42,1
197708,105,84,21,43,1
197708,2,2,0,44,1
197708,103,82,21,45,1
197708,1057,454,603,52,3
197708,2,1,1,59,1
197708,101,81,20,60,1
197735,604,604,0,1,4
197735,470,470,0,2,1
197735,470,470,0,3,1
197735,111,111,0,4,1
197735,359,359,0,5,1
197735,134,134,0,12,3
197735,3,3,0,19,1
197735,356,356,0,20,1
197735,604,604,0,21,4
197735,470,470,0,22,1
197735,470,470,0,23,1
197735,111,111,0,24,1
197735,359,359,0,25,1
197735,134,134,0,32,3
197735,3,3,0,39,1
197735,356,356,0,40,1
197744,198,198,0,1,4
197744,164,164,0,2,1
197744,164,164,0,3,1
197744,12,12,0,4,1
197744,152,152,0,5,1
197744,34,34,0,12,3
197744,44,44,0,19,1
197744,108,108,0,20,1
197744,198,198,0,21,4
197744,164,164,0,22,1
197744,164,164,0,23,1
197744,12,12,0,24,1
197744,152,152,0,25,1
197744,34,34,0,32,3
197744,44,44,0,39,1
197744,108,108,0,40,1
197814,2607,916,1691,1,4
197814,2607,916,1691,2,1
197814,2147,757,1390,3,1
197814,568,261,307,4,1
197814,1579,496,1083,5,1
197814,460,159,301,11,1
197814,454,137,317,19,1
197814,1125,359,766,20,1
197814,1170,495,675,21,4
197814,1170,495,675,22,1
197814,1097,468,629,23,1
197814,391,193,198,24,1
197814,706,275,431,25,1
197814,73,27,46,31,1
197814,192,71,121,39,1
197814,514,204,310,40,1
197814,1437,421,1016,41,4
197814,1437,421,1016,42,1
197814,1050,289,761,43,1
197814,177,68,109,44,1
197814,873,221,652,45,1
197814,387,132,255,51,1
197814,262,66,196,59,1
197814,611,155,456,60,1
197832,1427,670,757,1,4
197832,1427,670,757,2,1
197832,1427,670,757,3,1
197832,423,223,200,4,1
197832,1004,447,557,5,1
197832,199,93,106,19,1
197832,805,354,451,20,1
197832,817,388,429,21,4
197832,817,388,429,22,1
197832,817,388,429,23,1
197832,280,147,133,24,1
197832,537,241,296,25,1
197832,111,54,57,39,1
197832,426,187,239,40,1
197832,610,282,328,41,4
197832,610,282,328,42,1
197832,610,282,328,43,1
197832,143,76,67,44,1
197832,467,206,261,45,1
197832,88,39,49,59,1
197832,379,167,212,60,1
197850,2776,871,1905,1,4
197850,2776,871,1905,2,1
197850,1921,589,1332,3,1
197850,475,196,279,4,1
197850,1446,393,1053,5,1
197850,855,282,573,11,1
197850,199,46,153,19,1
197850,1247,347,900,20,1
197850,762,261,501,21,4
197850,762,261,501,22,1
197850,651,230,421,23,1
197850,190,90,100,24,1
197850,461,140,321,25,1
197850,111,31,80,31,1
197850,73,16,57,39,1
197850,388,124,264,40,1
197850,2014,610,1404,41,4
197850,2014,610,1404,42,1
197850,1270,359,911,43,1
197850,285,106,179,44,1
197850,985,253,732,45,1
197850,744,251,493,51,1
197850,126,30,96,59,1
197850,859,223,636,60,1
197869,17838,8050,9788,1,4
197869,16025,7499,8526,2,1
197869,15840,7420,8420,3,1
197869,2883,1295,1588,4,1
197869,12957,6125,6832,5,1
197869,185,79,106,11,1
197869,1813,551,1262,12,3
197869,1329,598,731,19,1
197869,11628,5527,6101,20,1
197869,16021,7459,8562,21,4
197869,15115,7141,7974,22,1
197869,15023,7107,7916,23,1
197869,2883,1295,1588,24,1
197869,12140,5812,6328,25,1
197869,92,34,58,31,1
197869,906,318,588,32,3
197869,1167,572,595,39,1
197869,10973,5240,5733,40,1
197869,1817,591,1226,41,4
197869,910,358,552,42,1
197869,817,313,504,43,1
197869,817,313,504,45,1
197869,93,45,48,51,1
197869,907,233,674,52,3
197869,162,26,136,59,1
197869,655,287,368,60,1
197887,8092,3500,4592,1,4
197887,8092,3500,4592,2,1
197887,6327,2727,3600,3,1
197887,1098,506,592,4,1
197887,5229,2221,3008,5,1
197887,1765,773,992,11,1
197887,1259,505,754,19,1
197887,3970,1716,2254,20,1
197887,2638,1177,1461,21,4
197887,2638,1177,1461,22,1
197887,2508,1106,1402,23,1
197887,543,253,290,24,1
197887,1965,853,1112,25,1
197887,130,71,59,31,1
197887,496,217,279,39,1
197887,1469,636,833,40,1
197887,5454,2323,3131,41,4
197887,5454,2323,3131,42,1
197887,3819,1621,2198,43,1
197887,555,253,302,44,1
197887,3264,1368,1896,45,1
197887,1635,702,933,51,1
197887,763,288,475,59,1
197887,2501,1080,1421,60,1
197911,1065,327,738,1,4
197911,1057,327,730,2,1
197911,1043,326,717,3,1
197911,217,75,142,4,1
197911,826,251,575,5,1
197911,14,1,13,11,1
197911,8,0,8,12,3
197911,93,30,63,19,1
197911,733,221,512,20,1
197911,906,311,595,21,4
197911,900,311,589,22,1
197911,899,311,588,23,1
197911,215,75,140,24,1
197911,684,236,448,25,1
197911,1,0,1,31,1
197911,6,0,6,32,3
197911,73,27,46,39,1
197911,611,209,402,40,1
197911,159,16,143,41,4
197911,157,16,141,42,1
197911,144,15,129,43,1
197911,2,0,2,44,1
197911,142,15,127,45,1
197911,13,1,12,51,1
197911,2,0,2,52,3
197911,20,3,17,59,1
197911,122,12,110,60,1
197966,2019,711,1308,1,4
197966,2019,711,1308,2,1
197966,1587,546,1041,3,1
197966,288,138,150,4,1
197966,1299,408,891,5,1
197966,432,165,267,11,1
197966,334,94,240,19,1
197966,965,314,651,20,1
197966,866,353,513,21,4
197966,866,353,513,22,1
197966,819,335,484,23,1
197966,175,89,86,24,1
197966,644,246,398,25,1
197966,47,18,29,31,1
197966,148,55,93,39,1
197966,496,191,305,40,1
197966,1153,358,795,41,4
197966,1153,358,795,42,1
197966,768,211,557,43,1
197966,113,49,64,44,1
197966,655,162,493,45,1
197966,385,147,238,51,1
197966,186,39,147,59,1
197966,469,123,346,60,1
197984,1647,693,954,1,4
197984,1647,693,954,2,1
197984,1634,686,948,3,1
197984,286,152,134,4,1
197984,1348,534,814,5,1
197984,13,7,6,11,1
197984,176,65,111,19,1
197984,1172,469,703,20,1
197984,1549,656,893,21,4
197984,1549,656,893,22,1
197984,1542,652,890,23,1
197984,285,151,134,24,1
197984,1257,501,756,25,1
197984,7,4,3,31,1
197984,165,61,104,39,1
197984,1092,440,652,40,1
197984,98,37,61,41,4
197984,98,37,61,42,1
197984,92,34,58,43,1
197984,1,1,0,44,1
197984,91,33,58,45,1
197984,6,3,3,51,1
197984,11,4,7,59,1
197984,80,29,51,60,1
197993,680,0,680,1,4
197993,680,0,680,2,1
197993,612,0,612,3,1
197993,194,0,194,4,1
197993,418,0,418,5,1
197993,68,0,68,11,1
197993,15,0,15,19,1
197993,403,0,403,20,1
197993,609,0,609,21,4
197993,609,0,609,22,1
197993,609,0,609,23,1
197993,194,0,194,24,1
197993,415,0,415,25,1
197993,14,0,14,39,1
197993,401,0,401,40,1
197993,71,0,71,41,4
197993,71,0,71,42,1
197993,3,0,3,43,1
197993,3,0,3,45,1
197993,68,0,68,51,1
197993,1,0,1,59,1
197993,2,0,2,60,1
198011,1199,341,858,1,4
198011,1199,341,858,2,1
198011,1016,264,752,3,1
198011,220,84,136,4,1
198011,796,180,616,5,1
198011,183,77,106,11,1
198011,322,54,268,19,1
198011,474,126,348,20,1
198011,539,154,385,21,4
198011,539,154,385,22,1
198011,530,152,378,23,1
198011,139,55,84,24,1
198011,391,97,294,25,1
198011,9,2,7,31,1
198011,133,22,111,39,1
198011,258,75,183,40,1
198011,660,187,473,41,4
198011,660,187,473,42,1
198011,486,112,374,43,1
198011,81,29,52,44,1
198011,405,83,322,45,1
198011,174,75,99,51,1
198011,189,32,157,59,1
198011,216,51,165,60,1
198039,2324,969,1355,1,4
198039,2324,969,1355,2,1
198039,1924,807,1117,3,1
198039,367,163,204,4,1
198039,1557,644,913,5,1
198039,400,162,238,11,1
198039,172,76,96,19,1
198039,1385,568,817,20,1
198039,717,311,406,21,4
198039,717,311,406,22,1
198039,668,299,369,23,1
198039,171,70,101,24,1
198039,497,229,268,25,1
198039,49,12,37,31,1
198039,53,28,25,39,1
198039,444,201,243,40,1
198039,1607,658,949,41,4
198039,1607,658,949,42,1
198039,1256,508,748,43,1
198039,196,93,103,44,1
198039,1060,415,645,45,1
198039,351,150,201,51,1
198039,119,48,71,59,1
198039,941,367,574,60,1
198066,701,433,268,1,4
198066,701,433,268,2,1
198066,700,432,268,3,1
198066,242,158,84,4,1
198066,458,274,184,5,1
198066,1,1,0,11,1
198066,60,36,24,19,1
198066,398,238,160,20,1
198066,690,428,262,21,4
198066,690,428,262,22,1
198066,689,427,262,23,1
198066,242,158,84,24,1
198066,447,269,178,25,1
198066,1,1,0,31,1
198066,60,36,24,39,1
198066,387,233,154,40,1
198066,11,5,6,41,4
198066,11,5,6,42,1
198066,11,5,6,43,1
198066,11,5,6,45,1
198066,11,5,6,60,1
198075,128,10,118,1,4
198075,128,10,118,2,1
198075,128,10,118,3,1
198075,29,3,26,4,1
198075,99,7,92,5,1
198075,99,7,92,20,1
198075,128,10,118,21,4
198075,128,10,118,22,1
198075,128,10,118,23,1
198075,29,3,26,24,1
198075,99,7,92,25,1
198075,99,7,92,40,1
198084,1809,702,1107,1,4
198084,1809,702,1107,2,1
198084,1406,525,881,3,1
198084,250,104,146,4,1
198084,1156,421,735,5,1
198084,403,177,226,11,1
198084,310,105,205,19,1
198084,846,316,530,20,1
198084,932,401,531,21,4
198084,932,401,531,22,1
198084,828,365,463,23,1
198084,186,84,102,24,1
198084,642,281,361,25,1
198084,104,36,68,31,1
198084,146,64,82,39,1
198084,496,217,279,40,1
198084,877,301,576,41,4
198084,877,301,576,42,1
198084,578,160,418,43,1
198084,64,20,44,44,1
198084,514,140,374,45,1
198084,299,141,158,51,1
198084,164,41,123,59,1
198084,350,99,251,60,1
198109,451,38,413,1,4
198109,451,38,413,2,1
198109,440,37,403,3,1
198109,29,6,23,4,1
198109,411,31,380,5,1
198109,11,1,10,11,1
198109,110,8,102,19,1
198109,301,23,278,20,1
198109,169,16,153,21,4
198109,169,16,153,22,1
198109,169,16,153,23,1
198109,25,5,20,24,1
198109,144,11,133,25,1
198109,59,4,55,39,1
198109,85,7,78,40,1
198109,282,22,260,41,4
198109,282,22,260,42,1
198109,271,21,250,43,1
198109,4,1,3,44,1
198109,267,20,247,45,1
198109,11,1,10,51,1
198109,51,4,47,59,1
198109,216,16,200,60,1
198118,3933,1716,2217,1,4
198118,3933,1716,2217,2,1
198118,3050,1299,1751,3,1
198118,496,246,250,4,1
198118,2554,1053,1501,5,1
198118,883,417,466,11,1
198118,875,391,484,19,1
198118,1679,662,1017,20,1
198118,1584,722,862,21,4
198118,1584,722,862,22,1
198118,1437,664,773,23,1
198118,272,132,140,24,1
198118,1165,532,633,25,1
198118,147,58,89,31,1
198118,383,202,181,39,1
198118,782,330,452,40,1
198118,2349,994,1355,41,4
198118,2349,994,1355,42,1
198118,1613,635,978,43,1
198118,224,114,110,44,1
198118,1389,521,868,45,1
198118,736,359,377,51,1
198118,492,189,303,59,1
198118,897,332,565,60,1
198136,6122,2923,3199,1,4
198136,4465,2223,2242,2,1
198136,4463,2222,2241,3,1
198136,794,356,438,4,1
198136,3669,1866,1803,5,1
198136,2,1,1,11,1
198136,1657,700,957,12,3
198136,989,597,392,19,1
198136,2680,1269,1411,20,1
198136,4981,2256,2725,21,4
198136,3537,1635,1902,22,1
198136,3537,1635,1902,23,1
198136,779,347,432,24,1
198136,2758,1288,1470,25,1
198136,1444,621,823,32,3
198136,548,305,243,39,1
198136,2210,983,1227,40,1
198136,1141,667,474,41,4
198136,928,588,340,42,1
198136,926,587,339,43,1
198136,15,9,6,44,1
198136,911,578,333,45,1
198136,2,1,1,51,1
198136,213,79,134,52,3
198136,441,292,149,59,1
198136,470,286,184,60,1
198154,9246,4291,4955,1,4
198154,9246,4291,4955,2,1
198154,8798,4097,4701,3,1
198154,1589,834,755,4,1
198154,7209,3263,3946,5,1
198154,448,194,254,11,1
198154,843,414,429,19,1
198154,6366,2849,3517,20,1
198154,4507,2243,2264,21,4
198154,4507,2243,2264,22,1
198154,4408,2200,2208,23,1
198154,1089,572,517,24,1
198154,3319,1628,1691,25,1
198154,99,43,56,31,1
198154,519,273,246,39,1
198154,2800,1355,1445,40,1
198154,4739,2048,2691,41,4
198154,4739,2048,2691,42,1
198154,4390,1897,2493,43,1
198154,500,262,238,44,1
198154,3890,1635,2255,45,1
198154,349,151,198,51,1
198154,324,141,183,59,1
198154,3566,1494,2072,60,1
198190,57,38,19,1,4
198190,57,38,19,2,1
198190,57,38,19,3,1
198190,18,12,6,4,1
198190,39,26,13,5,1
198190,39,26,13,20,1
198190,40,28,12,21,4
198190,40,28,12,22,1
198190,40,28,12,23,1
198190,12,9,3,24,1
198190,28,19,9,25,1
198190,28,19,9,40,1
198190,17,10,7,41,4
198190,17,10,7,42,1
198190,17,10,7,43,1
198190,6,3,3,44,1
198190,11,7,4,45,1
198190,11,7,4,60,1
198206,1524,500,1024,1,4
198206,1524,500,1024,2,1
198206,1409,466,943,3,1
198206,222,87,135,4,1
198206,1187,379,808,5,1
198206,115,34,81,11,1
198206,444,137,307,19,1
198206,743,242,501,20,1
198206,642,247,395,21,4
198206,642,247,395,22,1
198206,638,245,393,23,1
198206,119,47,72,24,1
198206,519,198,321,25,1
198206,4,2,2,31,1
198206,180,68,112,39,1
198206,339,130,209,40,1
198206,882,253,629,41,4
198206,882,253,629,42,1
198206,771,221,550,43,1
198206,103,40,63,44,1
198206,668,181,487,45,1
198206,111,32,79,51,1
198206,264,69,195,59,1
198206,404,112,292,60,1
198215,1310,618,692,1,4
198215,1298,618,680,2,1
198215,1273,614,659,3,1
198215,335,170,165,4,1
198215,938,444,494,5,1
198215,25,4,21,11,1
198215,12,0,12,12,3
198215,130,40,90,19,1
198215,808,404,404,20,1
198215,1211,595,616,21,4
198215,1210,595,615,22,1
198215,1209,595,614,23,1
198215,335,170,165,24,1
198215,874,425,449,25,1
198215,1,0,1,31,1
198215,1,0,1,32,3
198215,111,35,76,39,1
198215,763,390,373,40,1
198215,99,23,76,41,4
198215,88,23,65,42,1
198215,64,19,45,43,1
198215,64,19,45,45,1
198215,24,4,20,51,1
198215,11,0,11,52,3
198215,19,5,14,59,1
198215,45,14,31,60,1
198233,4561,1889,2672,1,4
198233,4561,1889,2672,2,1
198233,3781,1582,2199,3,1
198233,928,462,466,4,1
198233,2853,1120,1733,5,1
198233,780,307,473,11,1
198233,1040,358,682,19,1
198233,1813,762,1051,20,1
198233,1779,821,958,21,4
198233,1779,821,958,22,1
198233,1668,787,881,23,1
198233,486,244,242,24,1
198233,1182,543,639,25,1
198233,111,34,77,31,1
198233,368,161,207,39,1
198233,814,382,432,40,1
198233,2782,1068,1714,41,4
198233,2782,1068,1714,42,1
198233,2113,795,1318,43,1
198233,442,218,224,44,1
198233,1671,577,1094,45,1
198233,669,273,396,51,1
198233,672,197,475,59,1
198233,999,380,619,60,1
198242,256,65,191,1,4
198242,256,65,191,2,1
198242,256,65,191,3,1
198242,11,2,9,4,1
198242,245,63,182,5,1
198242,36,6,30,19,1
198242,209,57,152,20,1
198242,228,59,169,21,4
198242,228,59,169,22,1
198242,228,59,169,23,1
198242,10,2,8,24,1
198242,218,57,161,25,1
198242,29,5,24,39,1
198242,189,52,137,40,1
198242,28,6,22,41,4
198242,28,6,22,42,1
198242,28,6,22,43,1
198242,1,0,1,44,1
198242,27,6,21,45,1
198242,7,1,6,59,1
198242,20,5,15,60,1
198251,4728,1637,3091,1,4
198251,4728,1637,3091,2,1
198251,3985,1347,2638,3,1
198251,736,355,381,4,1
198251,3249,992,2257,5,1
198251,743,290,453,11,1
198251,873,247,626,19,1
198251,2376,745,1631,20,1
198251,2210,851,1359,21,4
198251,2210,851,1359,22,1
198251,2103,808,1295,23,1
198251,491,262,229,24,1
198251,1612,546,1066,25,1
198251,107,43,64,31,1
198251,394,128,266,39,1
198251,1218,418,800,40,1
198251,2518,786,1732,41,4
198251,2518,786,1732,42,1
198251,1882,539,1343,43,1
198251,245,93,152,44,1
198251,1637,446,1191,45,1
198251,636,247,389,51,1
198251,479,119,360,59,1
198251,1158,327,831,60,1
198260,20198,8790,11408,1,4
198260,20198,8790,11408,2,1
198260,18774,8177,10597,3,1
198260,3759,1779,1980,4,1
198260,15015,6398,8617,5,1
198260,1424,613,811,11,1
198260,739,305,434,19,1
198260,14276,6093,8183,20,1
198260,7140,3346,3794,21,4
198260,7140,3346,3794,22,1
198260,6904,3217,3687,23,1
198260,1710,844,866,24,1
198260,5194,2373,2821,25,1
198260,236,129,107,31,1
198260,259,121,138,39,1
198260,4935,2252,2683,40,1
198260,13058,5444,7614,41,4
198260,13058,5444,7614,42,1
198260,11870,4960,6910,43,1
198260,2049,935,1114,44,1
198260,9821,4025,5796,45,1
198260,1188,484,704,51,1
198260,480,184,296,59,1
198260,9341,3841,5500,60,1
198303,1367,644,723,1,4
198303,1361,644,717,2,1
198303,1361,644,717,3,1
198303,474,238,236,4,1
198303,887,406,481,5,1
198303,6,0,6,12,3
198303,83,42,41,19,1
198303,804,364,440,20,1
198303,1285,622,663,21,4
198303,1285,622,663,22,1
198303,1285,622,663,23,1
198303,474,238,236,24,1
198303,811,384,427,25,1
198303,73,39,34,39,1
198303,738,345,393,40,1
198303,82,22,60,41,4
198303,76,22,54,42,1
198303,76,22,54,43,1
198303,76,22,54,45,1
198303,6,0,6,52,3
198303,10,3,7,59,1
198303,66,19,47,60,1
198321,3371,1276,2095,1,4
198321,3371,1276,2095,2,1
198321,3123,1186,1937,3,1
198321,833,364,469,4,1
198321,2290,822,1468,5,1
198321,248,90,158,11,1
198321,449,141,308,19,1
198321,1841,681,1160,20,1
198321,1175,415,760,21,4
198321,1175,415,760,22,1
198321,1151,403,748,23,1
198321,259,101,158,24,1
198321,892,302,590,25,1
198321,24,12,12,31,1
198321,125,34,91,39,1
198321,767,268,499,40,1
198321,2196,861,1335,41,4
198321,2196,861,1335,42,1
198321,1972,783,1189,43,1
198321,574,263,311,44,1
198321,1398,520,878,45,1
198321,224,78,146,51,1
198321,324,107,217,59,1
198321,1074,413,661,60,1
198330,4433,1784,2649,1,4
198330,4433,1784,2649,2,1
198330,4185,1700,2485,3,1
198330,878,454,424,4,1
198330,3307,1246,2061,5,1
198330,248,84,164,11,1
198330,610,208,402,19,1
198330,2697,1038,1659,20,1
198330,2232,909,1323,21,4
198330,2232,909,1323,22,1
198330,2224,904,1320,23,1
198330,551,272,279,24,1
198330,1673,632,1041,25,1
198330,8,5,3,31,1
198330,322,93,229,39,1
198330,1351,539,812,40,1
198330,2201,875,1326,41,4
198330,2201,875,1326,42,1
198330,1961,796,1165,43,1
198330,327,182,145,44,1
198330,1634,614,1020,45,1
198330,240,79,161,51,1
198330,288,115,173,59,1
198330,1346,499,847,60,1
198367,3376,1314,2062,1,4
198367,3376,1314,2062,2,1
198367,3205,1245,1960,3,1
198367,681,305,376,4,1
198367,2524,940,1584,5,1
198367,171,69,102,11,1
198367,220,86,134,19,1
198367,2304,854,1450,20,1
198367,1412,565,847,21,4
198367,1412,565,847,22,1
198367,1388,554,834,23,1
198367,279,118,161,24,1
198367,1109,436,673,25,1
198367,24,11,13,31,1
198367,90,34,56,39,1
198367,1019,402,617,40,1
198367,1964,749,1215,41,4
198367,1964,749,1215,42,1
198367,1817,691,1126,43,1
198367,402,187,215,44,1
198367,1415,504,911,45,1
198367,147,58,89,51,1
198367,130,52,78,59,1
198367,1285,452,833,60,1
198376,4073,1410,2663,1,4
198376,4073,1410,2663,2,1
198376,3570,1221,2349,3,1
198376,884,394,490,4,1
198376,2686,827,1859,5,1
198376,503,189,314,11,1
198376,341,106,235,19,1
198376,2345,721,1624,20,1
198376,1980,781,1199,21,4
198376,1980,781,1199,22,1
198376,1849,729,1120,23,1
198376,587,277,310,24,1
198376,1262,452,810,25,1
198376,131,52,79,31,1
198376,172,70,102,39,1
198376,1090,382,708,40,1
198376,2093,629,1464,41,4
198376,2093,629,1464,42,1
198376,1721,492,1229,43,1
198376,297,117,180,44,1
198376,1424,375,1049,45,1
198376,372,137,235,51,1
198376,169,36,133,59,1
198376,1255,339,916,60,1
198385,1788,889,899,1,4
198385,1788,889,899,2,1
198385,1782,887,895,3,1
198385,483,228,255,4,1
198385,1299,659,640,5,1
198385,6,2,4,11,1
198385,15,7,8,19,1
198385,1284,652,632,20,1
198385,1788,889,899,21,4
198385,1788,889,899,22,1
198385,1782,887,895,23,1
198385,483,228,255,24,1
198385,1299,659,640,25,1
198385,6,2,4,31,1
198385,15,7,8,39,1
198385,1284,652,632,40,1
198419,15467,7712,7755,1,4
198419,6646,3291,3355,2,1
198419,6501,3235,3266,3,1
198419,1730,841,889,4,1
198419,4771,2394,2377,5,1
198419,145,56,89,11,1
198419,8821,4421,4400,12,3
198419,22,11,11,19,1
198419,4749,2383,2366,20,1
198419,14894,7534,7360,21,4
198419,6629,3282,3347,22,1
198419,6495,3230,3265,23,1
198419,1730,841,889,24,1
198419,4765,2389,2376,25,1
198419,134,52,82,31,1
198419,8265,4252,4013,32,3
198419,22,11,11,39,1
198419,4743,2378,2365,40,1
198419,573,178,395,41,4
198419,17,9,8,42,1
198419,6,5,1,43,1
198419,6,5,1,45,1
198419,11,4,7,51,1
198419,556,169,387,52,3
198419,6,5,1,60,1
198455,5605,2240,3365,1,4
198455,5605,2240,3365,2,1
198455,5116,2068,3048,3,1
198455,804,396,408,4,1
198455,4312,1672,2640,5,1
198455,489,172,317,11,1
198455,752,317,435,19,1
198455,3560,1355,2205,20,1
198455,1620,765,855,21,4
198455,1620,765,855,22,1
198455,1576,747,829,23,1
198455,261,147,114,24,1
198455,1315,600,715,25,1
198455,44,18,26,31,1
198455,249,121,128,39,1
198455,1066,479,587,40,1
198455,3985,1475,2510,41,4
198455,3985,1475,2510,42,1
198455,3540,1321,2219,43,1
198455,543,249,294,44,1
198455,2997,1072,1925,45,1
198455,445,154,291,51,1
198455,503,196,307,59,1
198455,2494,876,1618,60,1
198464,26887,10684,16203,1,4
198464,21508,8802,12706,2,1
198464,20625,8561,12064,3,1
198464,4495,1833,2662,4,1
198464,16130,6728,9402,5,1
198464,883,241,642,11,1
198464,5379,1882,3497,12,3
198464,1328,594,734,19,1
198464,14802,6134,8668,20,1
198464,20971,8624,12347,21,4
198464,18500,7704,10796,22,1
198464,18369,7653,10716,23,1
198464,4463,1827,2636,24,1
198464,13906,5826,8080,25,1
198464,131,51,80,31,1
198464,2471,920,1551,32,3
198464,978,466,512,39,1
198464,12928,5360,7568,40,1
198464,5916,2060,3856,41,4
198464,3008,1098,1910,42,1
198464,2256,908,1348,43,1
198464,32,6,26,44,1
198464,2224,902,1322,45,1
198464,752,190,562,51,1
198464,2908,962,1946,52,3
198464,350,128,222,59,1
198464,1874,774,1100,60,1
198491,2808,769,2039,1,4
198491,2808,769,2039,2,1
198491,2524,672,1852,3,1
198491,484,204,280,4,1
198491,2040,468,1572,5,1
198491,284,97,187,11,1
198491,714,124,590,19,1
198491,1326,344,982,20,1
198491,1404,429,975,21,4
198491,1404,429,975,22,1
198491,1384,424,960,23,1
198491,328,152,176,24,1
198491,1056,272,784,25,1
198491,20,5,15,31,1
198491,337,68,269,39,1
198491,719,204,515,40,1
198491,1404,340,1064,41,4
198491,1404,340,1064,42,1
198491,1140,248,892,43,1
198491,156,52,104,44,1
198491,984,196,788,45,1
198491,264,92,172,51,1
198491,377,56,321,59,1
198491,607,140,467,60,1
198507,2421,981,1440,1,4
198507,2336,956,1380,2,1
198507,2276,938,1338,3,1
198507,323,155,168,4,1
198507,1953,783,1170,5,1
198507,60,18,42,11,1
198507,85,25,60,12,3
198507,152,56,96,19,1
198507,1801,727,1074,20,1
198507,2155,911,1244,21,4
198507,2146,907,1239,22,1
198507,2127,902,1225,23,1
198507,322,154,168,24,1
198507,1805,748,1057,25,1
198507,19,5,14,31,1
198507,9,4,5,32,3
198507,142,54,88,39,1
198507,1663,694,969,40,1
198507,266,70,196,41,4
198507,190,49,141,42,1
198507,149,36,113,43,1
198507,1,1,0,44,1
198507,148,35,113,45,1
198507,41,13,28,51,1
198507,76,21,55,52,3
198507,10,2,8,59,1
198507,138,33,105,60,1
198516,6305,2588,3717,1,4
198516,5599,2285,3314,2,1
198516,5599,2285,3314,3,1
198516,1475,585,890,4,1
198516,4124,1700,2424,5,1
198516,706,303,403,12,3
198516,102,47,55,19,1
198516,4022,1653,2369,20,1
198516,6052,2473,3579,21,4
198516,5464,2224,3240,22,1
198516,5464,2224,3240,23,1
198516,1475,585,890,24,1
198516,3989,1639,2350,25,1
198516,588,249,339,32,3
198516,101,47,54,39,1
198516,3888,1592,2296,40,1
198516,253,115,138,41,4
198516,135,61,74,42,1
198516,135,61,74,43,1
198516,135,61,74,45,1
198516,118,54,64,52,3
198516,1,0,1,59,1
198516,134,61,73,60,1
198525,47,4,43,1,4
198525,47,4,43,2,1
198525,47,4,43,3,1
198525,31,2,29,4,1
198525,16,2,14,5,1
198525,16,2,14,20,1
198525,46,4,42,21,4
198525,46,4,42,22,1
198525,46,4,42,23,1
198525,30,2,28,24,1
198525,16,2,14,25,1
198525,16,2,14,40,1
198525,1,0,1,41,4
198525,1,0,1,42,1
198525,1,0,1,43,1
198525,1,0,1,44,1
198534,12398,5040,7358,1,4
198534,12398,5040,7358,2,1
198534,10681,4038,6643,3,1
198534,1961,889,1072,4,1
198534,8720,3149,5571,5,1
198534,1717,1002,715,11,1
198534,2661,790,1871,19,1
198534,6059,2359,3700,20,1
198534,5119,2029,3090,21,4
198534,5119,2029,3090,22,1
198534,5063,2003,3060,23,1
198534,1068,499,569,24,1
198534,3995,1504,2491,25,1
198534,56,26,30,31,1
198534,1160,346,814,39,1
198534,2835,1158,1677,40,1
198534,7279,3011,4268,41,4
198534,7279,3011,4268,42,1
198534,5618,2035,3583,43,1
198534,893,390,503,44,1
198534,4725,1645,3080,45,1
198534,1661,976,685,51,1
198534,1501,444,1057,59,1
198534,3224,1201,2023,60,1
198543,6179,1868,4311,1,4
198543,5410,1670,3740,2,1
198543,5077,1566,3511,3,1
198543,707,249,458,4,1
198543,4370,1317,3053,5,1
198543,333,104,229,11,1
198543,769,198,571,12,3
198543,880,276,604,19,1
198543,3490,1041,2449,20,1
198543,4325,1379,2946,21,4
198543,3971,1300,2671,22,1
198543,3901,1277,2624,23,1
198543,689,241,448,24,1
198543,3212,1036,2176,25,1
198543,70,23,47,31,1
198543,354,79,275,32,3
198543,594,196,398,39,1
198543,2618,840,1778,40,1
198543,1854,489,1365,41,4
198543,1439,370,1069,42,1
198543,1176,289,887,43,1
198543,18,8,10,44,1
198543,1158,281,877,45,1
198543,263,81,182,51,1
198543,415,119,296,52,3
198543,286,80,206,59,1
198543,872,201,671,60,1
198552,9528,3826,5702,1,4
198552,9528,3826,5702,2,1
198552,8642,3483,5159,3,1
198552,1266,644,622,4,1
198552,7376,2839,4537,5,1
198552,886,343,543,11,1
198552,876,349,527,19,1
198552,6500,2490,4010,20,1
198552,4412,1947,2465,21,4
198552,4412,1947,2465,22,1
198552,4271,1890,2381,23,1
198552,819,441,378,24,1
198552,3452,1449,2003,25,1
198552,141,57,84,31,1
198552,470,219,251,39,1
198552,2982,1230,1752,40,1
198552,5116,1879,3237,41,4
198552,5116,1879,3237,42,1
198552,4371,1593,2778,43,1
198552,447,203,244,44,1
198552,3924,1390,2534,45,1
198552,745,286,459,51,1
198552,406,130,276,59,1
198552,3518,1260,2258,60,1
198561,4656,1497,3159,1,4
198561,2587,900,1687,2,1
198561,2559,889,1670,3,1
198561,434,187,247,4,1
198561,2125,702,1423,5,1
198561,28,11,17,11,1
198561,2069,597,1472,12,3
198561,378,89,289,19,1
198561,1747,613,1134,20,1
198561,2784,972,1812,21,4
198561,2089,779,1310,22,1
198561,2089,779,1310,23,1
198561,434,187,247,24,1
198561,1655,592,1063,25,1
198561,695,193,502,32,3
198561,269,68,201,39,1
198561,1386,524,862,40,1
198561,1872,525,1347,41,4
198561,498,121,377,42,1
198561,470,110,360,43,1
198561,470,110,360,45,1
198561,28,11,17,51,1
198561,1374,404,970,52,3
198561,109,21,88,59,1
198561,361,89,272,60,1
198570,5977,2115,3862,1,4
198570,5977,2115,3862,2,1
198570,5743,2042,3701,3,1
198570,1008,441,567,4,1
198570,4735,1601,3134,5,1
198570,234,73,161,11,1
198570,798,232,566,19,1
198570,3937,1369,2568,20,1
198570,2096,806,1290,21,4
198570,2096,806,1290,22,1
198570,2083,803,1280,23,1
198570,401,187,214,24,1
198570,1682,616,1066,25,1
198570,13,3,10,31,1
198570,242,77,165,39,1
198570,1440,539,901,40,1
198570,3881,1309,2572,41,4
198570,3881,1309,2572,42,1
198570,3660,1239,2421,43,1
198570,607,254,353,44,1
198570,3053,985,2068,45,1
198570,221,70,151,51,1
198570,556,155,401,59,1
198570,2497,830,1667,60,1
198598,1012,489,523,1,4
198598,974,479,495,2,1
198598,802,427,375,3,1
198598,201,117,84,4,1
198598,601,310,291,5,1
198598,172,52,120,11,1
198598,38,10,28,12,3
198598,81,45,36,19,1
198598,520,265,255,20,1
198598,781,415,366,21,4
198598,771,415,356,22,1
198598,763,415,348,23,1
198598,201,117,84,24,1
198598,562,298,264,25,1
198598,8,0,8,31,1
198598,10,0,10,32,3
198598,71,36,35,39,1
198598,491,262,229,40,1
198598,231,74,157,41,4
198598,203,64,139,42,1
198598,39,12,27,43,1
198598,39,12,27,45,1
198598,164,52,112,51,1
198598,28,10,18,52,3
198598,10,9,1,59,1
198598,29,3,26,60,1
198613,2302,1021,1281,1,4
198613,2302,1021,1281,2,1
198613,2171,967,1204,3,1
198613,406,232,174,4,1
198613,1765,735,1030,5,1
198613,131,54,77,11,1
198613,196,67,129,19,1
198613,1569,668,901,20,1
198613,1928,877,1051,21,4
198613,1928,877,1051,22,1
198613,1823,834,989,23,1
198613,392,226,166,24,1
198613,1431,608,823,25,1
198613,105,43,62,31,1
198613,125,46,79,39,1
198613,1306,562,744,40,1
198613,374,144,230,41,4
198613,374,144,230,42,1
198613,348,133,215,43,1
198613,14,6,8,44,1
198613,334,127,207,45,1
198613,26,11,15,51,1
198613,71,21,50,59,1
198613,263,106,157,60,1
198622,13656,5908,7748,1,4
198622,13656,5908,7748,2,1
198622,13419,5810,7609,3,1
198622,2507,1285,1222,4,1
198622,10912,4525,6387,5,1
198622,237,98,139,11,1
198622,1198,489,709,19,1
198622,9714,4036,5678,20,1
198622,6825,3150,3675,21,4
198622,6825,3150,3675,22,1
198622,6791,3130,3661,23,1
198622,1457,764,693,24,1
198622,5334,2366,2968,25,1
198622,34,20,14,31,1
198622,697,308,389,39,1
198622,4637,2058,2579,40,1
198622,6831,2758,4073,41,4
198622,6831,2758,4073,42,1
198622,6628,2680,3948,43,1
198622,1050,521,529,44,1
198622,5578,2159,3419,45,1
198622,203,78,125,51,1
198622,501,181,320,59,1
198622,5077,1978,3099,60,1
198640,1353,475,878,1,4
198640,1353,475,878,2,1
198640,1197,409,788,3,1
198640,299,130,169,4,1
198640,898,279,619,5,1
198640,156,66,90,11,1
198640,247,61,186,19,1
198640,651,218,433,20,1
198640,688,279,409,21,4
198640,688,279,409,22,1
198640,654,268,386,23,1
198640,204,100,104,24,1
198640,450,168,282,25,1
198640,34,11,23,31,1
198640,116,39,77,39,1
198640,334,129,205,40,1
198640,665,196,469,41,4
198640,665,196,469,42,1
198640,543,141,402,43,1
198640,95,30,65,44,1
198640,448,111,337,45,1
198640,122,55,67,51,1
198640,131,22,109,59,1
198640,317,89,228,60,1
198668,2290,852,1438,1,4
198668,2290,852,1438,2,1
198668,1927,739,1188,3,1
198668,416,207,209,4,1
198668,1511,532,979,5,1
198668,363,113,250,11,1
198668,524,144,380,19,1
198668,987,388,599,20,1
198668,997,396,601,21,4
198668,997,396,601,22,1
198668,849,368,481,23,1
198668,133,64,69,24,1
198668,716,304,412,25,1
198668,148,28,120,31,1
198668,214,76,138,39,1
198668,502,228,274,40,1
198668,1293,456,837,41,4
198668,1293,456,837,42,1
198668,1078,371,707,43,1
198668,283,143,140,44,1
198668,795,228,567,45,1
198668,215,85,130,51,1
198668,310,68,242,59,1
198668,485,160,325,60,1
198677,67,43,24,1,4
198677,67,43,24,2,1
198677,67,43,24,3,1
198677,10,7,3,4,1
198677,57,36,21,5,1
198677,5,3,2,19,1
198677,52,33,19,20,1
198677,50,33,17,21,4
198677,50,33,17,22,1
198677,50,33,17,23,1
198677,9,7,2,24,1
198677,41,26,15,25,1
198677,4,3,1,39,1
198677,37,23,14,40,1
198677,17,10,7,41,4
198677,17,10,7,42,1
198677,17,10,7,43,1
198677,1,0,1,44,1
198677,16,10,6,45,1
198677,1,0,1,59,1
198677,15,10,5,60,1
198695,4199,1693,2506,1,4
198695,3999,1644,2355,2,1
198695,3996,1642,2354,3,1
198695,1162,481,681,4,1
198695,2834,1161,1673,5,1
198695,3,2,1,11,1
198695,200,49,151,12,3
198695,84,52,32,19,1
198695,2750,1109,1641,20,1
198695,4017,1640,2377,21,4
198695,3953,1623,2330,22,1
198695,3950,1621,2329,23,1
198695,1162,481,681,24,1
198695,2788,1140,1648,25,1
198695,3,2,1,31,1
198695,64,17,47,32,3
198695,82,51,31,39,1
198695,2706,1089,1617,40,1
198695,182,53,129,41,4
198695,46,21,25,42,1
198695,46,21,25,43,1
198695,46,21,25,45,1
198695,136,32,104,52,3
198695,2,1,1,59,1
198695,44,20,24,60,1
198710,2390,967,1423,1,4
198710,2390,967,1423,2,1
198710,1616,600,1016,3,1
198710,264,133,131,4,1
198710,1352,467,885,5,1
198710,774,367,407,11,1
198710,185,53,132,19,1
198710,1167,414,753,20,1
198710,1064,433,631,21,4
198710,1064,433,631,22,1
198710,963,388,575,23,1
198710,198,103,95,24,1
198710,765,285,480,25,1
198710,101,45,56,31,1
198710,78,28,50,39,1
198710,687,257,430,40,1
198710,1326,534,792,41,4
198710,1326,534,792,42,1
198710,653,212,441,43,1
198710,66,30,36,44,1
198710,587,182,405,45,1
198710,673,322,351,51,1
198710,107,25,82,59,1
198710,480,157,323,60,1
198729,1291,374,917,1,4
198729,1291,374,917,2,1
198729,1022,275,747,3,1
198729,182,78,104,4,1
198729,840,197,643,5,1
198729,269,99,170,11,1
198729,248,48,200,19,1
198729,592,149,443,20,1
198729,697,205,492,21,4
198729,697,205,492,22,1
198729,658,190,468,23,1
198729,135,55,80,24,1
198729,523,135,388,25,1
198729,39,15,24,31,1
198729,141,33,108,39,1
198729,382,102,280,40,1
198729,594,169,425,41,4
198729,594,169,425,42,1
198729,364,85,279,43,1
198729,47,23,24,44,1
198729,317,62,255,45,1
198729,230,84,146,51,1
198729,107,15,92,59,1
198729,210,47,163,60,1
198747,610,395,215,1,4
198747,386,259,127,2,1
198747,386,259,127,3,1
198747,9,7,2,4,1
198747,377,252,125,5,1
198747,224,136,88,12,3
198747,22,11,11,19,1
198747,355,241,114,20,1
198747,152,77,75,21,4
198747,104,57,47,22,1
198747,104,57,47,23,1
198747,7,6,1,24,1
198747,97,51,46,25,1
198747,48,20,28,32,3
198747,13,8,5,39,1
198747,84,43,41,40,1
198747,458,318,140,41,4
198747,282,202,80,42,1
198747,282,202,80,43,1
198747,2,1,1,44,1
198747,280,201,79,45,1
198747,176,116,60,52,3
198747,9,3,6,59,1
198747,271,198,73,60,1
198756,1387,567,820,1,4
198756,1387,567,820,2,1
198756,1382,564,818,3,1
198756,232,94,138,4,1
198756,1150,470,680,5,1
198756,5,3,2,11,1
198756,84,45,39,19,1
198756,1066,425,641,20,1
198756,1323,544,779,21,4
198756,1323,544,779,22,1
198756,1319,541,778,23,1
198756,232,94,138,24,1
198756,1087,447,640,25,1
198756,4,3,1,31,1
198756,80,43,37,39,1
198756,1007,404,603,40,1
198756,64,23,41,41,4
198756,64,23,41,42,1
198756,63,23,40,43,1
198756,63,23,40,45,1
198756,1,0,1,51,1
198756,4,2,2,59,1
198756,59,21,38,60,1
198774,4235,1440,2795,1,4
198774,4235,1440,2795,2,1
198774,3719,1277,2442,3,1
198774,738,320,418,4,1
198774,2981,957,2024,5,1
198774,516,163,353,11,1
198774,808,187,621,19,1
198774,2173,770,1403,20,1
198774,2187,811,1376,21,4
198774,2187,811,1376,22,1
198774,2136,797,1339,23,1
198774,490,203,287,24,1
198774,1646,594,1052,25,1
198774,51,14,37,31,1
198774,405,114,291,39,1
198774,1241,480,761,40,1
198774,2048,629,1419,41,4
198774,2048,629,1419,42,1
198774,1583,480,1103,43,1
198774,248,117,131,44,1
198774,1335,363,972,45,1
198774,465,149,316,51,1
198774,403,73,330,59,1
198774,932,290,642,60,1
198808,890,353,537,1,4
198808,890,353,537,2,1
198808,888,353,535,3,1
198808,226,110,116,4,1
198808,662,243,419,5,1
198808,2,0,2,11,1
198808,167,41,126,19,1
198808,495,202,293,20,1
198808,883,347,536,21,4
198808,883,347,536,22,1
198808,881,347,534,23,1
198808,226,110,116,24,1
198808,655,237,418,25,1
198808,2,0,2,31,1
198808,167,41,126,39,1
198808,488,196,292,40,1
198808,7,6,1,41,4
198808,7,6,1,42,1
198808,7,6,1,43,1
198808,7,6,1,45,1
198808,7,6,1,60,1
198817,2813,1141,1672,1,4
198817,2813,1141,1672,2,1
198817,2056,851,1205,3,1
198817,540,276,264,4,1
198817,1516,575,941,5,1
198817,757,290,467,11,1
198817,561,198,363,19,1
198817,955,377,578,20,1
198817,1343,582,761,21,4
198817,1343,582,761,22,1
198817,1282,558,724,23,1
198817,411,205,206,24,1
198817,871,353,518,25,1
198817,61,24,37,31,1
198817,277,102,175,39,1
198817,594,251,343,40,1
198817,1470,559,911,41,4
198817,1470,559,911,42,1
198817,774,293,481,43,1
198817,129,71,58,44,1
198817,645,222,423,45,1
198817,696,266,430,51,1
198817,284,96,188,59,1
198817,361,126,235,60,1
198835,1898,727,1171,1,4
198835,1491,620,871,2,1
198835,1409,584,825,3,1
198835,311,144,167,4,1
198835,1098,440,658,5,1
198835,82,36,46,11,1
198835,407,107,300,12,3
198835,108,43,65,19,1
198835,990,397,593,20,1
198835,1519,609,910,21,4
198835,1306,556,750,22,1
198835,1296,554,742,23,1
198835,311,144,167,24,1
198835,985,410,575,25,1
198835,10,2,8,31,1
198835,213,53,160,32,3
198835,74,40,34,39,1
198835,911,370,541,40,1
198835,379,118,261,41,4
198835,185,64,121,42,1
198835,113,30,83,43,1
198835,113,30,83,45,1
198835,72,34,38,51,1
198835,194,54,140,52,3
198835,34,3,31,59,1
198835,79,27,52,60,1
198844,143,1,142,1,4
198844,143,1,142,2,1
198844,143,1,142,3,1
198844,41,0,41,4,1
198844,102,1,101,5,1
198844,102,1,101,20,1
198844,87,1,86,21,4
198844,87,1,86,22,1
198844,87,1,86,23,1
198844,23,0,23,24,1
198844,64,1,63,25,1
198844,64,1,63,40,1
198844,56,0,56,41,4
198844,56,0,56,42,1
198844,56,0,56,43,1
198844,18,0,18,44,1
198844,38,0,38,45,1
198844,38,0,38,60,1
198862,1175,653,522,1,4
198862,1175,653,522,2,1
198862,1172,651,521,3,1
198862,395,219,176,4,1
198862,777,432,345,5,1
198862,3,2,1,11,1
198862,62,40,22,19,1
198862,715,392,323,20,1
198862,1164,647,517,21,4
198862,1164,647,517,22,1
198862,1164,647,517,23,1
198862,395,219,176,24,1
198862,769,428,341,25,1
198862,62,40,22,39,1
198862,707,388,319,40,1
198862,11,6,5,41,4
198862,11,6,5,42,1
198862,8,4,4,43,1
198862,8,4,4,45,1
198862,3,2,1,51,1
198862,8,4,4,60,1
198871,678,449,229,1,4
198871,678,449,229,2,1
198871,676,449,227,3,1
198871,345,237,108,4,1
198871,331,212,119,5,1
198871,2,0,2,11,1
198871,60,45,15,19,1
198871,271,167,104,20,1
198871,674,447,227,21,4
198871,674,447,227,22,1
198871,674,447,227,23,1
198871,345,237,108,24,1
198871,329,210,119,25,1
198871,60,45,15,39,1
198871,269,165,104,40,1
198871,4,2,2,41,4
198871,4,2,2,42,1
198871,2,2,0,43,1
198871,2,2,0,45,1
198871,2,0,2,51,1
198871,2,2,0,60,1
198899,1440,717,723,1,4
198899,1426,716,710,2,1
198899,1393,702,691,3,1
198899,419,232,187,4,1
198899,974,470,504,5,1
198899,33,14,19,11,1
198899,14,1,13,12,3
198899,114,50,64,19,1
198899,860,420,440,20,1
198899,1333,688,645,21,4
198899,1319,687,632,22,1
198899,1311,683,628,23,1
198899,417,231,186,24,1
198899,894,452,442,25,1
198899,8,4,4,31,1
198899,14,1,13,32,3
198899,102,49,53,39,1
198899,792,403,389,40,1
198899,107,29,78,41,4
198899,107,29,78,42,1
198899,82,19,63,43,1
198899,2,1,1,44,1
198899,80,18,62,45,1
198899,25,10,15,51,1
198899,12,1,11,59,1
198899,68,17,51,60,1
198905,799,260,539,1,4
198905,799,260,539,2,1
198905,572,177,395,3,1
198905,95,34,61,4,1
198905,477,143,334,5,1
198905,227,83,144,11,1
198905,181,49,132,19,1
198905,296,94,202,20,1
198905,382,122,260,21,4
198905,382,122,260,22,1
198905,369,119,250,23,1
198905,64,22,42,24,1
198905,305,97,208,25,1
198905,13,3,10,31,1
198905,118,33,85,39,1
198905,187,64,123,40,1
198905,417,138,279,41,4
198905,417,138,279,42,1
198905,203,58,145,43,1
198905,31,12,19,44,1
198905,172,46,126,45,1
198905,214,80,134,51,1
198905,63,16,47,59,1
198905,109,30,79,60,1
198914,1254,541,713,1,4
198914,1254,541,713,2,1
198914,751,261,490,3,1
198914,146,55,91,4,1
198914,605,206,399,5,1
198914,503,280,223,11,1
198914,29,11,18,19,1
198914,576,195,381,20,1
198914,390,130,260,21,4
198914,390,130,260,22,1
198914,361,125,236,23,1
198914,80,28,52,24,1
198914,281,97,184,25,1
198914,29,5,24,31,1
198914,8,3,5,39,1
198914,273,94,179,40,1
198914,864,411,453,41,4
198914,864,411,453,42,1
198914,390,136,254,43,1
198914,66,27,39,44,1
198914,324,109,215,45,1
198914,474,275,199,51,1
198914,21,8,13,59,1
198914,303,101,202,60,1
198923,1152,450,702,1,4
198923,1152,450,702,2,1
198923,808,303,505,3,1
198923,142,68,74,4,1
198923,666,235,431,5,1
198923,344,147,197,11,1
198923,165,59,106,19,1
198923,501,176,325,20,1
198923,440,185,255,21,4
198923,440,185,255,22,1
198923,402,168,234,23,1
198923,97,44,53,24,1
198923,305,124,181,25,1
198923,38,17,21,31,1
198923,63,30,33,39,1
198923,242,94,148,40,1
198923,712,265,447,41,4
198923,712,265,447,42,1
198923,406,135,271,43,1
198923,45,24,21,44,1
198923,361,111,250,45,1
198923,306,130,176,51,1
198923,102,29,73,59,1
198923,259,82,177,60,1
198941,137,20,117,1,4
198941,137,20,117,2,1
198941,137,20,117,3,1
198941,137,20,117,5,1
198941,137,20,117,20,1
198941,11,1,10,21,4
198941,11,1,10,22,1
198941,11,1,10,23,1
198941,11,1,10,25,1
198941,11,1,10,40,1
198941,126,19,107,41,4
198941,126,19,107,42,1
198941,126,19,107,43,1
198941,126,19,107,45,1
198941,126,19,107,60,1
198950,1872,39,1833,1,4
198950,1571,2,1569,2,1
198950,1543,0,1543,3,1
198950,415,0,415,4,1
198950,1128,0,1128,5,1
198950,28,2,26,11,1
198950,301,37,264,12,3
198950,73,0,73,19,1
198950,1055,0,1055,20,1
198950,1602,12,1590,21,4
198950,1490,0,1490,22,1
198950,1487,0,1487,23,1
198950,415,0,415,24,1
198950,1072,0,1072,25,1
198950,3,0,3,31,1
198950,112,12,100,32,3
198950,69,0,69,39,1
198950,1003,0,1003,40,1
198950,270,27,243,41,4
198950,81,2,79,42,1
198950,56,0,56,43,1
198950,56,0,56,45,1
198950,25,2,23,51,1
198950,189,25,164,52,3
198950,4,0,4,59,1
198950,52,0,52,60,1
198969,2463,1285,1178,1,4
198969,2243,1206,1037,2,1
198969,2172,1170,1002,3,1
198969,558,373,185,4,1
198969,1614,797,817,5,1
198969,71,36,35,11,1
198969,220,79,141,12,3
198969,263,108,155,19,1
198969,1351,689,662,20,1
198969,2100,1102,998,21,4
198969,1962,1065,897,22,1
198969,1944,1059,885,23,1
198969,548,366,182,24,1
198969,1396,693,703,25,1
198969,18,6,12,31,1
198969,138,37,101,32,3
198969,205,79,126,39,1
198969,1191,614,577,40,1
198969,363,183,180,41,4
198969,281,141,140,42,1
198969,228,111,117,43,1
198969,10,7,3,44,1
198969,218,104,114,45,1
198969,53,30,23,51,1
198969,82,42,40,52,3
198969,58,29,29,59,1
198969,160,75,85,60,1
198978,2856,398,2458,1,4
198978,2856,398,2458,2,1
198978,2856,398,2458,3,1
198978,466,84,382,4,1
198978,2390,314,2076,5,1
198978,523,58,465,19,1
198978,1867,256,1611,20,1
198978,1562,222,1340,21,4
198978,1562,222,1340,22,1
198978,1562,222,1340,23,1
198978,275,50,225,24,1
198978,1287,172,1115,25,1
198978,272,37,235,39,1
198978,1015,135,880,40,1
198978,1294,176,1118,41,4
198978,1294,176,1118,42,1
198978,1294,176,1118,43,1
198978,191,34,157,44,1
198978,1103,142,961,45,1
198978,251,21,230,59,1
198978,852,121,731,60,1
198987,3514,1246,2268,1,4
198987,3514,1246,2268,2,1
198987,2672,967,1705,3,1
198987,582,245,337,4,1
198987,2090,722,1368,5,1
198987,842,279,563,11,1
198987,118,49,69,19,1
198987,1972,673,1299,20,1
198987,1532,598,934,21,4
198987,1532,598,934,22,1
198987,1417,550,867,23,1
198987,382,160,222,24,1
198987,1035,390,645,25,1
198987,115,48,67,31,1
198987,67,39,28,39,1
198987,968,351,617,40,1
198987,1982,648,1334,41,4
198987,1982,648,1334,42,1
198987,1255,417,838,43,1
198987,200,85,115,44,1
198987,1055,332,723,45,1
198987,727,231,496,51,1
198987,51,10,41,59,1
198987,1004,322,682,60,1
198996,42,5,37,1,4
198996,42,5,37,2,1
198996,42,5,37,3,1
198996,24,4,20,4,1
198996,18,1,17,5,1
198996,18,1,17,20,1
198996,42,5,37,21,4
198996,42,5,37,22,1
198996,42,5,37,23,1
198996,24,4,20,24,1
198996,18,1,17,25,1
198996,18,1,17,40,1
199005,39,1,38,1,4
199005,39,1,38,2,1
199005,39,1,38,3,1
199005,22,1,21,4,1
199005,17,0,17,5,1
199005,17,0,17,20,1
199005,39,1,38,21,4
199005,39,1,38,22,1
199005,39,1,38,23,1
199005,22,1,21,24,1
199005,17,0,17,25,1
199005,17,0,17,40,1
199014,43,10,33,1,4
199014,43,10,33,2,1
199014,43,10,33,3,1
199014,30,6,24,4,1
199014,13,4,9,5,1
199014,13,4,9,20,1
199014,28,5,23,21,4
199014,28,5,23,22,1
199014,28,5,23,23,1
199014,20,3,17,24,1
199014,8,2,6,25,1
199014,8,2,6,40,1
199014,15,5,10,41,4
199014,15,5,10,42,1
199014,15,5,10,43,1
199014,10,3,7,44,1
199014,5,2,3,45,1
199014,5,2,3,60,1
199023,884,321,563,1,4
199023,884,321,563,2,1
199023,800,283,517,3,1
199023,120,55,65,4,1
199023,680,228,452,5,1
199023,84,38,46,11,1
199023,244,96,148,19,1
199023,436,132,304,20,1
199023,304,128,176,21,4
199023,304,128,176,22,1
199023,302,128,174,23,1
199023,83,40,43,24,1
199023,219,88,131,25,1
199023,2,0,2,31,1
199023,108,46,62,39,1
199023,111,42,69,40,1
199023,580,193,387,41,4
199023,580,193,387,42,1
199023,498,155,343,43,1
199023,37,15,22,44,1
199023,461,140,321,45,1
199023,82,38,44,51,1
199023,136,50,86,59,1
199023,325,90,235,60,1
199032,926,375,551,1,4
199032,743,320,423,2,1
199032,661,290,371,3,1
199032,108,63,45,4,1
199032,553,227,326,5,1
199032,82,30,52,11,1
199032,183,55,128,12,3
199032,81,30,51,19,1
199032,472,197,275,20,1
199032,635,279,356,21,4
199032,462,227,235,22,1
199032,459,226,233,23,1
199032,103,59,44,24,1
199032,356,167,189,25,1
199032,3,1,2,31,1
199032,173,52,121,32,3
199032,60,27,33,39,1
199032,296,140,156,40,1
199032,291,96,195,41,4
199032,281,93,188,42,1
199032,202,64,138,43,1
199032,5,4,1,44,1
199032,197,60,137,45,1
199032,79,29,50,51,1
199032,10,3,7,52,3
199032,21,3,18,59,1
199032,176,57,119,60,1
199069,3414,1140,2274,1,4
199069,3414,1140,2274,2,1
199069,3336,1086,2250,3,1
199069,236,94,142,4,1
199069,3100,992,2108,5,1
199069,78,54,24,11,1
199069,656,208,448,19,1
199069,2444,784,1660,20,1
199069,1386,547,839,21,4
199069,1386,547,839,22,1
199069,1384,545,839,23,1
199069,200,86,114,24,1
199069,1184,459,725,25,1
199069,2,2,0,31,1
199069,180,77,103,39,1
199069,1004,382,622,40,1
199069,2028,593,1435,41,4
199069,2028,593,1435,42,1
199069,1952,541,1411,43,1
199069,36,8,28,44,1
199069,1916,533,1383,45,1
199069,76,52,24,51,1
199069,476,131,345,59,1
199069,1440,402,1038,60,1
199078,182,18,164,1,4
199078,182,18,164,2,1
199078,182,18,164,3,1
199078,66,13,53,4,1
199078,116,5,111,5,1
199078,116,5,111,20,1
199078,182,18,164,21,4
199078,182,18,164,22,1
199078,182,18,164,23,1
199078,66,13,53,24,1
199078,116,5,111,25,1
199078,116,5,111,40,1
199087,3279,1237,2042,1,4
199087,3279,1237,2042,2,1
199087,2641,937,1704,3,1
199087,517,221,296,4,1
199087,2124,716,1408,5,1
199087,638,300,338,11,1
199087,515,145,370,19,1
199087,1609,571,1038,20,1
199087,1536,607,929,21,4
199087,1536,607,929,22,1
199087,1466,576,890,23,1
199087,378,179,199,24,1
199087,1088,397,691,25,1
199087,70,31,39,31,1
199087,252,74,178,39,1
199087,836,323,513,40,1
199087,1743,630,1113,41,4
199087,1743,630,1113,42,1
199087,1175,361,814,43,1
199087,139,42,97,44,1
199087,1036,319,717,45,1
199087,568,269,299,51,1
199087,263,71,192,59,1
199087,773,248,525,60,1
199102,10561,4794,5767,1,4
199102,8872,4061,4811,2,1
199102,8577,3906,4671,3,1
199102,1777,790,987,4,1
199102,6800,3116,3684,5,1
199102,295,155,140,11,1
199102,1689,733,956,12,3
199102,430,210,220,19,1
199102,6370,2906,3464,20,1
199102,9086,4072,5014,21,4
199102,8098,3652,4446,22,1
199102,8015,3610,4405,23,1
199102,1768,786,982,24,1
199102,6247,2824,3423,25,1
199102,83,42,41,31,1
199102,988,420,568,32,3
199102,383,180,203,39,1
199102,5864,2644,3220,40,1
199102,1475,722,753,41,4
199102,774,409,365,42,1
199102,562,296,266,43,1
199102,9,4,5,44,1
199102,553,292,261,45,1
199102,212,113,99,51,1
199102,701,313,388,52,3
199102,47,30,17,59,1
199102,506,262,244,60,1
199111,3784,1614,2170,1,4
199111,3736,1593,2143,2,1
199111,3323,1443,1880,3,1
199111,596,237,359,4,1
199111,2727,1206,1521,5,1
199111,413,150,263,11,1
199111,48,21,27,12,3
199111,378,184,194,19,1
199111,2349,1022,1327,20,1
199111,3129,1359,1770,21,4
199111,3129,1359,1770,22,1
199111,3014,1307,1707,23,1
199111,594,237,357,24,1
199111,2420,1070,1350,25,1
199111,115,52,63,31,1
199111,345,171,174,39,1
199111,2075,899,1176,40,1
199111,655,255,400,41,4
199111,607,234,373,42,1
199111,309,136,173,43,1
199111,2,0,2,44,1
199111,307,136,171,45,1
199111,298,98,200,51,1
199111,48,21,27,52,3
199111,33,13,20,59,1
199111,274,123,151,60,1
199120,29127,12442,16685,1,4
199120,18370,7696,10674,2,1
199120,17882,7468,10414,3,1
199120,3946,1601,2345,4,1
199120,13936,5867,8069,5,1
199120,488,228,260,11,1
199120,10757,4746,6011,12,3
199120,876,395,481,19,1
199120,13060,5472,7588,20,1
199120,24390,10265,14125,21,4
199120,17570,7296,10274,22,1
199120,17519,7284,10235,23,1
199120,3943,1598,2345,24,1
199120,13576,5686,7890,25,1
199120,51,12,39,31,1
199120,6820,2969,3851,32,3
199120,867,390,477,39,1
199120,12709,5296,7413,40,1
199120,4737,2177,2560,41,4
199120,800,400,400,42,1
199120,363,184,179,43,1
199120,3,3,0,44,1
199120,360,181,179,45,1
199120,437,216,221,51,1
199120,3937,1777,2160,52,3
199120,9,5,4,59,1
199120,351,176,175,60,1
199139,26571,13153,13418,1,4
199139,21503,11084,10419,2,1
199139,21400,11032,10368,3,1
199139,3087,1580,1507,4,1
199139,18313,9452,8861,5,1
199139,103,52,51,11,1
199139,5068,2069,2999,12,3
199139,2646,1348,1298,19,1
199139,15667,8104,7563,20,1
199139,20436,10544,9892,21,4
199139,18309,9549,8760,22,1
199139,18303,9547,8756,23,1
199139,3057,1571,1486,24,1
199139,15246,7976,7270,25,1
199139,6,2,4,31,1
199139,2127,995,1132,32,3
199139,2138,1135,1003,39,1
199139,13108,6841,6267,40,1
199139,6135,2609,3526,41,4
199139,3194,1535,1659,42,1
199139,3097,1485,1612,43,1
199139,30,9,21,44,1
199139,3067,1476,1591,45,1
199139,97,50,47,51,1
199139,2941,1074,1867,52,3
199139,508,213,295,59,1
199139,2559,1263,1296,60,1
199148,18074,6149,11925,1,4
199148,14753,5103,9650,2,1
199148,14138,4881,9257,3,1
199148,2482,808,1674,4,1
199148,11656,4073,7583,5,1
199148,615,222,393,11,1
199148,3321,1046,2275,12,3
199148,1523,557,966,19,1
199148,10133,3516,6617,20,1
199148,13858,4698,9160,21,4
199148,12469,4302,8167,22,1
199148,12350,4262,8088,23,1
199148,2467,798,1669,24,1
199148,9883,3464,6419,25,1
199148,119,40,79,31,1
199148,1389,396,993,32,3
199148,1200,459,741,39,1
199148,8683,3005,5678,40,1
199148,4216,1451,2765,41,4
199148,2284,801,1483,42,1
199148,1788,619,1169,43,1
199148,15,10,5,44,1
199148,1773,609,1164,45,1
199148,496,182,314,51,1
199148,1932,650,1282,52,3
199148,323,98,225,59,1
199148,1450,511,939,60,1
199157,8093,2637,5456,1,4
199157,6220,2055,4165,2,1
199157,5876,1944,3932,3,1
199157,933,315,618,4,1
199157,4943,1629,3314,5,1
199157,344,111,233,11,1
199157,1873,582,1291,12,3
199157,495,159,336,19,1
199157,4448,1470,2978,20,1
199157,6550,2215,4335,21,4
199157,5297,1784,3513,22,1
199157,5200,1753,3447,23,1
199157,922,311,611,24,1
199157,4278,1442,2836,25,1
199157,97,31,66,31,1
199157,1253,431,822,32,3
199157,392,133,259,39,1
199157,3886,1309,2577,40,1
199157,1543,422,1121,41,4
199157,923,271,652,42,1
199157,676,191,485,43,1
199157,11,4,7,44,1
199157,665,187,478,45,1
199157,247,80,167,51,1
199157,620,151,469,52,3
199157,103,26,77,59,1
199157,562,161,401,60,1
199184,912,504,408,1,4
199184,797,442,355,2,1
199184,792,439,353,3,1
199184,212,102,110,4,1
199184,580,337,243,5,1
199184,5,3,2,11,1
199184,115,62,53,12,3
199184,49,28,21,19,1
199184,531,309,222,20,1
199184,895,496,399,21,4
199184,781,434,347,22,1
199184,781,434,347,23,1
199184,210,102,108,24,1
199184,571,332,239,25,1
199184,114,62,52,32,3
199184,49,28,21,39,1
199184,522,304,218,40,1
199184,17,8,9,41,4
199184,16,8,8,42,1
199184,11,5,6,43,1
199184,2,0,2,44,1
199184,9,5,4,45,1
199184,5,3,2,51,1
199184,1,0,1,52,3
199184,9,5,4,60,1
199193,34009,18913,15096,1,4
199193,24536,13761,10775,2,1
199193,22977,12939,10038,3,1
199193,4307,2348,1959,4,1
199193,18670,10591,8079,5,1
199193,1559,822,737,11,1
199193,9473,5152,4321,12,3
199193,1215,680,535,19,1
199193,17455,9911,7544,20,1
199193,26770,14775,11995,21,4
199193,21469,11953,9516,22,1
199193,21330,11883,9447,23,1
199193,4298,2342,1956,24,1
199193,17032,9541,7491,25,1
199193,139,70,69,31,1
199193,5301,2822,2479,32,3
199193,1102,611,491,39,1
199193,15930,8930,7000,40,1
199193,7239,4138,3101,41,4
199193,3067,1808,1259,42,1
199193,1647,1056,591,43,1
199193,9,6,3,44,1
199193,1638,1050,588,45,1
199193,1420,752,668,51,1
199193,4172,2330,1842,52,3
199193,113,69,44,59,1
199193,1525,981,544,60,1
199209,1602,655,947,1,4
199209,1602,655,947,2,1
199209,1602,655,947,3,1
199209,231,152,79,4,1
199209,1371,503,868,5,1
199209,39,16,23,19,1
199209,1332,487,845,20,1
199209,1232,535,697,21,4
199209,1232,535,697,22,1
199209,1232,535,697,23,1
199209,228,151,77,24,1
199209,1004,384,620,25,1
199209,30,14,16,39,1
199209,974,370,604,40,1
199209,370,120,250,41,4
199209,370,120,250,42,1
199209,370,120,250,43,1
199209,3,1,2,44,1
199209,367,119,248,45,1
199209,9,2,7,59,1
199209,358,117,241,60,1
199218,13937,5430,8507,1,4
199218,12447,4982,7465,2,1
199218,12178,4882,7296,3,1
199218,1939,704,1235,4,1
199218,10239,4178,6061,5,1
199218,269,100,169,11,1
199218,1490,448,1042,12,3
199218,1687,691,996,19,1
199218,8552,3487,5065,20,1
199218,12001,4736,7265,21,4
199218,11408,4566,6842,22,1
199218,11333,4547,6786,23,1
199218,1935,703,1232,24,1
199218,9398,3844,5554,25,1
199218,75,19,56,31,1
199218,593,170,423,32,3
199218,1503,637,866,39,1
199218,7895,3207,4688,40,1
199218,1936,694,1242,41,4
199218,1039,416,623,42,1
199218,845,335,510,43,1
199218,4,1,3,44,1
199218,841,334,507,45,1
199218,194,81,113,51,1
199218,897,278,619,52,3
199218,184,54,130,59,1
199218,657,280,377,60,1
199263,597,255,342,1,4
199263,597,255,342,2,1
199263,355,162,193,3,1
199263,101,71,30,4,1
199263,254,91,163,5,1
199263,242,93,149,11,1
199263,100,31,69,19,1
199263,154,60,94,20,1
199263,201,95,106,21,4
199263,201,95,106,22,1
199263,171,88,83,23,1
199263,55,39,16,24,1
199263,116,49,67,25,1
199263,30,7,23,31,1
199263,41,14,27,39,1
199263,75,35,40,40,1
199263,396,160,236,41,4
199263,396,160,236,42,1
199263,184,74,110,43,1
199263,46,32,14,44,1
199263,138,42,96,45,1
199263,212,86,126,51,1
199263,59,17,42,59,1
199263,79,25,54,60,1
199272,1007,290,717,1,4
199272,1007,290,717,2,1
199272,999,290,709,3,1
199272,317,125,192,4,1
199272,682,165,517,5,1
199272,8,0,8,11,1
199272,188,59,129,19,1
199272,494,106,388,20,1
199272,875,262,613,21,4
199272,875,262,613,22,1
199272,867,262,605,23,1
199272,311,123,188,24,1
199272,556,139,417,25,1
199272,8,0,8,31,1
199272,133,48,85,39,1
199272,423,91,332,40,1
199272,132,28,104,41,4
199272,132,28,104,42,1
199272,132,28,104,43,1
199272,6,2,4,44,1
199272,126,26,100,45,1
199272,55,11,44,59,1
199272,71,15,56,60,1
199281,6222,2296,3926,1,4
199281,5429,2066,3363,2,1
199281,5184,2021,3163,3,1
199281,1050,450,600,4,1
199281,4134,1571,2563,5,1
199281,245,45,200,11,1
199281,793,230,563,12,3
199281,496,172,324,19,1
199281,3638,1399,2239,20,1
199281,4485,1820,2665,21,4
199281,4230,1765,2465,22,1
199281,4204,1751,2453,23,1
199281,1033,444,589,24,1
199281,3171,1307,1864,25,1
199281,26,14,12,31,1
199281,255,55,200,32,3
199281,379,137,242,39,1
199281,2792,1170,1622,40,1
199281,1737,476,1261,41,4
199281,1199,301,898,42,1
199281,980,270,710,43,1
199281,17,6,11,44,1
199281,963,264,699,45,1
199281,219,31,188,51,1
199281,538,175,363,52,3
199281,117,35,82,59,1
199281,846,229,617,60,1
199306,1860,617,1243,1,4
199306,951,377,574,2,1
199306,947,376,571,3,1
199306,234,112,122,4,1
199306,713,264,449,5,1
199306,4,1,3,11,1
199306,909,240,669,12,3
199306,99,40,59,19,1
199306,614,224,390,20,1
199306,1041,386,655,21,4
199306,856,350,506,22,1
199306,856,350,506,23,1
199306,231,111,120,24,1
199306,625,239,386,25,1
199306,185,36,149,32,3
199306,78,30,48,39,1
199306,547,209,338,40,1
199306,819,231,588,41,4
199306,95,27,68,42,1
199306,91,26,65,43,1
199306,3,1,2,44,1
199306,88,25,63,45,1
199306,4,1,3,51,1
199306,724,204,520,52,3
199306,21,10,11,59,1
199306,67,15,52,60,1
199315,384,253,131,1,4
199315,197,114,83,2,1
199315,197,114,83,3,1
199315,33,17,16,4,1
199315,164,97,67,5,1
199315,187,139,48,12,3
199315,26,17,9,19,1
199315,138,80,58,20,1
199315,177,111,66,21,4
199315,149,86,63,22,1
199315,149,86,63,23,1
199315,31,16,15,24,1
199315,118,70,48,25,1
199315,28,25,3,32,3
199315,19,11,8,39,1
199315,99,59,40,40,1
199315,207,142,65,41,4
199315,48,28,20,42,1
199315,48,28,20,43,1
199315,2,1,1,44,1
199315,46,27,19,45,1
199315,159,114,45,52,3
199315,7,6,1,59,1
199315,39,21,18,60,1
199324,1591,598,993,1,4
199324,1591,598,993,2,1
199324,1338,490,848,3,1
199324,214,115,99,4,1
199324,1124,375,749,5,1
199324,253,108,145,11,1
199324,170,50,120,19,1
199324,954,325,629,20,1
199324,699,278,421,21,4
199324,699,278,421,22,1
199324,694,278,416,23,1
199324,144,83,61,24,1
199324,550,195,355,25,1
199324,5,0,5,31,1
199324,55,18,37,39,1
199324,495,177,318,40,1
199324,892,320,572,41,4
199324,892,320,572,42,1
199324,644,212,432,43,1
199324,70,32,38,44,1
199324,574,180,394,45,1
199324,248,108,140,51,1
199324,115,32,83,59,1
199324,459,148,311,60,1
199333,8902,3517,5385,1,4
199333,8902,3517,5385,2,1
199333,8055,3205,4850,3,1
199333,1481,703,778,4,1
199333,6574,2502,4072,5,1
199333,847,312,535,11,1
199333,2291,857,1434,19,1
199333,4283,1645,2638,20,1
199333,4670,1963,2707,21,4
199333,4670,1963,2707,22,1
199333,4642,1947,2695,23,1
199333,1038,509,529,24,1
199333,3604,1438,2166,25,1
199333,28,16,12,31,1
199333,1173,474,699,39,1
199333,2431,964,1467,40,1
199333,4232,1554,2678,41,4
199333,4232,1554,2678,42,1
199333,3413,1258,2155,43,1
199333,443,194,249,44,1
199333,2970,1064,1906,45,1
199333,819,296,523,51,1
199333,1118,383,735,59,1
199333,1852,681,1171,60,1
199412,2285,669,1616,1,4
199412,1734,486,1248,2,1
199412,1703,474,1229,3,1
199412,316,100,216,4,1
199412,1387,374,1013,5,1
199412,31,12,19,11,1
199412,551,183,368,12,3
199412,163,51,112,19,1
199412,1224,323,901,20,1
199412,1579,490,1089,21,4
199412,1410,411,999,22,1
199412,1405,408,997,23,1
199412,315,100,215,24,1
199412,1090,308,782,25,1
199412,5,3,2,31,1
199412,169,79,90,32,3
199412,107,37,70,39,1
199412,983,271,712,40,1
199412,706,179,527,41,4
199412,324,75,249,42,1
199412,298,66,232,43,1
199412,1,0,1,44,1
199412,297,66,231,45,1
199412,26,9,17,51,1
199412,382,104,278,52,3
199412,56,14,42,59,1
199412,241,52,189,60,1
199421,3024,1093,1931,1,4
199421,3024,1093,1931,2,1
199421,2783,1003,1780,3,1
199421,647,271,376,4,1
199421,2136,732,1404,5,1
199421,241,90,151,11,1
199421,114,35,79,19,1
199421,2022,697,1325,20,1
199421,1155,450,705,21,4
199421,1155,450,705,22,1
199421,1151,449,702,23,1
199421,291,128,163,24,1
199421,860,321,539,25,1
199421,4,1,3,31,1
199421,44,15,29,39,1
199421,816,306,510,40,1
199421,1869,643,1226,41,4
199421,1869,643,1226,42,1
199421,1632,554,1078,43,1
199421,356,143,213,44,1
199421,1276,411,865,45,1
199421,237,89,148,51,1
199421,70,20,50,59,1
199421,1206,391,815,60,1
199449,2664,873,1791,1,4
199449,2664,873,1791,2,1
199449,2048,670,1378,3,1
199449,474,218,256,4,1
199449,1574,452,1122,5,1
199449,616,203,413,11,1
199449,143,46,97,19,1
199449,1431,406,1025,20,1
199449,1112,386,726,21,4
199449,1112,386,726,22,1
199449,1053,367,686,23,1
199449,224,95,129,24,1
199449,829,272,557,25,1
199449,59,19,40,31,1
199449,76,32,44,39,1
199449,753,240,513,40,1
199449,1552,487,1065,41,4
199449,1552,487,1065,42,1
199449,995,303,692,43,1
199449,250,123,127,44,1
199449,745,180,565,45,1
199449,557,184,373,51,1
199449,67,14,53,59,1
199449,678,166,512,60,1
199458,162,77,85,1,4
199458,162,77,85,2,1
199458,161,76,85,3,1
199458,40,13,27,4,1
199458,121,63,58,5,1
199458,1,1,0,11,1
199458,25,12,13,19,1
199458,96,51,45,20,1
199458,129,58,71,21,4
199458,129,58,71,22,1
199458,129,58,71,23,1
199458,38,13,25,24,1
199458,91,45,46,25,1
199458,18,10,8,39,1
199458,73,35,38,40,1
199458,33,19,14,41,4
199458,33,19,14,42,1
199458,32,18,14,43,1
199458,2,0,2,44,1
199458,30,18,12,45,1
199458,1,1,0,51,1
199458,7,2,5,59,1
199458,23,16,7,60,1
199467,933,287,646,1,4
199467,933,287,646,2,1
199467,881,270,611,3,1
199467,145,54,91,4,1
199467,736,216,520,5,1
199467,52,17,35,11,1
199467,135,38,97,19,1
199467,601,178,423,20,1
199467,422,139,283,21,4
199467,422,139,283,22,1
199467,401,134,267,23,1
199467,76,25,51,24,1
199467,325,109,216,25,1
199467,21,5,16,31,1
199467,87,23,64,39,1
199467,238,86,152,40,1
199467,511,148,363,41,4
199467,511,148,363,42,1
199467,480,136,344,43,1
199467,69,29,40,44,1
199467,411,107,304,45,1
199467,31,12,19,51,1
199467,48,15,33,59,1
199467,363,92,271,60,1
199476,2260,703,1557,1,4
199476,2260,703,1557,2,1
199476,2062,637,1425,3,1
199476,418,176,242,4,1
199476,1644,461,1183,5,1
199476,198,66,132,11,1
199476,419,119,300,19,1
199476,1225,342,883,20,1
199476,876,348,528,21,4
199476,876,348,528,22,1
199476,843,333,510,23,1
199476,193,93,100,24,1
199476,650,240,410,25,1
199476,33,15,18,31,1
199476,181,65,116,39,1
199476,469,175,294,40,1
199476,1384,355,1029,41,4
199476,1384,355,1029,42,1
199476,1219,304,915,43,1
199476,225,83,142,44,1
199476,994,221,773,45,1
199476,165,51,114,51,1
199476,238,54,184,59,1
199476,756,167,589,60,1
199485,1854,743,1111,1,4
199485,1854,743,1111,2,1
199485,1810,728,1082,3,1
199485,443,212,231,4,1
199485,1367,516,851,5,1
199485,44,15,29,11,1
199485,117,64,53,19,1
199485,1250,452,798,20,1
199485,857,389,468,21,4
199485,857,389,468,22,1
199485,856,388,468,23,1
199485,258,134,124,24,1
199485,598,254,344,25,1
199485,1,1,0,31,1
199485,60,40,20,39,1
199485,538,214,324,40,1
199485,997,354,643,41,4
199485,997,354,643,42,1
199485,954,340,614,43,1
199485,185,78,107,44,1
199485,769,262,507,45,1
199485,43,14,29,51,1
199485,57,24,33,59,1
199485,712,238,474,60,1
199494,6731,2511,4220,1,4
199494,6731,2511,4220,2,1
199494,5842,2203,3639,3,1
199494,3520,1376,2144,4,1
199494,2322,827,1495,5,1
199494,889,308,581,11,1
199494,1026,388,638,19,1
199494,1296,439,857,20,1
199494,2610,1025,1585,21,4
199494,2610,1025,1585,22,1
199494,2400,942,1458,23,1
199494,1633,658,975,24,1
199494,767,284,483,25,1
199494,210,83,127,31,1
199494,337,136,201,39,1
199494,430,148,282,40,1
199494,4121,1486,2635,41,4
199494,4121,1486,2635,42,1
199494,3442,1261,2181,43,1
199494,1887,718,1169,44,1
199494,1555,543,1012,45,1
199494,679,225,454,51,1
199494,689,252,437,59,1
199494,866,291,575,60,1
199582,1299,655,644,1,4
199582,1299,655,644,2,1
199582,1299,655,644,3,1
199582,327,175,152,4,1
199582,972,480,492,5,1
199582,48,33,15,19,1
199582,924,447,477,20,1
199582,1265,639,626,21,4
199582,1265,639,626,22,1
199582,1265,639,626,23,1
199582,323,172,151,24,1
199582,942,467,475,25,1
199582,46,32,14,39,1
199582,896,435,461,40,1
199582,34,16,18,41,4
199582,34,16,18,42,1
199582,34,16,18,43,1
199582,4,3,1,44,1
199582,30,13,17,45,1
199582,2,1,1,59,1
199582,28,12,16,60,1
199607,1187,67,1120,1,4
199607,979,45,934,2,1
199607,950,38,912,3,1
199607,181,1,180,4,1
199607,769,37,732,5,1
199607,29,7,22,11,1
199607,208,22,186,12,3
199607,81,11,70,19,1
199607,688,26,662,20,1
199607,845,25,820,21,4
199607,827,25,802,22,1
199607,824,24,800,23,1
199607,180,0,180,24,1
199607,644,24,620,25,1
199607,3,1,2,31,1
199607,18,0,18,32,3
199607,46,6,40,39,1
199607,598,18,580,40,1
199607,342,42,300,41,4
199607,152,20,132,42,1
199607,126,14,112,43,1
199607,1,1,0,44,1
199607,125,13,112,45,1
199607,26,6,20,51,1
199607,190,22,168,52,3
199607,35,5,30,59,1
199607,90,8,82,60,1
199625,1538,472,1066,1,4
199625,1538,472,1066,2,1
199625,1342,402,940,3,1
199625,229,85,144,4,1
199625,1113,317,796,5,1
199625,196,70,126,11,1
199625,144,24,120,19,1
199625,969,293,676,20,1
199625,723,221,502,21,4
199625,723,221,502,22,1
199625,634,195,439,23,1
199625,165,58,107,24,1
199625,469,137,332,25,1
199625,89,26,63,31,1
199625,57,10,47,39,1
199625,412,127,285,40,1
199625,815,251,564,41,4
199625,815,251,564,42,1
199625,708,207,501,43,1
199625,64,27,37,44,1
199625,644,180,464,45,1
199625,107,44,63,51,1
199625,87,14,73,59,1
199625,557,166,391,60,1
199634,4158,1461,2697,1,4
199634,4158,1461,2697,2,1
199634,3378,1190,2188,3,1
199634,677,302,375,4,1
199634,2701,888,1813,5,1
199634,780,271,509,11,1
199634,1172,338,834,19,1
199634,1529,550,979,20,1
199634,1973,778,1195,21,4
199634,1973,778,1195,22,1
199634,1882,739,1143,23,1
199634,478,224,254,24,1
199634,1404,515,889,25,1
199634,91,39,52,31,1
199634,578,196,382,39,1
199634,826,319,507,40,1
199634,2185,683,1502,41,4
199634,2185,683,1502,42,1
199634,1496,451,1045,43,1
199634,199,78,121,44,1
199634,1297,373,924,45,1
199634,689,232,457,51,1
199634,594,142,452,59,1
199634,703,231,472,60,1
199643,2062,908,1154,1,4
199643,1923,851,1072,2,1
199643,1923,851,1072,3,1
199643,537,266,271,4,1
199643,1386,585,801,5,1
199643,139,57,82,12,3
199643,95,47,48,19,1
199643,1291,538,753,20,1
199643,1875,844,1031,21,4
199643,1784,799,985,22,1
199643,1784,799,985,23,1
199643,534,264,270,24,1
199643,1250,535,715,25,1
199643,91,45,46,32,3
199643,87,42,45,39,1
199643,1163,493,670,40,1
199643,187,64,123,41,4
199643,139,52,87,42,1
199643,139,52,87,43,1
199643,3,2,1,44,1
199643,136,50,86,45,1
199643,48,12,36,52,3
199643,8,5,3,59,1
199643,128,45,83,60,1
199689,189,5,184,1,4
199689,189,5,184,2,1
199689,189,5,184,3,1
199689,28,1,27,4,1
199689,161,4,157,5,1
199689,161,4,157,20,1
199689,140,4,136,21,4
199689,140,4,136,22,1
199689,140,4,136,23,1
199689,26,1,25,24,1
199689,114,3,111,25,1
199689,114,3,111,40,1
199689,49,1,48,41,4
199689,49,1,48,42,1
199689,49,1,48,43,1
199689,2,0,2,44,1
199689,47,1,46,45,1
199689,47,1,46,60,1
199698,635,295,340,1,4
199698,595,281,314,2,1
199698,573,271,302,3,1
199698,178,97,81,4,1
199698,395,174,221,5,1
199698,22,10,12,11,1
199698,40,14,26,12,3
199698,92,45,47,19,1
199698,303,129,174,20,1
199698,592,284,308,21,4
199698,558,272,286,22,1
199698,546,266,280,23,1
199698,178,97,81,24,1
199698,368,169,199,25,1
199698,12,6,6,31,1
199698,34,12,22,32,3
199698,84,43,41,39,1
199698,284,126,158,40,1
199698,43,11,32,41,4
199698,37,9,28,42,1
199698,27,5,22,43,1
199698,27,5,22,45,1
199698,10,4,6,51,1
199698,6,2,4,52,3
199698,8,2,6,59,1
199698,19,3,16,60,1
199713,97,9,88,1,4
199713,97,9,88,2,1
199713,97,9,88,3,1
199713,25,3,22,4,1
199713,72,6,66,5,1
199713,72,6,66,20,1
199713,96,9,87,21,4
199713,96,9,87,22,1
199713,96,9,87,23,1
199713,25,3,22,24,1
199713,71,6,65,25,1
199713,71,6,65,40,1
199713,1,0,1,41,4
199713,1,0,1,42,1
199713,1,0,1,43,1
199713,1,0,1,45,1
199713,1,0,1,60,1
199722,1402,474,928,1,4
199722,1402,474,928,2,1
199722,1146,384,762,3,1
199722,248,125,123,4,1
199722,898,259,639,5,1
199722,256,90,166,11,1
199722,40,13,27,19,1
199722,858,246,612,20,1
199722,766,283,483,21,4
199722,766,283,483,22,1
199722,709,257,452,23,1
199722,174,92,82,24,1
199722,535,165,370,25,1
199722,57,26,31,31,1
199722,28,11,17,39,1
199722,507,154,353,40,1
199722,636,191,445,41,4
199722,636,191,445,42,1
199722,437,127,310,43,1
199722,74,33,41,44,1
199722,363,94,269,45,1
199722,199,64,135,51,1
199722,12,2,10,59,1
199722,351,92,259,60,1
199731,2242,920,1322,1,4
199731,2242,920,1322,2,1
199731,1597,612,985,3,1
199731,239,118,121,4,1
199731,1358,494,864,5,1
199731,645,308,337,11,1
199731,479,203,276,19,1
199731,879,291,588,20,1
199731,937,386,551,21,4
199731,937,386,551,22,1
199731,805,326,479,23,1
199731,143,67,76,24,1
199731,662,259,403,25,1
199731,132,60,72,31,1
199731,220,99,121,39,1
199731,442,160,282,40,1
199731,1305,534,771,41,4
199731,1305,534,771,42,1
199731,792,286,506,43,1
199731,96,51,45,44,1
199731,696,235,461,45,1
199731,513,248,265,51,1
199731,259,104,155,59,1
199731,437,131,306,60,1
199740,2885,896,1989,1,4
199740,2885,896,1989,2,1
199740,2384,749,1635,3,1
199740,399,173,226,4,1
199740,1985,576,1409,5,1
199740,501,147,354,11,1
199740,652,177,475,19,1
199740,1333,399,934,20,1
199740,1072,403,669,21,4
199740,1072,403,669,22,1
199740,1040,388,652,23,1
199740,258,124,134,24,1
199740,782,264,518,25,1
199740,32,15,17,31,1
199740,242,78,164,39,1
199740,540,186,354,40,1
199740,1813,493,1320,41,4
199740,1813,493,1320,42,1
199740,1344,361,983,43,1
199740,141,49,92,44,1
199740,1203,312,891,45,1
199740,469,132,337,51,1
199740,410,99,311,59,1
199740,793,213,580,60,1
199759,2604,1926,678,1,4
199759,574,301,273,2,1
199759,543,289,254,3,1
199759,78,49,29,4,1
199759,465,240,225,5,1
199759,31,12,19,11,1
199759,2030,1625,405,12,3
199759,49,34,15,19,1
199759,416,206,210,20,1
199759,1454,1156,298,21,4
199759,238,150,88,22,1
199759,237,149,88,23,1
199759,54,29,25,24,1
199759,183,120,63,25,1
199759,1,1,0,31,1
199759,1216,1006,210,32,3
199759,37,27,10,39,1
199759,146,93,53,40,1
199759,1150,770,380,41,4
199759,336,151,185,42,1
199759,306,140,166,43,1
199759,24,20,4,44,1
199759,282,120,162,45,1
199759,30,11,19,51,1
199759,814,619,195,52,3
199759,12,7,5,59,1
199759,270,113,157,60,1
199768,3454,1354,2100,1,4
199768,3454,1354,2100,2,1
199768,2492,1011,1481,3,1
199768,500,250,250,4,1
199768,1992,761,1231,5,1
199768,962,343,619,11,1
199768,257,84,173,19,1
199768,1735,677,1058,20,1
199768,1640,677,963,21,4
199768,1640,677,963,22,1
199768,1494,621,873,23,1
199768,366,178,188,24,1
199768,1128,443,685,25,1
199768,146,56,90,31,1
199768,105,43,62,39,1
199768,1023,400,623,40,1
199768,1814,677,1137,41,4
199768,1814,677,1137,42,1
199768,998,390,608,43,1
199768,134,72,62,44,1
199768,864,318,546,45,1
199768,816,287,529,51,1
199768,152,41,111,59,1
199768,712,277,435,60,1
199786,4161,1478,2683,1,4
199786,4161,1478,2683,2,1
199786,3960,1408,2552,3,1
199786,587,258,329,4,1
199786,3373,1150,2223,5,1
199786,201,70,131,11,1
199786,742,238,504,19,1
199786,2631,912,1719,20,1
199786,1877,712,1165,21,4
199786,1877,712,1165,22,1
199786,1856,705,1151,23,1
199786,392,177,215,24,1
199786,1464,528,936,25,1
199786,21,7,14,31,1
199786,260,105,155,39,1
199786,1204,423,781,40,1
199786,2284,766,1518,41,4
199786,2284,766,1518,42,1
199786,2104,703,1401,43,1
199786,195,81,114,44,1
199786,1909,622,1287,45,1
199786,180,63,117,51,1
199786,482,133,349,59,1
199786,1427,489,938,60,1
199795,1412,517,895,1,4
199795,1412,517,895,2,1
199795,949,317,632,3,1
199795,147,77,70,4,1
199795,802,240,562,5,1
199795,463,200,263,11,1
199795,169,49,120,19,1
199795,633,191,442,20,1
199795,654,220,434,21,4
199795,654,220,434,22,1
199795,603,203,400,23,1
199795,118,59,59,24,1
199795,485,144,341,25,1
199795,51,17,34,31,1
199795,94,29,65,39,1
199795,391,115,276,40,1
199795,758,297,461,41,4
199795,758,297,461,42,1
199795,346,114,232,43,1
199795,29,18,11,44,1
199795,317,96,221,45,1
199795,412,183,229,51,1
199795,75,20,55,59,1
199795,242,76,166,60,1
199838,4008,1347,2661,1,4
199838,4008,1347,2661,2,1
199838,3863,1302,2561,3,1
199838,757,299,458,4,1
199838,3106,1003,2103,5,1
199838,145,45,100,11,1
199838,157,57,100,19,1
199838,2949,946,2003,20,1
199838,1087,388,699,21,4
199838,1087,388,699,22,1
199838,1081,384,697,23,1
199838,190,77,113,24,1
199838,891,307,584,25,1
199838,6,4,2,31,1
199838,43,16,27,39,1
199838,848,291,557,40,1
199838,2921,959,1962,41,4
199838,2921,959,1962,42,1
199838,2782,918,1864,43,1
199838,567,222,345,44,1
199838,2215,696,1519,45,1
199838,139,41,98,51,1
199838,114,41,73,59,1
199838,2101,655,1446,60,1
199847,7602,3787,3815,1,4
199847,4823,2307,2516,2,1
199847,4812,2304,2508,3,1
199847,1230,586,644,4,1
199847,3582,1718,1864,5,1
199847,11,3,8,11,1
199847,2779,1480,1299,12,3
199847,35,15,20,19,1
199847,3547,1703,1844,20,1
199847,7375,3689,3686,21,4
199847,4756,2265,2491,22,1
199847,4752,2264,2488,23,1
199847,1230,586,644,24,1
199847,3522,1678,1844,25,1
199847,4,1,3,31,1
199847,2619,1424,1195,32,3
199847,35,15,20,39,1
199847,3487,1663,1824,40,1
199847,227,98,129,41,4
199847,67,42,25,42,1
199847,60,40,20,43,1
199847,60,40,20,45,1
199847,7,2,5,51,1
199847,160,56,104,52,3
199847,60,40,20,60,1
199856,19160,8630,10530,1,4
199856,19160,8630,10530,2,1
199856,18020,8239,9781,3,1
199856,3723,1957,1766,4,1
199856,14297,6282,8015,5,1
199856,1140,391,749,11,1
199856,5389,2231,3158,19,1
199856,8908,4051,4857,20,1
199856,5986,2997,2989,21,4
199856,5986,2997,2989,22,1
199856,5893,2963,2930,23,1
199856,1629,890,739,24,1
199856,4264,2073,2191,25,1
199856,93,34,59,31,1
199856,1491,705,786,39,1
199856,2773,1368,1405,40,1
199856,13174,5633,7541,41,4
199856,13174,5633,7541,42,1
199856,12127,5276,6851,43,1
199856,2094,1067,1027,44,1
199856,10033,4209,5824,45,1
199856,1047,357,690,51,1
199856,3898,1526,2372,59,1
199856,6135,2683,3452,60,1
199865,893,334,559,1,4
199865,830,320,510,2,1
199865,821,315,506,3,1
199865,220,71,149,4,1
199865,601,244,357,5,1
199865,9,5,4,11,1
199865,63,14,49,12,3
199865,71,27,44,19,1
199865,530,217,313,20,1
199865,887,330,557,21,4
199865,824,316,508,22,1
199865,818,313,505,23,1
199865,220,71,149,24,1
199865,598,242,356,25,1
199865,6,3,3,31,1
199865,63,14,49,32,3
199865,71,27,44,39,1
199865,527,215,312,40,1
199865,6,4,2,41,4
199865,6,4,2,42,1
199865,3,2,1,43,1
199865,3,2,1,45,1
199865,3,2,1,51,1
199865,3,2,1,60,1
199883,138,13,125,1,4
199883,138,13,125,2,1
199883,138,13,125,3,1
199883,138,13,125,5,1
199883,138,13,125,20,1
199883,138,13,125,21,4
199883,138,13,125,22,1
199883,138,13,125,23,1
199883,138,13,125,25,1
199883,138,13,125,40,1
199892,3837,1533,2304,1,4
199892,3837,1533,2304,2,1
199892,3235,1281,1954,3,1
199892,655,296,359,4,1
199892,2580,985,1595,5,1
199892,602,252,350,11,1
199892,1002,332,670,19,1
199892,1578,653,925,20,1
199892,1813,783,1030,21,4
199892,1813,783,1030,22,1
199892,1742,744,998,23,1
199892,440,208,232,24,1
199892,1302,536,766,25,1
199892,71,39,32,31,1
199892,503,185,318,39,1
199892,799,351,448,40,1
199892,2024,750,1274,41,4
199892,2024,750,1274,42,1
199892,1493,537,956,43,1
199892,215,88,127,44,1
199892,1278,449,829,45,1
199892,531,213,318,51,1
199892,499,147,352,59,1
199892,779,302,477,60,1
199908,2352,907,1445,1,4
199908,2352,907,1445,2,1
199908,2047,797,1250,3,1
199908,460,208,252,4,1
199908,1587,589,998,5,1
199908,305,110,195,11,1
199908,421,145,276,19,1
199908,1166,444,722,20,1
199908,1242,501,741,21,4
199908,1242,501,741,22,1
199908,1176,471,705,23,1
199908,319,146,173,24,1
199908,857,325,532,25,1
199908,66,30,36,31,1
199908,231,84,147,39,1
199908,626,241,385,40,1
199908,1110,406,704,41,4
199908,1110,406,704,42,1
199908,871,326,545,43,1
199908,141,62,79,44,1
199908,730,264,466,45,1
199908,239,80,159,51,1
199908,190,61,129,59,1
199908,540,203,337,60,1
199926,2753,1226,1527,1,4
199926,2753,1226,1527,2,1
199926,2102,916,1186,3,1
199926,433,226,207,4,1
199926,1669,690,979,5,1
199926,651,310,341,11,1
199926,258,111,147,19,1
199926,1411,579,832,20,1
199926,1500,688,812,21,4
199926,1500,688,812,22,1
199926,1438,664,774,23,1
199926,354,194,160,24,1
199926,1084,470,614,25,1
199926,62,24,38,31,1
199926,124,68,56,39,1
199926,960,402,558,40,1
199926,1253,538,715,41,4
199926,1253,538,715,42,1
199926,664,252,412,43,1
199926,79,32,47,44,1
199926,585,220,365,45,1
199926,589,286,303,51,1
199926,134,43,91,59,1
199926,451,177,274,60,1
199953,2117,699,1418,1,4
199953,2117,699,1418,2,1
199953,1694,552,1142,3,1
199953,257,108,149,4,1
199953,1437,444,993,5,1
199953,423,147,276,11,1
199953,432,111,321,19,1
199953,1005,333,672,20,1
199953,1072,382,690,21,4
199953,1072,382,690,22,1
199953,1057,376,681,23,1
199953,201,89,112,24,1
199953,856,287,569,25,1
199953,15,6,9,31,1
199953,223,68,155,39,1
199953,633,219,414,40,1
199953,1045,317,728,41,4
199953,1045,317,728,42,1
199953,637,176,461,43,1
199953,56,19,37,44,1
199953,581,157,424,45,1
199953,408,141,267,51,1
199953,209,43,166,59,1
199953,372,114,258,60,1
199962,3002,1205,1797,1,4
199962,2009,824,1185,2,1
199962,2002,819,1183,3,1
199962,642,275,367,4,1
199962,1360,544,816,5,1
199962,7,5,2,11,1
199962,993,381,612,12,3
199962,109,44,65,19,1
199962,1251,500,751,20,1
199962,2457,985,1472,21,4
199962,1953,798,1155,22,1
199962,1952,798,1154,23,1
199962,642,275,367,24,1
199962,1310,523,787,25,1
199962,1,0,1,31,1
199962,504,187,317,32,3
199962,98,39,59,39,1
199962,1212,484,728,40,1
199962,545,220,325,41,4
199962,56,26,30,42,1
199962,50,21,29,43,1
199962,50,21,29,45,1
199962,6,5,1,51,1
199962,489,194,295,52,3
199962,11,5,6,59,1
199962,39,16,23,60,1
199971,53,26,27,1,4
199971,36,18,18,2,1
199971,36,18,18,3,1
199971,2,2,0,4,1
199971,34,16,18,5,1
199971,17,8,9,12,3
199971,2,0,2,19,1
199971,32,16,16,20,1
199971,53,26,27,21,4
199971,36,18,18,22,1
199971,36,18,18,23,1
199971,2,2,0,24,1
199971,34,16,18,25,1
199971,17,8,9,32,3
199971,2,0,2,39,1
199971,32,16,16,40,1
199980,60,56,4,1,4
199980,60,56,4,2,1
199980,60,56,4,3,1
199980,17,16,1,4,1
199980,43,40,3,5,1
199980,43,40,3,20,1
199980,60,56,4,21,4
199980,60,56,4,22,1
199980,60,56,4,23,1
199980,17,16,1,24,1
199980,43,40,3,25,1
199980,43,40,3,40,1
199999,5399,1555,3844,1,4
199999,4938,1432,3506,2,1
199999,4877,1405,3472,3,1
199999,728,219,509,4,1
199999,4149,1186,2963,5,1
199999,61,27,34,11,1
199999,461,123,338,12,3
199999,620,153,467,19,1
199999,3529,1033,2496,20,1
199999,4614,1338,3276,21,4
199999,4317,1260,3057,22,1
199999,4316,1259,3057,23,1
199999,724,218,506,24,1
199999,3592,1041,2551,25,1
199999,1,1,0,31,1
199999,297,78,219,32,3
199999,478,131,347,39,1
199999,3114,910,2204,40,1
199999,785,217,568,41,4
199999,621,172,449,42,1
199999,561,146,415,43,1
199999,4,1,3,44,1
199999,557,145,412,45,1
199999,60,26,34,51,1
199999,164,45,119,52,3
199999,142,22,120,59,1
199999,415,123,292,60,1
200004,10107,4365,5742,1,4
200004,8448,3806,4642,2,1
200004,8238,3752,4486,3,1
200004,1621,678,943,4,1
200004,6617,3074,3543,5,1
200004,210,54,156,11,1
200004,1659,559,1100,12,3
200004,851,391,460,19,1
200004,5766,2683,3083,20,1
200004,7750,3463,4287,21,4
200004,7081,3252,3829,22,1
200004,7045,3240,3805,23,1
200004,1614,676,938,24,1
200004,5431,2564,2867,25,1
200004,36,12,24,31,1
200004,669,211,458,32,3
200004,540,281,259,39,1
200004,4891,2283,2608,40,1
200004,2357,902,1455,41,4
200004,1367,554,813,42,1
200004,1193,512,681,43,1
200004,7,2,5,44,1
200004,1186,510,676,45,1
200004,174,42,132,51,1
200004,990,348,642,52,3
200004,311,110,201,59,1
200004,875,400,475,60,1
200013,964,271,693,1,4
200013,964,271,693,2,1
200013,923,248,675,3,1
200013,60,22,38,4,1
200013,863,226,637,5,1
200013,41,23,18,11,1
200013,162,38,124,19,1
200013,701,188,513,20,1
200013,526,128,398,21,4
200013,526,128,398,22,1
200013,526,128,398,23,1
200013,46,16,30,24,1
200013,480,112,368,25,1
200013,119,23,96,39,1
200013,361,89,272,40,1
200013,438,143,295,41,4
200013,438,143,295,42,1
200013,397,120,277,43,1
200013,14,6,8,44,1
200013,383,114,269,45,1
200013,41,23,18,51,1
200013,43,15,28,59,1
200013,340,99,241,60,1
200022,4062,2282,1780,1,4
200022,4062,2282,1780,2,1
200022,3233,1885,1348,3,1
200022,907,520,387,4,1
200022,2326,1365,961,5,1
200022,829,397,432,11,1
200022,281,181,100,19,1
200022,2045,1184,861,20,1
200022,2365,1388,977,21,4
200022,2365,1388,977,22,1
200022,2339,1367,972,23,1
200022,847,491,356,24,1
200022,1492,876,616,25,1
200022,26,21,5,31,1
200022,208,135,73,39,1
200022,1284,741,543,40,1
200022,1697,894,803,41,4
200022,1697,894,803,42,1
200022,894,518,376,43,1
200022,60,29,31,44,1
200022,834,489,345,45,1
200022,803,376,427,51,1
200022,73,46,27,59,1
200022,761,443,318,60,1
200059,1449,571,878,1,4
200059,1449,571,878,2,1
200059,1257,497,760,3,1
200059,165,89,76,4,1
200059,1092,408,684,5,1
200059,192,74,118,11,1
200059,127,44,83,19,1
200059,965,364,601,20,1
200059,1018,427,591,21,4
200059,1018,427,591,22,1
200059,1001,425,576,23,1
200059,163,89,74,24,1
200059,838,336,502,25,1
200059,17,2,15,31,1
200059,89,36,53,39,1
200059,749,300,449,40,1
200059,431,144,287,41,4
200059,431,144,287,42,1
200059,256,72,184,43,1
200059,2,0,2,44,1
200059,254,72,182,45,1
200059,175,72,103,51,1
200059,38,8,30,59,1
200059,216,64,152,60,1
200086,203,67,136,1,4
200086,203,67,136,2,1
200086,181,64,117,3,1
200086,41,16,25,4,1
200086,140,48,92,5,1
200086,22,3,19,11,1
200086,23,12,11,19,1
200086,117,36,81,20,1
200086,128,49,79,21,4
200086,128,49,79,22,1
200086,122,49,73,23,1
200086,31,13,18,24,1
200086,91,36,55,25,1
200086,6,0,6,31,1
200086,12,7,5,39,1
200086,79,29,50,40,1
200086,75,18,57,41,4
200086,75,18,57,42,1
200086,59,15,44,43,1
200086,10,3,7,44,1
200086,49,12,37,45,1
200086,16,3,13,51,1
200086,11,5,6,59,1
200086,38,7,31,60,1
200110,69,0,69,1,4
200110,69,0,69,2,1
200110,69,0,69,3,1
200110,39,0,39,4,1
200110,30,0,30,5,1
200110,30,0,30,20,1
200110,69,0,69,21,4
200110,69,0,69,22,1
200110,69,0,69,23,1
200110,39,0,39,24,1
200110,30,0,30,25,1
200110,30,0,30,40,1
200129,53,2,51,1,4
200129,53,2,51,2,1
200129,53,2,51,3,1
200129,31,2,29,4,1
200129,22,0,22,5,1
200129,22,0,22,20,1
200129,53,2,51,21,4
200129,53,2,51,22,1
200129,53,2,51,23,1
200129,31,2,29,24,1
200129,22,0,22,25,1
200129,22,0,22,40,1
200156,997,466,531,1,4
200156,955,449,506,2,1
200156,923,440,483,3,1
200156,262,126,136,4,1
200156,661,314,347,5,1
200156,32,9,23,11,1
200156,42,17,25,12,3
200156,64,39,25,19,1
200156,597,275,322,20,1
200156,923,432,491,21,4
200156,882,416,466,22,1
200156,878,416,462,23,1
200156,257,124,133,24,1
200156,621,292,329,25,1
200156,4,0,4,31,1
200156,41,16,25,32,3
200156,60,38,22,39,1
200156,561,254,307,40,1
200156,74,34,40,41,4
200156,73,33,40,42,1
200156,45,24,21,43,1
200156,5,2,3,44,1
200156,40,22,18,45,1
200156,28,9,19,51,1
200156,1,1,0,52,3
200156,4,1,3,59,1
200156,36,21,15,60,1
200165,63,2,61,1,4
200165,63,2,61,2,1
200165,63,2,61,3,1
200165,13,1,12,4,1
200165,50,1,49,5,1
200165,50,1,49,20,1
200165,63,2,61,21,4
200165,63,2,61,22,1
200165,63,2,61,23,1
200165,13,1,12,24,1
200165,50,1,49,25,1
200165,50,1,49,40,1
200192,1898,798,1100,1,4
200192,1898,798,1100,2,1
200192,661,265,396,3,1
200192,206,101,105,4,1
200192,455,164,291,5,1
200192,1237,533,704,11,1
200192,96,31,65,19,1
200192,359,133,226,20,1
200192,486,214,272,21,4
200192,486,214,272,22,1
200192,465,207,258,23,1
200192,190,94,96,24,1
200192,275,113,162,25,1
200192,21,7,14,31,1
200192,52,19,33,39,1
200192,223,94,129,40,1
200192,1412,584,828,41,4
200192,1412,584,828,42,1
200192,196,58,138,43,1
200192,16,7,9,44,1
200192,180,51,129,45,1
200192,1216,526,690,51,1
200192,44,12,32,59,1
200192,136,39,97,60,1
200208,254,102,152,1,4
200208,254,102,152,2,1
200208,229,95,134,3,1
200208,41,25,16,4,1
200208,188,70,118,5,1
200208,25,7,18,11,1
200208,2,0,2,19,1
200208,186,70,116,20,1
200208,159,71,88,21,4
200208,159,71,88,22,1
200208,159,71,88,23,1
200208,34,21,13,24,1
200208,125,50,75,25,1
200208,2,0,2,39,1
200208,123,50,73,40,1
200208,95,31,64,41,4
200208,95,31,64,42,1
200208,70,24,46,43,1
200208,7,4,3,44,1
200208,63,20,43,45,1
200208,25,7,18,51,1
200208,63,20,43,60,1
200217,2910,1005,1905,1,4
200217,2044,729,1315,2,1
200217,1865,679,1186,3,1
200217,423,153,270,4,1
200217,1442,526,916,5,1
200217,179,50,129,11,1
200217,866,276,590,12,3
200217,182,70,112,19,1
200217,1260,456,804,20,1
200217,1744,614,1130,21,4
200217,1637,582,1055,22,1
200217,1624,576,1048,23,1
200217,423,153,270,24,1
200217,1201,423,778,25,1
200217,13,6,7,31,1
200217,107,32,75,32,3
200217,162,68,94,39,1
200217,1039,355,684,40,1
200217,1166,391,775,41,4
200217,407,147,260,42,1
200217,241,103,138,43,1
200217,241,103,138,45,1
200217,166,44,122,51,1
200217,759,244,515,52,3
200217,20,2,18,59,1
200217,221,101,120,60,1
200226,1065,458,607,1,4
200226,1036,452,584,2,1
200226,763,345,418,3,1
200226,134,79,55,4,1
200226,629,266,363,5,1
200226,273,107,166,11,1
200226,29,6,23,12,3
200226,98,39,59,19,1
200226,531,227,304,20,1
200226,587,301,286,21,4
200226,587,301,286,22,1
200226,586,300,286,23,1
200226,132,79,53,24,1
200226,454,221,233,25,1
200226,1,1,0,31,1
200226,60,31,29,39,1
200226,394,190,204,40,1
200226,478,157,321,41,4
200226,449,151,298,42,1
200226,177,45,132,43,1
200226,2,0,2,44,1
200226,175,45,130,45,1
200226,272,106,166,51,1
200226,29,6,23,52,3
200226,38,8,30,59,1
200226,137,37,100,60,1
200244,136,15,121,1,4
200244,136,15,121,2,1
200244,136,15,121,3,1
200244,136,15,121,5,1
200244,38,5,33,19,1
200244,98,10,88,20,1
200244,94,9,85,21,4
200244,94,9,85,22,1
200244,94,9,85,23,1
200244,94,9,85,25,1
200244,94,9,85,40,1
200244,42,6,36,41,4
200244,42,6,36,42,1
200244,42,6,36,43,1
200244,42,6,36,45,1
200244,38,5,33,59,1
200244,4,1,3,60,1
200253,3533,1344,2189,1,4
200253,3254,1254,2000,2,1
200253,2693,982,1711,3,1
200253,397,154,243,4,1
200253,2296,828,1468,5,1
200253,561,272,289,11,1
200253,279,90,189,12,3
200253,320,115,205,19,1
200253,1976,713,1263,20,1
200253,2273,826,1447,21,4
200253,2151,788,1363,22,1
200253,2140,785,1355,23,1
200253,349,134,215,24,1
200253,1791,651,1140,25,1
200253,11,3,8,31,1
200253,122,38,84,32,3
200253,243,90,153,39,1
200253,1548,561,987,40,1
200253,1260,518,742,41,4
200253,1103,466,637,42,1
200253,553,197,356,43,1
200253,48,20,28,44,1
200253,505,177,328,45,1
200253,550,269,281,51,1
200253,157,52,105,52,3
200253,77,25,52,59,1
200253,428,152,276,60,1
200262,7,6,1,1,4
200262,7,6,1,2,1
200262,7,6,1,3,1
200262,2,2,0,4,1
200262,5,4,1,5,1
200262,5,4,1,20,1
200262,7,6,1,21,4
200262,7,6,1,22,1
200262,7,6,1,23,1
200262,2,2,0,24,1
200262,5,4,1,25,1
200262,5,4,1,40,1
200280,15143,8018,7125,1,4
200280,11724,6640,5084,2,1
200280,11182,6339,4843,3,1
200280,1908,1057,851,4,1
200280,9274,5282,3992,5,1
200280,542,301,241,11,1
200280,3419,1378,2041,12,3
200280,824,514,310,19,1
200280,8450,4768,3682,20,1
200280,11160,5925,5235,21,4
200280,9385,5126,4259,22,1
200280,9312,5082,4230,23,1
200280,1888,1045,843,24,1
200280,7424,4037,3387,25,1
200280,73,44,29,31,1
200280,1775,799,976,32,3
200280,540,322,218,39,1
200280,6884,3715,3169,40,1
200280,3983,2093,1890,41,4
200280,2339,1514,825,42,1
200280,1870,1257,613,43,1
200280,20,12,8,44,1
200280,1850,1245,605,45,1
200280,469,257,212,51,1
200280,1644,579,1065,52,3
200280,284,192,92,59,1
200280,1566,1053,513,60,1
200305,3168,1694,1474,1,4
200305,3168,1694,1474,2,1
200305,2119,1239,880,3,1
200305,796,538,258,4,1
200305,1323,701,622,5,1
200305,1049,455,594,11,1
200305,139,63,76,19,1
200305,1184,638,546,20,1
200305,1712,1094,618,21,4
200305,1712,1094,618,22,1
200305,1704,1090,614,23,1
200305,740,517,223,24,1
200305,964,573,391,25,1
200305,8,4,4,31,1
200305,110,55,55,39,1
200305,854,518,336,40,1
200305,1456,600,856,41,4
200305,1456,600,856,42,1
200305,415,149,266,43,1
200305,56,21,35,44,1
200305,359,128,231,45,1
200305,1041,451,590,51,1
200305,29,8,21,59,1
200305,330,120,210,60,1
200314,793,391,402,1,4
200314,793,391,402,2,1
200314,470,202,268,3,1
200314,231,117,114,4,1
200314,239,85,154,5,1
200314,323,189,134,11,1
200314,66,29,37,19,1
200314,173,56,117,20,1
200314,367,182,185,21,4
200314,367,182,185,22,1
200314,367,182,185,23,1
200314,195,109,86,24,1
200314,172,73,99,25,1
200314,50,27,23,39,1
200314,122,46,76,40,1
200314,426,209,217,41,4
200314,426,209,217,42,1
200314,103,20,83,43,1
200314,36,8,28,44,1
200314,67,12,55,45,1
200314,323,189,134,51,1
200314,16,2,14,59,1
200314,51,10,41,60,1
200332,14629,7956,6673,1,4
200332,11948,6676,5272,2,1
200332,11629,6512,5117,3,1
200332,2553,1407,1146,4,1
200332,9076,5105,3971,5,1
200332,319,164,155,11,1
200332,2681,1280,1401,12,3
200332,644,364,280,19,1
200332,8432,4741,3691,20,1
200332,11798,6617,5181,21,4
200332,10707,6076,4631,22,1
200332,10662,6046,4616,23,1
200332,2524,1394,1130,24,1
200332,8138,4652,3486,25,1
200332,45,30,15,31,1
200332,1091,541,550,32,3
200332,577,332,245,39,1
200332,7561,4320,3241,40,1
200332,2831,1339,1492,41,4
200332,1241,600,641,42,1
200332,967,466,501,43,1
200332,29,13,16,44,1
200332,938,453,485,45,1
200332,274,134,140,51,1
200332,1590,739,851,52,3
200332,67,32,35,59,1
200332,871,421,450,60,1
200341,909,339,570,1,4
200341,909,339,570,2,1
200341,558,204,354,3,1
200341,156,86,70,4,1
200341,402,118,284,5,1
200341,351,135,216,11,1
200341,90,29,61,19,1
200341,312,89,223,20,1
200341,430,180,250,21,4
200341,430,180,250,22,1
200341,405,175,230,23,1
200341,138,83,55,24,1
200341,267,92,175,25,1
200341,25,5,20,31,1
200341,56,23,33,39,1
200341,211,69,142,40,1
200341,479,159,320,41,4
200341,479,159,320,42,1
200341,153,29,124,43,1
200341,18,3,15,44,1
200341,135,26,109,45,1
200341,326,130,196,51,1
200341,34,6,28,59,1
200341,101,20,81,60,1
200387,56,1,55,1,4
200387,56,1,55,2,1
200387,56,1,55,3,1
200387,7,0,7,4,1
200387,49,1,48,5,1
200387,49,1,48,20,1
200387,56,1,55,21,4
200387,56,1,55,22,1
200387,56,1,55,23,1
200387,7,0,7,24,1
200387,49,1,48,25,1
200387,49,1,48,40,1
200466,279,114,165,1,4
200466,279,114,165,2,1
200466,264,110,154,3,1
200466,81,51,30,4,1
200466,183,59,124,5,1
200466,15,4,11,11,1
200466,16,6,10,19,1
200466,167,53,114,20,1
200466,194,76,118,21,4
200466,194,76,118,22,1
200466,194,76,118,23,1
200466,45,24,21,24,1
200466,149,52,97,25,1
200466,15,5,10,39,1
200466,134,47,87,40,1
200466,85,38,47,41,4
200466,85,38,47,42,1
200466,70,34,36,43,1
200466,36,27,9,44,1
200466,34,7,27,45,1
200466,15,4,11,51,1
200466,1,1,0,59,1
200466,33,6,27,60,1
200484,198,121,77,1,4
200484,198,121,77,2,1
200484,195,119,76,3,1
200484,53,33,20,4,1
200484,142,86,56,5,1
200484,3,2,1,11,1
200484,9,6,3,19,1
200484,133,80,53,20,1
200484,160,104,56,21,4
200484,160,104,56,22,1
200484,160,104,56,23,1
200484,43,29,14,24,1
200484,117,75,42,25,1
200484,8,5,3,39,1
200484,109,70,39,40,1
200484,38,17,21,41,4
200484,38,17,21,42,1
200484,35,15,20,43,1
200484,10,4,6,44,1
200484,25,11,14,45,1
200484,3,2,1,51,1
200484,1,1,0,59,1
200484,24,10,14,60,1
200527,602,227,375,1,4
200527,602,227,375,2,1
200527,537,205,332,3,1
200527,120,53,67,4,1
200527,417,152,265,5,1
200527,65,22,43,11,1
200527,9,3,6,19,1
200527,408,149,259,20,1
200527,483,187,296,21,4
200527,483,187,296,22,1
200527,482,187,295,23,1
200527,109,48,61,24,1
200527,373,139,234,25,1
200527,1,0,1,31,1
200527,9,3,6,39,1
200527,364,136,228,40,1
200527,119,40,79,41,4
200527,119,40,79,42,1
200527,55,18,37,43,1
200527,11,5,6,44,1
200527,44,13,31,45,1
200527,64,22,42,51,1
200527,44,13,31,60,1
200554,505,181,324,1,4
200554,505,181,324,2,1
200554,486,175,311,3,1
200554,114,58,56,4,1
200554,372,117,255,5,1
200554,19,6,13,11,1
200554,70,24,46,19,1
200554,302,93,209,20,1
200554,441,165,276,21,4
200554,441,165,276,22,1
200554,441,165,276,23,1
200554,112,57,55,24,1
200554,329,108,221,25,1
200554,67,24,43,39,1
200554,262,84,178,40,1
200554,64,16,48,41,4
200554,64,16,48,42,1
200554,45,10,35,43,1
200554,2,1,1,44,1
200554,43,9,34,45,1
200554,19,6,13,51,1
200554,3,0,3,59,1
200554,40,9,31,60,1
200572,1366,583,783,1,4
200572,1211,534,677,2,1
200572,924,452,472,3,1
200572,185,98,87,4,1
200572,739,354,385,5,1
200572,287,82,205,11,1
200572,155,49,106,12,3
200572,111,54,57,19,1
200572,628,300,328,20,1
200572,761,378,383,21,4
200572,759,378,381,22,1
200572,701,368,333,23,1
200572,159,87,72,24,1
200572,542,281,261,25,1
200572,58,10,48,31,1
200572,2,0,2,32,3
200572,71,40,31,39,1
200572,471,241,230,40,1
200572,605,205,400,41,4
200572,452,156,296,42,1
200572,223,84,139,43,1
200572,26,11,15,44,1
200572,197,73,124,45,1
200572,229,72,157,51,1
200572,153,49,104,52,3
200572,40,14,26,59,1
200572,157,59,98,60,1
200590,161,71,90,1,4
200590,161,71,90,2,1
200590,161,71,90,3,1
200590,25,20,5,4,1
200590,136,51,85,5,1
200590,16,9,7,19,1
200590,120,42,78,20,1
200590,105,19,86,21,4
200590,105,19,86,22,1
200590,105,19,86,23,1
200590,6,2,4,24,1
200590,99,17,82,25,1
200590,7,1,6,39,1
200590,92,16,76,40,1
200590,56,52,4,41,4
200590,56,52,4,42,1
200590,56,52,4,43,1
200590,19,18,1,44,1
200590,37,34,3,45,1
200590,9,8,1,59,1
200590,28,26,2,60,1
200624,38,19,19,1,4
200624,38,19,19,2,1
200624,38,19,19,3,1
200624,9,4,5,4,1
200624,29,15,14,5,1
200624,2,1,1,19,1
200624,27,14,13,20,1
200624,33,17,16,21,4
200624,33,17,16,22,1
200624,33,17,16,23,1
200624,9,4,5,24,1
200624,24,13,11,25,1
200624,2,1,1,39,1
200624,22,12,10,40,1
200624,5,2,3,41,4
200624,5,2,3,42,1
200624,5,2,3,43,1
200624,5,2,3,45,1
200624,5,2,3,60,1
200633,243,47,196,1,4
200633,243,47,196,2,1
200633,243,47,196,3,1
200633,80,15,65,4,1
200633,163,32,131,5,1
200633,6,1,5,19,1
200633,157,31,126,20,1
200633,144,30,114,21,4
200633,144,30,114,22,1
200633,144,30,114,23,1
200633,53,11,42,24,1
200633,91,19,72,25,1
200633,3,1,2,39,1
200633,88,18,70,40,1
200633,99,17,82,41,4
200633,99,17,82,42,1
200633,99,17,82,43,1
200633,27,4,23,44,1
200633,72,13,59,45,1
200633,3,0,3,59,1
200633,69,13,56,60,1
200697,853,749,104,1,4
200697,853,749,104,12,3
200697,638,562,76,21,4
200697,638,562,76,32,3
200697,215,187,28,41,4
200697,215,187,28,52,3
200785,302,51,251,1,4
200785,302,51,251,2,1
200785,298,49,249,3,1
200785,35,5,30,4,1
200785,263,44,219,5,1
200785,4,2,2,11,1
200785,20,1,19,19,1
200785,243,43,200,20,1
200785,191,34,157,21,4
200785,191,34,157,22,1
200785,191,34,157,23,1
200785,31,5,26,24,1
200785,160,29,131,25,1
200785,18,1,17,39,1
200785,142,28,114,40,1
200785,111,17,94,41,4
200785,111,17,94,42,1
200785,107,15,92,43,1
200785,4,0,4,44,1
200785,103,15,88,45,1
200785,4,2,2,51,1
200785,2,0,2,59,1
200785,101,15,86,60,1
200800,24932,12640,12292,1,4
200800,20477,10696,9781,2,1
200800,19022,10042,8980,3,1
200800,3802,2013,1789,4,1
200800,15220,8029,7191,5,1
200800,1455,654,801,11,1
200800,4455,1944,2511,12,3
200800,849,459,390,19,1
200800,14371,7570,6801,20,1
200800,18340,9662,8678,21,4
200800,15870,8414,7456,22,1
200800,15456,8204,7252,23,1
200800,3589,1916,1673,24,1
200800,11867,6288,5579,25,1
200800,414,210,204,31,1
200800,2470,1248,1222,32,3
200800,665,379,286,39,1
200800,11202,5909,5293,40,1
200800,6592,2978,3614,41,4
200800,4607,2282,2325,42,1
200800,3566,1838,1728,43,1
200800,213,97,116,44,1
200800,3353,1741,1612,45,1
200800,1041,444,597,51,1
200800,1985,696,1289,52,3
200800,184,80,104,59,1
200800,3169,1661,1508,60,1
200828,34,5,29,1,4
200828,34,5,29,2,1
200828,34,5,29,3,1
200828,30,4,26,4,1
200828,4,1,3,5,1
200828,4,1,3,20,1
200828,34,5,29,21,4
200828,34,5,29,22,1
200828,34,5,29,23,1
200828,30,4,26,24,1
200828,4,1,3,25,1
200828,4,1,3,40,1
200846,2020,818,1202,1,4
200846,2020,818,1202,2,1
200846,1409,578,831,3,1
200846,375,166,209,4,1
200846,1034,412,622,5,1
200846,611,240,371,11,1
200846,87,28,59,19,1
200846,947,384,563,20,1
200846,885,386,499,21,4
200846,885,386,499,22,1
200846,775,337,438,23,1
200846,283,128,155,24,1
200846,492,209,283,25,1
200846,110,49,61,31,1
200846,45,15,30,39,1
200846,447,194,253,40,1
200846,1135,432,703,41,4
200846,1135,432,703,42,1
200846,634,241,393,43,1
200846,92,38,54,44,1
200846,542,203,339,45,1
200846,501,191,310,51,1
200846,42,13,29,59,1
200846,500,190,310,60,1
200873,43,17,26,1,4
200873,43,17,26,2,1
200873,37,14,23,3,1
200873,15,4,11,4,1
200873,22,10,12,5,1
200873,6,3,3,11,1
200873,2,1,1,19,1
200873,20,9,11,20,1
200873,31,9,22,21,4
200873,31,9,22,22,1
200873,31,9,22,23,1
200873,15,4,11,24,1
200873,16,5,11,25,1
200873,2,1,1,39,1
200873,14,4,10,40,1
200873,12,8,4,41,4
200873,12,8,4,42,1
200873,6,5,1,43,1
200873,6,5,1,45,1
200873,6,3,3,51,1
200873,6,5,1,60,1
201016,180,62,118,1,4
201016,180,62,118,2,1
201016,180,62,118,3,1
201016,16,3,13,4,1
201016,164,59,105,5,1
201016,164,59,105,20,1
201016,162,55,107,21,4
201016,162,55,107,22,1
201016,162,55,107,23,1
201016,16,3,13,24,1
201016,146,52,94,25,1
201016,146,52,94,40,1
201016,18,7,11,41,4
201016,18,7,11,42,1
201016,18,7,11,43,1
201016,18,7,11,45,1
201016,18,7,11,60,1
201034,654,297,357,1,4
201034,654,297,357,2,1
201034,506,268,238,3,1
201034,438,222,216,4,1
201034,68,46,22,5,1
201034,148,29,119,11,1
201034,68,46,22,20,1
201034,229,112,117,21,4
201034,229,112,117,22,1
201034,229,112,117,23,1
201034,161,66,95,24,1
201034,68,46,22,25,1
201034,68,46,22,40,1
201034,425,185,240,41,4
201034,425,185,240,42,1
201034,277,156,121,43,1
201034,277,156,121,44,1
201034,148,29,119,51,1
201061,215,91,124,1,4
201061,207,88,119,2,1
201061,206,87,119,3,1
201061,55,22,33,4,1
201061,151,65,86,5,1
201061,1,1,0,11,1
201061,8,3,5,12,3
201061,10,4,6,19,1
201061,141,61,80,20,1
201061,201,84,117,21,4
201061,193,81,112,22,1
201061,193,81,112,23,1
201061,54,21,33,24,1
201061,139,60,79,25,1
201061,8,3,5,32,3
201061,7,2,5,39,1
201061,132,58,74,40,1
201061,14,7,7,41,4
201061,14,7,7,42,1
201061,13,6,7,43,1
201061,1,1,0,44,1
201061,12,5,7,45,1
201061,1,1,0,51,1
201061,3,2,1,59,1
201061,9,3,6,60,1
201098,74,24,50,1,4
201098,74,24,50,2,1
201098,74,24,50,3,1
201098,70,22,48,4,1
201098,4,2,2,5,1
201098,4,2,2,20,1
201098,58,22,36,21,4
201098,58,22,36,22,1
201098,58,22,36,23,1
201098,56,20,36,24,1
201098,2,2,0,25,1
201098,2,2,0,40,1
201098,16,2,14,41,4
201098,16,2,14,42,1
201098,16,2,14,43,1
201098,14,2,12,44,1
201098,2,0,2,45,1
201098,2,0,2,60,1
201104,5979,2598,3381,1,4
201104,3198,1555,1643,2,1
201104,3118,1529,1589,3,1
201104,623,243,380,4,1
201104,2495,1286,1209,5,1
201104,80,26,54,11,1
201104,2781,1043,1738,12,3
201104,153,40,113,19,1
201104,2342,1246,1096,20,1
201104,3444,1382,2062,21,4
201104,2389,920,1469,22,1
201104,2371,915,1456,23,1
201104,621,242,379,24,1
201104,1750,673,1077,25,1
201104,18,5,13,31,1
201104,1055,462,593,32,3
201104,118,36,82,39,1
201104,1632,637,995,40,1
201104,2535,1216,1319,41,4
201104,809,635,174,42,1
201104,747,614,133,43,1
201104,2,1,1,44,1
201104,745,613,132,45,1
201104,62,21,41,51,1
201104,1726,581,1145,52,3
201104,35,4,31,59,1
201104,710,609,101,60,1
201131,159,61,98,1,4
201131,159,61,98,2,1
201131,159,61,98,3,1
201131,137,53,84,4,1
201131,22,8,14,5,1
201131,22,8,14,20,1
201131,68,4,64,21,4
201131,68,4,64,22,1
201131,68,4,64,23,1
201131,57,2,55,24,1
201131,11,2,9,25,1
201131,11,2,9,40,1
201131,91,57,34,41,4
201131,91,57,34,42,1
201131,91,57,34,43,1
201131,80,51,29,44,1
201131,11,6,5,45,1
201131,11,6,5,60,1
201140,208,151,57,1,4
201140,96,66,30,2,1
201140,64,37,27,3,1
201140,27,16,11,4,1
201140,37,21,16,5,1
201140,32,29,3,11,1
201140,112,85,27,12,3
201140,37,21,16,20,1
201140,63,59,4,21,4
201140,63,59,4,32,3
201140,145,92,53,41,4
201140,96,66,30,42,1
201140,64,37,27,43,1
201140,27,16,11,44,1
201140,37,21,16,45,1
201140,32,29,3,51,1
201140,49,26,23,52,3
201140,37,21,16,60,1
201159,203,166,37,1,4
201159,203,166,37,2,1
201159,203,166,37,3,1
201159,161,142,19,4,1
201159,42,24,18,5,1
201159,42,24,18,20,1
201159,139,114,25,21,4
201159,139,114,25,22,1
201159,139,114,25,23,1
201159,111,102,9,24,1
201159,28,12,16,25,1
201159,28,12,16,40,1
201159,64,52,12,41,4
201159,64,52,12,42,1
201159,64,52,12,43,1
201159,50,40,10,44,1
201159,14,12,2,45,1
201159,14,12,2,60,1
201177,306,40,266,1,4
201177,306,40,266,2,1
201177,300,40,260,3,1
201177,5,1,4,4,1
201177,295,39,256,5,1
201177,6,0,6,11,1
201177,81,5,76,19,1
201177,214,34,180,20,1
201177,52,6,46,21,4
201177,52,6,46,22,1
201177,52,6,46,23,1
201177,2,1,1,24,1
201177,50,5,45,25,1
201177,28,2,26,39,1
201177,22,3,19,40,1
201177,254,34,220,41,4
201177,254,34,220,42,1
201177,248,34,214,43,1
201177,3,0,3,44,1
201177,245,34,211,45,1
201177,6,0,6,51,1
201177,53,3,50,59,1
201177,192,31,161,60,1
201195,4053,1794,2259,1,4
201195,3425,1536,1889,2,1
201195,3331,1499,1832,3,1
201195,765,367,398,4,1
201195,2566,1132,1434,5,1
201195,94,37,57,11,1
201195,628,258,370,12,3
201195,201,79,122,19,1
201195,2365,1053,1312,20,1
201195,3363,1543,1820,21,4
201195,3003,1395,1608,22,1
201195,2972,1381,1591,23,1
201195,762,367,395,24,1
201195,2210,1014,1196,25,1
201195,31,14,17,31,1
201195,360,148,212,32,3
201195,151,63,88,39,1
201195,2059,951,1108,40,1
201195,690,251,439,41,4
201195,422,141,281,42,1
201195,359,118,241,43,1
201195,3,0,3,44,1
201195,356,118,238,45,1
201195,63,23,40,51,1
201195,268,110,158,52,3
201195,50,16,34,59,1
201195,306,102,204,60,1
201283,1259,455,804,1,4
201283,1259,455,804,2,1
201283,1179,415,764,3,1
201283,226,97,129,4,1
201283,953,318,635,5,1
201283,80,40,40,11,1
201283,83,33,50,19,1
201283,870,285,585,20,1
201283,708,281,427,21,4
201283,708,281,427,22,1
201283,700,281,419,23,1
201283,175,78,97,24,1
201283,525,203,322,25,1
201283,8,0,8,31,1
201283,44,22,22,39,1
201283,481,181,300,40,1
201283,551,174,377,41,4
201283,551,174,377,42,1
201283,479,134,345,43,1
201283,51,19,32,44,1
201283,428,115,313,45,1
201283,72,40,32,51,1
201283,39,11,28,59,1
201283,389,104,285,60,1
201371,1146,571,575,1,4
201371,1053,531,522,2,1
201371,941,472,469,3,1
201371,250,151,99,4,1
201371,691,321,370,5,1
201371,112,59,53,11,1
201371,93,40,53,12,3
201371,44,22,22,19,1
201371,647,299,348,20,1
201371,920,485,435,21,4
201371,838,445,393,22,1
201371,837,445,392,23,1
201371,250,151,99,24,1
201371,587,294,293,25,1
201371,1,0,1,31,1
201371,82,40,42,32,3
201371,44,22,22,39,1
201371,543,272,271,40,1
201371,226,86,140,41,4
201371,215,86,129,42,1
201371,104,27,77,43,1
201371,104,27,77,45,1
201371,111,59,52,51,1
201371,11,0,11,52,3
201371,104,27,77,60,1
201399,356,154,202,1,4
201399,356,154,202,2,1
201399,356,154,202,3,1
201399,98,41,57,4,1
201399,258,113,145,5,1
201399,8,2,6,19,1
201399,250,111,139,20,1
201399,267,78,189,21,4
201399,267,78,189,22,1
201399,267,78,189,23,1
201399,78,23,55,24,1
201399,189,55,134,25,1
201399,7,1,6,39,1
201399,182,54,128,40,1
201399,89,76,13,41,4
201399,89,76,13,42,1
201399,89,76,13,43,1
201399,20,18,2,44,1
201399,69,58,11,45,1
201399,1,1,0,59,1
201399,68,57,11,60,1
201432,2441,843,1598,1,4
201432,2441,843,1598,2,1
201432,1721,581,1140,3,1
201432,408,169,239,4,1
201432,1313,412,901,5,1
201432,720,262,458,11,1
201432,133,32,101,19,1
201432,1180,380,800,20,1
201432,1236,447,789,21,4
201432,1236,447,789,22,1
201432,1112,405,707,23,1
201432,330,142,188,24,1
201432,782,263,519,25,1
201432,124,42,82,31,1
201432,75,18,57,39,1
201432,707,245,462,40,1
201432,1205,396,809,41,4
201432,1205,396,809,42,1
201432,609,176,433,43,1
201432,78,27,51,44,1
201432,531,149,382,45,1
201432,596,220,376,51,1
201432,58,14,44,59,1
201432,473,135,338,60,1
201441,16958,7298,9660,1,4
201441,14477,6333,8144,2,1
201441,14161,6214,7947,3,1
201441,3348,1381,1967,4,1
201441,10813,4833,5980,5,1
201441,316,119,197,11,1
201441,2481,965,1516,12,3
201441,674,326,348,19,1
201441,10139,4507,5632,20,1
201441,14764,6379,8385,21,4
201441,13387,5788,7599,22,1
201441,13329,5766,7563,23,1
201441,3330,1374,1956,24,1
201441,9999,4392,5607,25,1
201441,58,22,36,31,1
201441,1377,591,786,32,3
201441,571,267,304,39,1
201441,9428,4125,5303,40,1
201441,2194,919,1275,41,4
201441,1090,545,545,42,1
201441,832,448,384,43,1
201441,18,7,11,44,1
201441,814,441,373,45,1
201441,258,97,161,51,1
201441,1104,374,730,52,3
201441,103,59,44,59,1
201441,711,382,329,60,1
201469,662,81,581,1,4
201469,662,81,581,2,1
201469,662,81,581,3,1
201469,42,9,33,4,1
201469,620,72,548,5,1
201469,147,18,129,19,1
201469,473,54,419,20,1
201469,324,42,282,21,4
201469,324,42,282,22,1
201469,324,42,282,23,1
201469,33,6,27,24,1
201469,291,36,255,25,1
201469,95,10,85,39,1
201469,196,26,170,40,1
201469,338,39,299,41,4
201469,338,39,299,42,1
201469,338,39,299,43,1
201469,9,3,6,44,1
201469,329,36,293,45,1
201469,52,8,44,59,1
201469,277,28,249,60,1
201478,108,39,69,1,4
201478,108,39,69,2,1
201478,108,39,69,3,1
201478,108,39,69,4,1
201478,100,39,61,21,4
201478,100,39,61,22,1
201478,100,39,61,23,1
201478,100,39,61,24,1
201478,8,0,8,41,4
201478,8,0,8,42,1
201478,8,0,8,43,1
201478,8,0,8,44,1
201496,303,202,101,1,4
201496,303,202,101,2,1
201496,303,202,101,3,1
201496,207,144,63,4,1
201496,96,58,38,5,1
201496,96,58,38,20,1
201496,303,202,101,21,4
201496,303,202,101,22,1
201496,303,202,101,23,1
201496,207,144,63,24,1
201496,96,58,38,25,1
201496,96,58,38,40,1
201539,91,17,74,1,4
201539,91,17,74,2,1
201539,91,17,74,3,1
201539,45,9,36,4,1
201539,46,8,38,5,1
201539,46,8,38,20,1
201539,70,13,57,21,4
201539,70,13,57,22,1
201539,70,13,57,23,1
201539,38,7,31,24,1
201539,32,6,26,25,1
201539,32,6,26,40,1
201539,21,4,17,41,4
201539,21,4,17,42,1
201539,21,4,17,43,1
201539,7,2,5,44,1
201539,14,2,12,45,1
201539,14,2,12,60,1
201548,3628,1587,2041,1,4
201548,2788,1176,1612,2,1
201548,2647,1132,1515,3,1
201548,691,312,379,4,1
201548,1956,820,1136,5,1
201548,141,44,97,11,1
201548,840,411,429,12,3
201548,160,55,105,19,1
201548,1796,765,1031,20,1
201548,2980,1352,1628,21,4
201548,2481,1092,1389,22,1
201548,2417,1071,1346,23,1
201548,691,312,379,24,1
201548,1726,759,967,25,1
201548,64,21,43,31,1
201548,499,260,239,32,3
201548,116,47,69,39,1
201548,1610,712,898,40,1
201548,648,235,413,41,4
201548,307,84,223,42,1
201548,230,61,169,43,1
201548,230,61,169,45,1
201548,77,23,54,51,1
201548,341,151,190,52,3
201548,44,8,36,59,1
201548,186,53,133,60,1
201584,19,1,18,1,4
201584,19,1,18,2,1
201584,19,1,18,3,1
201584,4,1,3,4,1
201584,15,0,15,5,1
201584,15,0,15,20,1
201584,19,1,18,21,4
201584,19,1,18,22,1
201584,19,1,18,23,1
201584,4,1,3,24,1
201584,15,0,15,25,1
201584,15,0,15,40,1
201609,25,1,24,1,4
201609,25,1,24,2,1
201609,25,1,24,3,1
201609,18,1,17,4,1
201609,7,0,7,5,1
201609,7,0,7,20,1
201609,18,0,18,21,4
201609,18,0,18,22,1
201609,18,0,18,23,1
201609,13,0,13,24,1
201609,5,0,5,25,1
201609,5,0,5,40,1
201609,7,1,6,41,4
201609,7,1,6,42,1
201609,7,1,6,43,1
201609,5,1,4,44,1
201609,2,0,2,45,1
201609,2,0,2,60,1
201618,31,2,29,1,4
201618,31,2,29,2,1
201618,31,2,29,3,1
201618,11,1,10,4,1
201618,20,1,19,5,1
201618,20,1,19,20,1
201618,31,2,29,21,4
201618,31,2,29,22,1
201618,31,2,29,23,1
201618,11,1,10,24,1
201618,20,1,19,25,1
201618,20,1,19,40,1
201627,34,2,32,1,4
201627,34,2,32,2,1
201627,34,2,32,3,1
201627,9,0,9,4,1
201627,25,2,23,5,1
201627,25,2,23,20,1
201627,20,2,18,21,4
201627,20,2,18,22,1
201627,20,2,18,23,1
201627,5,0,5,24,1
201627,15,2,13,25,1
201627,15,2,13,40,1
201627,14,0,14,41,4
201627,14,0,14,42,1
201627,14,0,14,43,1
201627,4,0,4,44,1
201627,10,0,10,45,1
201627,10,0,10,60,1
201645,10325,5231,5094,1,4
201645,4661,2555,2106,2,1
201645,4551,2509,2042,3,1
201645,1252,664,588,4,1
201645,3299,1845,1454,5,1
201645,110,46,64,11,1
201645,5664,2676,2988,12,3
201645,60,28,32,19,1
201645,3239,1817,1422,20,1
201645,9270,4824,4446,21,4
201645,4528,2500,2028,22,1
201645,4501,2485,2016,23,1
201645,1252,664,588,24,1
201645,3249,1821,1428,25,1
201645,27,15,12,31,1
201645,4742,2324,2418,32,3
201645,57,28,29,39,1
201645,3192,1793,1399,40,1
201645,1055,407,648,41,4
201645,133,55,78,42,1
201645,50,24,26,43,1
201645,50,24,26,45,1
201645,83,31,52,51,1
201645,922,352,570,52,3
201645,3,0,3,59,1
201645,47,24,23,60,1
201654,3462,1608,1854,1,4
201654,3238,1531,1707,2,1
201654,3108,1471,1637,3,1
201654,781,368,413,4,1
201654,2327,1103,1224,5,1
201654,130,60,70,11,1
201654,224,77,147,12,3
201654,66,31,35,19,1
201654,2261,1072,1189,20,1
201654,3163,1484,1679,21,4
201654,3044,1439,1605,22,1
201654,3043,1438,1605,23,1
201654,779,367,412,24,1
201654,2264,1071,1193,25,1
201654,1,1,0,31,1
201654,119,45,74,32,3
201654,63,30,33,39,1
201654,2201,1041,1160,40,1
201654,299,124,175,41,4
201654,194,92,102,42,1
201654,65,33,32,43,1
201654,2,1,1,44,1
201654,63,32,31,45,1
201654,129,59,70,51,1
201654,105,32,73,52,3
201654,3,1,2,59,1
201654,60,31,29,60,1
201672,3648,1104,2544,1,4
201672,3648,1104,2544,2,1
201672,3370,1002,2368,3,1
201672,602,211,391,4,1
201672,2768,791,1977,5,1
201672,278,102,176,11,1
201672,418,135,283,19,1
201672,2350,656,1694,20,1
201672,995,368,627,21,4
201672,995,368,627,22,1
201672,977,364,613,23,1
201672,250,94,156,24,1
201672,727,270,457,25,1
201672,18,4,14,31,1
201672,143,60,83,39,1
201672,584,210,374,40,1
201672,2653,736,1917,41,4
201672,2653,736,1917,42,1
201672,2393,638,1755,43,1
201672,352,117,235,44,1
201672,2041,521,1520,45,1
201672,260,98,162,51,1
201672,275,75,200,59,1
201672,1766,446,1320,60,1
201681,123,10,113,1,4
201681,123,10,113,2,1
201681,123,10,113,3,1
201681,119,10,109,4,1
201681,4,0,4,5,1
201681,4,0,4,20,1
201681,123,10,113,21,4
201681,123,10,113,22,1
201681,123,10,113,23,1
201681,119,10,109,24,1
201681,4,0,4,25,1
201681,4,0,4,40,1
201690,2068,963,1105,1,4
201690,2036,949,1087,2,1
201690,2028,946,1082,3,1
201690,417,200,217,4,1
201690,1611,746,865,5,1
201690,8,3,5,11,1
201690,32,14,18,12,3
201690,161,68,93,19,1
201690,1450,678,772,20,1
201690,1840,875,965,21,4
201690,1840,875,965,22,1
201690,1839,875,964,23,1
201690,411,196,215,24,1
201690,1428,679,749,25,1
201690,1,0,1,31,1
201690,155,67,88,39,1
201690,1273,612,661,40,1
201690,228,88,140,41,4
201690,196,74,122,42,1
201690,189,71,118,43,1
201690,6,4,2,44,1
201690,183,67,116,45,1
201690,7,3,4,51,1
201690,32,14,18,52,3
201690,6,1,5,59,1
201690,177,66,111,60,1
201751,427,106,321,1,4
201751,427,106,321,2,1
201751,325,67,258,3,1
201751,71,19,52,4,1
201751,254,48,206,5,1
201751,102,39,63,11,1
201751,254,48,206,20,1
201751,213,54,159,21,4
201751,213,54,159,22,1
201751,178,41,137,23,1
201751,46,14,32,24,1
201751,132,27,105,25,1
201751,35,13,22,31,1
201751,132,27,105,40,1
201751,214,52,162,41,4
201751,214,52,162,42,1
201751,147,26,121,43,1
201751,25,5,20,44,1
201751,122,21,101,45,1
201751,67,26,41,51,1
201751,122,21,101,60,1
201803,154,12,142,1,4
201803,154,12,142,2,1
201803,154,12,142,3,1
201803,143,10,133,4,1
201803,11,2,9,5,1
201803,11,2,9,20,1
201803,105,10,95,21,4
201803,105,10,95,22,1
201803,105,10,95,23,1
201803,100,8,92,24,1
201803,5,2,3,25,1
201803,5,2,3,40,1
201803,49,2,47,41,4
201803,49,2,47,42,1
201803,49,2,47,43,1
201803,43,2,41,44,1
201803,6,0,6,45,1
201803,6,0,6,60,1
201821,535,65,470,1,4
201821,535,65,470,2,1
201821,535,65,470,3,1
201821,30,2,28,4,1
201821,505,63,442,5,1
201821,184,25,159,19,1
201821,321,38,283,20,1
201821,269,26,243,21,4
201821,269,26,243,22,1
201821,269,26,243,23,1
201821,28,2,26,24,1
201821,241,24,217,25,1
201821,95,12,83,39,1
201821,146,12,134,40,1
201821,266,39,227,41,4
201821,266,39,227,42,1
201821,266,39,227,43,1
201821,2,0,2,44,1
201821,264,39,225,45,1
201821,89,13,76,59,1
201821,175,26,149,60,1
201858,918,530,388,1,4
201858,676,363,313,2,1
201858,669,363,306,3,1
201858,111,60,51,4,1
201858,558,303,255,5,1
201858,7,0,7,11,1
201858,242,167,75,12,3
201858,69,28,41,19,1
201858,489,275,214,20,1
201858,716,409,307,21,4
201858,569,309,260,22,1
201858,567,309,258,23,1
201858,109,59,50,24,1
201858,458,250,208,25,1
201858,2,0,2,31,1
201858,147,100,47,32,3
201858,58,28,30,39,1
201858,400,222,178,40,1
201858,202,121,81,41,4
201858,107,54,53,42,1
201858,102,54,48,43,1
201858,2,1,1,44,1
201858,100,53,47,45,1
201858,5,0,5,51,1
201858,95,67,28,52,3
201858,11,0,11,59,1
201858,89,53,36,60,1
201867,81,27,54,1,4
201867,81,27,54,2,1
201867,81,27,54,3,1
201867,81,27,54,5,1
201867,46,20,26,19,1
201867,35,7,28,20,1
201867,81,27,54,21,4
201867,81,27,54,22,1
201867,81,27,54,23,1
201867,81,27,54,25,1
201867,46,20,26,39,1
201867,35,7,28,40,1
201885,34379,16079,18300,1,4
201885,23706,11812,11894,2,1
201885,23360,11642,11718,3,1
201885,4486,2409,2077,4,1
201885,18874,9233,9641,5,1
201885,346,170,176,11,1
201885,10673,4267,6406,12,3
201885,1168,453,715,19,1
201885,17706,8780,8926,20,1
201885,25873,13312,12561,21,4
201885,20332,10699,9633,22,1
201885,20278,10668,9610,23,1
201885,4431,2396,2035,24,1
201885,15847,8272,7575,25,1
201885,54,31,23,31,1
201885,5541,2613,2928,32,3
201885,807,367,440,39,1
201885,15040,7905,7135,40,1
201885,8506,2767,5739,41,4
201885,3374,1113,2261,42,1
201885,3082,974,2108,43,1
201885,55,13,42,44,1
201885,3027,961,2066,45,1
201885,292,139,153,51,1
201885,5132,1654,3478,52,3
201885,361,86,275,59,1
201885,2666,875,1791,60,1
201928,11167,5654,5513,1,4
201928,11167,5654,5513,2,1
201928,9787,4920,4867,3,1
201928,1825,1026,799,4,1
201928,7962,3894,4068,5,1
201928,1380,734,646,11,1
201928,784,424,360,19,1
201928,7178,3470,3708,20,1
201928,4157,2289,1868,21,4
201928,4157,2289,1868,22,1
201928,4085,2243,1842,23,1
201928,1143,660,483,24,1
201928,2942,1583,1359,25,1
201928,72,46,26,31,1
201928,397,242,155,39,1
201928,2545,1341,1204,40,1
201928,7010,3365,3645,41,4
201928,7010,3365,3645,42,1
201928,5702,2677,3025,43,1
201928,682,366,316,44,1
201928,5020,2311,2709,45,1
201928,1308,688,620,51,1
201928,387,182,205,59,1
201928,4633,2129,2504,60,1
201946,3461,1489,1972,1,4
201946,3446,1485,1961,2,1
201946,3015,1307,1708,3,1
201946,782,359,423,4,1
201946,2233,948,1285,5,1
201946,431,178,253,11,1
201946,15,4,11,12,3
201946,237,100,137,19,1
201946,1996,848,1148,20,1
201946,2091,946,1145,21,4
201946,2083,944,1139,22,1
201946,1942,879,1063,23,1
201946,668,307,361,24,1
201946,1274,572,702,25,1
201946,141,65,76,31,1
201946,8,2,6,32,3
201946,167,80,87,39,1
201946,1107,492,615,40,1
201946,1370,543,827,41,4
201946,1363,541,822,42,1
201946,1073,428,645,43,1
201946,114,52,62,44,1
201946,959,376,583,45,1
201946,290,113,177,51,1
201946,7,2,5,52,3
201946,70,20,50,59,1
201946,889,356,533,60,1
201955,4816,1980,2836,1,4
201955,4796,1974,2822,2,1
201955,4550,1864,2686,3,1
201955,1085,459,626,4,1
201955,3465,1405,2060,5,1
201955,246,110,136,11,1
201955,20,6,14,12,3
201955,362,170,192,19,1
201955,3103,1235,1868,20,1
201955,2967,1291,1676,21,4
201955,2966,1290,1676,22,1
201955,2903,1258,1645,23,1
201955,921,393,528,24,1
201955,1982,865,1117,25,1
201955,63,32,31,31,1
201955,1,1,0,32,3
201955,246,122,124,39,1
201955,1736,743,993,40,1
201955,1849,689,1160,41,4
201955,1830,684,1146,42,1
201955,1647,606,1041,43,1
201955,164,66,98,44,1
201955,1483,540,943,45,1
201955,183,78,105,51,1
201955,19,5,14,52,3
201955,116,48,68,59,1
201955,1367,492,875,60,1
201964,3711,1482,2229,1,4
201964,3528,1392,2136,2,1
201964,3155,1256,1899,3,1
201964,719,310,409,4,1
201964,2436,946,1490,5,1
201964,373,136,237,11,1
201964,183,90,93,12,3
201964,309,127,182,19,1
201964,2127,819,1308,20,1
201964,1859,742,1117,21,4
201964,1748,691,1057,22,1
201964,1727,685,1042,23,1
201964,362,163,199,24,1
201964,1365,522,843,25,1
201964,21,6,15,31,1
201964,111,51,60,32,3
201964,153,63,90,39,1
201964,1212,459,753,40,1
201964,1852,740,1112,41,4
201964,1780,701,1079,42,1
201964,1428,571,857,43,1
201964,357,147,210,44,1
201964,1071,424,647,45,1
201964,352,130,222,51,1
201964,72,39,33,52,3
201964,156,64,92,59,1
201964,915,360,555,60,1
201973,5653,1989,3664,1,4
201973,5653,1989,3664,2,1
201973,4824,1652,3172,3,1
201973,783,356,427,4,1
201973,4041,1296,2745,5,1
201973,829,337,492,11,1
201973,828,312,516,19,1
201973,3213,984,2229,20,1
201973,1693,657,1036,21,4
201973,1693,657,1036,22,1
201973,1609,623,986,23,1
201973,289,127,162,24,1
201973,1320,496,824,25,1
201973,84,34,50,31,1
201973,279,117,162,39,1
201973,1041,379,662,40,1
201973,3960,1332,2628,41,4
201973,3960,1332,2628,42,1
201973,3215,1029,2186,43,1
201973,494,229,265,44,1
201973,2721,800,1921,45,1
201973,745,303,442,51,1
201973,549,195,354,59,1
201973,2172,605,1567,60,1
201982,99,2,97,1,4
201982,99,2,97,2,1
201982,99,2,97,3,1
201982,47,1,46,4,1
201982,52,1,51,5,1
201982,52,1,51,20,1
201982,99,2,97,21,4
201982,99,2,97,22,1
201982,99,2,97,23,1
201982,47,1,46,24,1
201982,52,1,51,25,1
201982,52,1,51,40,1
202046,568,241,327,1,4
202046,568,241,327,2,1
202046,556,236,320,3,1
202046,155,60,95,4,1
202046,401,176,225,5,1
202046,12,5,7,11,1
202046,29,15,14,19,1
202046,372,161,211,20,1
202046,558,238,320,21,4
202046,558,238,320,22,1
202046,551,234,317,23,1
202046,155,60,95,24,1
202046,396,174,222,25,1
202046,7,4,3,31,1
202046,29,15,14,39,1
202046,367,159,208,40,1
202046,10,3,7,41,4
202046,10,3,7,42,1
202046,5,2,3,43,1
202046,5,2,3,45,1
202046,5,1,4,51,1
202046,5,2,3,60,1
202055,113,13,100,1,4
202055,113,13,100,2,1
202055,113,13,100,3,1
202055,56,9,47,4,1
202055,57,4,53,5,1
202055,57,4,53,20,1
202055,113,13,100,21,4
202055,113,13,100,22,1
202055,113,13,100,23,1
202055,56,9,47,24,1
202055,57,4,53,25,1
202055,57,4,53,40,1
202073,451,208,243,1,4
202073,237,119,118,2,1
202073,237,119,118,3,1
202073,64,27,37,4,1
202073,173,92,81,5,1
202073,214,89,125,12,3
202073,5,3,2,19,1
202073,168,89,79,20,1
202073,445,204,241,21,4
202073,236,119,117,22,1
202073,236,119,117,23,1
202073,64,27,37,24,1
202073,172,92,80,25,1
202073,209,85,124,32,3
202073,5,3,2,39,1
202073,167,89,78,40,1
202073,6,4,2,41,4
202073,1,0,1,42,1
202073,1,0,1,43,1
202073,1,0,1,45,1
202073,5,4,1,52,3
202073,1,0,1,60,1
202134,17497,7811,9686,1,4
202134,12133,5547,6586,2,1
202134,11484,5275,6209,3,1
202134,1773,787,986,4,1
202134,9711,4488,5223,5,1
202134,649,272,377,11,1
202134,5364,2264,3100,12,3
202134,1658,726,932,19,1
202134,8053,3762,4291,20,1
202134,10825,4898,5927,21,4
202134,8998,4174,4824,22,1
202134,8888,4127,4761,23,1
202134,1729,758,971,24,1
202134,7159,3369,3790,25,1
202134,110,47,63,31,1
202134,1827,724,1103,32,3
202134,1233,549,684,39,1
202134,5926,2820,3106,40,1
202134,6672,2913,3759,41,4
202134,3135,1373,1762,42,1
202134,2596,1148,1448,43,1
202134,44,29,15,44,1
202134,2552,1119,1433,45,1
202134,539,225,314,51,1
202134,3537,1540,1997,52,3
202134,425,177,248,59,1
202134,2127,942,1185,60,1
202152,190,71,119,1,4
202152,190,71,119,2,1
202152,190,71,119,3,1
202152,114,39,75,4,1
202152,76,32,44,5,1
202152,76,32,44,20,1
202152,154,54,100,21,4
202152,154,54,100,22,1
202152,154,54,100,23,1
202152,91,28,63,24,1
202152,63,26,37,25,1
202152,63,26,37,40,1
202152,36,17,19,41,4
202152,36,17,19,42,1
202152,36,17,19,43,1
202152,23,11,12,44,1
202152,13,6,7,45,1
202152,13,6,7,60,1
202161,449,124,325,1,4
202161,449,124,325,2,1
202161,449,124,325,3,1
202161,85,22,63,4,1
202161,364,102,262,5,1
202161,98,23,75,19,1
202161,266,79,187,20,1
202161,449,124,325,21,4
202161,449,124,325,22,1
202161,449,124,325,23,1
202161,85,22,63,24,1
202161,364,102,262,25,1
202161,98,23,75,39,1
202161,266,79,187,40,1
202170,1379,523,856,1,4
202170,1348,508,840,2,1
202170,1277,486,791,3,1
202170,235,82,153,4,1
202170,1042,404,638,5,1
202170,71,22,49,11,1
202170,31,15,16,12,3
202170,87,24,63,19,1
202170,955,380,575,20,1
202170,1258,474,784,21,4
202170,1227,459,768,22,1
202170,1227,459,768,23,1
202170,234,81,153,24,1
202170,993,378,615,25,1
202170,31,15,16,32,3
202170,87,24,63,39,1
202170,906,354,552,40,1
202170,121,49,72,41,4
202170,121,49,72,42,1
202170,50,27,23,43,1
202170,1,1,0,44,1
202170,49,26,23,45,1
202170,71,22,49,51,1
202170,49,26,23,60,1
202222,25249,11523,13726,1,4
202222,25249,11523,13726,2,1
202222,13260,5883,7377,3,1
202222,2796,1391,1405,4,1
202222,10464,4492,5972,5,1
202222,11989,5640,6349,11,1
202222,1079,455,624,19,1
202222,9385,4037,5348,20,1
202222,8817,4276,4541,21,4
202222,8817,4276,4541,22,1
202222,4909,2280,2629,23,1
202222,1515,727,788,24,1
202222,3394,1553,1841,25,1
202222,3908,1996,1912,31,1
202222,491,218,273,39,1
202222,2903,1335,1568,40,1
202222,16432,7247,9185,41,4
202222,16432,7247,9185,42,1
202222,8351,3603,4748,43,1
202222,1281,664,617,44,1
202222,7070,2939,4131,45,1
202222,8081,3644,4437,51,1
202222,588,237,351,59,1
202222,6482,2702,3780,60,1
202356,27910,10936,16974,1,4
202356,27910,10936,16974,2,1
202356,14357,5724,8633,3,1
202356,2519,1226,1293,4,1
202356,11838,4498,7340,5,1
202356,13553,5212,8341,11,1
202356,1149,484,665,19,1
202356,10689,4014,6675,20,1
202356,9526,4396,5130,21,4
202356,9526,4396,5130,22,1
202356,5564,2528,3036,23,1
202356,1493,717,776,24,1
202356,4071,1811,2260,25,1
202356,3962,1868,2094,31,1
202356,554,261,293,39,1
202356,3517,1550,1967,40,1
202356,18384,6540,11844,41,4
202356,18384,6540,11844,42,1
202356,8793,3196,5597,43,1
202356,1026,509,517,44,1
202356,7767,2687,5080,45,1
202356,9591,3344,6247,51,1
202356,595,223,372,59,1
202356,7172,2464,4708,60,1
202435,218,44,174,1,4
202435,218,44,174,2,1
202435,217,43,174,3,1
202435,25,6,19,4,1
202435,192,37,155,5,1
202435,1,1,0,11,1
202435,64,18,46,19,1
202435,128,19,109,20,1
202435,53,10,43,21,4
202435,53,10,43,22,1
202435,53,10,43,23,1
202435,7,2,5,24,1
202435,46,8,38,25,1
202435,20,5,15,39,1
202435,26,3,23,40,1
202435,165,34,131,41,4
202435,165,34,131,42,1
202435,164,33,131,43,1
202435,18,4,14,44,1
202435,146,29,117,45,1
202435,1,1,0,51,1
202435,44,13,31,59,1
202435,102,16,86,60,1
202453,57,53,4,1,4
202453,57,53,4,2,1
202453,57,53,4,3,1
202453,19,19,0,4,1
202453,38,34,4,5,1
202453,38,34,4,20,1
202453,47,44,3,21,4
202453,47,44,3,22,1
202453,47,44,3,23,1
202453,14,14,0,24,1
202453,33,30,3,25,1
202453,33,30,3,40,1
202453,10,9,1,41,4
202453,10,9,1,42,1
202453,10,9,1,43,1
202453,5,5,0,44,1
202453,5,4,1,45,1
202453,5,4,1,60,1
202480,10835,5524,5311,1,4
202480,7975,4122,3853,2,1
202480,7812,4041,3771,3,1
202480,1769,900,869,4,1
202480,6043,3141,2902,5,1
202480,163,81,82,11,1
202480,2860,1402,1458,12,3
202480,133,78,55,19,1
202480,5910,3063,2847,20,1
202480,9390,4847,4543,21,4
202480,7455,3822,3633,22,1
202480,7441,3816,3625,23,1
202480,1765,899,866,24,1
202480,5676,2917,2759,25,1
202480,14,6,8,31,1
202480,1935,1025,910,32,3
202480,122,72,50,39,1
202480,5554,2845,2709,40,1
202480,1445,677,768,41,4
202480,520,300,220,42,1
202480,371,225,146,43,1
202480,4,1,3,44,1
202480,367,224,143,45,1
202480,149,75,74,51,1
202480,925,377,548,52,3
202480,11,6,5,59,1
202480,356,218,138,60,1
202514,989,510,479,1,4
202514,892,462,430,2,1
202514,871,457,414,3,1
202514,241,154,87,4,1
202514,630,303,327,5,1
202514,21,5,16,11,1
202514,97,48,49,12,3
202514,57,27,30,19,1
202514,573,276,297,20,1
202514,766,426,340,21,4
202514,732,412,320,22,1
202514,732,412,320,23,1
202514,240,153,87,24,1
202514,492,259,233,25,1
202514,34,14,20,32,3
202514,34,21,13,39,1
202514,458,238,220,40,1
202514,223,84,139,41,4
202514,160,50,110,42,1
202514,139,45,94,43,1
202514,1,1,0,44,1
202514,138,44,94,45,1
202514,21,5,16,51,1
202514,63,34,29,52,3
202514,23,6,17,59,1
202514,115,38,77,60,1
202523,2274,958,1316,1,4
202523,2274,958,1316,2,1
202523,2255,950,1305,3,1
202523,582,259,323,4,1
202523,1673,691,982,5,1
202523,19,8,11,11,1
202523,17,10,7,19,1
202523,1656,681,975,20,1
202523,2253,949,1304,21,4
202523,2253,949,1304,22,1
202523,2253,949,1304,23,1
202523,582,259,323,24,1
202523,1671,690,981,25,1
202523,17,10,7,39,1
202523,1654,680,974,40,1
202523,21,9,12,41,4
202523,21,9,12,42,1
202523,2,1,1,43,1
202523,2,1,1,45,1
202523,19,8,11,51,1
202523,2,1,1,60,1
202639,71,1,70,1,4
202639,71,1,70,2,1
202639,71,1,70,3,1
202639,19,0,19,4,1
202639,52,1,51,5,1
202639,52,1,51,20,1
202639,37,1,36,21,4
202639,37,1,36,22,1
202639,37,1,36,23,1
202639,12,0,12,24,1
202639,25,1,24,25,1
202639,25,1,24,40,1
202639,34,0,34,41,4
202639,34,0,34,42,1
202639,34,0,34,43,1
202639,7,0,7,44,1
202639,27,0,27,45,1
202639,27,0,27,60,1
202648,2993,1087,1906,1,4
202648,2993,1087,1906,2,1
202648,2167,767,1400,3,1
202648,439,181,258,4,1
202648,1728,586,1142,5,1
202648,826,320,506,11,1
202648,159,62,97,19,1
202648,1569,524,1045,20,1
202648,877,400,477,21,4
202648,877,400,477,22,1
202648,676,306,370,23,1
202648,208,94,114,24,1
202648,468,212,256,25,1
202648,201,94,107,31,1
202648,42,23,19,39,1
202648,426,189,237,40,1
202648,2116,687,1429,41,4
202648,2116,687,1429,42,1
202648,1491,461,1030,43,1
202648,231,87,144,44,1
202648,1260,374,886,45,1
202648,625,226,399,51,1
202648,117,39,78,59,1
202648,1143,335,808,60,1
202657,302,98,204,1,4
202657,302,98,204,2,1
202657,302,98,204,3,1
202657,150,47,103,4,1
202657,152,51,101,5,1
202657,152,51,101,20,1
202657,242,66,176,21,4
202657,242,66,176,22,1
202657,242,66,176,23,1
202657,112,28,84,24,1
202657,130,38,92,25,1
202657,130,38,92,40,1
202657,60,32,28,41,4
202657,60,32,28,42,1
202657,60,32,28,43,1
202657,38,19,19,44,1
202657,22,13,9,45,1
202657,22,13,9,60,1
202684,538,119,419,1,4
202684,538,119,419,2,1
202684,538,119,419,3,1
202684,31,10,21,4,1
202684,507,109,398,5,1
202684,80,21,59,19,1
202684,427,88,339,20,1
202684,218,52,166,21,4
202684,218,52,166,22,1
202684,218,52,166,23,1
202684,18,5,13,24,1
202684,200,47,153,25,1
202684,60,14,46,39,1
202684,140,33,107,40,1
202684,320,67,253,41,4
202684,320,67,253,42,1
202684,320,67,253,43,1
202684,13,5,8,44,1
202684,307,62,245,45,1
202684,20,7,13,59,1
202684,287,55,232,60,1
202736,86,3,83,1,4
202736,86,3,83,2,1
202736,86,3,83,3,1
202736,33,1,32,4,1
202736,53,2,51,5,1
202736,53,2,51,20,1
202736,86,3,83,21,4
202736,86,3,83,22,1
202736,86,3,83,23,1
202736,33,1,32,24,1
202736,53,2,51,25,1
202736,53,2,51,40,1
202763,4880,1855,3025,1,4
202763,3872,1455,2417,2,1
202763,2663,958,1705,3,1
202763,581,184,397,4,1
202763,2082,774,1308,5,1
202763,1209,497,712,11,1
202763,1008,400,608,12,3
202763,128,47,81,19,1
202763,1954,727,1227,20,1
202763,3041,1116,1925,21,4
202763,2490,897,1593,22,1
202763,2473,890,1583,23,1
202763,581,184,397,24,1
202763,1892,706,1186,25,1
202763,17,7,10,31,1
202763,551,219,332,32,3
202763,119,45,74,39,1
202763,1773,661,1112,40,1
202763,1839,739,1100,41,4
202763,1382,558,824,42,1
202763,190,68,122,43,1
202763,190,68,122,45,1
202763,1192,490,702,51,1
202763,457,181,276,52,3
202763,9,2,7,59,1
202763,181,66,115,60,1
202806,6274,2684,3590,1,4
202806,5185,2262,2923,2,1
202806,5129,2226,2903,3,1
202806,86,35,51,4,1
202806,5043,2191,2852,5,1
202806,56,36,20,11,1
202806,1089,422,667,12,3
202806,937,393,544,19,1
202806,4106,1798,2308,20,1
202806,2570,1107,1463,21,4
202806,1789,793,996,22,1
202806,1780,785,995,23,1
202806,9,5,4,24,1
202806,1771,780,991,25,1
202806,9,8,1,31,1
202806,781,314,467,32,3
202806,258,117,141,39,1
202806,1513,663,850,40,1
202806,3704,1577,2127,41,4
202806,3396,1469,1927,42,1
202806,3349,1441,1908,43,1
202806,77,30,47,44,1
202806,3272,1411,1861,45,1
202806,47,28,19,51,1
202806,308,108,200,52,3
202806,679,276,403,59,1
202806,2593,1135,1458,60,1
202888,67,2,65,1,4
202888,67,2,65,2,1
202888,67,2,65,3,1
202888,28,1,27,4,1
202888,39,1,38,5,1
202888,39,1,38,20,1
202888,34,0,34,21,4
202888,34,0,34,22,1
202888,34,0,34,23,1
202888,14,0,14,24,1
202888,20,0,20,25,1
202888,20,0,20,40,1
202888,33,2,31,41,4
202888,33,2,31,42,1
202888,33,2,31,43,1
202888,14,1,13,44,1
202888,19,1,18,45,1
202888,19,1,18,60,1
202903,305,156,149,1,4
202903,305,156,149,2,1
202903,259,128,131,3,1
202903,67,35,32,4,1
202903,192,93,99,5,1
202903,46,28,18,11,1
202903,14,5,9,19,1
202903,178,88,90,20,1
202903,204,96,108,21,4
202903,204,96,108,22,1
202903,204,96,108,23,1
202903,59,30,29,24,1
202903,145,66,79,25,1
202903,8,3,5,39,1
202903,137,63,74,40,1
202903,101,60,41,41,4
202903,101,60,41,42,1
202903,55,32,23,43,1
202903,8,5,3,44,1
202903,47,27,20,45,1
202903,46,28,18,51,1
202903,6,2,4,59,1
202903,41,25,16,60,1
202912,355,35,320,1,4
202912,355,35,320,2,1
202912,355,35,320,3,1
202912,16,1,15,4,1
202912,339,34,305,5,1
202912,74,1,73,19,1
202912,265,33,232,20,1
202912,148,12,136,21,4
202912,148,12,136,22,1
202912,148,12,136,23,1
202912,16,1,15,24,1
202912,132,11,121,25,1
202912,38,1,37,39,1
202912,94,10,84,40,1
202912,207,23,184,41,4
202912,207,23,184,42,1
202912,207,23,184,43,1
202912,207,23,184,45,1
202912,36,0,36,59,1
202912,171,23,148,60,1
202949,289,236,53,1,4
202949,289,236,53,2,1
202949,289,236,53,3,1
202949,111,91,20,4,1
202949,178,145,33,5,1
202949,178,145,33,20,1
202949,289,236,53,21,4
202949,289,236,53,22,1
202949,289,236,53,23,1
202949,111,91,20,24,1
202949,178,145,33,25,1
202949,178,145,33,40,1
202985,77,8,69,1,4
202985,77,8,69,2,1
202985,77,8,69,3,1
202985,20,1,19,4,1
202985,57,7,50,5,1
202985,57,7,50,20,1
202985,77,8,69,21,4
202985,77,8,69,22,1
202985,77,8,69,23,1
202985,20,1,19,24,1
202985,57,7,50,25,1
202985,57,7,50,40,1
203030,140,27,113,1,4
203030,140,27,113,2,1
203030,140,27,113,3,1
203030,64,12,52,4,1
203030,76,15,61,5,1
203030,76,15,61,20,1
203030,126,22,104,21,4
203030,126,22,104,22,1
203030,126,22,104,23,1
203030,60,10,50,24,1
203030,66,12,54,25,1
203030,66,12,54,40,1
203030,14,5,9,41,4
203030,14,5,9,42,1
203030,14,5,9,43,1
203030,4,2,2,44,1
203030,10,3,7,45,1
203030,10,3,7,60,1
203067,359,145,214,1,4
203067,359,145,214,12,3
203067,256,110,146,21,4
203067,256,110,146,32,3
203067,103,35,68,41,4
203067,103,35,68,52,3
203085,1241,590,651,1,4
203085,1107,551,556,2,1
203085,1099,550,549,3,1
203085,351,176,175,4,1
203085,748,374,374,5,1
203085,8,1,7,11,1
203085,134,39,95,12,3
203085,32,19,13,19,1
203085,716,355,361,20,1
203085,1094,544,550,21,4
203085,1055,534,521,22,1
203085,1050,533,517,23,1
203085,351,176,175,24,1
203085,699,357,342,25,1
203085,5,1,4,31,1
203085,39,10,29,32,3
203085,30,19,11,39,1
203085,669,338,331,40,1
203085,147,46,101,41,4
203085,52,17,35,42,1
203085,49,17,32,43,1
203085,49,17,32,45,1
203085,3,0,3,51,1
203085,95,29,66,52,3
203085,2,0,2,59,1
203085,47,17,30,60,1
203128,1311,590,721,1,4
203128,1283,581,702,2,1
203128,1260,572,688,3,1
203128,290,159,131,4,1
203128,970,413,557,5,1
203128,23,9,14,11,1
203128,28,9,19,12,3
203128,81,45,36,19,1
203128,889,368,521,20,1
203128,1117,520,597,21,4
203128,1117,520,597,22,1
203128,1116,520,596,23,1
203128,287,156,131,24,1
203128,829,364,465,25,1
203128,1,0,1,31,1
203128,64,37,27,39,1
203128,765,327,438,40,1
203128,194,70,124,41,4
203128,166,61,105,42,1
203128,144,52,92,43,1
203128,3,3,0,44,1
203128,141,49,92,45,1
203128,22,9,13,51,1
203128,28,9,19,52,3
203128,17,8,9,59,1
203128,124,41,83,60,1
203146,285,276,9,1,4
203146,285,276,9,2,1
203146,285,276,9,3,1
203146,124,122,2,4,1
203146,161,154,7,5,1
203146,161,154,7,20,1
203146,285,276,9,21,4
203146,285,276,9,22,1
203146,285,276,9,23,1
203146,124,122,2,24,1
203146,161,154,7,25,1
203146,161,154,7,40,1
203155,4094,2008,2086,1,4
203155,4094,2008,2086,2,1
203155,3854,1931,1923,3,1
203155,924,551,373,4,1
203155,2930,1380,1550,5,1
203155,240,77,163,11,1
203155,303,171,132,19,1
203155,2627,1209,1418,20,1
203155,3012,1608,1404,21,4
203155,3012,1608,1404,22,1
203155,2994,1601,1393,23,1
203155,874,524,350,24,1
203155,2120,1077,1043,25,1
203155,18,7,11,31,1
203155,265,158,107,39,1
203155,1855,919,936,40,1
203155,1082,400,682,41,4
203155,1082,400,682,42,1
203155,860,330,530,43,1
203155,50,27,23,44,1
203155,810,303,507,45,1
203155,222,70,152,51,1
203155,38,13,25,59,1
203155,772,290,482,60,1
203225,250,174,76,1,4
203225,250,174,76,2,1
203225,250,174,76,3,1
203225,73,49,24,4,1
203225,177,125,52,5,1
203225,177,125,52,20,1
203225,250,174,76,21,4
203225,250,174,76,22,1
203225,250,174,76,23,1
203225,73,49,24,24,1
203225,177,125,52,25,1
203225,177,125,52,40,1
203234,126,7,119,1,4
203234,126,7,119,2,1
203234,126,7,119,3,1
203234,42,2,40,4,1
203234,84,5,79,5,1
203234,84,5,79,20,1
203234,126,7,119,21,4
203234,126,7,119,22,1
203234,126,7,119,23,1
203234,42,2,40,24,1
203234,84,5,79,25,1
203234,84,5,79,40,1
203289,74,59,15,1,4
203289,74,59,15,2,1
203289,74,59,15,3,1
203289,12,11,1,4,1
203289,62,48,14,5,1
203289,12,8,4,19,1
203289,50,40,10,20,1
203289,74,59,15,21,4
203289,74,59,15,22,1
203289,74,59,15,23,1
203289,12,11,1,24,1
203289,62,48,14,25,1
203289,12,8,4,39,1
203289,50,40,10,40,1
203313,304,195,109,1,4
203313,304,195,109,2,1
203313,304,195,109,3,1
203313,53,31,22,4,1
203313,251,164,87,5,1
203313,8,3,5,19,1
203313,243,161,82,20,1
203313,225,143,82,21,4
203313,225,143,82,22,1
203313,225,143,82,23,1
203313,46,27,19,24,1
203313,179,116,63,25,1
203313,5,2,3,39,1
203313,174,114,60,40,1
203313,79,52,27,41,4
203313,79,52,27,42,1
203313,79,52,27,43,1
203313,7,4,3,44,1
203313,72,48,24,45,1
203313,3,1,2,59,1
203313,69,47,22,60,1
203331,2929,1053,1876,1,4
203331,2929,1053,1876,2,1
203331,2365,810,1555,3,1
203331,629,236,393,4,1
203331,1736,574,1162,5,1
203331,564,243,321,11,1
203331,210,73,137,19,1
203331,1526,501,1025,20,1
203331,1414,532,882,21,4
203331,1414,532,882,22,1
203331,1386,517,869,23,1
203331,458,179,279,24,1
203331,928,338,590,25,1
203331,28,15,13,31,1
203331,131,43,88,39,1
203331,797,295,502,40,1
203331,1515,521,994,41,4
203331,1515,521,994,42,1
203331,979,293,686,43,1
203331,171,57,114,44,1
203331,808,236,572,45,1
203331,536,228,308,51,1
203331,79,30,49,59,1
203331,729,206,523,60,1
203368,3711,1786,1925,1,4
203368,3040,1585,1455,2,1
203368,3009,1564,1445,3,1
203368,793,411,382,4,1
203368,2216,1153,1063,5,1
203368,31,21,10,11,1
203368,671,201,470,12,3
203368,92,51,41,19,1
203368,2124,1102,1022,20,1
203368,3213,1606,1607,21,4
203368,2950,1526,1424,22,1
203368,2950,1526,1424,23,1
203368,792,411,381,24,1
203368,2158,1115,1043,25,1
203368,263,80,183,32,3
203368,85,48,37,39,1
203368,2073,1067,1006,40,1
203368,498,180,318,41,4
203368,90,59,31,42,1
203368,59,38,21,43,1
203368,1,0,1,44,1
203368,58,38,20,45,1
203368,31,21,10,51,1
203368,408,121,287,52,3
203368,7,3,4,59,1
203368,51,35,16,60,1
203386,1656,123,1533,1,4
203386,1656,123,1533,2,1
203386,1656,123,1533,3,1
203386,58,3,55,4,1
203386,1598,120,1478,5,1
203386,482,33,449,19,1
203386,1116,87,1029,20,1
203386,1278,97,1181,21,4
203386,1278,97,1181,22,1
203386,1278,97,1181,23,1
203386,58,3,55,24,1
203386,1220,94,1126,25,1
203386,343,25,318,39,1
203386,877,69,808,40,1
203386,378,26,352,41,4
203386,378,26,352,42,1
203386,378,26,352,43,1
203386,378,26,352,45,1
203386,139,8,131,59,1
203386,239,18,221,60,1
203438,156,3,153,1,4
203438,156,3,153,2,1
203438,156,3,153,3,1
203438,23,0,23,4,1
203438,133,3,130,5,1
203438,133,3,130,20,1
203438,97,3,94,21,4
203438,97,3,94,22,1
203438,97,3,94,23,1
203438,17,0,17,24,1
203438,80,3,77,25,1
203438,80,3,77,40,1
203438,59,0,59,41,4
203438,59,0,59,42,1
203438,59,0,59,43,1
203438,6,0,6,44,1
203438,53,0,53,45,1
203438,53,0,53,60,1
203447,2341,774,1567,1,4
203447,2339,772,1567,2,1
203447,2221,722,1499,3,1
203447,224,93,131,4,1
203447,1997,629,1368,5,1
203447,118,50,68,11,1
203447,2,2,0,12,3
203447,147,45,102,19,1
203447,1850,584,1266,20,1
203447,670,227,443,21,4
203447,670,227,443,22,1
203447,656,224,432,23,1
203447,151,61,90,24,1
203447,505,163,342,25,1
203447,14,3,11,31,1
203447,68,24,44,39,1
203447,437,139,298,40,1
203447,1671,547,1124,41,4
203447,1669,545,1124,42,1
203447,1565,498,1067,43,1
203447,73,32,41,44,1
203447,1492,466,1026,45,1
203447,104,47,57,51,1
203447,2,2,0,52,3
203447,79,21,58,59,1
203447,1413,445,968,60,1
203456,1672,503,1169,1,4
203456,1671,503,1168,2,1
203456,1529,445,1084,3,1
203456,122,42,80,4,1
203456,1407,403,1004,5,1
203456,142,58,84,11,1
203456,1,0,1,12,3
203456,74,20,54,19,1
203456,1333,383,950,20,1
203456,232,83,149,21,4
203456,232,83,149,22,1
203456,232,83,149,23,1
203456,101,35,66,24,1
203456,131,48,83,25,1
203456,23,10,13,39,1
203456,108,38,70,40,1
203456,1440,420,1020,41,4
203456,1439,420,1019,42,1
203456,1297,362,935,43,1
203456,21,7,14,44,1
203456,1276,355,921,45,1
203456,142,58,84,51,1
203456,1,0,1,52,3
203456,51,10,41,59,1
203456,1225,345,880,60,1
203465,4886,1964,2922,1,4
203465,4836,1941,2895,2,1
203465,4680,1895,2785,3,1
203465,729,299,430,4,1
203465,3951,1596,2355,5,1
203465,156,46,110,11,1
203465,50,23,27,12,3
203465,457,184,273,19,1
203465,3494,1412,2082,20,1
203465,2215,955,1260,21,4
203465,2214,955,1259,22,1
203465,2210,953,1257,23,1
203465,604,255,349,24,1
203465,1606,698,908,25,1
203465,4,2,2,31,1
203465,1,0,1,32,3
203465,218,95,123,39,1
203465,1388,603,785,40,1
203465,2671,1009,1662,41,4
203465,2622,986,1636,42,1
203465,2470,942,1528,43,1
203465,125,44,81,44,1
203465,2345,898,1447,45,1
203465,152,44,108,51,1
203465,49,23,26,52,3
203465,239,89,150,59,1
203465,2106,809,1297,60,1
203474,3087,1132,1955,1,4
203474,3061,1129,1932,2,1
203474,2944,1085,1859,3,1
203474,371,136,235,4,1
203474,2573,949,1624,5,1
203474,117,44,73,11,1
203474,26,3,23,12,3
203474,198,70,128,19,1
203474,2375,879,1496,20,1
203474,926,327,599,21,4
203474,926,327,599,22,1
203474,916,325,591,23,1
203474,279,102,177,24,1
203474,637,223,414,25,1
203474,10,2,8,31,1
203474,104,36,68,39,1
203474,533,187,346,40,1
203474,2161,805,1356,41,4
203474,2135,802,1333,42,1
203474,2028,760,1268,43,1
203474,92,34,58,44,1
203474,1936,726,1210,45,1
203474,107,42,65,51,1
203474,26,3,23,52,3
203474,94,34,60,59,1
203474,1842,692,1150,60,1
203483,2408,1015,1393,1,4
203483,2375,1010,1365,2,1
203483,2030,848,1182,3,1
203483,329,135,194,4,1
203483,1701,713,988,5,1
203483,345,162,183,11,1
203483,33,5,28,12,3
203483,94,41,53,19,1
203483,1607,672,935,20,1
203483,875,401,474,21,4
203483,875,401,474,22,1
203483,818,376,442,23,1
203483,258,111,147,24,1
203483,560,265,295,25,1
203483,57,25,32,31,1
203483,40,13,27,39,1
203483,520,252,268,40,1
203483,1533,614,919,41,4
203483,1500,609,891,42,1
203483,1212,472,740,43,1
203483,71,24,47,44,1
203483,1141,448,693,45,1
203483,288,137,151,51,1
203483,33,5,28,52,3
203483,54,28,26,59,1
203483,1087,420,667,60,1
203492,1846,538,1308,1,4
203492,1844,537,1307,2,1
203492,1713,482,1231,3,1
203492,205,61,144,4,1
203492,1508,421,1087,5,1
203492,131,55,76,11,1
203492,2,1,1,12,3
203492,116,34,82,19,1
203492,1392,387,1005,20,1
203492,703,190,513,21,4
203492,703,190,513,22,1
203492,668,176,492,23,1
203492,174,46,128,24,1
203492,494,130,364,25,1
203492,35,14,21,31,1
203492,61,21,40,39,1
203492,433,109,324,40,1
203492,1143,348,795,41,4
203492,1141,347,794,42,1
203492,1045,306,739,43,1
203492,31,15,16,44,1
203492,1014,291,723,45,1
203492,96,41,55,51,1
203492,2,1,1,52,3
203492,55,13,42,59,1
203492,959,278,681,60,1
203517,28998,11682,17316,1,4
203517,22968,9508,13460,2,1
203517,22071,9126,12945,3,1
203517,4350,1626,2724,4,1
203517,17721,7500,10221,5,1
203517,897,382,515,11,1
203517,6030,2174,3856,12,3
203517,1204,554,650,19,1
203517,16517,6946,9571,20,1
203517,21737,9057,12680,21,4
203517,18533,7706,10827,22,1
203517,18158,7526,10632,23,1
203517,4293,1593,2700,24,1
203517,13865,5933,7932,25,1
203517,375,180,195,31,1
203517,3204,1351,1853,32,3
203517,987,470,517,39,1
203517,12878,5463,7415,40,1
203517,7261,2625,4636,41,4
203517,4435,1802,2633,42,1
203517,3913,1600,2313,43,1
203517,57,33,24,44,1
203517,3856,1567,2289,45,1
203517,522,202,320,51,1
203517,2826,823,2003,52,3
203517,217,84,133,59,1
203517,3639,1483,2156,60,1
203526,2653,1009,1644,1,4
203526,2646,1008,1638,2,1
203526,2407,936,1471,3,1
203526,344,175,169,4,1
203526,2063,761,1302,5,1
203526,239,72,167,11,1
203526,7,1,6,12,3
203526,192,75,117,19,1
203526,1871,686,1185,20,1
203526,589,291,298,21,4
203526,589,291,298,22,1
203526,571,281,290,23,1
203526,274,147,127,24,1
203526,297,134,163,25,1
203526,18,10,8,31,1
203526,65,37,28,39,1
203526,232,97,135,40,1
203526,2064,718,1346,41,4
203526,2057,717,1340,42,1
203526,1836,655,1181,43,1
203526,70,28,42,44,1
203526,1766,627,1139,45,1
203526,221,62,159,51,1
203526,7,1,6,52,3
203526,127,38,89,59,1
203526,1639,589,1050,60,1
203535,1705,789,916,1,4
203535,1705,789,916,2,1
203535,1694,786,908,3,1
203535,480,220,260,4,1
203535,1214,566,648,5,1
203535,11,3,8,11,1
203535,13,4,9,19,1
203535,1201,562,639,20,1
203535,1695,786,909,21,4
203535,1695,786,909,22,1
203535,1694,786,908,23,1
203535,480,220,260,24,1
203535,1214,566,648,25,1
203535,1,0,1,31,1
203535,13,4,9,39,1
203535,1201,562,639,40,1
203535,10,3,7,41,4
203535,10,3,7,42,1
203535,10,3,7,51,1
203544,880,176,704,1,4
203544,800,148,652,2,1
203544,783,143,640,3,1
203544,67,5,62,4,1
203544,716,138,578,5,1
203544,17,5,12,11,1
203544,80,28,52,12,3
203544,109,24,85,19,1
203544,607,114,493,20,1
203544,497,107,390,21,4
203544,419,80,339,22,1
203544,416,79,337,23,1
203544,58,4,54,24,1
203544,358,75,283,25,1
203544,3,1,2,31,1
203544,78,27,51,32,3
203544,58,15,43,39,1
203544,300,60,240,40,1
203544,383,69,314,41,4
203544,381,68,313,42,1
203544,367,64,303,43,1
203544,9,1,8,44,1
203544,358,63,295,45,1
203544,14,4,10,51,1
203544,2,1,1,52,3
203544,51,9,42,59,1
203544,307,54,253,60,1
203580,1086,568,518,1,4
203580,922,474,448,2,1
203580,839,455,384,3,1
203580,206,119,87,4,1
203580,633,336,297,5,1
203580,83,19,64,11,1
203580,164,94,70,12,3
203580,45,28,17,19,1
203580,588,308,280,20,1
203580,875,467,408,21,4
203580,852,455,397,22,1
203580,818,446,372,23,1
203580,206,119,87,24,1
203580,612,327,285,25,1
203580,34,9,25,31,1
203580,23,12,11,32,3
203580,45,28,17,39,1
203580,567,299,268,40,1
203580,211,101,110,41,4
203580,70,19,51,42,1
203580,21,9,12,43,1
203580,21,9,12,45,1
203580,49,10,39,51,1
203580,141,82,59,52,3
203580,21,9,12,60,1
203599,8839,3601,5238,1,4
203599,8839,3601,5238,2,1
203599,6555,2718,3837,3,1
203599,1232,609,623,4,1
203599,5323,2109,3214,5,1
203599,2284,883,1401,11,1
203599,491,171,320,19,1
203599,4832,1938,2894,20,1
203599,3171,1468,1703,21,4
203599,3171,1468,1703,22,1
203599,2368,1149,1219,23,1
203599,720,381,339,24,1
203599,1648,768,880,25,1
203599,803,319,484,31,1
203599,212,93,119,39,1
203599,1436,675,761,40,1
203599,5668,2133,3535,41,4
203599,5668,2133,3535,42,1
203599,4187,1569,2618,43,1
203599,512,228,284,44,1
203599,3675,1341,2334,45,1
203599,1481,564,917,51,1
203599,279,78,201,59,1
203599,3396,1263,2133,60,1
203614,407,171,236,1,4
203614,407,171,236,2,1
203614,407,171,236,3,1
203614,207,115,92,4,1
203614,200,56,144,5,1
203614,200,56,144,20,1
203614,374,153,221,21,4
203614,374,153,221,22,1
203614,374,153,221,23,1
203614,185,102,83,24,1
203614,189,51,138,25,1
203614,189,51,138,40,1
203614,33,18,15,41,4
203614,33,18,15,42,1
203614,33,18,15,43,1
203614,22,13,9,44,1
203614,11,5,6,45,1
203614,11,5,6,60,1
203678,3599,1200,2399,1,4
203678,3599,1200,2399,2,1
203678,2754,838,1916,3,1
203678,549,202,347,4,1
203678,2205,636,1569,5,1
203678,845,362,483,11,1
203678,183,56,127,19,1
203678,2022,580,1442,20,1
203678,1409,481,928,21,4
203678,1409,481,928,22,1
203678,1369,468,901,23,1
203678,427,166,261,24,1
203678,942,302,640,25,1
203678,40,13,27,31,1
203678,110,34,76,39,1
203678,832,268,564,40,1
203678,2190,719,1471,41,4
203678,2190,719,1471,42,1
203678,1385,370,1015,43,1
203678,122,36,86,44,1
203678,1263,334,929,45,1
203678,805,349,456,51,1
203678,73,22,51,59,1
203678,1190,312,878,60,1
203720,415,67,348,1,4
203720,415,67,348,2,1
203720,415,67,348,3,1
203720,53,9,44,4,1
203720,362,58,304,5,1
203720,129,19,110,19,1
203720,233,39,194,20,1
203720,320,51,269,21,4
203720,320,51,269,22,1
203720,320,51,269,23,1
203720,48,8,40,24,1
203720,272,43,229,25,1
203720,109,14,95,39,1
203720,163,29,134,40,1
203720,95,16,79,41,4
203720,95,16,79,42,1
203720,95,16,79,43,1
203720,5,1,4,44,1
203720,90,15,75,45,1
203720,20,5,15,59,1
203720,70,10,60,60,1
203739,387,88,299,1,4
203739,387,88,299,2,1
203739,387,88,299,3,1
203739,27,7,20,4,1
203739,360,81,279,5,1
203739,79,19,60,19,1
203739,281,62,219,20,1
203739,200,46,154,21,4
203739,200,46,154,22,1
203739,200,46,154,23,1
203739,22,5,17,24,1
203739,178,41,137,25,1
203739,39,10,29,39,1
203739,139,31,108,40,1
203739,187,42,145,41,4
203739,187,42,145,42,1
203739,187,42,145,43,1
203739,5,2,3,44,1
203739,182,40,142,45,1
203739,40,9,31,59,1
203739,142,31,111,60,1
203748,12274,4478,7796,1,4
203748,12274,4478,7796,2,1
203748,10582,3843,6739,3,1
203748,1928,862,1066,4,1
203748,8654,2981,5673,5,1
203748,1692,635,1057,11,1
203748,699,244,455,19,1
203748,7955,2737,5218,20,1
203748,3391,1446,1945,21,4
203748,3391,1446,1945,22,1
203748,3180,1368,1812,23,1
203748,997,453,544,24,1
203748,2183,915,1268,25,1
203748,211,78,133,31,1
203748,211,79,132,39,1
203748,1972,836,1136,40,1
203748,8883,3032,5851,41,4
203748,8883,3032,5851,42,1
203748,7402,2475,4927,43,1
203748,931,409,522,44,1
203748,6471,2066,4405,45,1
203748,1481,557,924,51,1
203748,488,165,323,59,1
203748,5983,1901,4082,60,1
203757,2187,602,1585,1,4
203757,1806,535,1271,2,1
203757,1747,515,1232,3,1
203757,223,61,162,4,1
203757,1524,454,1070,5,1
203757,59,20,39,11,1
203757,381,67,314,12,3
203757,153,54,99,19,1
203757,1371,400,971,20,1
203757,1452,417,1035,21,4
203757,1137,357,780,22,1
203757,1132,354,778,23,1
203757,209,58,151,24,1
203757,923,296,627,25,1
203757,5,3,2,31,1
203757,315,60,255,32,3
203757,101,47,54,39,1
203757,822,249,573,40,1
203757,735,185,550,41,4
203757,669,178,491,42,1
203757,615,161,454,43,1
203757,14,3,11,44,1
203757,601,158,443,45,1
203757,54,17,37,51,1
203757,66,7,59,52,3
203757,52,7,45,59,1
203757,549,151,398,60,1
203775,2074,839,1235,1,4
203775,1656,705,951,2,1
203775,1571,682,889,3,1
203775,316,151,165,4,1
203775,1255,531,724,5,1
203775,85,23,62,11,1
203775,418,134,284,12,3
203775,126,46,80,19,1
203775,1129,485,644,20,1
203775,1525,686,839,21,4
203775,1453,654,799,22,1
203775,1436,646,790,23,1
203775,314,149,165,24,1
203775,1122,497,625,25,1
203775,17,8,9,31,1
203775,72,32,40,32,3
203775,112,46,66,39,1
203775,1010,451,559,40,1
203775,549,153,396,41,4
203775,203,51,152,42,1
203775,135,36,99,43,1
203775,2,2,0,44,1
203775,133,34,99,45,1
203775,68,15,53,51,1
203775,346,102,244,52,3
203775,14,0,14,59,1
203775,119,34,85,60,1
203845,1542,848,694,1,4
203845,1416,824,592,2,1
203845,1390,810,580,3,1
203845,385,243,142,4,1
203845,1005,567,438,5,1
203845,26,14,12,11,1
203845,126,24,102,12,3
203845,38,20,18,19,1
203845,967,547,420,20,1
203845,1429,814,615,21,4
203845,1352,795,557,22,1
203845,1352,795,557,23,1
203845,385,243,142,24,1
203845,967,552,415,25,1
203845,77,19,58,32,3
203845,38,20,18,39,1
203845,929,532,397,40,1
203845,113,34,79,41,4
203845,64,29,35,42,1
203845,38,15,23,43,1
203845,38,15,23,45,1
203845,26,14,12,51,1
203845,49,5,44,52,3
203845,38,15,23,60,1
203881,2698,1133,1565,1,4
203881,2698,1133,1565,2,1
203881,2047,865,1182,3,1
203881,362,190,172,4,1
203881,1685,675,1010,5,1
203881,651,268,383,11,1
203881,252,85,167,19,1
203881,1433,590,843,20,1
203881,902,336,566,21,4
203881,902,336,566,22,1
203881,880,326,554,23,1
203881,190,70,120,24,1
203881,690,256,434,25,1
203881,22,10,12,31,1
203881,111,36,75,39,1
203881,579,220,359,40,1
203881,1796,797,999,41,4
203881,1796,797,999,42,1
203881,1167,539,628,43,1
203881,172,120,52,44,1
203881,995,419,576,45,1
203881,629,258,371,51,1
203881,141,49,92,59,1
203881,854,370,484,60,1
203942,105,46,59,1,4
203942,105,46,59,2,1
203942,105,46,59,3,1
203942,76,34,42,4,1
203942,29,12,17,5,1
203942,29,12,17,20,1
203942,62,27,35,21,4
203942,62,27,35,22,1
203942,62,27,35,23,1
203942,41,20,21,24,1
203942,21,7,14,25,1
203942,21,7,14,40,1
203942,43,19,24,41,4
203942,43,19,24,42,1
203942,43,19,24,43,1
203942,35,14,21,44,1
203942,8,5,3,45,1
203942,8,5,3,60,1
203960,1195,170,1025,1,4
203960,1195,170,1025,2,1
203960,1192,168,1024,3,1
203960,34,6,28,4,1
203960,1158,162,996,5,1
203960,3,2,1,11,1
203960,356,54,302,19,1
203960,802,108,694,20,1
203960,501,80,421,21,4
203960,501,80,421,22,1
203960,501,80,421,23,1
203960,31,5,26,24,1
203960,470,75,395,25,1
203960,131,25,106,39,1
203960,339,50,289,40,1
203960,694,90,604,41,4
203960,694,90,604,42,1
203960,691,88,603,43,1
203960,3,1,2,44,1
203960,688,87,601,45,1
203960,3,2,1,51,1
203960,225,29,196,59,1
203960,463,58,405,60,1
203997,193,80,113,1,4
203997,193,80,113,12,3
203997,133,53,80,21,4
203997,133,53,80,32,3
203997,60,27,33,41,4
203997,60,27,33,52,3
204006,3621,1615,2006,1,4
204006,3621,1615,2006,2,1
204006,3421,1559,1862,3,1
204006,783,362,421,4,1
204006,2638,1197,1441,5,1
204006,200,56,144,11,1
204006,220,110,110,19,1
204006,2418,1087,1331,20,1
204006,2521,1106,1415,21,4
204006,2521,1106,1415,22,1
204006,2489,1094,1395,23,1
204006,645,292,353,24,1
204006,1844,802,1042,25,1
204006,32,12,20,31,1
204006,152,67,85,39,1
204006,1692,735,957,40,1
204006,1100,509,591,41,4
204006,1100,509,591,42,1
204006,932,465,467,43,1
204006,138,70,68,44,1
204006,794,395,399,45,1
204006,168,44,124,51,1
204006,68,43,25,59,1
204006,726,352,374,60,1
204015,2221,902,1319,1,4
204015,2221,902,1319,2,1
204015,1765,745,1020,3,1
204015,421,186,235,4,1
204015,1344,559,785,5,1
204015,456,157,299,11,1
204015,138,71,67,19,1
204015,1206,488,718,20,1
204015,1330,567,763,21,4
204015,1330,567,763,22,1
204015,1307,559,748,23,1
204015,359,166,193,24,1
204015,948,393,555,25,1
204015,23,8,15,31,1
204015,94,45,49,39,1
204015,854,348,506,40,1
204015,891,335,556,41,4
204015,891,335,556,42,1
204015,458,186,272,43,1
204015,62,20,42,44,1
204015,396,166,230,45,1
204015,433,149,284,51,1
204015,44,26,18,59,1
204015,352,140,212,60,1
204024,17901,8239,9662,1,4
204024,15462,7470,7992,2,1
204024,15378,7430,7948,3,1
204024,3644,1741,1903,4,1
204024,11734,5689,6045,5,1
204024,84,40,44,11,1
204024,2439,769,1670,12,3
204024,254,142,112,19,1
204024,11480,5547,5933,20,1
204024,16038,7666,8372,21,4
204024,15001,7215,7786,22,1
204024,14952,7192,7760,23,1
204024,3637,1738,1899,24,1
204024,11315,5454,5861,25,1
204024,49,23,26,31,1
204024,1037,451,586,32,3
204024,252,141,111,39,1
204024,11063,5313,5750,40,1
204024,1863,573,1290,41,4
204024,461,255,206,42,1
204024,426,238,188,43,1
204024,7,3,4,44,1
204024,419,235,184,45,1
204024,35,17,18,51,1
204024,1402,318,1084,52,3
204024,2,1,1,59,1
204024,417,234,183,60,1
204060,258,54,204,1,4
204060,258,54,204,2,1
204060,258,54,204,3,1
204060,56,12,44,4,1
204060,202,42,160,5,1
204060,23,7,16,19,1
204060,179,35,144,20,1
204060,161,36,125,21,4
204060,161,36,125,22,1
204060,161,36,125,23,1
204060,43,10,33,24,1
204060,118,26,92,25,1
204060,13,4,9,39,1
204060,105,22,83,40,1
204060,97,18,79,41,4
204060,97,18,79,42,1
204060,97,18,79,43,1
204060,13,2,11,44,1
204060,84,16,68,45,1
204060,10,3,7,59,1
204060,74,13,61,60,1
204121,80,1,79,1,4
204121,80,1,79,2,1
204121,80,1,79,3,1
204121,42,1,41,4,1
204121,38,0,38,5,1
204121,38,0,38,20,1
204121,41,1,40,21,4
204121,41,1,40,22,1
204121,41,1,40,23,1
204121,23,1,22,24,1
204121,18,0,18,25,1
204121,18,0,18,40,1
204121,39,0,39,41,4
204121,39,0,39,42,1
204121,39,0,39,43,1
204121,19,0,19,44,1
204121,20,0,20,45,1
204121,20,0,20,60,1
204158,407,168,239,1,4
204158,407,168,239,2,1
204158,407,168,239,3,1
204158,172,72,100,4,1
204158,235,96,139,5,1
204158,235,96,139,20,1
204158,407,168,239,21,4
204158,407,168,239,22,1
204158,407,168,239,23,1
204158,172,72,100,24,1
204158,235,96,139,25,1
204158,235,96,139,40,1
204176,1121,106,1015,1,4
204176,947,96,851,2,1
204176,947,96,851,3,1
204176,96,9,87,4,1
204176,851,87,764,5,1
204176,174,10,164,12,3
204176,146,13,133,19,1
204176,705,74,631,20,1
204176,752,76,676,21,4
204176,655,69,586,22,1
204176,655,69,586,23,1
204176,86,7,79,24,1
204176,569,62,507,25,1
204176,97,7,90,32,3
204176,76,9,67,39,1
204176,493,53,440,40,1
204176,369,30,339,41,4
204176,292,27,265,42,1
204176,292,27,265,43,1
204176,10,2,8,44,1
204176,282,25,257,45,1
204176,77,3,74,52,3
204176,70,4,66,59,1
204176,212,21,191,60,1
204185,2187,1079,1108,1,4
204185,2096,1053,1043,2,1
204185,2056,1030,1026,3,1
204185,552,283,269,4,1
204185,1504,747,757,5,1
204185,40,23,17,11,1
204185,91,26,65,12,3
204185,90,56,34,19,1
204185,1414,691,723,20,1
204185,2118,1052,1066,21,4
204185,2056,1033,1023,22,1
204185,2045,1028,1017,23,1
204185,552,283,269,24,1
204185,1493,745,748,25,1
204185,11,5,6,31,1
204185,62,19,43,32,3
204185,90,56,34,39,1
204185,1403,689,714,40,1
204185,69,27,42,41,4
204185,40,20,20,42,1
204185,11,2,9,43,1
204185,11,2,9,45,1
204185,29,18,11,51,1
204185,29,7,22,52,3
204185,11,2,9,60,1
204194,2229,789,1440,1,4
204194,1829,650,1179,2,1
204194,1774,632,1142,3,1
204194,302,116,186,4,1
204194,1472,516,956,5,1
204194,55,18,37,11,1
204194,400,139,261,12,3
204194,56,28,28,19,1
204194,1416,488,928,20,1
204194,1667,607,1060,21,4
204194,1450,540,910,22,1
204194,1437,538,899,23,1
204194,301,115,186,24,1
204194,1136,423,713,25,1
204194,13,2,11,31,1
204194,217,67,150,32,3
204194,55,27,28,39,1
204194,1081,396,685,40,1
204194,562,182,380,41,4
204194,379,110,269,42,1
204194,337,94,243,43,1
204194,1,1,0,44,1
204194,336,93,243,45,1
204194,42,16,26,51,1
204194,183,72,111,52,3
204194,1,1,0,59,1
204194,335,92,243,60,1
204200,2326,798,1528,1,4
204200,1795,662,1133,2,1
204200,1655,647,1008,3,1
204200,324,174,150,4,1
204200,1331,473,858,5,1
204200,140,15,125,11,1
204200,531,136,395,12,3
204200,165,51,114,19,1
204200,1166,422,744,20,1
204200,1432,606,826,21,4
204200,1223,548,675,22,1
204200,1222,548,674,23,1
204200,312,171,141,24,1
204200,910,377,533,25,1
204200,1,0,1,31,1
204200,209,58,151,32,3
204200,70,40,30,39,1
204200,840,337,503,40,1
204200,894,192,702,41,4
204200,572,114,458,42,1
204200,433,99,334,43,1
204200,12,3,9,44,1
204200,421,96,325,45,1
204200,139,15,124,51,1
204200,322,78,244,52,3
204200,95,11,84,59,1
204200,326,85,241,60,1
204255,3652,1764,1888,1,4
204255,3652,1764,1888,2,1
204255,2351,1178,1173,3,1
204255,888,593,295,4,1
204255,1463,585,878,5,1
204255,1301,586,715,11,1
204255,387,148,239,19,1
204255,1076,437,639,20,1
204255,1320,553,767,21,4
204255,1320,553,767,22,1
204255,1160,494,666,23,1
204255,358,154,204,24,1
204255,802,340,462,25,1
204255,160,59,101,31,1
204255,327,130,197,39,1
204255,475,210,265,40,1
204255,2332,1211,1121,41,4
204255,2332,1211,1121,42,1
204255,1191,684,507,43,1
204255,530,439,91,44,1
204255,661,245,416,45,1
204255,1141,527,614,51,1
204255,60,18,42,59,1
204255,601,227,374,60,1
204264,2154,874,1280,1,4
204264,1728,775,953,2,1
204264,1641,739,902,3,1
204264,404,200,204,4,1
204264,1237,539,698,5,1
204264,87,36,51,11,1
204264,426,99,327,12,3
204264,70,31,39,19,1
204264,1167,508,659,20,1
204264,1501,733,768,21,4
204264,1438,713,725,22,1
204264,1420,703,717,23,1
204264,403,200,203,24,1
204264,1017,503,514,25,1
204264,18,10,8,31,1
204264,63,20,43,32,3
204264,51,29,22,39,1
204264,966,474,492,40,1
204264,653,141,512,41,4
204264,290,62,228,42,1
204264,221,36,185,43,1
204264,1,0,1,44,1
204264,220,36,184,45,1
204264,69,26,43,51,1
204264,363,79,284,52,3
204264,19,2,17,59,1
204264,201,34,167,60,1
204307,471,55,416,1,4
204307,471,55,416,2,1
204307,471,55,416,3,1
204307,23,3,20,4,1
204307,448,52,396,5,1
204307,97,12,85,19,1
204307,351,40,311,20,1
204307,394,49,345,21,4
204307,394,49,345,22,1
204307,394,49,345,23,1
204307,22,3,19,24,1
204307,372,46,326,25,1
204307,83,11,72,39,1
204307,289,35,254,40,1
204307,77,6,71,41,4
204307,77,6,71,42,1
204307,77,6,71,43,1
204307,1,0,1,44,1
204307,76,6,70,45,1
204307,14,1,13,59,1
204307,62,5,57,60,1
204316,563,131,432,1,4
204316,563,131,432,2,1
204316,563,131,432,3,1
204316,148,36,112,4,1
204316,415,95,320,5,1
204316,10,3,7,19,1
204316,405,92,313,20,1
204316,563,131,432,21,4
204316,563,131,432,22,1
204316,563,131,432,23,1
204316,148,36,112,24,1
204316,415,95,320,25,1
204316,10,3,7,39,1
204316,405,92,313,40,1
204334,78,3,75,1,4
204334,78,3,75,2,1
204334,78,3,75,3,1
204334,28,3,25,4,1
204334,50,0,50,5,1
204334,50,0,50,20,1
204334,78,3,75,21,4
204334,78,3,75,22,1
204334,78,3,75,23,1
204334,28,3,25,24,1
204334,50,0,50,25,1
204334,50,0,50,40,1
204422,2958,1128,1830,1,4
204422,2958,1128,1830,2,1
204422,2479,927,1552,3,1
204422,491,217,274,4,1
204422,1988,710,1278,5,1
204422,479,201,278,11,1
204422,250,104,146,19,1
204422,1738,606,1132,20,1
204422,846,384,462,21,4
204422,846,384,462,22,1
204422,759,335,424,23,1
204422,218,91,127,24,1
204422,541,244,297,25,1
204422,87,49,38,31,1
204422,97,46,51,39,1
204422,444,198,246,40,1
204422,2112,744,1368,41,4
204422,2112,744,1368,42,1
204422,1720,592,1128,43,1
204422,273,126,147,44,1
204422,1447,466,981,45,1
204422,392,152,240,51,1
204422,153,58,95,59,1
204422,1294,408,886,60,1
204431,33,5,28,1,4
204431,33,5,28,2,1
204431,33,5,28,3,1
204431,13,3,10,4,1
204431,20,2,18,5,1
204431,20,2,18,20,1
204431,33,5,28,21,4
204431,33,5,28,22,1
204431,33,5,28,23,1
204431,13,3,10,24,1
204431,20,2,18,25,1
204431,20,2,18,40,1
204440,4603,2752,1851,1,4
204440,4603,2752,1851,2,1
204440,2030,730,1300,3,1
204440,312,111,201,4,1
204440,1718,619,1099,5,1
204440,2573,2022,551,11,1
204440,53,19,34,19,1
204440,1665,600,1065,20,1
204440,798,322,476,21,4
204440,798,322,476,22,1
204440,624,236,388,23,1
204440,160,56,104,24,1
204440,464,180,284,25,1
204440,174,86,88,31,1
204440,18,10,8,39,1
204440,446,170,276,40,1
204440,3805,2430,1375,41,4
204440,3805,2430,1375,42,1
204440,1406,494,912,43,1
204440,152,55,97,44,1
204440,1254,439,815,45,1
204440,2399,1936,463,51,1
204440,35,9,26,59,1
204440,1219,430,789,60,1
204459,145,49,96,1,4
204459,145,49,96,2,1
204459,145,49,96,3,1
204459,24,9,15,4,1
204459,121,40,81,5,1
204459,121,40,81,20,1
204459,145,49,96,21,4
204459,145,49,96,22,1
204459,145,49,96,23,1
204459,24,9,15,24,1
204459,121,40,81,25,1
204459,121,40,81,40,1
204468,2269,951,1318,1,4
204468,1989,890,1099,2,1
204468,1792,810,982,3,1
204468,334,198,136,4,1
204468,1458,612,846,5,1
204468,197,80,117,11,1
204468,280,61,219,12,3
204468,146,44,102,19,1
204468,1312,568,744,20,1
204468,1405,743,662,21,4
204468,1405,743,662,22,1
204468,1374,727,647,23,1
204468,330,196,134,24,1
204468,1044,531,513,25,1
204468,31,16,15,31,1
204468,69,30,39,39,1
204468,975,501,474,40,1
204468,864,208,656,41,4
204468,584,147,437,42,1
204468,418,83,335,43,1
204468,4,2,2,44,1
204468,414,81,333,45,1
204468,166,64,102,51,1
204468,280,61,219,52,3
204468,77,14,63,59,1
204468,337,67,270,60,1
204477,832,428,404,1,4
204477,832,428,404,12,3
204477,824,425,399,21,4
204477,824,425,399,32,3
204477,8,3,5,41,4
204477,8,3,5,52,3
204486,4167,3284,883,1,4
204486,4117,3261,856,2,1
204486,4104,3255,849,3,1
204486,1362,1139,223,4,1
204486,2742,2116,626,5,1
204486,13,6,7,11,1
204486,50,23,27,12,3
204486,201,104,97,19,1
204486,2541,2012,529,20,1
204486,3669,3038,631,21,4
204486,3633,3020,613,22,1
204486,3632,3020,612,23,1
204486,1298,1088,210,24,1
204486,2334,1932,402,25,1
204486,1,0,1,31,1
204486,36,18,18,32,3
204486,162,90,72,39,1
204486,2172,1842,330,40,1
204486,498,246,252,41,4
204486,484,241,243,42,1
204486,472,235,237,43,1
204486,64,51,13,44,1
204486,408,184,224,45,1
204486,12,6,6,51,1
204486,14,5,9,52,3
204486,39,14,25,59,1
204486,369,170,199,60,1
204501,2911,1326,1585,1,4
204501,2894,1316,1578,2,1
204501,2894,1316,1578,3,1
204501,780,337,443,4,1
204501,2114,979,1135,5,1
204501,17,10,7,12,3
204501,24,13,11,19,1
204501,2090,966,1124,20,1
204501,2872,1305,1567,21,4
204501,2855,1295,1560,22,1
204501,2855,1295,1560,23,1
204501,780,337,443,24,1
204501,2075,958,1117,25,1
204501,17,10,7,32,3
204501,24,13,11,39,1
204501,2051,945,1106,40,1
204501,39,21,18,41,4
204501,39,21,18,42,1
204501,39,21,18,43,1
204501,39,21,18,45,1
204501,39,21,18,60,1
204592,103,13,90,1,4
204592,103,13,90,2,1
204592,103,13,90,3,1
204592,48,5,43,4,1
204592,55,8,47,5,1
204592,10,2,8,19,1
204592,45,6,39,20,1
204592,73,7,66,21,4
204592,73,7,66,22,1
204592,73,7,66,23,1
204592,26,2,24,24,1
204592,47,5,42,25,1
204592,6,1,5,39,1
204592,41,4,37,40,1
204592,30,6,24,41,4
204592,30,6,24,42,1
204592,30,6,24,43,1
204592,22,3,19,44,1
204592,8,3,5,45,1
204592,4,1,3,59,1
204592,4,2,2,60,1
204608,1119,1063,56,1,4
204608,1119,1063,56,2,1
204608,1119,1063,56,3,1
204608,306,288,18,4,1
204608,813,775,38,5,1
204608,813,775,38,20,1
204608,1119,1063,56,21,4
204608,1119,1063,56,22,1
204608,1119,1063,56,23,1
204608,306,288,18,24,1
204608,813,775,38,25,1
204608,813,775,38,40,1
204617,2573,1028,1545,1,4
204617,2005,851,1154,2,1
204617,1483,639,844,3,1
204617,239,119,120,4,1
204617,1244,520,724,5,1
204617,522,212,310,11,1
204617,568,177,391,12,3
204617,114,47,67,19,1
204617,1130,473,657,20,1
204617,1845,756,1089,21,4
204617,1391,611,780,22,1
204617,1348,596,752,23,1
204617,237,119,118,24,1
204617,1111,477,634,25,1
204617,43,15,28,31,1
204617,454,145,309,32,3
204617,75,37,38,39,1
204617,1036,440,596,40,1
204617,728,272,456,41,4
204617,614,240,374,42,1
204617,135,43,92,43,1
204617,2,0,2,44,1
204617,133,43,90,45,1
204617,479,197,282,51,1
204617,114,32,82,52,3
204617,39,10,29,59,1
204617,94,33,61,60,1
204626,404,93,311,1,4
204626,404,93,311,2,1
204626,404,93,311,3,1
204626,47,7,40,4,1
204626,357,86,271,5,1
204626,61,10,51,19,1
204626,296,76,220,20,1
204626,404,93,311,21,4
204626,404,93,311,22,1
204626,404,93,311,23,1
204626,47,7,40,24,1
204626,357,86,271,25,1
204626,61,10,51,39,1
204626,296,76,220,40,1
204635,3619,1780,1839,1,4
204635,2702,1396,1306,2,1
204635,2205,1153,1052,3,1
204635,613,299,314,4,1
204635,1592,854,738,5,1
204635,497,243,254,11,1
204635,917,384,533,12,3
204635,73,39,34,19,1
204635,1519,815,704,20,1
204635,3098,1528,1570,21,4
204635,2194,1150,1044,22,1
204635,2148,1127,1021,23,1
204635,613,299,314,24,1
204635,1535,828,707,25,1
204635,46,23,23,31,1
204635,904,378,526,32,3
204635,58,38,20,39,1
204635,1477,790,687,40,1
204635,521,252,269,41,4
204635,508,246,262,42,1
204635,57,26,31,43,1
204635,57,26,31,45,1
204635,451,220,231,51,1
204635,13,6,7,52,3
204635,15,1,14,59,1
204635,42,25,17,60,1
204662,643,383,260,1,4
204662,643,383,260,2,1
204662,628,369,259,3,1
204662,285,165,120,4,1
204662,343,204,139,5,1
204662,15,14,1,11,1
204662,13,9,4,19,1
204662,330,195,135,20,1
204662,554,322,232,21,4
204662,554,322,232,22,1
204662,554,322,232,23,1
204662,280,162,118,24,1
204662,274,160,114,25,1
204662,11,8,3,39,1
204662,263,152,111,40,1
204662,89,61,28,41,4
204662,89,61,28,42,1
204662,74,47,27,43,1
204662,5,3,2,44,1
204662,69,44,25,45,1
204662,15,14,1,51,1
204662,2,1,1,59,1
204662,67,43,24,60,1
204671,1077,481,596,1,4
204671,1059,478,581,2,1
204671,1008,461,547,3,1
204671,394,208,186,4,1
204671,614,253,361,5,1
204671,51,17,34,11,1
204671,18,3,15,12,3
204671,65,18,47,19,1
204671,549,235,314,20,1
204671,880,405,475,21,4
204671,872,403,469,22,1
204671,865,400,465,23,1
204671,381,200,181,24,1
204671,484,200,284,25,1
204671,7,3,4,31,1
204671,8,2,6,32,3
204671,51,16,35,39,1
204671,433,184,249,40,1
204671,197,76,121,41,4
204671,187,75,112,42,1
204671,143,61,82,43,1
204671,13,8,5,44,1
204671,130,53,77,45,1
204671,44,14,30,51,1
204671,10,1,9,52,3
204671,14,2,12,59,1
204671,116,51,65,60,1
204680,1204,521,683,1,4
204680,1155,519,636,2,1
204680,1121,506,615,3,1
204680,503,254,249,4,1
204680,618,252,366,5,1
204680,34,13,21,11,1
204680,49,2,47,12,3
204680,51,23,28,19,1
204680,567,229,338,20,1
204680,985,441,544,21,4
204680,967,440,527,22,1
204680,965,440,525,23,1
204680,486,246,240,24,1
204680,479,194,285,25,1
204680,2,0,2,31,1
204680,18,1,17,32,3
204680,41,21,20,39,1
204680,438,173,265,40,1
204680,219,80,139,41,4
204680,188,79,109,42,1
204680,156,66,90,43,1
204680,17,8,9,44,1
204680,139,58,81,45,1
204680,32,13,19,51,1
204680,31,1,30,52,3
204680,10,2,8,59,1
204680,129,56,73,60,1
204699,1259,569,690,1,4
204699,1230,565,665,2,1
204699,1192,553,639,3,1
204699,447,231,216,4,1
204699,745,322,423,5,1
204699,38,12,26,11,1
204699,29,4,25,12,3
204699,69,27,42,19,1
204699,676,295,381,20,1
204699,973,458,515,21,4
204699,955,454,501,22,1
204699,947,452,495,23,1
204699,406,214,192,24,1
204699,541,238,303,25,1
204699,8,2,6,31,1
204699,18,4,14,32,3
204699,52,21,31,39,1
204699,489,217,272,40,1
204699,286,111,175,41,4
204699,275,111,164,42,1
204699,245,101,144,43,1
204699,41,17,24,44,1
204699,204,84,120,45,1
204699,30,10,20,51,1
204699,11,0,11,52,3
204699,17,6,11,59,1
204699,187,78,109,60,1
204705,2315,1097,1218,1,4
204705,2263,1093,1170,2,1
204705,2205,1060,1145,3,1
204705,1092,582,510,4,1
204705,1113,478,635,5,1
204705,58,33,25,11,1
204705,52,4,48,12,3
204705,131,57,74,19,1
204705,982,421,561,20,1
204705,1893,911,982,21,4
204705,1883,910,973,22,1
204705,1881,909,972,23,1
204705,1056,567,489,24,1
204705,825,342,483,25,1
204705,2,1,1,31,1
204705,10,1,9,32,3
204705,105,47,58,39,1
204705,720,295,425,40,1
204705,422,186,236,41,4
204705,380,183,197,42,1
204705,324,151,173,43,1
204705,36,15,21,44,1
204705,288,136,152,45,1
204705,56,32,24,51,1
204705,42,3,39,52,3
204705,26,10,16,59,1
204705,262,126,136,60,1
204714,171,5,166,1,4
204714,171,5,166,2,1
204714,171,5,166,3,1
204714,53,3,50,4,1
204714,118,2,116,5,1
204714,118,2,116,20,1
204714,171,5,166,21,4
204714,171,5,166,22,1
204714,171,5,166,23,1
204714,53,3,50,24,1
204714,118,2,116,25,1
204714,118,2,116,40,1
204723,142,127,15,1,4
204723,142,127,15,2,1
204723,142,127,15,3,1
204723,32,28,4,4,1
204723,110,99,11,5,1
204723,110,99,11,20,1
204723,142,127,15,21,4
204723,142,127,15,22,1
204723,142,127,15,23,1
204723,32,28,4,24,1
204723,110,99,11,25,1
204723,110,99,11,40,1
204769,61,3,58,1,4
204769,61,3,58,2,1
204769,61,3,58,3,1
204769,49,2,47,4,1
204769,12,1,11,5,1
204769,12,1,11,20,1
204769,61,3,58,21,4
204769,61,3,58,22,1
204769,61,3,58,23,1
204769,49,2,47,24,1
204769,12,1,11,25,1
204769,12,1,11,40,1
204778,89,21,68,1,4
204778,89,21,68,2,1
204778,89,21,68,3,1
204778,54,9,45,4,1
204778,35,12,23,5,1
204778,35,12,23,20,1
204778,89,21,68,21,4
204778,89,21,68,22,1
204778,89,21,68,23,1
204778,54,9,45,24,1
204778,35,12,23,25,1
204778,35,12,23,40,1
204796,57466,29421,28045,1,4
204796,44201,23282,20919,2,1
204796,43139,22795,20344,3,1
204796,7130,3594,3536,4,1
204796,36009,19201,16808,5,1
204796,1062,487,575,11,1
204796,13265,6139,7126,12,3
204796,2513,1339,1174,19,1
204796,33496,17862,15634,20,1
204796,50012,25653,24359,21,4
204796,40020,20989,19031,22,1
204796,39877,20920,18957,23,1
204796,7121,3586,3535,24,1
204796,32756,17334,15422,25,1
204796,143,69,74,31,1
204796,9992,4664,5328,32,3
204796,2316,1237,1079,39,1
204796,30440,16097,14343,40,1
204796,7454,3768,3686,41,4
204796,4181,2293,1888,42,1
204796,3262,1875,1387,43,1
204796,9,8,1,44,1
204796,3253,1867,1386,45,1
204796,919,418,501,51,1
204796,3273,1475,1798,52,3
204796,197,102,95,59,1
204796,3056,1765,1291,60,1
204802,1091,444,647,1,4
204802,1091,444,647,2,1
204802,1010,413,597,3,1
204802,121,54,67,4,1
204802,889,359,530,5,1
204802,81,31,50,11,1
204802,77,27,50,19,1
204802,812,332,480,20,1
204802,451,182,269,21,4
204802,451,182,269,22,1
204802,409,164,245,23,1
204802,119,53,66,24,1
204802,290,111,179,25,1
204802,42,18,24,31,1
204802,39,11,28,39,1
204802,251,100,151,40,1
204802,640,262,378,41,4
204802,640,262,378,42,1
204802,601,249,352,43,1
204802,2,1,1,44,1
204802,599,248,351,45,1
204802,39,13,26,51,1
204802,38,16,22,59,1
204802,561,232,329,60,1
204820,2330,877,1453,1,4
204820,2330,877,1453,2,1
204820,2219,836,1383,3,1
204820,383,174,209,4,1
204820,1836,662,1174,5,1
204820,111,41,70,11,1
204820,143,47,96,19,1
204820,1693,615,1078,20,1
204820,1135,416,719,21,4
204820,1135,416,719,22,1
204820,1098,397,701,23,1
204820,341,157,184,24,1
204820,757,240,517,25,1
204820,37,19,18,31,1
204820,71,20,51,39,1
204820,686,220,466,40,1
204820,1195,461,734,41,4
204820,1195,461,734,42,1
204820,1121,439,682,43,1
204820,42,17,25,44,1
204820,1079,422,657,45,1
204820,74,22,52,51,1
204820,72,27,45,59,1
204820,1007,395,612,60,1
204839,2012,734,1278,1,4
204839,2012,734,1278,2,1
204839,1841,673,1168,3,1
204839,275,99,176,4,1
204839,1566,574,992,5,1
204839,171,61,110,11,1
204839,131,47,84,19,1
204839,1435,527,908,20,1
204839,1066,357,709,21,4
204839,1066,357,709,22,1
204839,1007,338,669,23,1
204839,254,91,163,24,1
204839,753,247,506,25,1
204839,59,19,40,31,1
204839,54,17,37,39,1
204839,699,230,469,40,1
204839,946,377,569,41,4
204839,946,377,569,42,1
204839,834,335,499,43,1
204839,21,8,13,44,1
204839,813,327,486,45,1
204839,112,42,70,51,1
204839,77,30,47,59,1
204839,736,297,439,60,1
204848,2596,910,1686,1,4
204848,2596,910,1686,2,1
204848,2340,836,1504,3,1
204848,465,199,266,4,1
204848,1875,637,1238,5,1
204848,256,74,182,11,1
204848,107,31,76,19,1
204848,1768,606,1162,20,1
204848,1222,439,783,21,4
204848,1222,439,783,22,1
204848,1136,419,717,23,1
204848,410,173,237,24,1
204848,726,246,480,25,1
204848,86,20,66,31,1
204848,50,13,37,39,1
204848,676,233,443,40,1
204848,1374,471,903,41,4
204848,1374,471,903,42,1
204848,1204,417,787,43,1
204848,55,26,29,44,1
204848,1149,391,758,45,1
204848,170,54,116,51,1
204848,57,18,39,59,1
204848,1092,373,719,60,1
204857,28786,11887,16899,1,4
204857,23504,9464,14040,2,1
204857,23331,9382,13949,3,1
204857,4243,2030,2213,4,1
204857,19088,7352,11736,5,1
204857,173,82,91,11,1
204857,5282,2423,2859,12,3
204857,1519,459,1060,19,1
204857,17569,6893,10676,20,1
204857,19449,9395,10054,21,4
204857,16756,8127,8629,22,1
204857,16732,8111,8621,23,1
204857,4233,2025,2208,24,1
204857,12499,6086,6413,25,1
204857,24,16,8,31,1
204857,2693,1268,1425,32,3
204857,642,315,327,39,1
204857,11857,5771,6086,40,1
204857,9337,2492,6845,41,4
204857,6748,1337,5411,42,1
204857,6599,1271,5328,43,1
204857,10,5,5,44,1
204857,6589,1266,5323,45,1
204857,149,66,83,51,1
204857,2589,1155,1434,52,3
204857,877,144,733,59,1
204857,5712,1122,4590,60,1
204866,2042,629,1413,1,4
204866,2042,629,1413,2,1
204866,1899,584,1315,3,1
204866,301,108,193,4,1
204866,1598,476,1122,5,1
204866,143,45,98,11,1
204866,131,43,88,19,1
204866,1467,433,1034,20,1
204866,885,283,602,21,4
204866,885,283,602,22,1
204866,845,268,577,23,1
204866,288,104,184,24,1
204866,557,164,393,25,1
204866,40,15,25,31,1
204866,46,17,29,39,1
204866,511,147,364,40,1
204866,1157,346,811,41,4
204866,1157,346,811,42,1
204866,1054,316,738,43,1
204866,13,4,9,44,1
204866,1041,312,729,45,1
204866,103,30,73,51,1
204866,85,26,59,59,1
204866,956,286,670,60,1
204884,183,20,163,1,4
204884,183,20,163,2,1
204884,183,20,163,3,1
204884,35,2,33,4,1
204884,148,18,130,5,1
204884,56,7,49,19,1
204884,92,11,81,20,1
204884,153,17,136,21,4
204884,153,17,136,22,1
204884,153,17,136,23,1
204884,35,2,33,24,1
204884,118,15,103,25,1
204884,45,7,38,39,1
204884,73,8,65,40,1
204884,30,3,27,41,4
204884,30,3,27,42,1
204884,30,3,27,43,1
204884,30,3,27,45,1
204884,11,0,11,59,1
204884,19,3,16,60,1
204893,87,9,78,1,4
204893,87,9,78,2,1
204893,87,9,78,3,1
204893,4,0,4,4,1
204893,83,9,74,5,1
204893,83,9,74,20,1
204893,87,9,78,21,4
204893,87,9,78,22,1
204893,87,9,78,23,1
204893,4,0,4,24,1
204893,83,9,74,25,1
204893,83,9,74,40,1
204909,1830,833,997,1,4
204909,1830,833,997,2,1
204909,1817,830,987,3,1
204909,537,249,288,4,1
204909,1280,581,699,5,1
204909,13,3,10,11,1
204909,31,16,15,19,1
204909,1249,565,684,20,1
204909,1809,824,985,21,4
204909,1809,824,985,22,1
204909,1808,824,984,23,1
204909,536,248,288,24,1
204909,1272,576,696,25,1
204909,1,0,1,31,1
204909,30,15,15,39,1
204909,1242,561,681,40,1
204909,21,9,12,41,4
204909,21,9,12,42,1
204909,9,6,3,43,1
204909,1,1,0,44,1
204909,8,5,3,45,1
204909,12,3,9,51,1
204909,1,1,0,59,1
204909,7,4,3,60,1
204936,2919,1032,1887,1,4
204936,2479,934,1545,2,1
204936,2436,925,1511,3,1
204936,575,212,363,4,1
204936,1861,713,1148,5,1
204936,43,9,34,11,1
204936,440,98,342,12,3
204936,103,51,52,19,1
204936,1758,662,1096,20,1
204936,2411,899,1512,21,4
204936,2206,840,1366,22,1
204936,2203,838,1365,23,1
204936,568,210,358,24,1
204936,1635,628,1007,25,1
204936,3,2,1,31,1
204936,205,59,146,32,3
204936,88,44,44,39,1
204936,1547,584,963,40,1
204936,508,133,375,41,4
204936,273,94,179,42,1
204936,233,87,146,43,1
204936,7,2,5,44,1
204936,226,85,141,45,1
204936,40,7,33,51,1
204936,235,39,196,52,3
204936,15,7,8,59,1
204936,211,78,133,60,1
204945,14691,7270,7421,1,4
204945,14691,7270,7421,2,1
204945,13251,6280,6971,3,1
204945,2252,1117,1135,4,1
204945,10999,5163,5836,5,1
204945,1440,990,450,11,1
204945,945,390,555,19,1
204945,10054,4773,5281,20,1
204945,5072,2324,2748,21,4
204945,5072,2324,2748,22,1
204945,5048,2313,2735,23,1
204945,1414,706,708,24,1
204945,3634,1607,2027,25,1
204945,24,11,13,31,1
204945,494,232,262,39,1
204945,3140,1375,1765,40,1
204945,9619,4946,4673,41,4
204945,9619,4946,4673,42,1
204945,8203,3967,4236,43,1
204945,838,411,427,44,1
204945,7365,3556,3809,45,1
204945,1416,979,437,51,1
204945,451,158,293,59,1
204945,6914,3398,3516,60,1
204963,101,8,93,1,4
204963,101,8,93,2,1
204963,101,8,93,3,1
204963,91,8,83,4,1
204963,10,0,10,5,1
204963,10,0,10,20,1
204963,52,4,48,21,4
204963,52,4,48,22,1
204963,52,4,48,23,1
204963,48,4,44,24,1
204963,4,0,4,25,1
204963,4,0,4,40,1
204963,49,4,45,41,4
204963,49,4,45,42,1
204963,49,4,45,43,1
204963,43,4,39,44,1
204963,6,0,6,45,1
204963,6,0,6,60,1
204981,106,11,95,1,4
204981,106,11,95,2,1
204981,106,11,95,3,1
204981,19,4,15,4,1
204981,87,7,80,5,1
204981,87,7,80,20,1
204981,42,7,35,21,4
204981,42,7,35,22,1
204981,42,7,35,23,1
204981,11,3,8,24,1
204981,31,4,27,25,1
204981,31,4,27,40,1
204981,64,4,60,41,4
204981,64,4,60,42,1
204981,64,4,60,43,1
204981,8,1,7,44,1
204981,56,3,53,45,1
204981,56,3,53,60,1
204990,135,59,76,1,4
204990,135,59,76,12,3
204990,75,36,39,21,4
204990,75,36,39,32,3
204990,60,23,37,41,4
204990,60,23,37,52,3
205027,213,212,1,1,4
205027,135,135,0,2,1
205027,135,135,0,3,1
205027,14,14,0,4,1
205027,121,121,0,5,1
205027,78,77,1,12,3
205027,40,40,0,19,1
205027,81,81,0,20,1
205027,211,211,0,21,4
205027,135,135,0,22,1
205027,135,135,0,23,1
205027,14,14,0,24,1
205027,121,121,0,25,1
205027,76,76,0,32,3
205027,40,40,0,39,1
205027,81,81,0,40,1
205027,2,1,1,41,4
205027,2,1,1,52,3
205054,311,52,259,1,4
205054,311,52,259,2,1
205054,311,52,259,3,1
205054,21,2,19,4,1
205054,290,50,240,5,1
205054,109,15,94,19,1
205054,181,35,146,20,1
205054,311,52,259,21,4
205054,311,52,259,22,1
205054,311,52,259,23,1
205054,21,2,19,24,1
205054,290,50,240,25,1
205054,109,15,94,39,1
205054,181,35,146,40,1
205090,99,14,85,1,4
205090,99,14,85,2,1
205090,99,14,85,3,1
205090,99,14,85,5,1
205090,99,14,85,20,1
205090,67,12,55,21,4
205090,67,12,55,22,1
205090,67,12,55,23,1
205090,67,12,55,25,1
205090,67,12,55,40,1
205090,32,2,30,41,4
205090,32,2,30,42,1
205090,32,2,30,43,1
205090,32,2,30,45,1
205090,32,2,30,60,1
205124,96,96,0,1,4
205124,56,56,0,2,1
205124,56,56,0,3,1
205124,13,13,0,4,1
205124,43,43,0,5,1
205124,40,40,0,12,3
205124,2,2,0,19,1
205124,41,41,0,20,1
205124,96,96,0,21,4
205124,56,56,0,22,1
205124,56,56,0,23,1
205124,13,13,0,24,1
205124,43,43,0,25,1
205124,40,40,0,32,3
205124,2,2,0,39,1
205124,41,41,0,40,1
205142,145,39,106,1,4
205142,145,39,106,2,1
205142,145,39,106,3,1
205142,14,4,10,4,1
205142,131,35,96,5,1
205142,131,35,96,20,1
205142,88,38,50,21,4
205142,88,38,50,22,1
205142,88,38,50,23,1
205142,7,4,3,24,1
205142,81,34,47,25,1
205142,81,34,47,40,1
205142,57,1,56,41,4
205142,57,1,56,42,1
205142,57,1,56,43,1
205142,7,0,7,44,1
205142,50,1,49,45,1
205142,50,1,49,60,1
205179,2802,444,2358,1,4
205179,2802,444,2358,2,1
205179,2802,444,2358,3,1
205179,777,97,680,4,1
205179,2025,347,1678,5,1
205179,9,0,9,19,1
205179,2016,347,1669,20,1
205179,2802,444,2358,21,4
205179,2802,444,2358,22,1
205179,2802,444,2358,23,1
205179,777,97,680,24,1
205179,2025,347,1678,25,1
205179,9,0,9,39,1
205179,2016,347,1669,40,1
205203,2314,868,1446,1,4
205203,2206,829,1377,2,1
205203,1419,521,898,3,1
205203,425,172,253,4,1
205203,994,349,645,5,1
205203,787,308,479,11,1
205203,108,39,69,12,3
205203,80,34,46,19,1
205203,914,315,599,20,1
205203,1808,716,1092,21,4
205203,1801,714,1087,22,1
205203,1155,456,699,23,1
205203,386,159,227,24,1
205203,769,297,472,25,1
205203,646,258,388,31,1
205203,7,2,5,32,3
205203,54,31,23,39,1
205203,715,266,449,40,1
205203,506,152,354,41,4
205203,405,115,290,42,1
205203,264,65,199,43,1
205203,39,13,26,44,1
205203,225,52,173,45,1
205203,141,50,91,51,1
205203,101,37,64,52,3
205203,26,3,23,59,1
205203,199,49,150,60,1
205391,140,49,91,1,4
205391,140,49,91,2,1
205391,140,49,91,3,1
205391,74,21,53,4,1
205391,66,28,38,5,1
205391,8,1,7,19,1
205391,58,27,31,20,1
205391,138,49,89,21,4
205391,138,49,89,22,1
205391,138,49,89,23,1
205391,74,21,53,24,1
205391,64,28,36,25,1
205391,8,1,7,39,1
205391,56,27,29,40,1
205391,2,0,2,41,4
205391,2,0,2,42,1
205391,2,0,2,43,1
205391,2,0,2,45,1
205391,2,0,2,60,1
205443,4341,1797,2544,1,4
205443,4255,1779,2476,2,1
205443,4110,1726,2384,3,1
205443,1104,472,632,4,1
205443,3006,1254,1752,5,1
205443,145,53,92,11,1
205443,86,18,68,12,3
205443,229,103,126,19,1
205443,2777,1151,1626,20,1
205443,3710,1604,2106,21,4
205443,3635,1589,2046,22,1
205443,3582,1569,2013,23,1
205443,1065,457,608,24,1
205443,2517,1112,1405,25,1
205443,53,20,33,31,1
205443,75,15,60,32,3
205443,189,99,90,39,1
205443,2328,1013,1315,40,1
205443,631,193,438,41,4
205443,620,190,430,42,1
205443,528,157,371,43,1
205443,39,15,24,44,1
205443,489,142,347,45,1
205443,92,33,59,51,1
205443,11,3,8,52,3
205443,40,4,36,59,1
205443,449,138,311,60,1
205470,19176,8280,10896,1,4
205470,19176,8280,10896,2,1
205470,16554,6998,9556,3,1
205470,3243,1581,1662,4,1
205470,13311,5417,7894,5,1
205470,2622,1282,1340,11,1
205470,1590,667,923,19,1
205470,11721,4750,6971,20,1
205470,6774,3211,3563,21,4
205470,6774,3211,3563,22,1
205470,6307,2988,3319,23,1
205470,1639,843,796,24,1
205470,4668,2145,2523,25,1
205470,467,223,244,31,1
205470,763,354,409,39,1
205470,3905,1791,2114,40,1
205470,12402,5069,7333,41,4
205470,12402,5069,7333,42,1
205470,10247,4010,6237,43,1
205470,1604,738,866,44,1
205470,8643,3272,5371,45,1
205470,2155,1059,1096,51,1
205470,827,313,514,59,1
205470,7816,2959,4857,60,1
205513,105,21,84,1,4
205513,105,21,84,2,1
205513,105,21,84,3,1
205513,20,5,15,4,1
205513,85,16,69,5,1
205513,85,16,69,20,1
205513,58,13,45,21,4
205513,58,13,45,22,1
205513,58,13,45,23,1
205513,19,5,14,24,1
205513,39,8,31,25,1
205513,39,8,31,40,1
205513,47,8,39,41,4
205513,47,8,39,42,1
205513,47,8,39,43,1
205513,1,0,1,44,1
205513,46,8,38,45,1
205513,46,8,38,60,1
205522,87,15,72,1,4
205522,87,15,72,2,1
205522,87,15,72,3,1
205522,9,0,9,4,1
205522,78,15,63,5,1
205522,7,4,3,19,1
205522,71,11,60,20,1
205522,71,14,57,21,4
205522,71,14,57,22,1
205522,71,14,57,23,1
205522,9,0,9,24,1
205522,62,14,48,25,1
205522,6,4,2,39,1
205522,56,10,46,40,1
205522,16,1,15,41,4
205522,16,1,15,42,1
205522,16,1,15,43,1
205522,16,1,15,45,1
205522,1,0,1,59,1
205522,15,1,14,60,1
205531,77,14,63,1,4
205531,77,14,63,2,1
205531,77,14,63,3,1
205531,6,1,5,4,1
205531,71,13,58,5,1
205531,10,3,7,19,1
205531,61,10,51,20,1
205531,59,10,49,21,4
205531,59,10,49,22,1
205531,59,10,49,23,1
205531,6,1,5,24,1
205531,53,9,44,25,1
205531,10,3,7,39,1
205531,43,6,37,40,1
205531,18,4,14,41,4
205531,18,4,14,42,1
205531,18,4,14,43,1
205531,18,4,14,45,1
205531,18,4,14,60,1
205559,69,13,56,1,4
205559,69,13,56,2,1
205559,69,13,56,3,1
205559,11,1,10,4,1
205559,58,12,46,5,1
205559,6,1,5,19,1
205559,52,11,41,20,1
205559,63,13,50,21,4
205559,63,13,50,22,1
205559,63,13,50,23,1
205559,10,1,9,24,1
205559,53,12,41,25,1
205559,6,1,5,39,1
205559,47,11,36,40,1
205559,6,0,6,41,4
205559,6,0,6,42,1
205559,6,0,6,43,1
205559,1,0,1,44,1
205559,5,0,5,45,1
205559,5,0,5,60,1
205568,76,13,63,1,4
205568,76,13,63,2,1
205568,76,13,63,3,1
205568,5,1,4,4,1
205568,71,12,59,5,1
205568,13,3,10,19,1
205568,58,9,49,20,1
205568,63,11,52,21,4
205568,63,11,52,22,1
205568,63,11,52,23,1
205568,5,1,4,24,1
205568,58,10,48,25,1
205568,11,2,9,39,1
205568,47,8,39,40,1
205568,13,2,11,41,4
205568,13,2,11,42,1
205568,13,2,11,43,1
205568,13,2,11,45,1
205568,2,1,1,59,1
205568,11,1,10,60,1
205610,1045,288,757,1,4
205610,1045,288,757,2,1
205610,1045,288,757,3,1
205610,172,52,120,4,1
205610,873,236,637,5,1
205610,141,34,107,19,1
205610,732,202,530,20,1
205610,1045,288,757,21,4
205610,1045,288,757,22,1
205610,1045,288,757,23,1
205610,172,52,120,24,1
205610,873,236,637,25,1
205610,141,34,107,39,1
205610,732,202,530,40,1
205647,694,144,550,1,4
205647,694,144,550,2,1
205647,694,144,550,3,1
205647,87,19,68,4,1
205647,607,125,482,5,1
205647,81,12,69,19,1
205647,526,113,413,20,1
205647,694,144,550,21,4
205647,694,144,550,22,1
205647,694,144,550,23,1
205647,87,19,68,24,1
205647,607,125,482,25,1
205647,81,12,69,39,1
205647,526,113,413,40,1
205708,123,28,95,1,4
205708,123,28,95,2,1
205708,114,26,88,3,1
205708,114,26,88,5,1
205708,9,2,7,11,1
205708,1,0,1,19,1
205708,113,26,87,20,1
205708,123,28,95,21,4
205708,123,28,95,22,1
205708,114,26,88,23,1
205708,114,26,88,25,1
205708,9,2,7,31,1
205708,1,0,1,39,1
205708,113,26,87,40,1
205726,58,9,49,1,4
205726,58,9,49,2,1
205726,58,9,49,3,1
205726,58,9,49,5,1
205726,58,9,49,20,1
205726,58,9,49,21,4
205726,58,9,49,22,1
205726,58,9,49,23,1
205726,58,9,49,25,1
205726,58,9,49,40,1
205841,15450,6173,9277,1,4
205841,15450,6173,9277,2,1
205841,12995,5094,7901,3,1
205841,2839,1325,1514,4,1
205841,10156,3769,6387,5,1
205841,2455,1079,1376,11,1
205841,1048,422,626,19,1
205841,9108,3347,5761,20,1
205841,4469,2031,2438,21,4
205841,4469,2031,2438,22,1
205841,4315,1976,2339,23,1
205841,1398,681,717,24,1
205841,2917,1295,1622,25,1
205841,154,55,99,31,1
205841,477,207,270,39,1
205841,2440,1088,1352,40,1
205841,10981,4142,6839,41,4
205841,10981,4142,6839,42,1
205841,8680,3118,5562,43,1
205841,1441,644,797,44,1
205841,7239,2474,4765,45,1
205841,2301,1024,1277,51,1
205841,571,215,356,59,1
205841,6668,2259,4409,60,1
205887,790,81,709,1,4
205887,790,81,709,2,1
205887,790,81,709,3,1
205887,32,4,28,4,1
205887,758,77,681,5,1
205887,173,20,153,19,1
205887,585,57,528,20,1
205887,383,27,356,21,4
205887,383,27,356,22,1
205887,383,27,356,23,1
205887,19,2,17,24,1
205887,364,25,339,25,1
205887,110,8,102,39,1
205887,254,17,237,40,1
205887,407,54,353,41,4
205887,407,54,353,42,1
205887,407,54,353,43,1
205887,13,2,11,44,1
205887,394,52,342,45,1
205887,63,12,51,59,1
205887,331,40,291,60,1
205957,2733,1054,1679,1,4
205957,2112,805,1307,2,1
205957,2055,782,1273,3,1
205957,460,150,310,4,1
205957,1595,632,963,5,1
205957,57,23,34,11,1
205957,621,249,372,12,3
205957,147,64,83,19,1
205957,1448,568,880,20,1
205957,2148,823,1325,21,4
205957,1989,752,1237,22,1
205957,1988,751,1237,23,1
205957,458,150,308,24,1
205957,1530,601,929,25,1
205957,1,1,0,31,1
205957,159,71,88,32,3
205957,142,61,81,39,1
205957,1388,540,848,40,1
205957,585,231,354,41,4
205957,123,53,70,42,1
205957,67,31,36,43,1
205957,2,0,2,44,1
205957,65,31,34,45,1
205957,56,22,34,51,1
205957,462,178,284,52,3
205957,5,3,2,59,1
205957,60,28,32,60,1
205966,2431,802,1629,1,4
205966,2431,802,1629,2,1
205966,2019,661,1358,3,1
205966,405,160,245,4,1
205966,1614,501,1113,5,1
205966,412,141,271,11,1
205966,67,32,35,19,1
205966,1547,469,1078,20,1
205966,1175,441,734,21,4
205966,1175,441,734,22,1
205966,1039,395,644,23,1
205966,289,127,162,24,1
205966,750,268,482,25,1
205966,136,46,90,31,1
205966,45,26,19,39,1
205966,705,242,463,40,1
205966,1256,361,895,41,4
205966,1256,361,895,42,1
205966,980,266,714,43,1
205966,116,33,83,44,1
205966,864,233,631,45,1
205966,276,95,181,51,1
205966,22,6,16,59,1
205966,842,227,615,60,1
206002,140,113,27,1,4
206002,140,113,27,2,1
206002,139,113,26,3,1
206002,70,55,15,4,1
206002,69,58,11,5,1
206002,1,0,1,11,1
206002,69,58,11,20,1
206002,135,111,24,21,4
206002,135,111,24,22,1
206002,135,111,24,23,1
206002,67,54,13,24,1
206002,68,57,11,25,1
206002,68,57,11,40,1
206002,5,2,3,41,4
206002,5,2,3,42,1
206002,4,2,2,43,1
206002,3,1,2,44,1
206002,1,1,0,45,1
206002,1,0,1,51,1
206002,1,1,0,60,1
206011,2923,1285,1638,1,4
206011,2923,1285,1638,2,1
206011,2339,1044,1295,3,1
206011,357,176,181,4,1
206011,1982,868,1114,5,1
206011,584,241,343,11,1
206011,259,114,145,19,1
206011,1723,754,969,20,1
206011,1092,449,643,21,4
206011,1092,449,643,22,1
206011,1032,429,603,23,1
206011,212,97,115,24,1
206011,820,332,488,25,1
206011,60,20,40,31,1
206011,128,56,72,39,1
206011,692,276,416,40,1
206011,1831,836,995,41,4
206011,1831,836,995,42,1
206011,1307,615,692,43,1
206011,145,79,66,44,1
206011,1162,536,626,45,1
206011,524,221,303,51,1
206011,131,58,73,59,1
206011,1031,478,553,60,1
206039,42,1,41,1,4
206039,42,1,41,2,1
206039,42,1,41,3,1
206039,17,1,16,4,1
206039,25,0,25,5,1
206039,25,0,25,20,1
206039,42,1,41,21,4
206039,42,1,41,22,1
206039,42,1,41,23,1
206039,17,1,16,24,1
206039,25,0,25,25,1
206039,25,0,25,40,1
206048,4954,2007,2947,1,4
206048,3764,1544,2220,2,1
206048,3309,1351,1958,3,1
206048,487,269,218,4,1
206048,2822,1082,1740,5,1
206048,455,193,262,11,1
206048,1190,463,727,12,3
206048,318,122,196,19,1
206048,2504,960,1544,20,1
206048,2323,1075,1248,21,4
206048,2145,1012,1133,22,1
206048,2142,1012,1130,23,1
206048,464,262,202,24,1
206048,1678,750,928,25,1
206048,3,0,3,31,1
206048,178,63,115,32,3
206048,208,90,118,39,1
206048,1470,660,810,40,1
206048,2631,932,1699,41,4
206048,1619,532,1087,42,1
206048,1167,339,828,43,1
206048,23,7,16,44,1
206048,1144,332,812,45,1
206048,452,193,259,51,1
206048,1012,400,612,52,3
206048,110,32,78,59,1
206048,1034,300,734,60,1
206084,20743,10322,10421,1,4
206084,16153,8253,7900,2,1
206084,15440,7936,7504,3,1
206084,3362,1654,1708,4,1
206084,12078,6282,5796,5,1
206084,713,317,396,11,1
206084,4590,2069,2521,12,3
206084,994,502,492,19,1
206084,11084,5780,5304,20,1
206084,16179,8259,7920,21,4
206084,13040,6715,6325,22,1
206084,12947,6654,6293,23,1
206084,3277,1602,1675,24,1
206084,9670,5052,4618,25,1
206084,93,61,32,31,1
206084,3139,1544,1595,32,3
206084,773,405,368,39,1
206084,8897,4647,4250,40,1
206084,4564,2063,2501,41,4
206084,3113,1538,1575,42,1
206084,2493,1282,1211,43,1
206084,85,52,33,44,1
206084,2408,1230,1178,45,1
206084,620,256,364,51,1
206084,1451,525,926,52,3
206084,221,97,124,59,1
206084,2187,1133,1054,60,1
206093,302,195,107,1,4
206093,302,195,107,2,1
206093,281,179,102,3,1
206093,63,35,28,4,1
206093,218,144,74,5,1
206093,21,16,5,11,1
206093,13,6,7,19,1
206093,205,138,67,20,1
206093,302,195,107,21,4
206093,302,195,107,22,1
206093,281,179,102,23,1
206093,63,35,28,24,1
206093,218,144,74,25,1
206093,21,16,5,31,1
206093,13,6,7,39,1
206093,205,138,67,40,1
206154,59,35,24,1,4
206154,59,35,24,2,1
206154,59,35,24,3,1
206154,4,3,1,4,1
206154,55,32,23,5,1
206154,7,4,3,19,1
206154,48,28,20,20,1
206154,23,17,6,21,4
206154,23,17,6,22,1
206154,23,17,6,23,1
206154,2,2,0,24,1
206154,21,15,6,25,1
206154,4,3,1,39,1
206154,17,12,5,40,1
206154,36,18,18,41,4
206154,36,18,18,42,1
206154,36,18,18,43,1
206154,2,1,1,44,1
206154,34,17,17,45,1
206154,3,1,2,59,1
206154,31,16,15,60,1
206172,129,28,101,1,4
206172,129,28,101,2,1
206172,129,28,101,3,1
206172,57,8,49,4,1
206172,72,20,52,5,1
206172,72,20,52,20,1
206172,129,28,101,21,4
206172,129,28,101,22,1
206172,129,28,101,23,1
206172,57,8,49,24,1
206172,72,20,52,25,1
206172,72,20,52,40,1
206181,158,36,122,1,4
206181,158,36,122,2,1
206181,158,36,122,3,1
206181,10,8,2,4,1
206181,148,28,120,5,1
206181,148,28,120,20,1
206181,124,20,104,21,4
206181,124,20,104,22,1
206181,124,20,104,23,1
206181,10,8,2,24,1
206181,114,12,102,25,1
206181,114,12,102,40,1
206181,34,16,18,41,4
206181,34,16,18,42,1
206181,34,16,18,43,1
206181,34,16,18,45,1
206181,34,16,18,60,1
206215,116,70,46,1,4
206215,116,70,46,12,3
206215,63,40,23,21,4
206215,63,40,23,32,3
206215,53,30,23,41,4
206215,53,30,23,52,3
206224,240,55,185,1,4
206224,240,55,185,2,1
206224,236,55,181,3,1
206224,33,10,23,4,1
206224,203,45,158,5,1
206224,4,0,4,11,1
206224,38,16,22,19,1
206224,165,29,136,20,1
206224,166,37,129,21,4
206224,166,37,129,22,1
206224,164,37,127,23,1
206224,29,8,21,24,1
206224,135,29,106,25,1
206224,2,0,2,31,1
206224,32,14,18,39,1
206224,103,15,88,40,1
206224,74,18,56,41,4
206224,74,18,56,42,1
206224,72,18,54,43,1
206224,4,2,2,44,1
206224,68,16,52,45,1
206224,2,0,2,51,1
206224,6,2,4,59,1
206224,62,14,48,60,1
206279,1660,681,979,1,4
206279,1241,562,679,2,1
206279,1217,551,666,3,1
206279,18,8,10,4,1
206279,1199,543,656,5,1
206279,24,11,13,11,1
206279,419,119,300,12,3
206279,399,154,245,19,1
206279,800,389,411,20,1
206279,1041,458,583,21,4
206279,775,375,400,22,1
206279,771,374,397,23,1
206279,12,4,8,24,1
206279,759,370,389,25,1
206279,4,1,3,31,1
206279,266,83,183,32,3
206279,273,107,166,39,1
206279,486,263,223,40,1
206279,619,223,396,41,4
206279,466,187,279,42,1
206279,446,177,269,43,1
206279,6,4,2,44,1
206279,440,173,267,45,1
206279,20,10,10,51,1
206279,153,36,117,52,3
206279,126,47,79,59,1
206279,314,126,188,60,1
206288,640,364,276,1,4
206288,640,364,276,12,3
206288,519,292,227,21,4
206288,519,292,227,32,3
206288,121,72,49,41,4
206288,121,72,49,52,3
206321,405,275,130,1,4
206321,405,275,130,2,1
206321,73,29,44,3,1
206321,44,23,21,4,1
206321,29,6,23,5,1
206321,332,246,86,11,1
206321,29,6,23,20,1
206321,38,4,34,21,4
206321,38,4,34,22,1
206321,38,4,34,23,1
206321,16,2,14,24,1
206321,22,2,20,25,1
206321,22,2,20,40,1
206321,367,271,96,41,4
206321,367,271,96,42,1
206321,35,25,10,43,1
206321,28,21,7,44,1
206321,7,4,3,45,1
206321,332,246,86,51,1
206321,7,4,3,60,1
206330,1748,751,997,1,4
206330,1584,695,889,2,1
206330,1008,480,528,3,1
206330,288,149,139,4,1
206330,720,331,389,5,1
206330,576,215,361,11,1
206330,164,56,108,12,3
206330,247,108,139,19,1
206330,473,223,250,20,1
206330,786,410,376,21,4
206330,755,393,362,22,1
206330,739,383,356,23,1
206330,251,143,108,24,1
206330,488,240,248,25,1
206330,16,10,6,31,1
206330,31,17,14,32,3
206330,147,82,65,39,1
206330,341,158,183,40,1
206330,962,341,621,41,4
206330,829,302,527,42,1
206330,269,97,172,43,1
206330,37,6,31,44,1
206330,232,91,141,45,1
206330,560,205,355,51,1
206330,133,39,94,52,3
206330,100,26,74,59,1
206330,132,65,67,60,1
206349,1357,131,1226,1,4
206349,805,66,739,2,1
206349,798,66,732,3,1
206349,103,3,100,4,1
206349,695,63,632,5,1
206349,7,0,7,11,1
206349,552,65,487,12,3
206349,104,13,91,19,1
206349,591,50,541,20,1
206349,626,44,582,21,4
206349,547,35,512,22,1
206349,547,35,512,23,1
206349,102,3,99,24,1
206349,445,32,413,25,1
206349,79,9,70,32,3
206349,48,4,44,39,1
206349,397,28,369,40,1
206349,731,87,644,41,4
206349,258,31,227,42,1
206349,251,31,220,43,1
206349,1,0,1,44,1
206349,250,31,219,45,1
206349,7,0,7,51,1
206349,473,56,417,52,3
206349,56,9,47,59,1
206349,194,22,172,60,1
206358,29,2,27,1,4
206358,29,2,27,2,1
206358,29,2,27,3,1
206358,8,2,6,4,1
206358,21,0,21,5,1
206358,21,0,21,20,1
206358,29,2,27,21,4
206358,29,2,27,22,1
206358,29,2,27,23,1
206358,8,2,6,24,1
206358,21,0,21,25,1
206358,21,0,21,40,1
206394,173,24,149,1,4
206394,173,24,149,2,1
206394,168,23,145,3,1
206394,15,4,11,4,1
206394,153,19,134,5,1
206394,5,1,4,11,1
206394,28,3,25,19,1
206394,125,16,109,20,1
206394,94,14,80,21,4
206394,94,14,80,22,1
206394,94,14,80,23,1
206394,10,2,8,24,1
206394,84,12,72,25,1
206394,17,1,16,39,1
206394,67,11,56,40,1
206394,79,10,69,41,4
206394,79,10,69,42,1
206394,74,9,65,43,1
206394,5,2,3,44,1
206394,69,7,62,45,1
206394,5,1,4,51,1
206394,11,2,9,59,1
206394,58,5,53,60,1
206437,2963,1090,1873,1,4
206437,2385,924,1461,2,1
206437,2280,887,1393,3,1
206437,493,216,277,4,1
206437,1787,671,1116,5,1
206437,105,37,68,11,1
206437,578,166,412,12,3
206437,146,65,81,19,1
206437,1641,606,1035,20,1
206437,2118,848,1270,21,4
206437,1916,781,1135,22,1
206437,1913,779,1134,23,1
206437,492,216,276,24,1
206437,1421,563,858,25,1
206437,3,2,1,31,1
206437,202,67,135,32,3
206437,86,47,39,39,1
206437,1335,516,819,40,1
206437,845,242,603,41,4
206437,469,143,326,42,1
206437,367,108,259,43,1
206437,1,0,1,44,1
206437,366,108,258,45,1
206437,102,35,67,51,1
206437,376,99,277,52,3
206437,60,18,42,59,1
206437,306,90,216,60,1
206446,1759,643,1116,1,4
206446,1759,643,1116,2,1
206446,1157,454,703,3,1
206446,188,84,104,4,1
206446,969,370,599,5,1
206446,602,189,413,11,1
206446,113,35,78,19,1
206446,856,335,521,20,1
206446,721,298,423,21,4
206446,721,298,423,22,1
206446,622,268,354,23,1
206446,129,60,69,24,1
206446,493,208,285,25,1
206446,99,30,69,31,1
206446,58,24,34,39,1
206446,435,184,251,40,1
206446,1038,345,693,41,4
206446,1038,345,693,42,1
206446,535,186,349,43,1
206446,59,24,35,44,1
206446,476,162,314,45,1
206446,503,159,344,51,1
206446,55,11,44,59,1
206446,421,151,270,60,1
206482,259,7,252,1,4
206482,259,7,252,2,1
206482,259,7,252,3,1
206482,62,4,58,4,1
206482,197,3,194,5,1
206482,197,3,194,20,1
206482,152,5,147,21,4
206482,152,5,147,22,1
206482,152,5,147,23,1
206482,39,3,36,24,1
206482,113,2,111,25,1
206482,113,2,111,40,1
206482,107,2,105,41,4
206482,107,2,105,42,1
206482,107,2,105,43,1
206482,23,1,22,44,1
206482,84,1,83,45,1
206482,84,1,83,60,1
206491,479,183,296,1,4
206491,463,179,284,2,1
206491,463,179,284,3,1
206491,70,30,40,4,1
206491,393,149,244,5,1
206491,16,4,12,12,3
206491,16,9,7,19,1
206491,377,140,237,20,1
206491,466,173,293,21,4
206491,451,170,281,22,1
206491,451,170,281,23,1
206491,70,30,40,24,1
206491,381,140,241,25,1
206491,15,3,12,32,3
206491,16,9,7,39,1
206491,365,131,234,40,1
206491,13,10,3,41,4
206491,12,9,3,42,1
206491,12,9,3,43,1
206491,12,9,3,45,1
206491,1,1,0,52,3
206491,12,9,3,60,1
206507,1173,549,624,1,4
206507,1169,548,621,2,1
206507,1163,542,621,3,1
206507,272,131,141,4,1
206507,891,411,480,5,1
206507,6,6,0,11,1
206507,4,1,3,12,3
206507,48,26,22,19,1
206507,843,385,458,20,1
206507,1031,491,540,21,4
206507,1030,491,539,22,1
206507,1030,491,539,23,1
206507,256,125,131,24,1
206507,774,366,408,25,1
206507,1,0,1,32,3
206507,48,26,22,39,1
206507,726,340,386,40,1
206507,142,58,84,41,4
206507,139,57,82,42,1
206507,133,51,82,43,1
206507,16,6,10,44,1
206507,117,45,72,45,1
206507,6,6,0,51,1
206507,3,1,2,52,3
206507,117,45,72,60,1
206516,60,34,26,1,4
206516,60,34,26,12,3
206516,25,16,9,21,4
206516,25,16,9,32,3
206516,35,18,17,41,4
206516,35,18,17,52,3
206525,1979,851,1128,1,4
206525,1959,851,1108,2,1
206525,1891,835,1056,3,1
206525,549,224,325,4,1
206525,1342,611,731,5,1
206525,68,16,52,11,1
206525,20,0,20,12,3
206525,32,18,14,19,1
206525,1310,593,717,20,1
206525,1853,819,1034,21,4
206525,1853,819,1034,22,1
206525,1845,814,1031,23,1
206525,549,224,325,24,1
206525,1296,590,706,25,1
206525,8,5,3,31,1
206525,32,18,14,39,1
206525,1264,572,692,40,1
206525,126,32,94,41,4
206525,106,32,74,42,1
206525,46,21,25,43,1
206525,46,21,25,45,1
206525,60,11,49,51,1
206525,20,0,20,52,3
206525,46,21,25,60,1
206589,2116,937,1179,1,4
206589,2116,937,1179,2,1
206589,2070,920,1150,3,1
206589,560,236,324,4,1
206589,1510,684,826,5,1
206589,46,17,29,11,1
206589,1510,684,826,20,1
206589,2077,922,1155,21,4
206589,2077,922,1155,22,1
206589,2060,917,1143,23,1
206589,560,236,324,24,1
206589,1500,681,819,25,1
206589,17,5,12,31,1
206589,1500,681,819,40,1
206589,39,15,24,41,4
206589,39,15,24,42,1
206589,10,3,7,43,1
206589,10,3,7,45,1
206589,29,12,17,51,1
206589,10,3,7,60,1
206604,16656,8001,8655,1,4
206604,12796,6222,6574,2,1
206604,12161,5906,6255,3,1
206604,2184,1017,1167,4,1
206604,9977,4889,5088,5,1
206604,635,316,319,11,1
206604,3860,1779,2081,12,3
206604,1147,579,568,19,1
206604,8830,4310,4520,20,1
206604,12900,6227,6673,21,4
206604,9987,4858,5129,22,1
206604,9940,4833,5107,23,1
206604,2141,990,1151,24,1
206604,7799,3843,3956,25,1
206604,47,25,22,31,1
206604,2913,1369,1544,32,3
206604,828,439,389,39,1
206604,6971,3404,3567,40,1
206604,3756,1774,1982,41,4
206604,2809,1364,1445,42,1
206604,2221,1073,1148,43,1
206604,43,27,16,44,1
206604,2178,1046,1132,45,1
206604,588,291,297,51,1
206604,947,410,537,52,3
206604,319,140,179,59,1
206604,1859,906,953,60,1
206613,1133,509,624,1,4
206613,1096,495,601,2,1
206613,926,433,493,3,1
206613,220,119,101,4,1
206613,706,314,392,5,1
206613,170,62,108,11,1
206613,37,14,23,12,3
206613,70,36,34,19,1
206613,636,278,358,20,1
206613,763,357,406,21,4
206613,729,344,385,22,1
206613,728,343,385,23,1
206613,205,109,96,24,1
206613,523,234,289,25,1
206613,1,1,0,31,1
206613,34,13,21,32,3
206613,47,26,21,39,1
206613,476,208,268,40,1
206613,370,152,218,41,4
206613,367,151,216,42,1
206613,198,90,108,43,1
206613,15,10,5,44,1
206613,183,80,103,45,1
206613,169,61,108,51,1
206613,3,1,2,52,3
206613,23,10,13,59,1
206613,160,70,90,60,1
206622,6633,2908,3725,1,4
206622,4620,2125,2495,2,1
206622,4452,2036,2416,3,1
206622,1289,566,723,4,1
206622,3163,1470,1693,5,1
206622,168,89,79,11,1
206622,2013,783,1230,12,3
206622,120,54,66,19,1
206622,3043,1416,1627,20,1
206622,4811,2175,2636,21,4
206622,4150,1912,2238,22,1
206622,4147,1910,2237,23,1
206622,1284,566,718,24,1
206622,2863,1344,1519,25,1
206622,3,2,1,31,1
206622,661,263,398,32,3
206622,80,40,40,39,1
206622,2783,1304,1479,40,1
206622,1822,733,1089,41,4
206622,470,213,257,42,1
206622,305,126,179,43,1
206622,5,0,5,44,1
206622,300,126,174,45,1
206622,165,87,78,51,1
206622,1352,520,832,52,3
206622,40,14,26,59,1
206622,260,112,148,60,1
206631,472,243,229,1,4
206631,472,243,229,2,1
206631,472,243,229,3,1
206631,66,38,28,4,1
206631,406,205,201,5,1
206631,15,5,10,19,1
206631,391,200,191,20,1
206631,372,190,182,21,4
206631,372,190,182,22,1
206631,372,190,182,23,1
206631,59,35,24,24,1
206631,313,155,158,25,1
206631,15,5,10,39,1
206631,298,150,148,40,1
206631,100,53,47,41,4
206631,100,53,47,42,1
206631,100,53,47,43,1
206631,7,3,4,44,1
206631,93,50,43,45,1
206631,93,50,43,60,1
206695,13352,6166,7186,1,4
206695,12138,5709,6429,2,1
206695,11613,5482,6131,3,1
206695,2090,977,1113,4,1
206695,9523,4505,5018,5,1
206695,525,227,298,11,1
206695,1214,457,757,12,3
206695,574,268,306,19,1
206695,8949,4237,4712,20,1
206695,10038,4815,5223,21,4
206695,9437,4573,4864,22,1
206695,9361,4555,4806,23,1
206695,1985,935,1050,24,1
206695,7376,3620,3756,25,1
206695,76,18,58,31,1
206695,601,242,359,32,3
206695,419,221,198,39,1
206695,6957,3399,3558,40,1
206695,3314,1351,1963,41,4
206695,2701,1136,1565,42,1
206695,2252,927,1325,43,1
206695,105,42,63,44,1
206695,2147,885,1262,45,1
206695,449,209,240,51,1
206695,613,215,398,52,3
206695,155,47,108,59,1
206695,1992,838,1154,60,1
206783,24,19,5,1,4
206783,24,19,5,2,1
206783,24,19,5,3,1
206783,4,4,0,4,1
206783,20,15,5,5,1
206783,20,15,5,20,1
206783,24,19,5,21,4
206783,24,19,5,22,1
206783,24,19,5,23,1
206783,4,4,0,24,1
206783,20,15,5,25,1
206783,20,15,5,40,1
206817,965,606,359,1,4
206817,965,606,359,2,1
206817,891,554,337,3,1
206817,243,165,78,4,1
206817,648,389,259,5,1
206817,74,52,22,11,1
206817,111,73,38,19,1
206817,537,316,221,20,1
206817,851,569,282,21,4
206817,851,569,282,22,1
206817,789,522,267,23,1
206817,237,163,74,24,1
206817,552,359,193,25,1
206817,62,47,15,31,1
206817,92,64,28,39,1
206817,460,295,165,40,1
206817,114,37,77,41,4
206817,114,37,77,42,1
206817,102,32,70,43,1
206817,6,2,4,44,1
206817,96,30,66,45,1
206817,12,5,7,51,1
206817,19,9,10,59,1
206817,77,21,56,60,1
206835,1355,531,824,1,4
206835,1214,471,743,2,1
206835,1110,425,685,3,1
206835,189,102,87,4,1
206835,921,323,598,5,1
206835,104,46,58,11,1
206835,141,60,81,12,3
206835,182,38,144,19,1
206835,739,285,454,20,1
206835,578,274,304,21,4
206835,571,270,301,22,1
206835,571,270,301,23,1
206835,177,94,83,24,1
206835,394,176,218,25,1
206835,7,4,3,32,3
206835,43,19,24,39,1
206835,351,157,194,40,1
206835,777,257,520,41,4
206835,643,201,442,42,1
206835,539,155,384,43,1
206835,12,8,4,44,1
206835,527,147,380,45,1
206835,104,46,58,51,1
206835,134,56,78,52,3
206835,139,19,120,59,1
206835,388,128,260,60,1
206862,2249,1029,1220,1,4
206862,1743,831,912,2,1
206862,1694,791,903,3,1
206862,283,152,131,4,1
206862,1411,639,772,5,1
206862,49,40,9,11,1
206862,506,198,308,12,3
206862,89,47,42,19,1
206862,1322,592,730,20,1
206862,2136,960,1176,21,4
206862,1634,763,871,22,1
206862,1631,762,869,23,1
206862,283,152,131,24,1
206862,1348,610,738,25,1
206862,3,1,2,31,1
206862,502,197,305,32,3
206862,84,42,42,39,1
206862,1264,568,696,40,1
206862,113,69,44,41,4
206862,109,68,41,42,1
206862,63,29,34,43,1
206862,63,29,34,45,1
206862,46,39,7,51,1
206862,4,1,3,52,3
206862,5,5,0,59,1
206862,58,24,34,60,1
206880,90,5,85,1,4
206880,90,5,85,2,1
206880,90,5,85,3,1
206880,44,2,42,4,1
206880,46,3,43,5,1
206880,46,3,43,20,1
206880,89,5,84,21,4
206880,89,5,84,22,1
206880,89,5,84,23,1
206880,44,2,42,24,1
206880,45,3,42,25,1
206880,45,3,42,40,1
206880,1,0,1,41,4
206880,1,0,1,42,1
206880,1,0,1,43,1
206880,1,0,1,45,1
206880,1,0,1,60,1
206905,117,59,58,1,4
206905,117,59,58,2,1
206905,117,59,58,3,1
206905,38,32,6,4,1
206905,79,27,52,5,1
206905,79,27,52,20,1
206905,96,49,47,21,4
206905,96,49,47,22,1
206905,96,49,47,23,1
206905,28,25,3,24,1
206905,68,24,44,25,1
206905,68,24,44,40,1
206905,21,10,11,41,4
206905,21,10,11,42,1
206905,21,10,11,43,1
206905,10,7,3,44,1
206905,11,3,8,45,1
206905,11,3,8,60,1
206914,5898,2271,3627,1,4
206914,5358,2094,3264,2,1
206914,5043,1963,3080,3,1
206914,946,380,566,4,1
206914,4097,1583,2514,5,1
206914,315,131,184,11,1
206914,540,177,363,12,3
206914,441,180,261,19,1
206914,3656,1403,2253,20,1
206914,3772,1552,2220,21,4
206914,3590,1489,2101,22,1
206914,3583,1486,2097,23,1
206914,829,339,490,24,1
206914,2754,1147,1607,25,1
206914,7,3,4,31,1
206914,182,63,119,32,3
206914,285,120,165,39,1
206914,2469,1027,1442,40,1
206914,2126,719,1407,41,4
206914,1768,605,1163,42,1
206914,1460,477,983,43,1
206914,117,41,76,44,1
206914,1343,436,907,45,1
206914,308,128,180,51,1
206914,358,114,244,52,3
206914,156,60,96,59,1
206914,1187,376,811,60,1
206923,2458,851,1607,1,4
206923,2458,851,1607,2,1
206923,2225,754,1471,3,1
206923,740,280,460,4,1
206923,1485,474,1011,5,1
206923,233,97,136,11,1
206923,96,34,62,19,1
206923,1389,440,949,20,1
206923,1609,592,1017,21,4
206923,1609,592,1017,22,1
206923,1601,588,1013,23,1
206923,607,233,374,24,1
206923,994,355,639,25,1
206923,8,4,4,31,1
206923,69,26,43,39,1
206923,925,329,596,40,1
206923,849,259,590,41,4
206923,849,259,590,42,1
206923,624,166,458,43,1
206923,133,47,86,44,1
206923,491,119,372,45,1
206923,225,93,132,51,1
206923,27,8,19,59,1
206923,464,111,353,60,1
206932,104,5,99,1,4
206932,104,5,99,2,1
206932,104,5,99,3,1
206932,23,2,21,4,1
206932,81,3,78,5,1
206932,81,3,78,20,1
206932,67,3,64,21,4
206932,67,3,64,22,1
206932,67,3,64,23,1
206932,11,0,11,24,1
206932,56,3,53,25,1
206932,56,3,53,40,1
206932,37,2,35,41,4
206932,37,2,35,42,1
206932,37,2,35,43,1
206932,12,2,10,44,1
206932,25,0,25,45,1
206932,25,0,25,60,1
206941,17220,7171,10049,1,4
206941,15218,6588,8630,2,1
206941,15119,6564,8555,3,1
206941,2223,965,1258,4,1
206941,12896,5599,7297,5,1
206941,99,24,75,11,1
206941,2002,583,1419,12,3
206941,1677,721,956,19,1
206941,11219,4878,6341,20,1
206941,11644,4968,6676,21,4
206941,10962,4775,6187,22,1
206941,10864,4751,6113,23,1
206941,2082,892,1190,24,1
206941,8782,3859,4923,25,1
206941,98,24,74,31,1
206941,682,193,489,32,3
206941,1171,526,645,39,1
206941,7611,3333,4278,40,1
206941,5576,2203,3373,41,4
206941,4256,1813,2443,42,1
206941,4255,1813,2442,43,1
206941,141,73,68,44,1
206941,4114,1740,2374,45,1
206941,1,0,1,51,1
206941,1320,390,930,52,3
206941,506,195,311,59,1
206941,3608,1545,2063,60,1
206969,17,0,17,1,4
206969,17,0,17,2,1
206969,17,0,17,3,1
206969,6,0,6,4,1
206969,11,0,11,5,1
206969,11,0,11,20,1
206969,17,0,17,21,4
206969,17,0,17,22,1
206969,17,0,17,23,1
206969,6,0,6,24,1
206969,11,0,11,25,1
206969,11,0,11,40,1
206996,2397,774,1623,1,4
206996,2397,774,1623,2,1
206996,1880,613,1267,3,1
206996,603,222,381,4,1
206996,1277,391,886,5,1
206996,517,161,356,11,1
206996,116,34,82,19,1
206996,1161,357,804,20,1
206996,1474,544,930,21,4
206996,1474,544,930,22,1
206996,1318,496,822,23,1
206996,501,193,308,24,1
206996,817,303,514,25,1
206996,156,48,108,31,1
206996,64,25,39,39,1
206996,753,278,475,40,1
206996,923,230,693,41,4
206996,923,230,693,42,1
206996,562,117,445,43,1
206996,102,29,73,44,1
206996,460,88,372,45,1
206996,361,113,248,51,1
206996,52,9,43,59,1
206996,408,79,329,60,1
207041,4587,1729,2858,1,4
207041,3757,1488,2269,2,1
207041,3757,1488,2269,3,1
207041,612,269,343,4,1
207041,3145,1219,1926,5,1
207041,830,241,589,12,3
207041,392,157,235,19,1
207041,2753,1062,1691,20,1
207041,3327,1356,1971,21,4
207041,3061,1272,1789,22,1
207041,3061,1272,1789,23,1
207041,596,263,333,24,1
207041,2465,1009,1456,25,1
207041,266,84,182,32,3
207041,308,137,171,39,1
207041,2157,872,1285,40,1
207041,1260,373,887,41,4
207041,696,216,480,42,1
207041,696,216,480,43,1
207041,16,6,10,44,1
207041,680,210,470,45,1
207041,564,157,407,52,3
207041,84,20,64,59,1
207041,596,190,406,60,1
207050,1832,579,1253,1,4
207050,1832,579,1253,2,1
207050,1477,474,1003,3,1
207050,347,146,201,4,1
207050,1130,328,802,5,1
207050,355,105,250,11,1
207050,134,44,90,19,1
207050,996,284,712,20,1
207050,995,381,614,21,4
207050,995,381,614,22,1
207050,986,378,608,23,1
207050,280,124,156,24,1
207050,706,254,452,25,1
207050,9,3,6,31,1
207050,81,36,45,39,1
207050,625,218,407,40,1
207050,837,198,639,41,4
207050,837,198,639,42,1
207050,491,96,395,43,1
207050,67,22,45,44,1
207050,424,74,350,45,1
207050,346,102,244,51,1
207050,53,8,45,59,1
207050,371,66,305,60,1
207069,2971,1122,1849,1,4
207069,2971,1122,1849,2,1
207069,1521,527,994,3,1
207069,414,175,239,4,1
207069,1107,352,755,5,1
207069,1450,595,855,11,1
207069,527,172,355,19,1
207069,580,180,400,20,1
207069,780,328,452,21,4
207069,780,328,452,22,1
207069,770,324,446,23,1
207069,297,133,164,24,1
207069,473,191,282,25,1
207069,10,4,6,31,1
207069,185,71,114,39,1
207069,288,120,168,40,1
207069,2191,794,1397,41,4
207069,2191,794,1397,42,1
207069,751,203,548,43,1
207069,117,42,75,44,1
207069,634,161,473,45,1
207069,1440,591,849,51,1
207069,342,101,241,59,1
207069,292,60,232,60,1
207087,43,2,41,1,4
207087,43,2,41,2,1
207087,43,2,41,3,1
207087,15,0,15,4,1
207087,28,2,26,5,1
207087,28,2,26,20,1
207087,43,2,41,21,4
207087,43,2,41,22,1
207087,43,2,41,23,1
207087,15,0,15,24,1
207087,28,2,26,25,1
207087,28,2,26,40,1
207102,86,7,79,1,4
207102,86,7,79,2,1
207102,86,7,79,3,1
207102,51,4,47,4,1
207102,35,3,32,5,1
207102,35,3,32,20,1
207102,86,7,79,21,4
207102,86,7,79,22,1
207102,86,7,79,23,1
207102,51,4,47,24,1
207102,35,3,32,25,1
207102,35,3,32,40,1
207157,202,135,67,1,4
207157,197,130,67,2,1
207157,195,130,65,3,1
207157,41,24,17,4,1
207157,154,106,48,5,1
207157,2,0,2,11,1
207157,5,5,0,12,3
207157,154,106,48,20,1
207157,169,111,58,21,4
207157,168,110,58,22,1
207157,168,110,58,23,1
207157,40,24,16,24,1
207157,128,86,42,25,1
207157,1,1,0,32,3
207157,128,86,42,40,1
207157,33,24,9,41,4
207157,29,20,9,42,1
207157,27,20,7,43,1
207157,1,0,1,44,1
207157,26,20,6,45,1
207157,2,0,2,51,1
207157,4,4,0,52,3
207157,26,20,6,60,1
207166,17,2,15,1,4
207166,17,2,15,2,1
207166,17,2,15,3,1
207166,11,2,9,4,1
207166,6,0,6,5,1
207166,6,0,6,20,1
207166,17,2,15,21,4
207166,17,2,15,22,1
207166,17,2,15,23,1
207166,11,2,9,24,1
207166,6,0,6,25,1
207166,6,0,6,40,1
207209,2533,984,1549,1,4
207209,2075,836,1239,2,1
207209,2062,834,1228,3,1
207209,598,273,325,4,1
207209,1464,561,903,5,1
207209,13,2,11,11,1
207209,458,148,310,12,3
207209,610,209,401,19,1
207209,854,352,502,20,1
207209,2025,840,1185,21,4
207209,1841,776,1065,22,1
207209,1841,776,1065,23,1
207209,597,273,324,24,1
207209,1244,503,741,25,1
207209,184,64,120,32,3
207209,464,175,289,39,1
207209,780,328,452,40,1
207209,508,144,364,41,4
207209,234,60,174,42,1
207209,221,58,163,43,1
207209,1,0,1,44,1
207209,220,58,162,45,1
207209,13,2,11,51,1
207209,274,84,190,52,3
207209,146,34,112,59,1
207209,74,24,50,60,1
207236,2343,705,1638,1,4
207236,2343,705,1638,2,1
207236,1802,543,1259,3,1
207236,608,212,396,4,1
207236,1194,331,863,5,1
207236,541,162,379,11,1
207236,239,74,165,19,1
207236,955,257,698,20,1
207236,1070,394,676,21,4
207236,1070,394,676,22,1
207236,1016,375,641,23,1
207236,441,163,278,24,1
207236,575,212,363,25,1
207236,54,19,35,31,1
207236,95,44,51,39,1
207236,480,168,312,40,1
207236,1273,311,962,41,4
207236,1273,311,962,42,1
207236,786,168,618,43,1
207236,167,49,118,44,1
207236,619,119,500,45,1
207236,487,143,344,51,1
207236,144,30,114,59,1
207236,475,89,386,60,1
207254,817,739,78,1,4
207254,817,739,78,2,1
207254,817,739,78,3,1
207254,303,266,37,4,1
207254,514,473,41,5,1
207254,514,473,41,20,1
207254,817,739,78,21,4
207254,817,739,78,22,1
207254,817,739,78,23,1
207254,303,266,37,24,1
207254,514,473,41,25,1
207254,514,473,41,40,1
207263,8548,3332,5216,1,4
207263,7418,2969,4449,2,1
207263,7215,2892,4323,3,1
207263,872,399,473,4,1
207263,6343,2493,3850,5,1
207263,203,77,126,11,1
207263,1130,363,767,12,3
207263,1296,471,825,19,1
207263,5047,2022,3025,20,1
207263,5695,2384,3311,21,4
207263,5283,2225,3058,22,1
207263,5283,2225,3058,23,1
207263,852,393,459,24,1
207263,4431,1832,2599,25,1
207263,412,159,253,32,3
207263,774,315,459,39,1
207263,3657,1517,2140,40,1
207263,2853,948,1905,41,4
207263,2135,744,1391,42,1
207263,1932,667,1265,43,1
207263,20,6,14,44,1
207263,1912,661,1251,45,1
207263,203,77,126,51,1
207263,718,204,514,52,3
207263,522,156,366,59,1
207263,1390,505,885,60,1
207272,24,0,24,1,4
207272,24,0,24,2,1
207272,24,0,24,3,1
207272,16,0,16,4,1
207272,8,0,8,5,1
207272,8,0,8,20,1
207272,24,0,24,21,4
207272,24,0,24,22,1
207272,24,0,24,23,1
207272,16,0,16,24,1
207272,8,0,8,25,1
207272,8,0,8,40,1
207281,4909,1944,2965,1,4
207281,4909,1944,2965,2,1
207281,4205,1642,2563,3,1
207281,1004,447,557,4,1
207281,3201,1195,2006,5,1
207281,704,302,402,11,1
207281,886,384,502,19,1
207281,2315,811,1504,20,1
207281,2348,1024,1324,21,4
207281,2348,1024,1324,22,1
207281,2316,1012,1304,23,1
207281,815,383,432,24,1
207281,1501,629,872,25,1
207281,32,12,20,31,1
207281,230,113,117,39,1
207281,1271,516,755,40,1
207281,2561,920,1641,41,4
207281,2561,920,1641,42,1
207281,1889,630,1259,43,1
207281,189,64,125,44,1
207281,1700,566,1134,45,1
207281,672,290,382,51,1
207281,656,271,385,59,1
207281,1044,295,749,60,1
207290,2347,1053,1294,1,4
207290,2347,1053,1294,2,1
207290,2137,986,1151,3,1
207290,788,427,361,4,1
207290,1349,559,790,5,1
207290,210,67,143,11,1
207290,201,88,113,19,1
207290,1148,471,677,20,1
207290,1744,882,862,21,4
207290,1744,882,862,22,1
207290,1723,875,848,23,1
207290,728,409,319,24,1
207290,995,466,529,25,1
207290,21,7,14,31,1
207290,139,72,67,39,1
207290,856,394,462,40,1
207290,603,171,432,41,4
207290,603,171,432,42,1
207290,414,111,303,43,1
207290,60,18,42,44,1
207290,354,93,261,45,1
207290,189,60,129,51,1
207290,62,16,46,59,1
207290,292,77,215,60,1
207306,2307,993,1314,1,4
207306,2077,916,1161,2,1
207306,2005,892,1113,3,1
207306,431,224,207,4,1
207306,1574,668,906,5,1
207306,72,24,48,11,1
207306,230,77,153,12,3
207306,227,79,148,19,1
207306,1347,589,758,20,1
207306,1605,740,865,21,4
207306,1516,714,802,22,1
207306,1516,714,802,23,1
207306,386,200,186,24,1
207306,1130,514,616,25,1
207306,89,26,63,32,3
207306,129,56,73,39,1
207306,1001,458,543,40,1
207306,702,253,449,41,4
207306,561,202,359,42,1
207306,489,178,311,43,1
207306,45,24,21,44,1
207306,444,154,290,45,1
207306,72,24,48,51,1
207306,141,51,90,52,3
207306,98,23,75,59,1
207306,346,131,215,60,1
207315,475,250,225,1,4
207315,475,250,225,12,3
207315,434,232,202,21,4
207315,434,232,202,32,3
207315,41,18,23,41,4
207315,41,18,23,52,3
207324,2421,1282,1139,1,4
207324,1962,1009,953,2,1
207324,1949,1003,946,3,1
207324,530,268,262,4,1
207324,1419,735,684,5,1
207324,13,6,7,11,1
207324,459,273,186,12,3
207324,138,71,67,19,1
207324,1281,664,617,20,1
207324,2116,1101,1015,21,4
207324,1874,967,907,22,1
207324,1865,963,902,23,1
207324,526,264,262,24,1
207324,1339,699,640,25,1
207324,9,4,5,31,1
207324,242,134,108,32,3
207324,128,69,59,39,1
207324,1211,630,581,40,1
207324,305,181,124,41,4
207324,88,42,46,42,1
207324,84,40,44,43,1
207324,4,4,0,44,1
207324,80,36,44,45,1
207324,4,2,2,51,1
207324,217,139,78,52,3
207324,10,2,8,59,1
207324,70,34,36,60,1
207342,3515,1184,2331,1,4
207342,820,104,716,2,1
207342,818,103,715,3,1
207342,818,103,715,5,1
207342,2,1,1,11,1
207342,2695,1080,1615,12,3
207342,443,56,387,19,1
207342,375,47,328,20,1
207342,2963,1030,1933,21,4
207342,782,92,690,22,1
207342,782,92,690,23,1
207342,782,92,690,25,1
207342,2181,938,1243,32,3
207342,429,53,376,39,1
207342,353,39,314,40,1
207342,552,154,398,41,4
207342,38,12,26,42,1
207342,36,11,25,43,1
207342,36,11,25,45,1
207342,2,1,1,51,1
207342,514,142,372,52,3
207342,14,3,11,59,1
207342,22,8,14,60,1
207351,1375,640,735,1,4
207351,1375,640,735,2,1
207351,1238,589,649,3,1
207351,278,161,117,4,1
207351,960,428,532,5,1
207351,137,51,86,11,1
207351,21,11,10,19,1
207351,939,417,522,20,1
207351,1041,553,488,21,4
207351,1041,553,488,22,1
207351,1034,551,483,23,1
207351,271,160,111,24,1
207351,763,391,372,25,1
207351,7,2,5,31,1
207351,18,11,7,39,1
207351,745,380,365,40,1
207351,334,87,247,41,4
207351,334,87,247,42,1
207351,204,38,166,43,1
207351,7,1,6,44,1
207351,197,37,160,45,1
207351,130,49,81,51,1
207351,3,0,3,59,1
207351,194,37,157,60,1
207388,26073,13446,12627,1,4
207388,20660,10491,10169,2,1
207388,20314,10375,9939,3,1
207388,3851,1829,2022,4,1
207388,16463,8546,7917,5,1
207388,346,116,230,11,1
207388,5413,2955,2458,12,3
207388,1565,786,779,19,1
207388,14898,7760,7138,20,1
207388,19959,10099,9860,21,4
207388,17793,9048,8745,22,1
207388,17747,9025,8722,23,1
207388,3701,1749,1952,24,1
207388,14046,7276,6770,25,1
207388,46,23,23,31,1
207388,2166,1051,1115,32,3
207388,1258,653,605,39,1
207388,12788,6623,6165,40,1
207388,6114,3347,2767,41,4
207388,2867,1443,1424,42,1
207388,2567,1350,1217,43,1
207388,150,80,70,44,1
207388,2417,1270,1147,45,1
207388,300,93,207,51,1
207388,3247,1904,1343,52,3
207388,307,133,174,59,1
207388,2110,1137,973,60,1
207397,6996,2818,4178,1,4
207397,6996,2818,4178,2,1
207397,6529,2634,3895,3,1
207397,988,474,514,4,1
207397,5541,2160,3381,5,1
207397,467,184,283,11,1
207397,3261,1363,1898,19,1
207397,2280,797,1483,20,1
207397,2251,1030,1221,21,4
207397,2251,1030,1221,22,1
207397,2248,1029,1219,23,1
207397,524,254,270,24,1
207397,1724,775,949,25,1
207397,3,1,2,31,1
207397,1008,477,531,39,1
207397,716,298,418,40,1
207397,4745,1788,2957,41,4
207397,4745,1788,2957,42,1
207397,4281,1605,2676,43,1
207397,464,220,244,44,1
207397,3817,1385,2432,45,1
207397,464,183,281,51,1
207397,2253,886,1367,59,1
207397,1564,499,1065,60,1
207403,2097,853,1244,1,4
207403,2019,819,1200,2,1
207403,1882,742,1140,3,1
207403,580,216,364,4,1
207403,1302,526,776,5,1
207403,137,77,60,11,1
207403,78,34,44,12,3
207403,90,43,47,19,1
207403,1212,483,729,20,1
207403,1931,754,1177,21,4
207403,1868,731,1137,22,1
207403,1836,716,1120,23,1
207403,578,215,363,24,1
207403,1258,501,757,25,1
207403,32,15,17,31,1
207403,63,23,40,32,3
207403,90,43,47,39,1
207403,1168,458,710,40,1
207403,166,99,67,41,4
207403,151,88,63,42,1
207403,46,26,20,43,1
207403,2,1,1,44,1
207403,44,25,19,45,1
207403,105,62,43,51,1
207403,15,11,4,52,3
207403,44,25,19,60,1
207449,13491,5655,7836,1,4
207449,13491,5655,7836,2,1
207449,12594,5257,7337,3,1
207449,2417,1114,1303,4,1
207449,10177,4143,6034,5,1
207449,897,398,499,11,1
207449,1055,425,630,19,1
207449,9122,3718,5404,20,1
207449,4617,2067,2550,21,4
207449,4617,2067,2550,22,1
207449,4593,2055,2538,23,1
207449,1158,546,612,24,1
207449,3435,1509,1926,25,1
207449,24,12,12,31,1
207449,323,149,174,39,1
207449,3112,1360,1752,40,1
207449,8874,3588,5286,41,4
207449,8874,3588,5286,42,1
207449,8001,3202,4799,43,1
207449,1259,568,691,44,1
207449,6742,2634,4108,45,1
207449,873,386,487,51,1
207449,732,276,456,59,1
207449,6010,2358,3652,60,1
207458,3179,1323,1856,1,4
207458,1964,749,1215,2,1
207458,1954,745,1209,3,1
207458,355,133,222,4,1
207458,1599,612,987,5,1
207458,10,4,6,11,1
207458,1215,574,641,12,3
207458,235,88,147,19,1
207458,1364,524,840,20,1
207458,2573,1081,1492,21,4
207458,1754,674,1080,22,1
207458,1754,674,1080,23,1
207458,355,133,222,24,1
207458,1399,541,858,25,1
207458,819,407,412,32,3
207458,186,73,113,39,1
207458,1213,468,745,40,1
207458,606,242,364,41,4
207458,210,75,135,42,1
207458,200,71,129,43,1
207458,200,71,129,45,1
207458,10,4,6,51,1
207458,396,167,229,52,3
207458,49,15,34,59,1
207458,151,56,95,60,1
207500,27292,13814,13478,1,4
207500,20985,10645,10340,2,1
207500,20528,10434,10094,3,1
207500,4052,1964,2088,4,1
207500,16476,8470,8006,5,1
207500,457,211,246,11,1
207500,6307,3169,3138,12,3
207500,1173,634,539,19,1
207500,15303,7836,7467,20,1
207500,20627,10380,10247,21,4
207500,17559,8846,8713,22,1
207500,17399,8769,8630,23,1
207500,3727,1849,1878,24,1
207500,13672,6920,6752,25,1
207500,160,77,83,31,1
207500,3068,1534,1534,32,3
207500,873,481,392,39,1
207500,12799,6439,6360,40,1
207500,6665,3434,3231,41,4
207500,3426,1799,1627,42,1
207500,3129,1665,1464,43,1
207500,325,115,210,44,1
207500,2804,1550,1254,45,1
207500,297,134,163,51,1
207500,3239,1635,1604,52,3
207500,300,153,147,59,1
207500,2504,1397,1107,60,1
207537,44,5,39,1,4
207537,44,5,39,2,1
207537,44,5,39,3,1
207537,12,2,10,4,1
207537,32,3,29,5,1
207537,32,3,29,20,1
207537,44,5,39,21,4
207537,44,5,39,22,1
207537,44,5,39,23,1
207537,12,2,10,24,1
207537,32,3,29,25,1
207537,32,3,29,40,1
207564,3618,2334,1284,1,4
207564,3618,2334,1284,2,1
207564,2841,1848,993,3,1
207564,885,611,274,4,1
207564,1956,1237,719,5,1
207564,777,486,291,11,1
207564,12,6,6,19,1
207564,1944,1231,713,20,1
207564,2207,1460,747,21,4
207564,2207,1460,747,22,1
207564,2077,1387,690,23,1
207564,542,404,138,24,1
207564,1535,983,552,25,1
207564,130,73,57,31,1
207564,1,0,1,39,1
207564,1534,983,551,40,1
207564,1411,874,537,41,4
207564,1411,874,537,42,1
207564,764,461,303,43,1
207564,343,207,136,44,1
207564,421,254,167,45,1
207564,647,413,234,51,1
207564,11,6,5,59,1
207564,410,248,162,60,1
207582,3414,1503,1911,1,4
207582,2884,1255,1629,2,1
207582,2884,1255,1629,3,1
207582,397,194,203,4,1
207582,2487,1061,1426,5,1
207582,530,248,282,12,3
207582,220,98,122,19,1
207582,2267,963,1304,20,1
207582,2862,1265,1597,21,4
207582,2517,1100,1417,22,1
207582,2517,1100,1417,23,1
207582,393,192,201,24,1
207582,2124,908,1216,25,1
207582,345,165,180,32,3
207582,200,87,113,39,1
207582,1924,821,1103,40,1
207582,552,238,314,41,4
207582,367,155,212,42,1
207582,367,155,212,43,1
207582,4,2,2,44,1
207582,363,153,210,45,1
207582,185,83,102,52,3
207582,20,11,9,59,1
207582,343,142,201,60,1
207607,624,291,333,1,4
207607,624,291,333,2,1
207607,624,291,333,3,1
207607,82,50,32,4,1
207607,542,241,301,5,1
207607,542,241,301,20,1
207607,122,66,56,21,4
207607,122,66,56,22,1
207607,122,66,56,23,1
207607,34,16,18,24,1
207607,88,50,38,25,1
207607,88,50,38,40,1
207607,502,225,277,41,4
207607,502,225,277,42,1
207607,502,225,277,43,1
207607,48,34,14,44,1
207607,454,191,263,45,1
207607,454,191,263,60,1
207625,200,17,183,1,4
207625,200,17,183,2,1
207625,200,17,183,3,1
207625,26,2,24,4,1
207625,174,15,159,5,1
207625,35,4,31,19,1
207625,139,11,128,20,1
207625,200,17,183,21,4
207625,200,17,183,22,1
207625,200,17,183,23,1
207625,26,2,24,24,1
207625,174,15,159,25,1
207625,35,4,31,39,1
207625,139,11,128,40,1
207661,4473,1675,2798,1,4
207661,4473,1675,2798,2,1
207661,3957,1480,2477,3,1
207661,800,319,481,4,1
207661,3157,1161,1996,5,1
207661,516,195,321,11,1
207661,335,149,186,19,1
207661,2822,1012,1810,20,1
207661,2600,1016,1584,21,4
207661,2600,1016,1584,22,1
207661,2594,1013,1581,23,1
207661,645,258,387,24,1
207661,1949,755,1194,25,1
207661,6,3,3,31,1
207661,227,102,125,39,1
207661,1722,653,1069,40,1
207661,1873,659,1214,41,4
207661,1873,659,1214,42,1
207661,1363,467,896,43,1
207661,155,61,94,44,1
207661,1208,406,802,45,1
207661,510,192,318,51,1
207661,108,47,61,59,1
207661,1100,359,741,60,1
207670,7193,2885,4308,1,4
207670,7193,2885,4308,2,1
207670,6427,2509,3918,3,1
207670,1334,583,751,4,1
207670,5093,1926,3167,5,1
207670,766,376,390,11,1
207670,1008,437,571,19,1
207670,4085,1489,2596,20,1
207670,2688,1087,1601,21,4
207670,2688,1087,1601,22,1
207670,2645,1068,1577,23,1
207670,822,340,482,24,1
207670,1823,728,1095,25,1
207670,43,19,24,31,1
207670,307,130,177,39,1
207670,1516,598,918,40,1
207670,4505,1798,2707,41,4
207670,4505,1798,2707,42,1
207670,3782,1441,2341,43,1
207670,512,243,269,44,1
207670,3270,1198,2072,45,1
207670,723,357,366,51,1
207670,701,307,394,59,1
207670,2569,891,1678,60,1
207689,684,300,384,1,4
207689,633,271,362,2,1
207689,624,270,354,3,1
207689,123,53,70,4,1
207689,501,217,284,5,1
207689,9,1,8,11,1
207689,51,29,22,12,3
207689,36,23,13,19,1
207689,465,194,271,20,1
207689,382,174,208,21,4
207689,369,165,204,22,1
207689,369,165,204,23,1
207689,108,45,63,24,1
207689,261,120,141,25,1
207689,13,9,4,32,3
207689,24,14,10,39,1
207689,237,106,131,40,1
207689,302,126,176,41,4
207689,264,106,158,42,1
207689,255,105,150,43,1
207689,15,8,7,44,1
207689,240,97,143,45,1
207689,9,1,8,51,1
207689,38,20,18,52,3
207689,12,9,3,59,1
207689,228,88,140,60,1
207704,83,1,82,1,4
207704,83,1,82,2,1
207704,83,1,82,3,1
207704,13,0,13,4,1
207704,70,1,69,5,1
207704,70,1,69,20,1
207704,83,1,82,21,4
207704,83,1,82,22,1
207704,83,1,82,23,1
207704,13,0,13,24,1
207704,70,1,69,25,1
207704,70,1,69,40,1
207722,918,334,584,1,4
207722,918,334,584,2,1
207722,864,314,550,3,1
207722,173,52,121,4,1
207722,691,262,429,5,1
207722,54,20,34,11,1
207722,147,73,74,19,1
207722,544,189,355,20,1
207722,805,294,511,21,4
207722,805,294,511,22,1
207722,805,294,511,23,1
207722,173,52,121,24,1
207722,632,242,390,25,1
207722,140,69,71,39,1
207722,492,173,319,40,1
207722,113,40,73,41,4
207722,113,40,73,42,1
207722,59,20,39,43,1
207722,59,20,39,45,1
207722,54,20,34,51,1
207722,7,4,3,59,1
207722,52,16,36,60,1
207740,2020,698,1322,1,4
207740,2020,698,1322,2,1
207740,1618,562,1056,3,1
207740,578,240,338,4,1
207740,1040,322,718,5,1
207740,402,136,266,11,1
207740,213,73,140,19,1
207740,827,249,578,20,1
207740,928,335,593,21,4
207740,928,335,593,22,1
207740,917,330,587,23,1
207740,408,165,243,24,1
207740,509,165,344,25,1
207740,11,5,6,31,1
207740,115,38,77,39,1
207740,394,127,267,40,1
207740,1092,363,729,41,4
207740,1092,363,729,42,1
207740,701,232,469,43,1
207740,170,75,95,44,1
207740,531,157,374,45,1
207740,391,131,260,51,1
207740,98,35,63,59,1
207740,433,122,311,60,1
207786,30,1,29,1,4
207786,30,1,29,2,1
207786,30,1,29,3,1
207786,28,1,27,4,1
207786,2,0,2,5,1
207786,2,0,2,20,1
207786,30,1,29,21,4
207786,30,1,29,22,1
207786,30,1,29,23,1
207786,28,1,27,24,1
207786,2,0,2,25,1
207786,2,0,2,40,1
207847,3826,1773,2053,1,4
207847,3498,1600,1898,2,1
207847,3363,1536,1827,3,1
207847,533,256,277,4,1
207847,2830,1280,1550,5,1
207847,135,64,71,11,1
207847,328,173,155,12,3
207847,690,332,358,19,1
207847,2140,948,1192,20,1
207847,2777,1335,1442,21,4
207847,2668,1276,1392,22,1
207847,2666,1275,1391,23,1
207847,511,249,262,24,1
207847,2155,1026,1129,25,1
207847,2,1,1,31,1
207847,109,59,50,32,3
207847,475,247,228,39,1
207847,1680,779,901,40,1
207847,1049,438,611,41,4
207847,830,324,506,42,1
207847,697,261,436,43,1
207847,22,7,15,44,1
207847,675,254,421,45,1
207847,133,63,70,51,1
207847,219,114,105,52,3
207847,215,85,130,59,1
207847,460,169,291,60,1
207856,847,388,459,1,4
207856,804,365,439,2,1
207856,801,364,437,3,1
207856,209,122,87,4,1
207856,592,242,350,5,1
207856,3,1,2,11,1
207856,43,23,20,12,3
207856,143,52,91,19,1
207856,449,190,259,20,1
207856,600,289,311,21,4
207856,565,271,294,22,1
207856,565,271,294,23,1
207856,157,89,68,24,1
207856,408,182,226,25,1
207856,35,18,17,32,3
207856,63,29,34,39,1
207856,345,153,192,40,1
207856,247,99,148,41,4
207856,239,94,145,42,1
207856,236,93,143,43,1
207856,52,33,19,44,1
207856,184,60,124,45,1
207856,3,1,2,51,1
207856,8,5,3,52,3
207856,80,23,57,59,1
207856,104,37,67,60,1
207865,4942,2078,2864,1,4
207865,4162,1756,2406,2,1
207865,3985,1678,2307,3,1
207865,898,397,501,4,1
207865,3087,1281,1806,5,1
207865,177,78,99,11,1
207865,780,322,458,12,3
207865,348,136,212,19,1
207865,2739,1145,1594,20,1
207865,3871,1697,2174,21,4
207865,3368,1482,1886,22,1
207865,3367,1482,1885,23,1
207865,875,386,489,24,1
207865,2492,1096,1396,25,1
207865,1,0,1,31,1
207865,503,215,288,32,3
207865,270,121,149,39,1
207865,2222,975,1247,40,1
207865,1071,381,690,41,4
207865,794,274,520,42,1
207865,618,196,422,43,1
207865,23,11,12,44,1
207865,595,185,410,45,1
207865,176,78,98,51,1
207865,277,107,170,52,3
207865,78,15,63,59,1
207865,517,170,347,60,1
207935,18640,7370,11270,1,4
207935,18640,7370,11270,2,1
207935,14559,5734,8825,3,1
207935,3267,1462,1805,4,1
207935,11292,4272,7020,5,1
207935,4081,1636,2445,11,1
207935,985,409,576,19,1
207935,10307,3863,6444,20,1
207935,6367,2718,3649,21,4
207935,6367,2718,3649,22,1
207935,5444,2303,3141,23,1
207935,1720,791,929,24,1
207935,3724,1512,2212,25,1
207935,923,415,508,31,1
207935,316,138,178,39,1
207935,3408,1374,2034,40,1
207935,12273,4652,7621,41,4
207935,12273,4652,7621,42,1
207935,9115,3431,5684,43,1
207935,1547,671,876,44,1
207935,7568,2760,4808,45,1
207935,3158,1221,1937,51,1
207935,669,271,398,59,1
207935,6899,2489,4410,60,1
207962,1094,1022,72,1,4
207962,1094,1022,72,2,1
207962,1094,1022,72,3,1
207962,522,481,41,4,1
207962,572,541,31,5,1
207962,572,541,31,20,1
207962,1094,1022,72,21,4
207962,1094,1022,72,22,1
207962,1094,1022,72,23,1
207962,522,481,41,24,1
207962,572,541,31,25,1
207962,572,541,31,40,1
207971,4597,2638,1959,1,4
207971,3428,1981,1447,2,1
207971,3394,1969,1425,3,1
207971,856,490,366,4,1
207971,2538,1479,1059,5,1
207971,34,12,22,11,1
207971,1169,657,512,12,3
207971,152,80,72,19,1
207971,2386,1399,987,20,1
207971,4102,2340,1762,21,4
207971,3293,1905,1388,22,1
207971,3272,1897,1375,23,1
207971,851,488,363,24,1
207971,2421,1409,1012,25,1
207971,21,8,13,31,1
207971,809,435,374,32,3
207971,141,76,65,39,1
207971,2280,1333,947,40,1
207971,495,298,197,41,4
207971,135,76,59,42,1
207971,122,72,50,43,1
207971,5,2,3,44,1
207971,117,70,47,45,1
207971,13,4,9,51,1
207971,360,222,138,52,3
207971,11,4,7,59,1
207971,106,66,40,60,1
208017,32,5,27,1,4
208017,32,5,27,2,1
208017,32,5,27,3,1
208017,3,0,3,4,1
208017,29,5,24,5,1
208017,29,5,24,20,1
208017,32,5,27,21,4
208017,32,5,27,22,1
208017,32,5,27,23,1
208017,3,0,3,24,1
208017,29,5,24,25,1
208017,29,5,24,40,1
208026,229,144,85,1,4
208026,229,144,85,2,1
208026,229,144,85,3,1
208026,185,127,58,4,1
208026,44,17,27,5,1
208026,44,17,27,20,1
208026,104,62,42,21,4
208026,104,62,42,22,1
208026,104,62,42,23,1
208026,63,45,18,24,1
208026,41,17,24,25,1
208026,41,17,24,40,1
208026,125,82,43,41,4
208026,125,82,43,42,1
208026,125,82,43,43,1
208026,122,82,40,44,1
208026,3,0,3,45,1
208026,3,0,3,60,1
208035,1690,727,963,1,4
208035,1690,727,963,2,1
208035,1306,499,807,3,1
208035,344,162,182,4,1
208035,962,337,625,5,1
208035,384,228,156,11,1
208035,268,97,171,19,1
208035,694,240,454,20,1
208035,675,336,339,21,4
208035,675,336,339,22,1
208035,669,334,335,23,1
208035,273,141,132,24,1
208035,396,193,203,25,1
208035,6,2,4,31,1
208035,75,39,36,39,1
208035,321,154,167,40,1
208035,1015,391,624,41,4
208035,1015,391,624,42,1
208035,637,165,472,43,1
208035,71,21,50,44,1
208035,566,144,422,45,1
208035,378,226,152,51,1
208035,193,58,135,59,1
208035,373,86,287,60,1
208044,27,1,26,1,4
208044,27,1,26,2,1
208044,27,1,26,3,1
208044,17,0,17,4,1
208044,10,1,9,5,1
208044,10,1,9,20,1
208044,27,1,26,21,4
208044,27,1,26,22,1
208044,27,1,26,23,1
208044,17,0,17,24,1
208044,10,1,9,25,1
208044,10,1,9,40,1
208053,257,132,125,1,4
208053,257,132,125,2,1
208053,82,16,66,3,1
208053,66,14,52,4,1
208053,16,2,14,5,1
208053,175,116,59,11,1
208053,16,2,14,20,1
208053,43,4,39,21,4
208053,43,4,39,22,1
208053,43,4,39,23,1
208053,37,4,33,24,1
208053,6,0,6,25,1
208053,6,0,6,40,1
208053,214,128,86,41,4
208053,214,128,86,42,1
208053,39,12,27,43,1
208053,29,10,19,44,1
208053,10,2,8,45,1
208053,175,116,59,51,1
208053,10,2,8,60,1
208080,56,14,42,1,4
208080,56,14,42,2,1
208080,56,14,42,3,1
208080,17,3,14,4,1
208080,39,11,28,5,1
208080,39,11,28,20,1
208080,56,14,42,21,4
208080,56,14,42,22,1
208080,56,14,42,23,1
208080,17,3,14,24,1
208080,39,11,28,25,1
208080,39,11,28,40,1
208123,80,10,70,1,4
208123,80,10,70,2,1
208123,80,10,70,3,1
208123,32,7,25,4,1
208123,48,3,45,5,1
208123,48,3,45,20,1
208123,80,10,70,21,4
208123,80,10,70,22,1
208123,80,10,70,23,1
208123,32,7,25,24,1
208123,48,3,45,25,1
208123,48,3,45,40,1
208187,88,4,84,1,4
208187,88,4,84,2,1
208187,88,4,84,3,1
208187,17,1,16,4,1
208187,71,3,68,5,1
208187,71,3,68,20,1
208187,88,4,84,21,4
208187,88,4,84,22,1
208187,88,4,84,23,1
208187,17,1,16,24,1
208187,71,3,68,25,1
208187,71,3,68,40,1
208239,1348,729,619,1,4
208239,1348,729,619,2,1
208239,1348,729,619,3,1
208239,206,119,87,4,1
208239,1142,610,532,5,1
208239,210,115,95,19,1
208239,932,495,437,20,1
208239,920,507,413,21,4
208239,920,507,413,22,1
208239,920,507,413,23,1
208239,169,98,71,24,1
208239,751,409,342,25,1
208239,160,86,74,39,1
208239,591,323,268,40,1
208239,428,222,206,41,4
208239,428,222,206,42,1
208239,428,222,206,43,1
208239,37,21,16,44,1
208239,391,201,190,45,1
208239,50,29,21,59,1
208239,341,172,169,60,1
208248,126,18,108,1,4
208248,126,18,108,2,1
208248,126,18,108,3,1
208248,25,3,22,4,1
208248,101,15,86,5,1
208248,101,15,86,20,1
208248,126,18,108,21,4
208248,126,18,108,22,1
208248,126,18,108,23,1
208248,25,3,22,24,1
208248,101,15,86,25,1
208248,101,15,86,40,1
208275,1880,729,1151,1,4
208275,1880,729,1151,2,1
208275,1550,574,976,3,1
208275,466,204,262,4,1
208275,1084,370,714,5,1
208275,330,155,175,11,1
208275,268,89,179,19,1
208275,816,281,535,20,1
208275,996,397,599,21,4
208275,996,397,599,22,1
208275,967,383,584,23,1
208275,328,151,177,24,1
208275,639,232,407,25,1
208275,29,14,15,31,1
208275,166,61,105,39,1
208275,473,171,302,40,1
208275,884,332,552,41,4
208275,884,332,552,42,1
208275,583,191,392,43,1
208275,138,53,85,44,1
208275,445,138,307,45,1
208275,301,141,160,51,1
208275,102,28,74,59,1
208275,343,110,233,60,1
208318,6760,2963,3797,1,4
208318,6760,2963,3797,2,1
208318,6282,2731,3551,3,1
208318,857,419,438,4,1
208318,5425,2312,3113,5,1
208318,478,232,246,11,1
208318,542,241,301,19,1
208318,4883,2071,2812,20,1
208318,2977,1373,1604,21,4
208318,2977,1373,1604,22,1
208318,2971,1370,1601,23,1
208318,484,236,248,24,1
208318,2487,1134,1353,25,1
208318,6,3,3,31,1
208318,280,132,148,39,1
208318,2207,1002,1205,40,1
208318,3783,1590,2193,41,4
208318,3783,1590,2193,42,1
208318,3311,1361,1950,43,1
208318,373,183,190,44,1
208318,2938,1178,1760,45,1
208318,472,229,243,51,1
208318,262,109,153,59,1
208318,2676,1069,1607,60,1
208390,12111,5271,6840,1,4
208390,12111,5271,6840,2,1
208390,10393,4462,5931,3,1
208390,1511,724,787,4,1
208390,8882,3738,5144,5,1
208390,1718,809,909,11,1
208390,135,60,75,19,1
208390,8747,3678,5069,20,1
208390,6107,2817,3290,21,4
208390,6107,2817,3290,22,1
208390,5540,2513,3027,23,1
208390,876,428,448,24,1
208390,4664,2085,2579,25,1
208390,567,304,263,31,1
208390,77,39,38,39,1
208390,4587,2046,2541,40,1
208390,6004,2454,3550,41,4
208390,6004,2454,3550,42,1
208390,4853,1949,2904,43,1
208390,635,296,339,44,1
208390,4218,1653,2565,45,1
208390,1151,505,646,51,1
208390,58,21,37,59,1
208390,4160,1632,2528,60,1
208406,7368,3523,3845,1,4
208406,7368,3523,3845,2,1
208406,7355,3516,3839,3,1
208406,1785,858,927,4,1
208406,5570,2658,2912,5,1
208406,13,7,6,11,1
208406,1123,506,617,19,1
208406,4447,2152,2295,20,1
208406,2838,1399,1439,21,4
208406,2838,1399,1439,22,1
208406,2837,1398,1439,23,1
208406,678,347,331,24,1
208406,2159,1051,1108,25,1
208406,1,1,0,31,1
208406,411,201,210,39,1
208406,1748,850,898,40,1
208406,4530,2124,2406,41,4
208406,4530,2124,2406,42,1
208406,4518,2118,2400,43,1
208406,1107,511,596,44,1
208406,3411,1607,1804,45,1
208406,12,6,6,51,1
208406,712,305,407,59,1
208406,2699,1302,1397,60,1
208415,1069,462,607,1,4
208415,1069,462,607,2,1
208415,801,323,478,3,1
208415,122,58,64,4,1
208415,679,265,414,5,1
208415,268,139,129,11,1
208415,55,16,39,19,1
208415,624,249,375,20,1
208415,455,214,241,21,4
208415,455,214,241,22,1
208415,428,198,230,23,1
208415,81,42,39,24,1
208415,347,156,191,25,1
208415,27,16,11,31,1
208415,26,8,18,39,1
208415,321,148,173,40,1
208415,614,248,366,41,4
208415,614,248,366,42,1
208415,373,125,248,43,1
208415,41,16,25,44,1
208415,332,109,223,45,1
208415,241,123,118,51,1
208415,29,8,21,59,1
208415,303,101,202,60,1
208433,68,4,64,1,4
208433,68,4,64,2,1
208433,68,4,64,3,1
208433,16,1,15,4,1
208433,52,3,49,5,1
208433,52,3,49,20,1
208433,68,4,64,21,4
208433,68,4,64,22,1
208433,68,4,64,23,1
208433,16,1,15,24,1
208433,52,3,49,25,1
208433,52,3,49,40,1
208479,925,131,794,1,4
208479,925,131,794,2,1
208479,925,131,794,3,1
208479,251,35,216,4,1
208479,674,96,578,5,1
208479,674,96,578,20,1
208479,925,131,794,21,4
208479,925,131,794,22,1
208479,925,131,794,23,1
208479,251,35,216,24,1
208479,674,96,578,25,1
208479,674,96,578,40,1
208488,5428,1346,4082,1,4
208488,1388,445,943,2,1
208488,1378,439,939,3,1
208488,222,50,172,4,1
208488,1156,389,767,5,1
208488,10,6,4,11,1
208488,4040,901,3139,12,3
208488,280,91,189,19,1
208488,876,298,578,20,1
208488,4960,1220,3740,21,4
208488,1188,390,798,22,1
208488,1186,389,797,23,1
208488,220,50,170,24,1
208488,966,339,627,25,1
208488,2,1,1,31,1
208488,3772,830,2942,32,3
208488,216,77,139,39,1
208488,750,262,488,40,1
208488,468,126,342,41,4
208488,200,55,145,42,1
208488,192,50,142,43,1
208488,2,0,2,44,1
208488,190,50,140,45,1
208488,8,5,3,51,1
208488,268,71,197,52,3
208488,64,14,50,59,1
208488,126,36,90,60,1
208512,263,42,221,1,4
208512,263,42,221,2,1
208512,263,42,221,3,1
208512,28,7,21,4,1
208512,235,35,200,5,1
208512,235,35,200,20,1
208512,260,42,218,21,4
208512,260,42,218,22,1
208512,260,42,218,23,1
208512,28,7,21,24,1
208512,232,35,197,25,1
208512,232,35,197,40,1
208512,3,0,3,41,4
208512,3,0,3,42,1
208512,3,0,3,43,1
208512,3,0,3,45,1
208512,3,0,3,60,1
208637,246,72,174,1,4
208637,246,72,174,2,1
208637,246,72,174,3,1
208637,110,30,80,4,1
208637,136,42,94,5,1
208637,136,42,94,20,1
208637,246,72,174,41,4
208637,246,72,174,42,1
208637,246,72,174,43,1
208637,110,30,80,44,1
208637,136,42,94,45,1
208637,136,42,94,60,1
208646,4157,1591,2566,1,4
208646,3754,1468,2286,2,1
208646,3422,1343,2079,3,1
208646,371,167,204,4,1
208646,3051,1176,1875,5,1
208646,332,125,207,11,1
208646,403,123,280,12,3
208646,572,212,360,19,1
208646,2479,964,1515,20,1
208646,2198,908,1290,21,4
208646,2140,886,1254,22,1
208646,2132,883,1249,23,1
208646,341,154,187,24,1
208646,1791,729,1062,25,1
208646,8,3,5,31,1
208646,58,22,36,32,3
208646,314,123,191,39,1
208646,1477,606,871,40,1
208646,1959,683,1276,41,4
208646,1614,582,1032,42,1
208646,1290,460,830,43,1
208646,30,13,17,44,1
208646,1260,447,813,45,1
208646,324,122,202,51,1
208646,345,101,244,52,3
208646,258,89,169,59,1
208646,1002,358,644,60,1
208655,132,15,117,1,4
208655,132,15,117,2,1
208655,132,15,117,3,1
208655,15,3,12,4,1
208655,117,12,105,5,1
208655,117,12,105,20,1
208655,132,15,117,21,4
208655,132,15,117,22,1
208655,132,15,117,23,1
208655,15,3,12,24,1
208655,117,12,105,25,1
208655,117,12,105,40,1
208725,179,91,88,1,4
208725,179,91,88,2,1
208725,179,91,88,3,1
208725,34,18,16,4,1
208725,145,73,72,5,1
208725,36,18,18,19,1
208725,109,55,54,20,1
208725,154,77,77,21,4
208725,154,77,77,22,1
208725,154,77,77,23,1
208725,31,15,16,24,1
208725,123,62,61,25,1
208725,26,13,13,39,1
208725,97,49,48,40,1
208725,25,14,11,41,4
208725,25,14,11,42,1
208725,25,14,11,43,1
208725,3,3,0,44,1
208725,22,11,11,45,1
208725,10,5,5,59,1
208725,12,6,6,60,1
208822,3712,1612,2100,1,4
208822,2384,1018,1366,2,1
208822,2358,1006,1352,3,1
208822,619,278,341,4,1
208822,1739,728,1011,5,1
208822,26,12,14,11,1
208822,1328,594,734,12,3
208822,254,113,141,19,1
208822,1485,615,870,20,1
208822,2493,1058,1435,21,4
208822,2108,914,1194,22,1
208822,2108,914,1194,23,1
208822,619,278,341,24,1
208822,1489,636,853,25,1
208822,385,144,241,32,3
208822,158,83,75,39,1
208822,1331,553,778,40,1
208822,1219,554,665,41,4
208822,276,104,172,42,1
208822,250,92,158,43,1
208822,250,92,158,45,1
208822,26,12,14,51,1
208822,943,450,493,52,3
208822,96,30,66,59,1
208822,154,62,92,60,1
208859,39,0,39,1,4
208859,39,0,39,2,1
208859,39,0,39,3,1
208859,23,0,23,4,1
208859,16,0,16,5,1
208859,16,0,16,20,1
208859,39,0,39,21,4
208859,39,0,39,22,1
208859,39,0,39,23,1
208859,23,0,23,24,1
208859,16,0,16,25,1
208859,16,0,16,40,1
208965,605,374,231,1,4
208965,605,374,231,2,1
208965,605,374,231,3,1
208965,75,53,22,4,1
208965,530,321,209,5,1
208965,16,5,11,19,1
208965,514,316,198,20,1
208965,418,277,141,21,4
208965,418,277,141,22,1
208965,418,277,141,23,1
208965,62,44,18,24,1
208965,356,233,123,25,1
208965,14,5,9,39,1
208965,342,228,114,40,1
208965,187,97,90,41,4
208965,187,97,90,42,1
208965,187,97,90,43,1
208965,13,9,4,44,1
208965,174,88,86,45,1
208965,2,0,2,59,1
208965,172,88,84,60,1
209038,11002,5385,5617,1,4
209038,11002,5385,5617,2,1
209038,9805,4660,5145,3,1
209038,1239,665,574,4,1
209038,8566,3995,4571,5,1
209038,1197,725,472,11,1
209038,977,482,495,19,1
209038,7589,3513,4076,20,1
209038,4996,2624,2372,21,4
209038,4996,2624,2372,22,1
209038,4655,2393,2262,23,1
209038,716,396,320,24,1
209038,3939,1997,1942,25,1
209038,341,231,110,31,1
209038,458,241,217,39,1
209038,3481,1756,1725,40,1
209038,6006,2761,3245,41,4
209038,6006,2761,3245,42,1
209038,5150,2267,2883,43,1
209038,523,269,254,44,1
209038,4627,1998,2629,45,1
209038,856,494,362,51,1
209038,519,241,278,59,1
209038,4108,1757,2351,60,1
209056,3521,1376,2145,1,4
209056,2126,868,1258,2,1
209056,1985,774,1211,3,1
209056,473,177,296,4,1
209056,1512,597,915,5,1
209056,141,94,47,11,1
209056,1395,508,887,12,3
209056,46,20,26,19,1
209056,1466,577,889,20,1
209056,3110,1241,1869,21,4
209056,2086,846,1240,22,1
209056,1965,763,1202,23,1
209056,473,177,296,24,1
209056,1492,586,906,25,1
209056,121,83,38,31,1
209056,1024,395,629,32,3
209056,46,20,26,39,1
209056,1446,566,880,40,1
209056,411,135,276,41,4
209056,40,22,18,42,1
209056,20,11,9,43,1
209056,20,11,9,45,1
209056,20,11,9,51,1
209056,371,113,258,52,3
209056,20,11,9,60,1
209065,1671,669,1002,1,4
209065,1671,669,1002,2,1
209065,1641,653,988,3,1
209065,449,170,279,4,1
209065,1192,483,709,5,1
209065,30,16,14,11,1
209065,66,18,48,19,1
209065,1126,465,661,20,1
209065,1630,650,980,21,4
209065,1630,650,980,22,1
209065,1615,640,975,23,1
209065,447,168,279,24,1
209065,1168,472,696,25,1
209065,15,10,5,31,1
209065,64,17,47,39,1
209065,1104,455,649,40,1
209065,41,19,22,41,4
209065,41,19,22,42,1
209065,26,13,13,43,1
209065,2,2,0,44,1
209065,24,11,13,45,1
209065,15,6,9,51,1
209065,2,1,1,59,1
209065,22,10,12,60,1
209074,5617,2711,2906,1,4
209074,5617,2711,2906,2,1
209074,5480,2653,2827,3,1
209074,1398,716,682,4,1
209074,4082,1937,2145,5,1
209074,137,58,79,11,1
209074,784,398,386,19,1
209074,3298,1539,1759,20,1
209074,2604,1373,1231,21,4
209074,2604,1373,1231,22,1
209074,2557,1350,1207,23,1
209074,809,435,374,24,1
209074,1748,915,833,25,1
209074,47,23,24,31,1
209074,275,173,102,39,1
209074,1473,742,731,40,1
209074,3013,1338,1675,41,4
209074,3013,1338,1675,42,1
209074,2923,1303,1620,43,1
209074,589,281,308,44,1
209074,2334,1022,1312,45,1
209074,90,35,55,51,1
209074,509,225,284,59,1
209074,1825,797,1028,60,1
209083,100,9,91,1,4
209083,100,9,91,2,1
209083,100,9,91,3,1
209083,17,2,15,4,1
209083,83,7,76,5,1
209083,83,7,76,20,1
209083,100,9,91,21,4
209083,100,9,91,22,1
209083,100,9,91,23,1
209083,17,2,15,24,1
209083,83,7,76,25,1
209083,83,7,76,40,1
209108,1408,495,913,1,4
209108,741,228,513,2,1
209108,672,199,473,3,1
209108,8,4,4,4,1
209108,664,195,469,5,1
209108,69,29,40,11,1
209108,667,267,400,12,3
209108,155,38,117,19,1
209108,509,157,352,20,1
209108,255,73,182,21,4
209108,176,53,123,22,1
209108,175,52,123,23,1
209108,2,1,1,24,1
209108,173,51,122,25,1
209108,1,1,0,31,1
209108,79,20,59,32,3
209108,46,8,38,39,1
209108,127,43,84,40,1
209108,1153,422,731,41,4
209108,565,175,390,42,1
209108,497,147,350,43,1
209108,6,3,3,44,1
209108,491,144,347,45,1
209108,68,28,40,51,1
209108,588,247,341,52,3
209108,109,30,79,59,1
209108,382,114,268,60,1
209153,67,4,63,1,4
209153,67,4,63,2,1
209153,67,4,63,3,1
209153,47,3,44,4,1
209153,20,1,19,5,1
209153,20,1,19,20,1
209153,67,4,63,21,4
209153,67,4,63,22,1
209153,67,4,63,23,1
209153,47,3,44,24,1
209153,20,1,19,25,1
209153,20,1,19,40,1
209205,141,10,131,1,4
209205,141,10,131,2,1
209205,141,10,131,3,1
209205,10,1,9,4,1
209205,131,9,122,5,1
209205,131,9,122,20,1
209205,141,10,131,21,4
209205,141,10,131,22,1
209205,141,10,131,23,1
209205,10,1,9,24,1
209205,131,9,122,25,1
209205,131,9,122,40,1
209241,170,164,6,1,4
209241,70,70,0,2,1
209241,70,70,0,3,1
209241,15,15,0,4,1
209241,55,55,0,5,1
209241,100,94,6,12,3
209241,55,55,0,20,1
209241,157,156,1,21,4
209241,70,70,0,22,1
209241,70,70,0,23,1
209241,15,15,0,24,1
209241,55,55,0,25,1
209241,87,86,1,32,3
209241,55,55,0,40,1
209241,13,8,5,41,4
209241,13,8,5,52,3
209250,9393,4420,4973,1,4
209250,9393,4420,4973,2,1
209250,8530,4075,4455,3,1
209250,2182,1012,1170,4,1
209250,6348,3063,3285,5,1
209250,863,345,518,11,1
209250,2600,1219,1381,19,1
209250,3748,1844,1904,20,1
209250,4256,1897,2359,21,4
209250,4256,1897,2359,22,1
209250,4057,1823,2234,23,1
209250,1269,625,644,24,1
209250,2788,1198,1590,25,1
209250,199,74,125,31,1
209250,1033,420,613,39,1
209250,1755,778,977,40,1
209250,5137,2523,2614,41,4
209250,5137,2523,2614,42,1
209250,4473,2252,2221,43,1
209250,913,387,526,44,1
209250,3560,1865,1695,45,1
209250,664,271,393,51,1
209250,1567,799,768,59,1
209250,1993,1066,927,60,1
209287,777,470,307,1,4
209287,438,268,170,2,1
209287,438,268,170,3,1
209287,55,27,28,4,1
209287,383,241,142,5,1
209287,339,202,137,12,3
209287,72,45,27,19,1
209287,311,196,115,20,1
209287,611,359,252,21,4
209287,358,212,146,22,1
209287,358,212,146,23,1
209287,51,23,28,24,1
209287,307,189,118,25,1
209287,253,147,106,32,3
209287,59,37,22,39,1
209287,248,152,96,40,1
209287,166,111,55,41,4
209287,80,56,24,42,1
209287,80,56,24,43,1
209287,4,4,0,44,1
209287,76,52,24,45,1
209287,86,55,31,52,3
209287,13,8,5,59,1
209287,63,44,19,60,1
209296,558,140,418,1,4
209296,558,140,418,12,3
209296,521,128,393,21,4
209296,521,128,393,32,3
209296,37,12,25,41,4
209296,37,12,25,52,3
209348,21,0,21,1,4
209348,21,0,21,2,1
209348,21,0,21,3,1
209348,9,0,9,4,1
209348,12,0,12,5,1
209348,12,0,12,20,1
209348,21,0,21,21,4
209348,21,0,21,22,1
209348,21,0,21,23,1
209348,9,0,9,24,1
209348,12,0,12,25,1
209348,12,0,12,40,1
209409,660,228,432,1,4
209409,484,175,309,2,1
209409,478,173,305,3,1
209409,82,15,67,4,1
209409,396,158,238,5,1
209409,6,2,4,11,1
209409,176,53,123,12,3
209409,59,32,27,19,1
209409,337,126,211,20,1
209409,541,190,351,21,4
209409,382,144,238,22,1
209409,379,142,237,23,1
209409,82,15,67,24,1
209409,297,127,170,25,1
209409,3,2,1,31,1
209409,159,46,113,32,3
209409,54,29,25,39,1
209409,243,98,145,40,1
209409,119,38,81,41,4
209409,102,31,71,42,1
209409,99,31,68,43,1
209409,99,31,68,45,1
209409,3,0,3,51,1
209409,17,7,10,52,3
209409,5,3,2,59,1
209409,94,28,66,60,1
209490,2838,993,1845,1,4
209490,832,147,685,2,1
209490,832,147,685,3,1
209490,832,147,685,5,1
209490,2006,846,1160,12,3
209490,416,67,349,19,1
209490,416,80,336,20,1
209490,1557,640,917,21,4
209490,211,28,183,22,1
209490,211,28,183,23,1
209490,211,28,183,25,1
209490,1346,612,734,32,3
209490,155,18,137,39,1
209490,56,10,46,40,1
209490,1281,353,928,41,4
209490,621,119,502,42,1
209490,621,119,502,43,1
209490,621,119,502,45,1
209490,660,234,426,52,3
209490,261,49,212,59,1
209490,360,70,290,60,1
209506,4407,2304,2103,1,4
209506,4366,2270,2096,2,1
209506,3443,1877,1566,3,1
209506,365,207,158,4,1
209506,3078,1670,1408,5,1
209506,923,393,530,11,1
209506,41,34,7,12,3
209506,680,351,329,19,1
209506,2398,1319,1079,20,1
209506,2370,1304,1066,21,4
209506,2341,1282,1059,22,1
209506,2331,1275,1056,23,1
209506,342,200,142,24,1
209506,1989,1075,914,25,1
209506,10,7,3,31,1
209506,29,22,7,32,3
209506,391,209,182,39,1
209506,1598,866,732,40,1
209506,2037,1000,1037,41,4
209506,2025,988,1037,42,1
209506,1112,602,510,43,1
209506,23,7,16,44,1
209506,1089,595,494,45,1
209506,913,386,527,51,1
209506,12,12,0,52,3
209506,289,142,147,59,1
209506,800,453,347,60,1
209533,156,33,123,1,4
209533,139,27,112,2,1
209533,139,27,112,3,1
209533,21,1,20,4,1
209533,118,26,92,5,1
209533,17,6,11,12,3
209533,20,3,17,19,1
209533,98,23,75,20,1
209533,133,30,103,21,4
209533,117,24,93,22,1
209533,117,24,93,23,1
209533,20,1,19,24,1
209533,97,23,74,25,1
209533,16,6,10,32,3
209533,18,3,15,39,1
209533,79,20,59,40,1
209533,23,3,20,41,4
209533,22,3,19,42,1
209533,22,3,19,43,1
209533,1,0,1,44,1
209533,21,3,18,45,1
209533,1,0,1,52,3
209533,2,0,2,59,1
209533,19,3,16,60,1
209542,27902,14912,12990,1,4
209542,23157,12468,10689,2,1
209542,22349,12026,10323,3,1
209542,3825,1983,1842,4,1
209542,18524,10043,8481,5,1
209542,808,442,366,11,1
209542,4745,2444,2301,12,3
209542,2150,1131,1019,19,1
209542,16374,8912,7462,20,1
209542,21958,12003,9955,21,4
209542,18484,10143,8341,22,1
209542,18118,9902,8216,23,1
209542,3553,1847,1706,24,1
209542,14565,8055,6510,25,1
209542,366,241,125,31,1
209542,3474,1860,1614,32,3
209542,1438,804,634,39,1
209542,13127,7251,5876,40,1
209542,5944,2909,3035,41,4
209542,4673,2325,2348,42,1
209542,4231,2124,2107,43,1
209542,272,136,136,44,1
209542,3959,1988,1971,45,1
209542,442,201,241,51,1
209542,1271,584,687,52,3
209542,712,327,385,59,1
209542,3247,1661,1586,60,1
209551,24473,11657,12816,1,4
209551,20797,9926,10871,2,1
209551,20473,9763,10710,3,1
209551,3959,1738,2221,4,1
209551,16514,8025,8489,5,1
209551,324,163,161,11,1
209551,3676,1731,1945,12,3
209551,1498,783,715,19,1
209551,15016,7242,7774,20,1
209551,21920,10446,11474,21,4
209551,18892,8982,9910,22,1
209551,18872,8972,9900,23,1
209551,3913,1718,2195,24,1
209551,14959,7254,7705,25,1
209551,20,10,10,31,1
209551,3028,1464,1564,32,3
209551,1338,697,641,39,1
209551,13621,6557,7064,40,1
209551,2553,1211,1342,41,4
209551,1905,944,961,42,1
209551,1601,791,810,43,1
209551,46,20,26,44,1
209551,1555,771,784,45,1
209551,304,153,151,51,1
209551,648,267,381,52,3
209551,160,86,74,59,1
209551,1395,685,710,60,1
209603,517,169,348,1,4
209603,413,137,276,2,1
209603,413,137,276,3,1
209603,61,16,45,4,1
209603,352,121,231,5,1
209603,104,32,72,12,3
209603,63,25,38,19,1
209603,289,96,193,20,1
209603,460,153,307,21,4
209603,356,121,235,22,1
209603,356,121,235,23,1
209603,60,16,44,24,1
209603,296,105,191,25,1
209603,104,32,72,32,3
209603,62,24,38,39,1
209603,234,81,153,40,1
209603,57,16,41,41,4
209603,57,16,41,42,1
209603,57,16,41,43,1
209603,1,0,1,44,1
209603,56,16,40,45,1
209603,1,1,0,59,1
209603,55,15,40,60,1
209612,3583,1303,2280,1,4
209612,1785,746,1039,2,1
209612,1729,726,1003,3,1
209612,421,168,253,4,1
209612,1308,558,750,5,1
209612,56,20,36,11,1
209612,1798,557,1241,12,3
209612,157,53,104,19,1
209612,1151,505,646,20,1
209612,3316,1225,2091,21,4
209612,1729,728,1001,22,1
209612,1715,720,995,23,1
209612,421,168,253,24,1
209612,1294,552,742,25,1
209612,14,8,6,31,1
209612,1587,497,1090,32,3
209612,155,53,102,39,1
209612,1139,499,640,40,1
209612,267,78,189,41,4
209612,56,18,38,42,1
209612,14,6,8,43,1
209612,14,6,8,45,1
209612,42,12,30,51,1
209612,211,60,151,52,3
209612,2,0,2,59,1
209612,12,6,6,60,1
209667,53,1,52,1,4
209667,53,1,52,2,1
209667,53,1,52,3,1
209667,37,1,36,4,1
209667,16,0,16,5,1
209667,16,0,16,20,1
209667,53,1,52,21,4
209667,53,1,52,22,1
209667,53,1,52,23,1
209667,37,1,36,24,1
209667,16,0,16,25,1
209667,16,0,16,40,1
209676,133,6,127,1,4
209676,133,6,127,2,1
209676,133,6,127,3,1
209676,96,5,91,4,1
209676,37,1,36,5,1
209676,37,1,36,20,1
209676,133,6,127,21,4
209676,133,6,127,22,1
209676,133,6,127,23,1
209676,96,5,91,24,1
209676,37,1,36,25,1
209676,37,1,36,40,1
209694,49,8,41,1,4
209694,49,8,41,2,1
209694,49,8,41,3,1
209694,42,8,34,4,1
209694,7,0,7,5,1
209694,7,0,7,20,1
209694,49,8,41,21,4
209694,49,8,41,22,1
209694,49,8,41,23,1
209694,42,8,34,24,1
209694,7,0,7,25,1
209694,7,0,7,40,1
209700,176,9,167,1,4
209700,176,9,167,2,1
209700,176,9,167,3,1
209700,35,1,34,4,1
209700,141,8,133,5,1
209700,141,8,133,20,1
209700,176,9,167,21,4
209700,176,9,167,22,1
209700,176,9,167,23,1
209700,35,1,34,24,1
209700,141,8,133,25,1
209700,141,8,133,40,1
209719,27,3,24,1,4
209719,27,3,24,2,1
209719,27,3,24,3,1
209719,4,0,4,4,1
209719,23,3,20,5,1
209719,23,3,20,20,1
209719,27,3,24,21,4
209719,27,3,24,22,1
209719,27,3,24,23,1
209719,4,0,4,24,1
209719,23,3,20,25,1
209719,23,3,20,40,1
209746,32411,15117,17294,1,4
209746,32411,15117,17294,2,1
209746,29774,13879,15895,3,1
209746,2075,1070,1005,4,1
209746,27699,12809,14890,5,1
209746,2637,1238,1399,11,1
209746,2074,940,1134,19,1
209746,25625,11869,13756,20,1
209746,13580,6752,6828,21,4
209746,13580,6752,6828,22,1
209746,13156,6514,6642,23,1
209746,1176,630,546,24,1
209746,11980,5884,6096,25,1
209746,424,238,186,31,1
209746,799,394,405,39,1
209746,11181,5490,5691,40,1
209746,18831,8365,10466,41,4
209746,18831,8365,10466,42,1
209746,16618,7365,9253,43,1
209746,899,440,459,44,1
209746,15719,6925,8794,45,1
209746,2213,1000,1213,51,1
209746,1275,546,729,59,1
209746,14444,6379,8065,60,1
209807,28260,13191,15069,1,4
209807,22927,11015,11912,2,1
209807,20085,9623,10462,3,1
209807,1644,739,905,4,1
209807,18441,8884,9557,5,1
209807,2842,1392,1450,11,1
209807,5333,2176,3157,12,3
209807,3592,1716,1876,19,1
209807,14849,7168,7681,20,1
209807,17308,8195,9113,21,4
209807,14671,7118,7553,22,1
209807,14075,6745,7330,23,1
209807,1517,679,838,24,1
209807,12558,6066,6492,25,1
209807,596,373,223,31,1
209807,2637,1077,1560,32,3
209807,2493,1163,1330,39,1
209807,10065,4903,5162,40,1
209807,10952,4996,5956,41,4
209807,8256,3897,4359,42,1
209807,6010,2878,3132,43,1
209807,127,60,67,44,1
209807,5883,2818,3065,45,1
209807,2246,1019,1227,51,1
209807,2696,1099,1597,52,3
209807,1099,553,546,59,1
209807,4784,2265,2519,60,1
209825,4036,1657,2379,1,4
209825,3494,1453,2041,2,1
209825,3468,1438,2030,3,1
209825,835,369,466,4,1
209825,2633,1069,1564,5,1
209825,26,15,11,11,1
209825,542,204,338,12,3
209825,81,36,45,19,1
209825,2552,1033,1519,20,1
209825,3515,1462,2053,21,4
209825,3410,1407,2003,22,1
209825,3410,1407,2003,23,1
209825,835,369,466,24,1
209825,2575,1038,1537,25,1
209825,105,55,50,32,3
209825,77,35,42,39,1
209825,2498,1003,1495,40,1
209825,521,195,326,41,4
209825,84,46,38,42,1
209825,58,31,27,43,1
209825,58,31,27,45,1
209825,26,15,11,51,1
209825,437,149,288,52,3
209825,4,1,3,59,1
209825,54,30,24,60,1
209922,1411,671,740,1,4
209922,1395,664,731,2,1
209922,1351,642,709,3,1
209922,354,172,182,4,1
209922,997,470,527,5,1
209922,44,22,22,11,1
209922,16,7,9,12,3
209922,36,15,21,19,1
209922,961,455,506,20,1
209922,1356,646,710,21,4
209922,1356,646,710,22,1
209922,1344,639,705,23,1
209922,354,172,182,24,1
209922,990,467,523,25,1
209922,12,7,5,31,1
209922,36,15,21,39,1
209922,954,452,502,40,1
209922,55,25,30,41,4
209922,39,18,21,42,1
209922,7,3,4,43,1
209922,7,3,4,45,1
209922,32,15,17,51,1
209922,16,7,9,52,3
209922,7,3,4,60,1
209940,5530,2401,3129,1,4
209940,5530,2401,3129,2,1
209940,4596,1873,2723,3,1
209940,816,355,461,4,1
209940,3780,1518,2262,5,1
209940,934,528,406,11,1
209940,141,57,84,19,1
209940,3639,1461,2178,20,1
209940,2392,1094,1298,21,4
209940,2392,1094,1298,22,1
209940,2077,903,1174,23,1
209940,394,183,211,24,1
209940,1683,720,963,25,1
209940,315,191,124,31,1
209940,71,26,45,39,1
209940,1612,694,918,40,1
209940,3138,1307,1831,41,4
209940,3138,1307,1831,42,1
209940,2519,970,1549,43,1
209940,422,172,250,44,1
209940,2097,798,1299,45,1
209940,619,337,282,51,1
209940,70,31,39,59,1
209940,2027,767,1260,60,1
209986,40,1,39,1,4
209986,40,1,39,2,1
209986,40,1,39,3,1
209986,12,1,11,4,1
209986,28,0,28,5,1
209986,28,0,28,20,1
209986,40,1,39,21,4
209986,40,1,39,22,1
209986,40,1,39,23,1
209986,12,1,11,24,1
209986,28,0,28,25,1
209986,28,0,28,40,1
210076,1109,306,803,1,4
210076,1109,306,803,2,1
210076,1108,306,802,3,1
210076,142,43,99,4,1
210076,966,263,703,5,1
210076,1,0,1,11,1
210076,744,194,550,19,1
210076,222,69,153,20,1
210076,757,204,553,21,4
210076,757,204,553,22,1
210076,757,204,553,23,1
210076,110,30,80,24,1
210076,647,174,473,25,1
210076,508,130,378,39,1
210076,139,44,95,40,1
210076,352,102,250,41,4
210076,352,102,250,42,1
210076,351,102,249,43,1
210076,32,13,19,44,1
210076,319,89,230,45,1
210076,1,0,1,51,1
210076,236,64,172,59,1
210076,83,25,58,60,1
210100,69,2,67,1,4
210100,69,2,67,2,1
210100,69,2,67,3,1
210100,10,0,10,4,1
210100,59,2,57,5,1
210100,59,2,57,20,1
210100,69,2,67,21,4
210100,69,2,67,22,1
210100,69,2,67,23,1
210100,10,0,10,24,1
210100,59,2,57,25,1
210100,59,2,57,40,1
210146,5992,2579,3413,1,4
210146,5500,2397,3103,2,1
210146,4436,1961,2475,3,1
210146,628,271,357,4,1
210146,3808,1690,2118,5,1
210146,1064,436,628,11,1
210146,492,182,310,12,3
210146,601,245,356,19,1
210146,3207,1445,1762,20,1
210146,3833,1716,2117,21,4
210146,3631,1646,1985,22,1
210146,3529,1610,1919,23,1
210146,595,253,342,24,1
210146,2934,1357,1577,25,1
210146,102,36,66,31,1
210146,202,70,132,32,3
210146,465,201,264,39,1
210146,2469,1156,1313,40,1
210146,2159,863,1296,41,4
210146,1869,751,1118,42,1
210146,907,351,556,43,1
210146,33,18,15,44,1
210146,874,333,541,45,1
210146,962,400,562,51,1
210146,290,112,178,52,3
210146,136,44,92,59,1
210146,738,289,449,60,1
210155,2038,885,1153,1,4
210155,2038,885,1153,2,1
210155,1633,675,958,3,1
210155,438,194,244,4,1
210155,1195,481,714,5,1
210155,405,210,195,11,1
210155,96,46,50,19,1
210155,1099,435,664,20,1
210155,1077,496,581,21,4
210155,1077,496,581,22,1
210155,1047,479,568,23,1
210155,379,172,207,24,1
210155,668,307,361,25,1
210155,30,17,13,31,1
210155,80,39,41,39,1
210155,588,268,320,40,1
210155,961,389,572,41,4
210155,961,389,572,42,1
210155,586,196,390,43,1
210155,59,22,37,44,1
210155,527,174,353,45,1
210155,375,193,182,51,1
210155,16,7,9,59,1
210155,511,167,344,60,1
210234,2443,980,1463,1,4
210234,2443,980,1463,2,1
210234,2273,908,1365,3,1
210234,635,306,329,4,1
210234,1638,602,1036,5,1
210234,170,72,98,11,1
210234,119,54,65,19,1
210234,1519,548,971,20,1
210234,1212,559,653,21,4
210234,1212,559,653,22,1
210234,1189,546,643,23,1
210234,417,222,195,24,1
210234,772,324,448,25,1
210234,23,13,10,31,1
210234,65,38,27,39,1
210234,707,286,421,40,1
210234,1231,421,810,41,4
210234,1231,421,810,42,1
210234,1084,362,722,43,1
210234,218,84,134,44,1
210234,866,278,588,45,1
210234,147,59,88,51,1
210234,54,16,38,59,1
210234,812,262,550,60,1
210270,2183,919,1264,1,4
210270,2183,919,1264,2,1
210270,1409,597,812,3,1
210270,147,64,83,4,1
210270,1262,533,729,5,1
210270,774,322,452,11,1
210270,424,179,245,19,1
210270,838,354,484,20,1
210270,1081,440,641,21,4
210270,1081,440,641,22,1
210270,713,291,422,23,1
210270,99,40,59,24,1
210270,614,251,363,25,1
210270,368,149,219,31,1
210270,177,77,100,39,1
210270,437,174,263,40,1
210270,1102,479,623,41,4
210270,1102,479,623,42,1
210270,696,306,390,43,1
210270,48,24,24,44,1
210270,648,282,366,45,1
210270,406,173,233,51,1
210270,247,102,145,59,1
210270,401,180,221,60,1
210304,506,224,282,1,4
210304,503,223,280,2,1
210304,501,222,279,3,1
210304,85,37,48,4,1
210304,416,185,231,5,1
210304,2,1,1,11,1
210304,3,1,2,12,3
210304,96,43,53,19,1
210304,320,142,178,20,1
210304,470,207,263,21,4
210304,469,207,262,22,1
210304,469,207,262,23,1
210304,74,32,42,24,1
210304,395,175,220,25,1
210304,1,0,1,32,3
210304,91,42,49,39,1
210304,304,133,171,40,1
210304,36,17,19,41,4
210304,34,16,18,42,1
210304,32,15,17,43,1
210304,11,5,6,44,1
210304,21,10,11,45,1
210304,2,1,1,51,1
210304,2,1,1,52,3
210304,5,1,4,59,1
210304,16,9,7,60,1
210331,1143,462,681,1,4
210331,936,368,568,2,1
210331,902,351,551,3,1
210331,222,83,139,4,1
210331,680,268,412,5,1
210331,34,17,17,11,1
210331,207,94,113,12,3
210331,58,32,26,19,1
210331,622,236,386,20,1
210331,916,369,547,21,4
210331,846,337,509,22,1
210331,833,328,505,23,1
210331,222,83,139,24,1
210331,611,245,366,25,1
210331,13,9,4,31,1
210331,70,32,38,32,3
210331,58,32,26,39,1
210331,553,213,340,40,1
210331,227,93,134,41,4
210331,90,31,59,42,1
210331,69,23,46,43,1
210331,69,23,46,45,1
210331,21,8,13,51,1
210331,137,62,75,52,3
210331,69,23,46,60,1
210340,93,3,90,1,4
210340,93,3,90,2,1
210340,93,3,90,3,1
210340,10,0,10,4,1
210340,83,3,80,5,1
210340,83,3,80,20,1
210340,93,3,90,21,4
210340,93,3,90,22,1
210340,93,3,90,23,1
210340,10,0,10,24,1
210340,83,3,80,25,1
210340,83,3,80,40,1
210359,227,84,143,1,4
210359,227,84,143,2,1
210359,227,84,143,3,1
210359,8,5,3,4,1
210359,219,79,140,5,1
210359,33,10,23,19,1
210359,186,69,117,20,1
210359,122,52,70,21,4
210359,122,52,70,22,1
210359,122,52,70,23,1
210359,8,5,3,24,1
210359,114,47,67,25,1
210359,25,7,18,39,1
210359,89,40,49,40,1
210359,105,32,73,41,4
210359,105,32,73,42,1
210359,105,32,73,43,1
210359,105,32,73,45,1
210359,8,3,5,59,1
210359,97,29,68,60,1
210368,767,519,248,1,4
210368,767,519,248,12,3
210368,96,66,30,21,4
210368,96,66,30,32,3
210368,671,453,218,41,4
210368,671,453,218,52,3
210401,2855,1342,1513,1,4
210401,2119,927,1192,2,1
210401,1970,864,1106,3,1
210401,545,254,291,4,1
210401,1425,610,815,5,1
210401,149,63,86,11,1
210401,736,415,321,12,3
210401,41,17,24,19,1
210401,1384,593,791,20,1
210401,2660,1257,1403,21,4
210401,1981,860,1121,22,1
210401,1948,851,1097,23,1
210401,545,254,291,24,1
210401,1403,597,806,25,1
210401,33,9,24,31,1
210401,679,397,282,32,3
210401,41,17,24,39,1
210401,1362,580,782,40,1
210401,195,85,110,41,4
210401,138,67,71,42,1
210401,22,13,9,43,1
210401,22,13,9,45,1
210401,116,54,62,51,1
210401,57,18,39,52,3
210401,22,13,9,60,1
210429,6177,2471,3706,1,4
210429,5263,2213,3050,2,1
210429,5142,2158,2984,3,1
210429,862,344,518,4,1
210429,4280,1814,2466,5,1
210429,121,55,66,11,1
210429,914,258,656,12,3
210429,678,296,382,19,1
210429,3602,1518,2084,20,1
210429,4720,1969,2751,21,4
210429,4423,1861,2562,22,1
210429,4420,1860,2560,23,1
210429,826,330,496,24,1
210429,3594,1530,2064,25,1
210429,3,1,2,31,1
210429,297,108,189,32,3
210429,548,249,299,39,1
210429,3046,1281,1765,40,1
210429,1457,502,955,41,4
210429,840,352,488,42,1
210429,722,298,424,43,1
210429,36,14,22,44,1
210429,686,284,402,45,1
210429,118,54,64,51,1
210429,617,150,467,52,3
210429,130,47,83,59,1
210429,556,237,319,60,1
210438,682,383,299,1,4
210438,80,26,54,2,1
210438,43,11,32,3,1
210438,10,1,9,4,1
210438,33,10,23,5,1
210438,37,15,22,11,1
210438,602,357,245,12,3
210438,33,10,23,19,1
210438,488,308,180,21,4
210438,488,308,180,32,3
210438,194,75,119,41,4
210438,80,26,54,42,1
210438,43,11,32,43,1
210438,10,1,9,44,1
210438,33,10,23,45,1
210438,37,15,22,51,1
210438,114,49,65,52,3
210438,33,10,23,59,1
210456,224,40,184,1,4
210456,224,40,184,2,1
210456,224,40,184,3,1
210456,224,40,184,5,1
210456,224,40,184,20,1
210456,216,38,178,21,4
210456,216,38,178,22,1
210456,216,38,178,23,1
210456,216,38,178,25,1
210456,216,38,178,40,1
210456,8,2,6,41,4
210456,8,2,6,42,1
210456,8,2,6,43,1
210456,8,2,6,45,1
210456,8,2,6,60,1
210474,97,23,74,1,4
210474,97,23,74,2,1
210474,97,23,74,3,1
210474,69,19,50,4,1
210474,28,4,24,5,1
210474,28,4,24,20,1
210474,60,15,45,21,4
210474,60,15,45,22,1
210474,60,15,45,23,1
210474,42,12,30,24,1
210474,18,3,15,25,1
210474,18,3,15,40,1
210474,37,8,29,41,4
210474,37,8,29,42,1
210474,37,8,29,43,1
210474,27,7,20,44,1
210474,10,1,9,45,1
210474,10,1,9,60,1
210483,313,114,199,1,4
210483,313,114,199,2,1
210483,313,114,199,3,1
210483,53,17,36,4,1
210483,260,97,163,5,1
210483,260,97,163,20,1
210483,313,114,199,21,4
210483,313,114,199,22,1
210483,313,114,199,23,1
210483,53,17,36,24,1
210483,260,97,163,25,1
210483,260,97,163,40,1
210492,278,135,143,1,4
210492,270,130,140,2,1
210492,269,129,140,3,1
210492,81,42,39,4,1
210492,188,87,101,5,1
210492,1,1,0,11,1
210492,8,5,3,12,3
210492,13,7,6,19,1
210492,175,80,95,20,1
210492,265,130,135,21,4
210492,262,127,135,22,1
210492,261,126,135,23,1
210492,80,41,39,24,1
210492,181,85,96,25,1
210492,1,1,0,31,1
210492,3,3,0,32,3
210492,13,7,6,39,1
210492,168,78,90,40,1
210492,13,5,8,41,4
210492,8,3,5,42,1
210492,8,3,5,43,1
210492,1,1,0,44,1
210492,7,2,5,45,1
210492,5,2,3,52,3
210492,7,2,5,60,1
210508,29,17,12,1,4
210508,29,17,12,12,3
210508,29,17,12,21,4
210508,29,17,12,32,3
210571,2384,996,1388,1,4
210571,2349,986,1363,2,1
210571,2333,982,1351,3,1
210571,655,270,385,4,1
210571,1678,712,966,5,1
210571,16,4,12,11,1
210571,35,10,25,12,3
210571,107,41,66,19,1
210571,1571,671,900,20,1
210571,2315,970,1345,21,4
210571,2315,970,1345,22,1
210571,2315,970,1345,23,1
210571,655,270,385,24,1
210571,1660,700,960,25,1
210571,107,41,66,39,1
210571,1553,659,894,40,1
210571,69,26,43,41,4
210571,34,16,18,42,1
210571,18,12,6,43,1
210571,18,12,6,45,1
210571,16,4,12,51,1
210571,35,10,25,52,3
210571,18,12,6,60,1
210599,343,322,21,1,4
210599,343,322,21,2,1
210599,343,322,21,3,1
210599,65,64,1,4,1
210599,278,258,20,5,1
210599,278,258,20,20,1
210599,343,322,21,21,4
210599,343,322,21,22,1
210599,343,322,21,23,1
210599,65,64,1,24,1
210599,278,258,20,25,1
210599,278,258,20,40,1
210605,18229,7812,10417,1,4
210605,18229,7812,10417,2,1
210605,17098,7309,9789,3,1
210605,3942,1870,2072,4,1
210605,13156,5439,7717,5,1
210605,1131,503,628,11,1
210605,828,371,457,19,1
210605,12328,5068,7260,20,1
210605,6317,2951,3366,21,4
210605,6317,2951,3366,22,1
210605,6231,2902,3329,23,1
210605,2170,1041,1129,24,1
210605,4061,1861,2200,25,1
210605,86,49,37,31,1
210605,369,178,191,39,1
210605,3692,1683,2009,40,1
210605,11912,4861,7051,41,4
210605,11912,4861,7051,42,1
210605,10867,4407,6460,43,1
210605,1772,829,943,44,1
210605,9095,3578,5517,45,1
210605,1045,454,591,51,1
210605,459,193,266,59,1
210605,8636,3385,5251,60,1
210669,2161,986,1175,1,4
210669,2161,986,1175,2,1
210669,2126,978,1148,3,1
210669,604,293,311,4,1
210669,1522,685,837,5,1
210669,35,8,27,11,1
210669,22,13,9,19,1
210669,1500,672,828,20,1
210669,2125,979,1146,21,4
210669,2125,979,1146,22,1
210669,2117,977,1140,23,1
210669,601,293,308,24,1
210669,1516,684,832,25,1
210669,8,2,6,31,1
210669,22,13,9,39,1
210669,1494,671,823,40,1
210669,36,7,29,41,4
210669,36,7,29,42,1
210669,9,1,8,43,1
210669,3,0,3,44,1
210669,6,1,5,45,1
210669,27,6,21,51,1
210669,6,1,5,60,1
210711,59,8,51,1,4
210711,59,8,51,2,1
210711,59,8,51,3,1
210711,54,8,46,4,1
210711,5,0,5,5,1
210711,5,0,5,20,1
210711,59,8,51,21,4
210711,59,8,51,22,1
210711,59,8,51,23,1
210711,54,8,46,24,1
210711,5,0,5,25,1
210711,5,0,5,40,1
210739,3266,1268,1998,1,4
210739,2482,948,1534,2,1
210739,2482,948,1534,3,1
210739,413,186,227,4,1
210739,2069,762,1307,5,1
210739,784,320,464,12,3
210739,77,29,48,19,1
210739,1992,733,1259,20,1
210739,2063,825,1238,21,4
210739,1836,750,1086,22,1
210739,1836,750,1086,23,1
210739,413,186,227,24,1
210739,1423,564,859,25,1
210739,227,75,152,32,3
210739,77,29,48,39,1
210739,1346,535,811,40,1
210739,1203,443,760,41,4
210739,646,198,448,42,1
210739,646,198,448,43,1
210739,646,198,448,45,1
210739,557,245,312,52,3
210739,646,198,448,60,1
210748,68,2,66,1,4
210748,68,2,66,2,1
210748,68,2,66,3,1
210748,11,0,11,4,1
210748,57,2,55,5,1
210748,57,2,55,20,1
210748,33,2,31,21,4
210748,33,2,31,22,1
210748,33,2,31,23,1
210748,7,0,7,24,1
210748,26,2,24,25,1
210748,26,2,24,40,1
210748,35,0,35,41,4
210748,35,0,35,42,1
210748,35,0,35,43,1
210748,4,0,4,44,1
210748,31,0,31,45,1
210748,31,0,31,60,1
210775,2871,841,2030,1,4
210775,2371,657,1714,2,1
210775,2169,630,1539,3,1
210775,389,111,278,4,1
210775,1780,519,1261,5,1
210775,202,27,175,11,1
210775,500,184,316,12,3
210775,105,38,67,19,1
210775,1675,481,1194,20,1
210775,1824,580,1244,21,4
210775,1719,535,1184,22,1
210775,1717,535,1182,23,1
210775,389,111,278,24,1
210775,1328,424,904,25,1
210775,2,0,2,31,1
210775,105,45,60,32,3
210775,103,38,65,39,1
210775,1225,386,839,40,1
210775,1047,261,786,41,4
210775,652,122,530,42,1
210775,452,95,357,43,1
210775,452,95,357,45,1
210775,200,27,173,51,1
210775,395,139,256,52,3
210775,2,0,2,59,1
210775,450,95,355,60,1
210784,106,8,98,1,4
210784,106,8,98,2,1
210784,106,8,98,3,1
210784,69,8,61,4,1
210784,37,0,37,5,1
210784,37,0,37,20,1
210784,78,6,72,21,4
210784,78,6,72,22,1
210784,78,6,72,23,1
210784,53,6,47,24,1
210784,25,0,25,25,1
210784,25,0,25,40,1
210784,28,2,26,41,4
210784,28,2,26,42,1
210784,28,2,26,43,1
210784,16,2,14,44,1
210784,12,0,12,45,1
210784,12,0,12,60,1
210809,27749,19513,8236,1,4
210809,26837,18854,7983,2,1
210809,26837,18854,7983,3,1
210809,26837,18854,7983,5,1
210809,912,659,253,12,3
210809,26837,18854,7983,20,1
210809,27749,19513,8236,41,4
210809,26837,18854,7983,42,1
210809,26837,18854,7983,43,1
210809,26837,18854,7983,45,1
210809,912,659,253,52,3
210809,26837,18854,7983,60,1
210890,189,58,131,1,4
210890,189,58,131,2,1
210890,189,58,131,3,1
210890,98,26,72,4,1
210890,91,32,59,5,1
210890,14,8,6,19,1
210890,77,24,53,20,1
210890,189,58,131,21,4
210890,189,58,131,22,1
210890,189,58,131,23,1
210890,98,26,72,24,1
210890,91,32,59,25,1
210890,14,8,6,39,1
210890,77,24,53,40,1
210906,462,216,246,1,4
210906,462,216,246,2,1
210906,462,216,246,3,1
210906,115,56,59,4,1
210906,347,160,187,5,1
210906,25,13,12,19,1
210906,322,147,175,20,1
210906,323,147,176,21,4
210906,323,147,176,22,1
210906,323,147,176,23,1
210906,73,33,40,24,1
210906,250,114,136,25,1
210906,14,9,5,39,1
210906,236,105,131,40,1
210906,139,69,70,41,4
210906,139,69,70,42,1
210906,139,69,70,43,1
210906,42,23,19,44,1
210906,97,46,51,45,1
210906,11,4,7,59,1
210906,86,42,44,60,1
210942,2494,1206,1288,1,4
210942,2494,1206,1288,2,1
210942,2494,1206,1288,3,1
210942,642,329,313,4,1
210942,1852,877,975,5,1
210942,145,67,78,19,1
210942,1707,810,897,20,1
210942,1516,768,748,21,4
210942,1516,768,748,22,1
210942,1516,768,748,23,1
210942,466,255,211,24,1
210942,1050,513,537,25,1
210942,110,53,57,39,1
210942,940,460,480,40,1
210942,978,438,540,41,4
210942,978,438,540,42,1
210942,978,438,540,43,1
210942,176,74,102,44,1
210942,802,364,438,45,1
210942,35,14,21,59,1
210942,767,350,417,60,1
210951,163,8,155,1,4
210951,163,8,155,2,1
210951,163,8,155,3,1
210951,35,3,32,4,1
210951,128,5,123,5,1
210951,21,1,20,19,1
210951,107,4,103,20,1
210951,163,8,155,21,4
210951,163,8,155,22,1
210951,163,8,155,23,1
210951,35,3,32,24,1
210951,128,5,123,25,1
210951,21,1,20,39,1
210951,107,4,103,40,1
210960,1544,769,775,1,4
210960,1544,769,775,2,1
210960,1544,769,775,3,1
210960,373,194,179,4,1
210960,1171,575,596,5,1
210960,140,57,83,19,1
210960,1031,518,513,20,1
210960,1137,566,571,21,4
210960,1137,566,571,22,1
210960,1137,566,571,23,1
210960,318,165,153,24,1
210960,819,401,418,25,1
210960,108,45,63,39,1
210960,711,356,355,40,1
210960,407,203,204,41,4
210960,407,203,204,42,1
210960,407,203,204,43,1
210960,55,29,26,44,1
210960,352,174,178,45,1
210960,32,12,20,59,1
210960,320,162,158,60,1
211006,354,341,13,1,4
211006,354,341,13,2,1
211006,354,341,13,3,1
211006,49,48,1,4,1
211006,305,293,12,5,1
211006,305,293,12,20,1
211006,308,299,9,21,4
211006,308,299,9,22,1
211006,308,299,9,23,1
211006,45,44,1,24,1
211006,263,255,8,25,1
211006,263,255,8,40,1
211006,46,42,4,41,4
211006,46,42,4,42,1
211006,46,42,4,43,1
211006,4,4,0,44,1
211006,42,38,4,45,1
211006,42,38,4,60,1
211024,918,543,375,1,4
211024,624,323,301,2,1
211024,606,309,297,3,1
211024,106,46,60,4,1
211024,500,263,237,5,1
211024,18,14,4,11,1
211024,294,220,74,12,3
211024,50,29,21,19,1
211024,450,234,216,20,1
211024,549,308,241,21,4
211024,387,181,206,22,1
211024,383,177,206,23,1
211024,99,43,56,24,1
211024,284,134,150,25,1
211024,4,4,0,31,1
211024,162,127,35,32,3
211024,34,18,16,39,1
211024,250,116,134,40,1
211024,369,235,134,41,4
211024,237,142,95,42,1
211024,223,132,91,43,1
211024,7,3,4,44,1
211024,216,129,87,45,1
211024,14,10,4,51,1
211024,132,93,39,52,3
211024,16,11,5,59,1
211024,200,118,82,60,1
211079,2335,951,1384,1,4
211079,2335,951,1384,2,1
211079,2030,861,1169,3,1
211079,410,186,224,4,1
211079,1620,675,945,5,1
211079,305,90,215,11,1
211079,432,201,231,19,1
211079,1188,474,714,20,1
211079,1014,479,535,21,4
211079,1014,479,535,22,1
211079,989,477,512,23,1
211079,291,147,144,24,1
211079,698,330,368,25,1
211079,25,2,23,31,1
211079,174,91,83,39,1
211079,524,239,285,40,1
211079,1321,472,849,41,4
211079,1321,472,849,42,1
211079,1041,384,657,43,1
211079,119,39,80,44,1
211079,922,345,577,45,1
211079,280,88,192,51,1
211079,258,110,148,59,1
211079,664,235,429,60,1
211088,3905,1148,2757,1,4
211088,2453,792,1661,2,1
211088,2400,765,1635,3,1
211088,597,178,419,4,1
211088,1803,587,1216,5,1
211088,53,27,26,11,1
211088,1452,356,1096,12,3
211088,116,43,73,19,1
211088,1687,544,1143,20,1
211088,2844,825,2019,21,4
211088,2260,707,1553,22,1
211088,2259,706,1553,23,1
211088,597,178,419,24,1
211088,1662,528,1134,25,1
211088,1,1,0,31,1
211088,584,118,466,32,3
211088,113,40,73,39,1
211088,1549,488,1061,40,1
211088,1061,323,738,41,4
211088,193,85,108,42,1
211088,141,59,82,43,1
211088,141,59,82,45,1
211088,52,26,26,51,1
211088,868,238,630,52,3
211088,3,3,0,59,1
211088,138,56,82,60,1
211130,294,195,99,1,4
211130,294,195,99,12,3
211130,170,124,46,21,4
211130,170,124,46,32,3
211130,124,71,53,41,4
211130,124,71,53,52,3
211149,159,59,100,1,4
211149,159,59,100,2,1
211149,159,59,100,3,1
211149,19,13,6,4,1
211149,140,46,94,5,1
211149,43,17,26,19,1
211149,97,29,68,20,1
211149,159,59,100,21,4
211149,159,59,100,22,1
211149,159,59,100,23,1
211149,19,13,6,24,1
211149,140,46,94,25,1
211149,43,17,26,39,1
211149,97,29,68,40,1
211158,10127,4294,5833,1,4
211158,9416,4098,5318,2,1
211158,9245,4025,5220,3,1
211158,2218,923,1295,4,1
211158,7027,3102,3925,5,1
211158,171,73,98,11,1
211158,711,196,515,12,3
211158,469,233,236,19,1
211158,6558,2869,3689,20,1
211158,9155,3919,5236,21,4
211158,8813,3813,5000,22,1
211158,8775,3801,4974,23,1
211158,2208,915,1293,24,1
211158,6567,2886,3681,25,1
211158,38,12,26,31,1
211158,342,106,236,32,3
211158,435,214,221,39,1
211158,6132,2672,3460,40,1
211158,972,375,597,41,4
211158,603,285,318,42,1
211158,470,224,246,43,1
211158,10,8,2,44,1
211158,460,216,244,45,1
211158,133,61,72,51,1
211158,369,90,279,52,3
211158,34,19,15,59,1
211158,426,197,229,60,1
211200,439,108,331,1,4
211200,439,108,331,2,1
211200,439,108,331,3,1
211200,187,51,136,4,1
211200,252,57,195,5,1
211200,43,5,38,19,1
211200,209,52,157,20,1
211200,439,108,331,21,4
211200,439,108,331,22,1
211200,439,108,331,23,1
211200,187,51,136,24,1
211200,252,57,195,25,1
211200,43,5,38,39,1
211200,209,52,157,40,1
211273,1738,83,1655,1,4
211273,1328,0,1328,2,1
211273,1316,0,1316,3,1
211273,365,0,365,4,1
211273,951,0,951,5,1
211273,12,0,12,11,1
211273,410,83,327,12,3
211273,12,0,12,19,1
211273,939,0,939,20,1
211273,1663,75,1588,21,4
211273,1315,0,1315,22,1
211273,1311,0,1311,23,1
211273,365,0,365,24,1
211273,946,0,946,25,1
211273,4,0,4,31,1
211273,348,75,273,32,3
211273,12,0,12,39,1
211273,934,0,934,40,1
211273,75,8,67,41,4
211273,13,0,13,42,1
211273,5,0,5,43,1
211273,5,0,5,45,1
211273,8,0,8,51,1
211273,62,8,54,52,3
211273,5,0,5,60,1
211291,3608,1723,1885,1,4
211291,3532,1687,1845,2,1
211291,3498,1668,1830,3,1
211291,933,449,484,4,1
211291,2565,1219,1346,5,1
211291,34,19,15,11,1
211291,76,36,40,12,3
211291,28,12,16,19,1
211291,2537,1207,1330,20,1
211291,3555,1706,1849,21,4
211291,3504,1677,1827,22,1
211291,3488,1666,1822,23,1
211291,933,449,484,24,1
211291,2555,1217,1338,25,1
211291,16,11,5,31,1
211291,51,29,22,32,3
211291,28,12,16,39,1
211291,2527,1205,1322,40,1
211291,53,17,36,41,4
211291,28,10,18,42,1
211291,10,2,8,43,1
211291,10,2,8,45,1
211291,18,8,10,51,1
211291,25,7,18,52,3
211291,10,2,8,60,1
211307,9880,4446,5434,1,4
211307,9880,4446,5434,2,1
211307,9347,4217,5130,3,1
211307,2345,1176,1169,4,1
211307,7002,3041,3961,5,1
211307,533,229,304,11,1
211307,1152,489,663,19,1
211307,5850,2552,3298,20,1
211307,3260,1608,1652,21,4
211307,3260,1608,1652,22,1
211307,3239,1599,1640,23,1
211307,1218,618,600,24,1
211307,2021,981,1040,25,1
211307,21,9,12,31,1
211307,367,158,209,39,1
211307,1654,823,831,40,1
211307,6620,2838,3782,41,4
211307,6620,2838,3782,42,1
211307,6108,2618,3490,43,1
211307,1127,558,569,44,1
211307,4981,2060,2921,45,1
211307,512,220,292,51,1
211307,785,331,454,59,1
211307,4196,1729,2467,60,1
211316,89,8,81,1,4
211316,89,8,81,2,1
211316,89,8,81,3,1
211316,40,4,36,4,1
211316,49,4,45,5,1
211316,49,4,45,20,1
211316,78,7,71,21,4
211316,78,7,71,22,1
211316,78,7,71,23,1
211316,35,3,32,24,1
211316,43,4,39,25,1
211316,43,4,39,40,1
211316,11,1,10,41,4
211316,11,1,10,42,1
211316,11,1,10,43,1
211316,5,1,4,44,1
211316,6,0,6,45,1
211316,6,0,6,60,1
211334,52,3,49,1,4
211334,52,3,49,2,1
211334,52,3,49,3,1
211334,31,3,28,4,1
211334,21,0,21,5,1
211334,21,0,21,20,1
211334,52,3,49,21,4
211334,52,3,49,22,1
211334,52,3,49,23,1
211334,31,3,28,24,1
211334,21,0,21,25,1
211334,21,0,21,40,1
211343,3686,1509,2177,1,4
211343,3686,1509,2177,2,1
211343,3286,1328,1958,3,1
211343,970,438,532,4,1
211343,2316,890,1426,5,1
211343,400,181,219,11,1
211343,257,112,145,19,1
211343,2059,778,1281,20,1
211343,1608,707,901,21,4
211343,1608,707,901,22,1
211343,1606,706,900,23,1
211343,651,288,363,24,1
211343,955,418,537,25,1
211343,2,1,1,31,1
211343,124,56,68,39,1
211343,831,362,469,40,1
211343,2078,802,1276,41,4
211343,2078,802,1276,42,1
211343,1680,622,1058,43,1
211343,319,150,169,44,1
211343,1361,472,889,45,1
211343,398,180,218,51,1
211343,133,56,77,59,1
211343,1228,416,812,60,1
211352,2448,753,1695,1,4
211352,1337,487,850,2,1
211352,1286,466,820,3,1
211352,304,103,201,4,1
211352,982,363,619,5,1
211352,51,21,30,11,1
211352,1111,266,845,12,3
211352,72,35,37,19,1
211352,910,328,582,20,1
211352,1303,457,846,21,4
211352,1228,435,793,22,1
211352,1228,435,793,23,1
211352,304,103,201,24,1
211352,924,332,592,25,1
211352,75,22,53,32,3
211352,66,32,34,39,1
211352,858,300,558,40,1
211352,1145,296,849,41,4
211352,109,52,57,42,1
211352,58,31,27,43,1
211352,58,31,27,45,1
211352,51,21,30,51,1
211352,1036,244,792,52,3
211352,6,3,3,59,1
211352,52,28,24,60,1
211361,8243,3806,4437,1,4
211361,6450,3122,3328,2,1
211361,6393,3089,3304,3,1
211361,1173,562,611,4,1
211361,5220,2527,2693,5,1
211361,57,33,24,11,1
211361,1793,684,1109,12,3
211361,646,281,365,19,1
211361,4574,2246,2328,20,1
211361,6527,3090,3437,21,4
211361,5649,2759,2890,22,1
211361,5638,2749,2889,23,1
211361,1164,555,609,24,1
211361,4474,2194,2280,25,1
211361,11,10,1,31,1
211361,878,331,547,32,3
211361,515,237,278,39,1
211361,3959,1957,2002,40,1
211361,1716,716,1000,41,4
211361,801,363,438,42,1
211361,755,340,415,43,1
211361,9,7,2,44,1
211361,746,333,413,45,1
211361,46,23,23,51,1
211361,915,353,562,52,3
211361,131,44,87,59,1
211361,615,289,326,60,1
211370,62,60,2,1,4
211370,62,60,2,12,3
211370,24,24,0,21,4
211370,24,24,0,32,3
211370,38,36,2,41,4
211370,38,36,2,52,3
211398,142,22,120,1,4
211398,142,22,120,2,1
211398,142,22,120,3,1
211398,42,6,36,4,1
211398,100,16,84,5,1
211398,17,3,14,19,1
211398,83,13,70,20,1
211398,141,22,119,21,4
211398,141,22,119,22,1
211398,141,22,119,23,1
211398,42,6,36,24,1
211398,99,16,83,25,1
211398,17,3,14,39,1
211398,82,13,69,40,1
211398,1,0,1,41,4
211398,1,0,1,42,1
211398,1,0,1,43,1
211398,1,0,1,45,1
211398,1,0,1,60,1
211431,3012,501,2511,1,4
211431,2100,374,1726,2,1
211431,1496,142,1354,3,1
211431,205,14,191,4,1
211431,1291,128,1163,5,1
211431,604,232,372,11,1
211431,912,127,785,12,3
211431,197,23,174,19,1
211431,1094,105,989,20,1
211431,1732,181,1551,21,4
211431,1079,92,987,22,1
211431,1065,87,978,23,1
211431,203,14,189,24,1
211431,862,73,789,25,1
211431,14,5,9,31,1
211431,653,89,564,32,3
211431,135,15,120,39,1
211431,727,58,669,40,1
211431,1280,320,960,41,4
211431,1021,282,739,42,1
211431,431,55,376,43,1
211431,2,0,2,44,1
211431,429,55,374,45,1
211431,590,227,363,51,1
211431,259,38,221,52,3
211431,62,8,54,59,1
211431,367,47,320,60,1
211440,12367,7740,4627,1,4
211440,5917,3420,2497,2,1
211440,5834,3365,2469,3,1
211440,1442,800,642,4,1
211440,4392,2565,1827,5,1
211440,83,55,28,11,1
211440,6450,4320,2130,12,3
211440,66,43,23,19,1
211440,4326,2522,1804,20,1
211440,11279,6941,4338,21,4
211440,5723,3303,2420,22,1
211440,5723,3303,2420,23,1
211440,1442,800,642,24,1
211440,4281,2503,1778,25,1
211440,5556,3638,1918,32,3
211440,65,42,23,39,1
211440,4216,2461,1755,40,1
211440,1088,799,289,41,4
211440,194,117,77,42,1
211440,111,62,49,43,1
211440,111,62,49,45,1
211440,83,55,28,51,1
211440,894,682,212,52,3
211440,1,1,0,59,1
211440,110,61,49,60,1
211468,1486,109,1377,1,4
211468,1286,90,1196,2,1
211468,1252,84,1168,3,1
211468,141,1,140,4,1
211468,1111,83,1028,5,1
211468,34,6,28,11,1
211468,200,19,181,12,3
211468,220,29,191,19,1
211468,891,54,837,20,1
211468,681,40,641,21,4
211468,640,33,607,22,1
211468,640,33,607,23,1
211468,140,1,139,24,1
211468,500,32,468,25,1
211468,41,7,34,32,3
211468,99,20,79,39,1
211468,401,12,389,40,1
211468,805,69,736,41,4
211468,646,57,589,42,1
211468,612,51,561,43,1
211468,1,0,1,44,1
211468,611,51,560,45,1
211468,34,6,28,51,1
211468,159,12,147,52,3
211468,121,9,112,59,1
211468,490,42,448,60,1
211477,1297,456,841,1,4
211477,1277,452,825,2,1
211477,1277,452,825,3,1
211477,127,57,70,4,1
211477,1150,395,755,5,1
211477,20,4,16,12,3
211477,1150,395,755,20,1
211477,638,248,390,21,4
211477,638,248,390,22,1
211477,638,248,390,23,1
211477,95,44,51,24,1
211477,543,204,339,25,1
211477,543,204,339,40,1
211477,659,208,451,41,4
211477,639,204,435,42,1
211477,639,204,435,43,1
211477,32,13,19,44,1
211477,607,191,416,45,1
211477,20,4,16,52,3
211477,607,191,416,60,1
211556,2170,331,1839,1,4
211556,973,88,885,2,1
211556,616,11,605,3,1
211556,92,0,92,4,1
211556,524,11,513,5,1
211556,357,77,280,11,1
211556,1197,243,954,12,3
211556,64,0,64,19,1
211556,460,11,449,20,1
211556,1488,205,1283,21,4
211556,611,26,585,22,1
211556,533,1,532,23,1
211556,92,0,92,24,1
211556,441,1,440,25,1
211556,78,25,53,31,1
211556,877,179,698,32,3
211556,57,0,57,39,1
211556,384,1,383,40,1
211556,682,126,556,41,4
211556,362,62,300,42,1
211556,83,10,73,43,1
211556,83,10,73,45,1
211556,279,52,227,51,1
211556,320,64,256,52,3
211556,7,0,7,59,1
211556,76,10,66,60,1
211583,2189,635,1554,1,4
211583,1517,491,1026,2,1
211583,1510,489,1021,3,1
211583,190,78,112,4,1
211583,1320,411,909,5,1
211583,7,2,5,11,1
211583,672,144,528,12,3
211583,234,63,171,19,1
211583,1086,348,738,20,1
211583,1442,462,980,21,4
211583,1165,411,754,22,1
211583,1165,411,754,23,1
211583,190,78,112,24,1
211583,975,333,642,25,1
211583,277,51,226,32,3
211583,134,42,92,39,1
211583,841,291,550,40,1
211583,747,173,574,41,4
211583,352,80,272,42,1
211583,345,78,267,43,1
211583,345,78,267,45,1
211583,7,2,5,51,1
211583,395,93,302,52,3
211583,100,21,79,59,1
211583,245,57,188,60,1
211608,1212,584,628,1,4
211608,1179,570,609,2,1
211608,1178,569,609,3,1
211608,346,174,172,4,1
211608,832,395,437,5,1
211608,1,1,0,11,1
211608,33,14,19,12,3
211608,63,32,31,19,1
211608,769,363,406,20,1
211608,1123,547,576,21,4
211608,1114,544,570,22,1
211608,1114,544,570,23,1
211608,344,173,171,24,1
211608,770,371,399,25,1
211608,9,3,6,32,3
211608,58,32,26,39,1
211608,712,339,373,40,1
211608,89,37,52,41,4
211608,65,26,39,42,1
211608,64,25,39,43,1
211608,2,1,1,44,1
211608,62,24,38,45,1
211608,1,1,0,51,1
211608,24,11,13,52,3
211608,5,0,5,59,1
211608,57,24,33,60,1
211617,718,264,454,1,4
211617,718,264,454,2,1
211617,718,264,454,3,1
211617,133,38,95,4,1
211617,585,226,359,5,1
211617,36,8,28,19,1
211617,549,218,331,20,1
211617,718,264,454,21,4
211617,718,264,454,22,1
211617,718,264,454,23,1
211617,133,38,95,24,1
211617,585,226,359,25,1
211617,36,8,28,39,1
211617,549,218,331,40,1
211635,181,15,166,1,4
211635,181,15,166,2,1
211635,181,15,166,3,1
211635,181,15,166,5,1
211635,181,15,166,20,1
211635,181,15,166,21,4
211635,181,15,166,22,1
211635,181,15,166,23,1
211635,181,15,166,25,1
211635,181,15,166,40,1
211644,6080,2128,3952,1,4
211644,5199,1934,3265,2,1
211644,5046,1897,3149,3,1
211644,996,392,604,4,1
211644,4050,1505,2545,5,1
211644,153,37,116,11,1
211644,881,194,687,12,3
211644,475,187,288,19,1
211644,3575,1318,2257,20,1
211644,4580,1755,2825,21,4
211644,4373,1715,2658,22,1
211644,4372,1715,2657,23,1
211644,964,381,583,24,1
211644,3408,1334,2074,25,1
211644,1,0,1,31,1
211644,207,40,167,32,3
211644,317,127,190,39,1
211644,3091,1207,1884,40,1
211644,1500,373,1127,41,4
211644,826,219,607,42,1
211644,674,182,492,43,1
211644,32,11,21,44,1
211644,642,171,471,45,1
211644,152,37,115,51,1
211644,674,154,520,52,3
211644,158,60,98,59,1
211644,484,111,373,60,1
211750,109,38,71,1,4
211750,109,38,71,2,1
211750,109,38,71,3,1
211750,1,1,0,4,1
211750,108,37,71,5,1
211750,108,37,71,20,1
211750,109,38,71,21,4
211750,109,38,71,22,1
211750,109,38,71,23,1
211750,1,1,0,24,1
211750,108,37,71,25,1
211750,108,37,71,40,1
211802,231,66,165,1,4
211802,231,66,165,2,1
211802,231,66,165,3,1
211802,39,18,21,4,1
211802,192,48,144,5,1
211802,192,48,144,20,1
211802,214,56,158,21,4
211802,214,56,158,22,1
211802,214,56,158,23,1
211802,29,11,18,24,1
211802,185,45,140,25,1
211802,185,45,140,40,1
211802,17,10,7,41,4
211802,17,10,7,42,1
211802,17,10,7,43,1
211802,10,7,3,44,1
211802,7,3,4,45,1
211802,7,3,4,60,1
211820,107,15,92,1,4
211820,107,15,92,2,1
211820,107,15,92,3,1
211820,14,1,13,4,1
211820,93,14,79,5,1
211820,19,6,13,19,1
211820,74,8,66,20,1
211820,103,14,89,21,4
211820,103,14,89,22,1
211820,103,14,89,23,1
211820,14,1,13,24,1
211820,89,13,76,25,1
211820,18,6,12,39,1
211820,71,7,64,40,1
211820,4,1,3,41,4
211820,4,1,3,42,1
211820,4,1,3,43,1
211820,4,1,3,45,1
211820,1,0,1,59,1
211820,3,1,2,60,1
211893,168,93,75,1,4
211893,122,65,57,2,1
211893,122,65,57,3,1
211893,29,14,15,4,1
211893,93,51,42,5,1
211893,46,28,18,12,3
211893,5,2,3,19,1
211893,88,49,39,20,1
211893,168,93,75,21,4
211893,122,65,57,22,1
211893,122,65,57,23,1
211893,29,14,15,24,1
211893,93,51,42,25,1
211893,46,28,18,32,3
211893,5,2,3,39,1
211893,88,49,39,40,1
211909,163,161,2,1,4
211909,163,161,2,2,1
211909,163,161,2,3,1
211909,70,69,1,4,1
211909,93,92,1,5,1
211909,93,92,1,20,1
211909,116,115,1,21,4
211909,116,115,1,22,1
211909,116,115,1,23,1
211909,53,52,1,24,1
211909,63,63,0,25,1
211909,63,63,0,40,1
211909,47,46,1,41,4
211909,47,46,1,42,1
211909,47,46,1,43,1
211909,17,17,0,44,1
211909,30,29,1,45,1
211909,30,29,1,60,1
211927,13198,5824,7374,1,4
211927,13198,5824,7374,2,1
211927,13198,5824,7374,3,1
211927,2516,1236,1280,4,1
211927,10682,4588,6094,5,1
211927,1103,477,626,19,1
211927,9579,4111,5468,20,1
211927,4844,2481,2363,21,4
211927,4844,2481,2363,22,1
211927,4844,2481,2363,23,1
211927,1269,667,602,24,1
211927,3575,1814,1761,25,1
211927,397,211,186,39,1
211927,3178,1603,1575,40,1
211927,8354,3343,5011,41,4
211927,8354,3343,5011,42,1
211927,8354,3343,5011,43,1
211927,1247,569,678,44,1
211927,7107,2774,4333,45,1
211927,706,266,440,59,1
211927,6401,2508,3893,60,1
211981,2023,750,1273,1,4
211981,1807,661,1146,2,1
211981,1774,640,1134,3,1
211981,416,140,276,4,1
211981,1358,500,858,5,1
211981,33,21,12,11,1
211981,216,89,127,12,3
211981,96,46,50,19,1
211981,1262,454,808,20,1
211981,1681,603,1078,21,4
211981,1609,573,1036,22,1
211981,1607,572,1035,23,1
211981,416,140,276,24,1
211981,1191,432,759,25,1
211981,2,1,1,31,1
211981,72,30,42,32,3
211981,87,41,46,39,1
211981,1104,391,713,40,1
211981,342,147,195,41,4
211981,198,88,110,42,1
211981,167,68,99,43,1
211981,167,68,99,45,1
211981,31,20,11,51,1
211981,144,59,85,52,3
211981,9,5,4,59,1
211981,158,63,95,60,1
212009,2396,1054,1342,1,4
212009,2396,1054,1342,2,1
212009,2352,1037,1315,3,1
212009,626,270,356,4,1
212009,1726,767,959,5,1
212009,44,17,27,11,1
212009,16,5,11,19,1
212009,1710,762,948,20,1
212009,2356,1035,1321,21,4
212009,2356,1035,1321,22,1
212009,2339,1031,1308,23,1
212009,626,270,356,24,1
212009,1713,761,952,25,1
212009,17,4,13,31,1
212009,16,5,11,39,1
212009,1697,756,941,40,1
212009,40,19,21,41,4
212009,40,19,21,42,1
212009,13,6,7,43,1
212009,13,6,7,45,1
212009,27,13,14,51,1
212009,13,6,7,60,1
212018,142,75,67,1,4
212018,142,75,67,12,3
212018,142,75,67,21,4
212018,142,75,67,32,3
212045,274,94,180,1,4
212045,274,94,180,2,1
212045,271,94,177,3,1
212045,79,26,53,4,1
212045,192,68,124,5,1
212045,3,0,3,11,1
212045,61,16,45,19,1
212045,131,52,79,20,1
212045,266,93,173,21,4
212045,266,93,173,22,1
212045,263,93,170,23,1
212045,74,26,48,24,1
212045,189,67,122,25,1
212045,3,0,3,31,1
212045,61,16,45,39,1
212045,128,51,77,40,1
212045,8,1,7,41,4
212045,8,1,7,42,1
212045,8,1,7,43,1
212045,5,0,5,44,1
212045,3,1,2,45,1
212045,3,1,2,60,1
212054,26132,12625,13507,1,4
212054,16616,8863,7753,2,1
212054,16257,8697,7560,3,1
212054,3039,1760,1279,4,1
212054,13218,6937,6281,5,1
212054,359,166,193,11,1
212054,9516,3762,5754,12,3
212054,1498,599,899,19,1
212054,11720,6338,5382,20,1
212054,18909,10086,8823,21,4
212054,13977,7920,6057,22,1
212054,13906,7885,6021,23,1
212054,3022,1753,1269,24,1
212054,10884,6132,4752,25,1
212054,71,35,36,31,1
212054,4932,2166,2766,32,3
212054,1009,489,520,39,1
212054,9875,5643,4232,40,1
212054,7223,2539,4684,41,4
212054,2639,943,1696,42,1
212054,2351,812,1539,43,1
212054,17,7,10,44,1
212054,2334,805,1529,45,1
212054,288,131,157,51,1
212054,4584,1596,2988,52,3
212054,489,110,379,59,1
212054,1845,695,1150,60,1
212072,122,23,99,1,4
212072,122,23,99,2,1
212072,122,23,99,3,1
212072,24,4,20,4,1
212072,98,19,79,5,1
212072,18,2,16,19,1
212072,80,17,63,20,1
212072,110,20,90,21,4
212072,110,20,90,22,1
212072,110,20,90,23,1
212072,24,4,20,24,1
212072,86,16,70,25,1
212072,18,2,16,39,1
212072,68,14,54,40,1
212072,12,3,9,41,4
212072,12,3,9,42,1
212072,12,3,9,43,1
212072,12,3,9,45,1
212072,12,3,9,60,1
212090,600,162,438,1,4
212090,600,162,438,2,1
212090,600,162,438,3,1
212090,46,6,40,4,1
212090,554,156,398,5,1
212090,90,26,64,19,1
212090,464,130,334,20,1
212090,460,92,368,21,4
212090,460,92,368,22,1
212090,460,92,368,23,1
212090,46,6,40,24,1
212090,414,86,328,25,1
212090,61,8,53,39,1
212090,353,78,275,40,1
212090,140,70,70,41,4
212090,140,70,70,42,1
212090,140,70,70,43,1
212090,140,70,70,45,1
212090,29,18,11,59,1
212090,111,52,59,60,1
212106,9904,4058,5846,1,4
212106,5970,2466,3504,2,1
212106,5944,2450,3494,3,1
212106,1547,573,974,4,1
212106,4397,1877,2520,5,1
212106,26,16,10,11,1
212106,3934,1592,2342,12,3
212106,148,79,69,19,1
212106,4249,1798,2451,20,1
212106,9008,3655,5353,21,4
212106,5740,2337,3403,22,1
212106,5736,2333,3403,23,1
212106,1537,568,969,24,1
212106,4199,1765,2434,25,1
212106,4,4,0,31,1
212106,3268,1318,1950,32,3
212106,142,77,65,39,1
212106,4057,1688,2369,40,1
212106,896,403,493,41,4
212106,230,129,101,42,1
212106,208,117,91,43,1
212106,10,5,5,44,1
212106,198,112,86,45,1
212106,22,12,10,51,1
212106,666,274,392,52,3
212106,6,2,4,59,1
212106,192,110,82,60,1
212115,6778,2986,3792,1,4
212115,6186,2762,3424,2,1
212115,6109,2732,3377,3,1
212115,1212,554,658,4,1
212115,4897,2178,2719,5,1
212115,77,30,47,11,1
212115,592,224,368,12,3
212115,646,287,359,19,1
212115,4251,1891,2360,20,1
212115,5794,2551,3243,21,4
212115,5495,2423,3072,22,1
212115,5460,2410,3050,23,1
212115,1143,512,631,24,1
212115,4317,1898,2419,25,1
212115,35,13,22,31,1
212115,299,128,171,32,3
212115,577,256,321,39,1
212115,3740,1642,2098,40,1
212115,984,435,549,41,4
212115,691,339,352,42,1
212115,649,322,327,43,1
212115,69,42,27,44,1
212115,580,280,300,45,1
212115,42,17,25,51,1
212115,293,96,197,52,3
212115,69,31,38,59,1
212115,511,249,262,60,1
212133,4004,1273,2731,1,4
212133,2541,758,1783,2,1
212133,2458,729,1729,3,1
212133,450,136,314,4,1
212133,2008,593,1415,5,1
212133,83,29,54,11,1
212133,1463,515,948,12,3
212133,271,62,209,19,1
212133,1737,531,1206,20,1
212133,2808,935,1873,21,4
212133,2076,659,1417,22,1
212133,2075,659,1416,23,1
212133,433,133,300,24,1
212133,1642,526,1116,25,1
212133,1,0,1,31,1
212133,732,276,456,32,3
212133,141,42,99,39,1
212133,1501,484,1017,40,1
212133,1196,338,858,41,4
212133,465,99,366,42,1
212133,383,70,313,43,1
212133,17,3,14,44,1
212133,366,67,299,45,1
212133,82,29,53,51,1
212133,731,239,492,52,3
212133,130,20,110,59,1
212133,236,47,189,60,1
212160,7098,2738,4360,1,4
212160,5864,2445,3419,2,1
212160,5756,2415,3341,3,1
212160,1086,454,632,4,1
212160,4670,1961,2709,5,1
212160,108,30,78,11,1
212160,1234,293,941,12,3
212160,461,204,257,19,1
212160,4209,1757,2452,20,1
212160,5770,2359,3411,21,4
212160,5320,2241,3079,22,1
212160,5316,2240,3076,23,1
212160,1073,450,623,24,1
212160,4243,1790,2453,25,1
212160,4,1,3,31,1
212160,450,118,332,32,3
212160,428,186,242,39,1
212160,3815,1604,2211,40,1
212160,1328,379,949,41,4
212160,544,204,340,42,1
212160,440,175,265,43,1
212160,13,4,9,44,1
212160,427,171,256,45,1
212160,104,29,75,51,1
212160,784,175,609,52,3
212160,33,18,15,59,1
212160,394,153,241,60,1
212197,1892,671,1221,1,4
212197,1844,669,1175,2,1
212197,1808,656,1152,3,1
212197,530,224,306,4,1
212197,1278,432,846,5,1
212197,36,13,23,11,1
212197,48,2,46,12,3
212197,25,8,17,19,1
212197,1253,424,829,20,1
212197,1856,655,1201,21,4
212197,1808,653,1155,22,1
212197,1796,648,1148,23,1
212197,530,224,306,24,1
212197,1266,424,842,25,1
212197,12,5,7,31,1
212197,48,2,46,32,3
212197,24,7,17,39,1
212197,1242,417,825,40,1
212197,36,16,20,41,4
212197,36,16,20,42,1
212197,12,8,4,43,1
212197,12,8,4,45,1
212197,24,8,16,51,1
212197,1,1,0,59,1
212197,11,7,4,60,1
212212,39,2,37,1,4
212212,39,2,37,2,1
212212,39,2,37,3,1
212212,21,2,19,4,1
212212,18,0,18,5,1
212212,18,0,18,20,1
212212,39,2,37,21,4
212212,39,2,37,22,1
212212,39,2,37,23,1
212212,21,2,19,24,1
212212,18,0,18,25,1
212212,18,0,18,40,1
212230,31,0,31,1,4
212230,31,0,31,2,1
212230,31,0,31,3,1
212230,17,0,17,4,1
212230,14,0,14,5,1
212230,14,0,14,20,1
212230,31,0,31,21,4
212230,31,0,31,22,1
212230,31,0,31,23,1
212230,17,0,17,24,1
212230,14,0,14,25,1
212230,14,0,14,40,1
212267,135,7,128,1,4
212267,135,7,128,2,1
212267,135,7,128,3,1
212267,60,2,58,4,1
212267,75,5,70,5,1
212267,75,5,70,20,1
212267,94,4,90,21,4
212267,94,4,90,22,1
212267,94,4,90,23,1
212267,42,1,41,24,1
212267,52,3,49,25,1
212267,52,3,49,40,1
212267,41,3,38,41,4
212267,41,3,38,42,1
212267,41,3,38,43,1
212267,18,1,17,44,1
212267,23,2,21,45,1
212267,23,2,21,60,1
212276,112,8,104,1,4
212276,112,8,104,2,1
212276,112,8,104,3,1
212276,54,5,49,4,1
212276,58,3,55,5,1
212276,58,3,55,20,1
212276,83,7,76,21,4
212276,83,7,76,22,1
212276,83,7,76,23,1
212276,47,4,43,24,1
212276,36,3,33,25,1
212276,36,3,33,40,1
212276,29,1,28,41,4
212276,29,1,28,42,1
212276,29,1,28,43,1
212276,7,1,6,44,1
212276,22,0,22,45,1
212276,22,0,22,60,1
212285,46,2,44,1,4
212285,46,2,44,2,1
212285,46,2,44,3,1
212285,27,2,25,4,1
212285,19,0,19,5,1
212285,19,0,19,20,1
212285,43,2,41,21,4
212285,43,2,41,22,1
212285,43,2,41,23,1
212285,26,2,24,24,1
212285,17,0,17,25,1
212285,17,0,17,40,1
212285,3,0,3,41,4
212285,3,0,3,42,1
212285,3,0,3,43,1
212285,1,0,1,44,1
212285,2,0,2,45,1
212285,2,0,2,60,1
212294,50,0,50,1,4
212294,50,0,50,2,1
212294,50,0,50,3,1
212294,27,0,27,4,1
212294,23,0,23,5,1
212294,23,0,23,20,1
212294,50,0,50,21,4
212294,50,0,50,22,1
212294,50,0,50,23,1
212294,27,0,27,24,1
212294,23,0,23,25,1
212294,23,0,23,40,1
212300,57,1,56,1,4
212300,57,1,56,2,1
212300,57,1,56,3,1
212300,22,1,21,4,1
212300,35,0,35,5,1
212300,35,0,35,20,1
212300,57,1,56,21,4
212300,57,1,56,22,1
212300,57,1,56,23,1
212300,22,1,21,24,1
212300,35,0,35,25,1
212300,35,0,35,40,1
212328,142,12,130,1,4
212328,142,12,130,2,1
212328,142,12,130,3,1
212328,55,1,54,4,1
212328,87,11,76,5,1
212328,87,11,76,20,1
212328,103,8,95,21,4
212328,103,8,95,22,1
212328,103,8,95,23,1
212328,42,1,41,24,1
212328,61,7,54,25,1
212328,61,7,54,40,1
212328,39,4,35,41,4
212328,39,4,35,42,1
212328,39,4,35,43,1
212328,13,0,13,44,1
212328,26,4,22,45,1
212328,26,4,22,60,1
212337,169,8,161,1,4
212337,169,8,161,2,1
212337,169,8,161,3,1
212337,52,2,50,4,1
212337,117,6,111,5,1
212337,117,6,111,20,1
212337,133,5,128,21,4
212337,133,5,128,22,1
212337,133,5,128,23,1
212337,43,2,41,24,1
212337,90,3,87,25,1
212337,90,3,87,40,1
212337,36,3,33,41,4
212337,36,3,33,42,1
212337,36,3,33,43,1
212337,9,0,9,44,1
212337,27,3,24,45,1
212337,27,3,24,60,1
212355,182,8,174,1,4
212355,182,8,174,2,1
212355,182,8,174,3,1
212355,94,4,90,4,1
212355,88,4,84,5,1
212355,88,4,84,20,1
212355,140,6,134,21,4
212355,140,6,134,22,1
212355,140,6,134,23,1
212355,75,3,72,24,1
212355,65,3,62,25,1
212355,65,3,62,40,1
212355,42,2,40,41,4
212355,42,2,40,42,1
212355,42,2,40,43,1
212355,19,1,18,44,1
212355,23,1,22,45,1
212355,23,1,22,60,1
212373,74,6,68,1,4
212373,74,6,68,2,1
212373,74,6,68,3,1
212373,28,3,25,4,1
212373,46,3,43,5,1
212373,46,3,43,20,1
212373,53,6,47,21,4
212373,53,6,47,22,1
212373,53,6,47,23,1
212373,20,3,17,24,1
212373,33,3,30,25,1
212373,33,3,30,40,1
212373,21,0,21,41,4
212373,21,0,21,42,1
212373,21,0,21,43,1
212373,8,0,8,44,1
212373,13,0,13,45,1
212373,13,0,13,60,1
212382,164,12,152,1,4
212382,164,12,152,2,1
212382,164,12,152,3,1
212382,49,3,46,4,1
212382,115,9,106,5,1
212382,115,9,106,20,1
212382,123,9,114,21,4
212382,123,9,114,22,1
212382,123,9,114,23,1
212382,37,2,35,24,1
212382,86,7,79,25,1
212382,86,7,79,40,1
212382,41,3,38,41,4
212382,41,3,38,42,1
212382,41,3,38,43,1
212382,12,1,11,44,1
212382,29,2,27,45,1
212382,29,2,27,60,1
212391,104,9,95,1,4
212391,104,9,95,2,1
212391,104,9,95,3,1
212391,59,5,54,4,1
212391,45,4,41,5,1
212391,45,4,41,20,1
212391,67,8,59,21,4
212391,67,8,59,22,1
212391,67,8,59,23,1
212391,41,5,36,24,1
212391,26,3,23,25,1
212391,26,3,23,40,1
212391,37,1,36,41,4
212391,37,1,36,42,1
212391,37,1,36,43,1
212391,18,0,18,44,1
212391,19,1,18,45,1
212391,19,1,18,60,1
212425,209,54,155,1,4
212425,209,54,155,2,1
212425,208,53,155,3,1
212425,62,18,44,4,1
212425,146,35,111,5,1
212425,1,1,0,11,1
212425,8,2,6,19,1
212425,138,33,105,20,1
212425,122,33,89,21,4
212425,122,33,89,22,1
212425,122,33,89,23,1
212425,54,13,41,24,1
212425,68,20,48,25,1
212425,6,2,4,39,1
212425,62,18,44,40,1
212425,87,21,66,41,4
212425,87,21,66,42,1
212425,86,20,66,43,1
212425,8,5,3,44,1
212425,78,15,63,45,1
212425,1,1,0,51,1
212425,2,0,2,59,1
212425,76,15,61,60,1
212434,216,196,20,1,4
212434,216,196,20,2,1
212434,216,196,20,3,1
212434,77,70,7,4,1
212434,139,126,13,5,1
212434,139,126,13,20,1
212434,216,196,20,21,4
212434,216,196,20,22,1
212434,216,196,20,23,1
212434,77,70,7,24,1
212434,139,126,13,25,1
212434,139,126,13,40,1
212443,113,67,46,1,4
212443,113,67,46,12,3
212443,31,13,18,21,4
212443,31,13,18,32,3
212443,82,54,28,41,4
212443,82,54,28,52,3
212452,380,190,190,1,4
212452,269,113,156,2,1
212452,236,106,130,3,1
212452,27,14,13,4,1
212452,209,92,117,5,1
212452,33,7,26,11,1
212452,111,77,34,12,3
212452,209,92,117,20,1
212452,331,171,160,21,4
212452,229,103,126,22,1
212452,228,102,126,23,1
212452,21,12,9,24,1
212452,207,90,117,25,1
212452,1,1,0,31,1
212452,102,68,34,32,3
212452,207,90,117,40,1
212452,49,19,30,41,4
212452,40,10,30,42,1
212452,8,4,4,43,1
212452,6,2,4,44,1
212452,2,2,0,45,1
212452,32,6,26,51,1
212452,9,9,0,52,3
212452,2,2,0,60,1
212568,208,41,167,1,4
212568,208,41,167,2,1
212568,208,41,167,3,1
212568,20,3,17,4,1
212568,188,38,150,5,1
212568,188,38,150,20,1
212568,208,41,167,21,4
212568,208,41,167,22,1
212568,208,41,167,23,1
212568,20,3,17,24,1
212568,188,38,150,25,1
212568,188,38,150,40,1
212577,2297,1111,1186,1,4
212577,2297,1111,1186,2,1
212577,2262,1102,1160,3,1
212577,605,302,303,4,1
212577,1657,800,857,5,1
212577,35,9,26,11,1
212577,11,6,5,19,1
212577,1646,794,852,20,1
212577,2258,1099,1159,21,4
212577,2258,1099,1159,22,1
212577,2256,1098,1158,23,1
212577,604,302,302,24,1
212577,1652,796,856,25,1
212577,2,1,1,31,1
212577,11,6,5,39,1
212577,1641,790,851,40,1
212577,39,12,27,41,4
212577,39,12,27,42,1
212577,6,4,2,43,1
212577,1,0,1,44,1
212577,5,4,1,45,1
212577,33,8,25,51,1
212577,5,4,1,60,1
212601,4211,1805,2406,1,4
212601,3111,1328,1783,2,1
212601,2697,1135,1562,3,1
212601,622,272,350,4,1
212601,2075,863,1212,5,1
212601,414,193,221,11,1
212601,1100,477,623,12,3
212601,148,69,79,19,1
212601,1927,794,1133,20,1
212601,3111,1357,1754,21,4
212601,2556,1082,1474,22,1
212601,2551,1080,1471,23,1
212601,611,265,346,24,1
212601,1940,815,1125,25,1
212601,5,2,3,31,1
212601,555,275,280,32,3
212601,115,65,50,39,1
212601,1825,750,1075,40,1
212601,1100,448,652,41,4
212601,555,246,309,42,1
212601,146,55,91,43,1
212601,11,7,4,44,1
212601,135,48,87,45,1
212601,409,191,218,51,1
212601,545,202,343,52,3
212601,33,4,29,59,1
212601,102,44,58,60,1
212656,1852,845,1007,1,4
212656,1541,738,803,2,1
212656,1532,732,800,3,1
212656,338,174,164,4,1
212656,1194,558,636,5,1
212656,9,6,3,11,1
212656,311,107,204,12,3
212656,49,25,24,19,1
212656,1145,533,612,20,1
212656,1669,766,903,21,4
212656,1475,704,771,22,1
212656,1474,704,770,23,1
212656,334,173,161,24,1
212656,1140,531,609,25,1
212656,1,0,1,31,1
212656,194,62,132,32,3
212656,47,24,23,39,1
212656,1093,507,586,40,1
212656,183,79,104,41,4
212656,66,34,32,42,1
212656,58,28,30,43,1
212656,4,1,3,44,1
212656,54,27,27,45,1
212656,8,6,2,51,1
212656,117,45,72,52,3
212656,2,1,1,59,1
212656,52,26,26,60,1
212674,2524,1204,1320,1,4
212674,2524,1204,1320,2,1
212674,2520,1201,1319,3,1
212674,703,337,366,4,1
212674,1817,864,953,5,1
212674,4,3,1,11,1
212674,14,5,9,19,1
212674,1803,859,944,20,1
212674,2517,1200,1317,21,4
212674,2517,1200,1317,22,1
212674,2513,1197,1316,23,1
212674,703,337,366,24,1
212674,1810,860,950,25,1
212674,4,3,1,31,1
212674,14,5,9,39,1
212674,1796,855,941,40,1
212674,7,4,3,41,4
212674,7,4,3,42,1
212674,7,4,3,43,1
212674,7,4,3,45,1
212674,7,4,3,60,1
212683,90,4,86,1,4
212683,90,4,86,2,1
212683,90,4,86,3,1
212683,45,1,44,4,1
212683,45,3,42,5,1
212683,45,3,42,20,1
212683,72,4,68,21,4
212683,72,4,68,22,1
212683,72,4,68,23,1
212683,38,1,37,24,1
212683,34,3,31,25,1
212683,34,3,31,40,1
212683,18,0,18,41,4
212683,18,0,18,42,1
212683,18,0,18,43,1
212683,7,0,7,44,1
212683,11,0,11,45,1
212683,11,0,11,60,1
212708,141,24,117,1,4
212708,141,24,117,2,1
212708,141,24,117,3,1
212708,43,8,35,4,1
212708,98,16,82,5,1
212708,98,16,82,20,1
212708,106,20,86,21,4
212708,106,20,86,22,1
212708,106,20,86,23,1
212708,37,7,30,24,1
212708,69,13,56,25,1
212708,69,13,56,40,1
212708,35,4,31,41,4
212708,35,4,31,42,1
212708,35,4,31,43,1
212708,6,1,5,44,1
212708,29,3,26,45,1
212708,29,3,26,60,1
212753,211,7,204,1,4
212753,211,7,204,2,1
212753,211,7,204,3,1
212753,105,2,103,4,1
212753,106,5,101,5,1
212753,106,5,101,20,1
212753,161,4,157,21,4
212753,161,4,157,22,1
212753,161,4,157,23,1
212753,85,1,84,24,1
212753,76,3,73,25,1
212753,76,3,73,40,1
212753,50,3,47,41,4
212753,50,3,47,42,1
212753,50,3,47,43,1
212753,20,1,19,44,1
212753,30,2,28,45,1
212753,30,2,28,60,1
212771,673,175,498,1,4
212771,11,3,8,2,1
212771,9,2,7,3,1
212771,9,2,7,5,1
212771,2,1,1,11,1
212771,662,172,490,12,3
212771,9,2,7,20,1
212771,51,14,37,21,4
212771,51,14,37,32,3
212771,622,161,461,41,4
212771,11,3,8,42,1
212771,9,2,7,43,1
212771,9,2,7,45,1
212771,2,1,1,51,1
212771,611,158,453,52,3
212771,9,2,7,60,1
212805,2491,1226,1265,1,4
212805,2491,1226,1265,2,1
212805,2455,1210,1245,3,1
212805,648,316,332,4,1
212805,1807,894,913,5,1
212805,36,16,20,11,1
212805,32,19,13,19,1
212805,1775,875,900,20,1
212805,2438,1194,1244,21,4
212805,2438,1194,1244,22,1
212805,2434,1192,1242,23,1
212805,648,316,332,24,1
212805,1786,876,910,25,1
212805,4,2,2,31,1
212805,32,19,13,39,1
212805,1754,857,897,40,1
212805,53,32,21,41,4
212805,53,32,21,42,1
212805,21,18,3,43,1
212805,21,18,3,45,1
212805,32,14,18,51,1
212805,21,18,3,60,1
212832,2371,580,1791,1,4
212832,2062,515,1547,2,1
212832,2031,508,1523,3,1
212832,211,70,141,4,1
212832,1820,438,1382,5,1
212832,31,7,24,11,1
212832,309,65,244,12,3
212832,279,42,237,19,1
212832,1541,396,1145,20,1
212832,1998,500,1498,21,4
212832,1851,465,1386,22,1
212832,1851,465,1386,23,1
212832,211,70,141,24,1
212832,1640,395,1245,25,1
212832,147,35,112,32,3
212832,241,35,206,39,1
212832,1399,360,1039,40,1
212832,373,80,293,41,4
212832,211,50,161,42,1
212832,180,43,137,43,1
212832,180,43,137,45,1
212832,31,7,24,51,1
212832,162,30,132,52,3
212832,38,7,31,59,1
212832,142,36,106,60,1
212869,1627,281,1346,1,4
212869,1627,281,1346,2,1
212869,1603,276,1327,3,1
212869,261,71,190,4,1
212869,1342,205,1137,5,1
212869,24,5,19,11,1
212869,413,63,350,19,1
212869,929,142,787,20,1
212869,1039,197,842,21,4
212869,1039,197,842,22,1
212869,1038,196,842,23,1
212869,249,70,179,24,1
212869,789,126,663,25,1
212869,1,1,0,31,1
212869,186,26,160,39,1
212869,603,100,503,40,1
212869,588,84,504,41,4
212869,588,84,504,42,1
212869,565,80,485,43,1
212869,12,1,11,44,1
212869,553,79,474,45,1
212869,23,4,19,51,1
212869,227,37,190,59,1
212869,326,42,284,60,1
212878,20780,7745,13035,1,4
212878,20780,7745,13035,2,1
212878,13321,4470,8851,3,1
212878,2051,812,1239,4,1
212878,11270,3658,7612,5,1
212878,7459,3275,4184,11,1
212878,455,154,301,19,1
212878,10815,3504,7311,20,1
212878,6506,2934,3572,21,4
212878,6506,2934,3572,22,1
212878,3898,1642,2256,23,1
212878,1030,429,601,24,1
212878,2868,1213,1655,25,1
212878,2608,1292,1316,31,1
212878,197,86,111,39,1
212878,2671,1127,1544,40,1
212878,14274,4811,9463,41,4
212878,14274,4811,9463,42,1
212878,9423,2828,6595,43,1
212878,1021,383,638,44,1
212878,8402,2445,5957,45,1
212878,4851,1983,2868,51,1
212878,258,68,190,59,1
212878,8144,2377,5767,60,1
212911,1187,568,619,1,4
212911,1187,568,619,2,1
212911,1187,568,619,3,1
212911,330,157,173,4,1
212911,857,411,446,5,1
212911,2,1,1,19,1
212911,855,410,445,20,1
212911,1187,568,619,21,4
212911,1187,568,619,22,1
212911,1187,568,619,23,1
212911,330,157,173,24,1
212911,857,411,446,25,1
212911,2,1,1,39,1
212911,855,410,445,40,1
212975,206,147,59,1,4
212975,206,147,59,2,1
212975,206,147,59,3,1
212975,85,60,25,4,1
212975,121,87,34,5,1
212975,121,87,34,20,1
212975,203,144,59,21,4
212975,203,144,59,22,1
212975,203,144,59,23,1
212975,84,59,25,24,1
212975,119,85,34,25,1
212975,119,85,34,40,1
212975,3,3,0,41,4
212975,3,3,0,42,1
212975,3,3,0,43,1
212975,1,1,0,44,1
212975,2,2,0,45,1
212975,2,2,0,60,1
212984,2956,766,2190,1,4
212984,2182,571,1611,2,1
212984,2018,520,1498,3,1
212984,291,77,214,4,1
212984,1727,443,1284,5,1
212984,164,51,113,11,1
212984,774,195,579,12,3
212984,215,54,161,19,1
212984,1512,389,1123,20,1
212984,1553,392,1161,21,4
212984,1499,379,1120,22,1
212984,1495,378,1117,23,1
212984,288,75,213,24,1
212984,1207,303,904,25,1
212984,4,1,3,31,1
212984,54,13,41,32,3
212984,185,43,142,39,1
212984,1022,260,762,40,1
212984,1403,374,1029,41,4
212984,683,192,491,42,1
212984,523,142,381,43,1
212984,3,2,1,44,1
212984,520,140,380,45,1
212984,160,50,110,51,1
212984,720,182,538,52,3
212984,30,11,19,59,1
212984,490,129,361,60,1
212993,86,43,43,1,4
212993,86,43,43,2,1
212993,86,43,43,3,1
212993,17,9,8,4,1
212993,69,34,35,5,1
212993,69,34,35,20,1
212993,86,43,43,21,4
212993,86,43,43,22,1
212993,86,43,43,23,1
212993,17,9,8,24,1
212993,69,34,35,25,1
212993,69,34,35,40,1
213002,557,223,334,1,4
213002,557,223,334,2,1
213002,557,223,334,3,1
213002,44,23,21,4,1
213002,513,200,313,5,1
213002,95,30,65,19,1
213002,418,170,248,20,1
213002,557,223,334,21,4
213002,557,223,334,22,1
213002,557,223,334,23,1
213002,44,23,21,24,1
213002,513,200,313,25,1
213002,95,30,65,39,1
213002,418,170,248,40,1
213011,3675,906,2769,1,4
213011,2560,624,1936,2,1
213011,2452,600,1852,3,1
213011,289,106,183,4,1
213011,2163,494,1669,5,1
213011,108,24,84,11,1
213011,1115,282,833,12,3
213011,230,60,170,19,1
213011,1933,434,1499,20,1
213011,1349,410,939,21,4
213011,1184,370,814,22,1
213011,1183,369,814,23,1
213011,287,106,181,24,1
213011,896,263,633,25,1
213011,1,1,0,31,1
213011,165,40,125,32,3
213011,82,31,51,39,1
213011,814,232,582,40,1
213011,2326,496,1830,41,4
213011,1376,254,1122,42,1
213011,1269,231,1038,43,1
213011,2,0,2,44,1
213011,1267,231,1036,45,1
213011,107,23,84,51,1
213011,950,242,708,52,3
213011,148,29,119,59,1
213011,1119,202,917,60,1
213020,14925,6646,8279,1,4
213020,12668,5721,6947,2,1
213020,12405,5587,6818,3,1
213020,2766,1165,1601,4,1
213020,9639,4422,5217,5,1
213020,263,134,129,11,1
213020,2257,925,1332,12,3
213020,626,342,284,19,1
213020,9013,4080,4933,20,1
213020,12965,5811,7154,21,4
213020,11944,5355,6589,22,1
213020,11886,5342,6544,23,1
213020,2756,1160,1596,24,1
213020,9130,4182,4948,25,1
213020,58,13,45,31,1
213020,1021,456,565,32,3
213020,601,332,269,39,1
213020,8529,3850,4679,40,1
213020,1960,835,1125,41,4
213020,724,366,358,42,1
213020,519,245,274,43,1
213020,10,5,5,44,1
213020,509,240,269,45,1
213020,205,121,84,51,1
213020,1236,469,767,52,3
213020,25,10,15,59,1
213020,484,230,254,60,1
213163,71,15,56,1,4
213163,71,15,56,2,1
213163,71,15,56,3,1
213163,71,15,56,5,1
213163,71,15,56,20,1
213163,71,15,56,21,4
213163,71,15,56,22,1
213163,71,15,56,23,1
213163,71,15,56,25,1
213163,71,15,56,40,1
213181,453,38,415,1,4
213181,453,38,415,2,1
213181,453,38,415,3,1
213181,116,11,105,4,1
213181,337,27,310,5,1
213181,62,7,55,19,1
213181,275,20,255,20,1
213181,453,38,415,21,4
213181,453,38,415,22,1
213181,453,38,415,23,1
213181,116,11,105,24,1
213181,337,27,310,25,1
213181,62,7,55,39,1
213181,275,20,255,40,1
213215,193,20,173,1,4
213215,193,20,173,2,1
213215,193,20,173,3,1
213215,141,16,125,4,1
213215,52,4,48,5,1
213215,52,4,48,20,1
213215,147,15,132,21,4
213215,147,15,132,22,1
213215,147,15,132,23,1
213215,109,12,97,24,1
213215,38,3,35,25,1
213215,38,3,35,40,1
213215,46,5,41,41,4
213215,46,5,41,42,1
213215,46,5,41,43,1
213215,32,4,28,44,1
213215,14,1,13,45,1
213215,14,1,13,60,1
213233,427,312,115,1,4
213233,427,312,115,2,1
213233,427,312,115,3,1
213233,156,125,31,4,1
213233,271,187,84,5,1
213233,63,33,30,19,1
213233,208,154,54,20,1
213233,405,303,102,21,4
213233,405,303,102,22,1
213233,405,303,102,23,1
213233,156,125,31,24,1
213233,249,178,71,25,1
213233,54,29,25,39,1
213233,195,149,46,40,1
213233,22,9,13,41,4
213233,22,9,13,42,1
213233,22,9,13,43,1
213233,22,9,13,45,1
213233,9,4,5,59,1
213233,13,5,8,60,1
213251,1635,734,901,1,4
213251,1625,730,895,2,1
213251,1503,683,820,3,1
213251,391,175,216,4,1
213251,1112,508,604,5,1
213251,122,47,75,11,1
213251,10,4,6,12,3
213251,25,11,14,19,1
213251,1087,497,590,20,1
213251,1565,699,866,21,4
213251,1555,695,860,22,1
213251,1500,682,818,23,1
213251,391,175,216,24,1
213251,1109,507,602,25,1
213251,55,13,42,31,1
213251,10,4,6,32,3
213251,24,11,13,39,1
213251,1085,496,589,40,1
213251,70,35,35,41,4
213251,70,35,35,42,1
213251,3,1,2,43,1
213251,3,1,2,45,1
213251,67,34,33,51,1
213251,1,0,1,59,1
213251,2,1,1,60,1
213303,1595,650,945,1,4
213303,1574,644,930,2,1
213303,1550,630,920,3,1
213303,323,125,198,4,1
213303,1227,505,722,5,1
213303,24,14,10,11,1
213303,21,6,15,12,3
213303,123,63,60,19,1
213303,1104,442,662,20,1
213303,1317,553,764,21,4
213303,1304,549,755,22,1
213303,1303,549,754,23,1
213303,311,122,189,24,1
213303,992,427,565,25,1
213303,1,0,1,31,1
213303,13,4,9,32,3
213303,105,56,49,39,1
213303,887,371,516,40,1
213303,278,97,181,41,4
213303,270,95,175,42,1
213303,247,81,166,43,1
213303,12,3,9,44,1
213303,235,78,157,45,1
213303,23,14,9,51,1
213303,8,2,6,52,3
213303,18,7,11,59,1
213303,217,71,146,60,1
213312,223,61,162,1,4
213312,223,61,162,2,1
213312,223,61,162,3,1
213312,99,24,75,4,1
213312,124,37,87,5,1
213312,124,37,87,20,1
213312,223,61,162,21,4
213312,223,61,162,22,1
213312,223,61,162,23,1
213312,99,24,75,24,1
213312,124,37,87,25,1
213312,124,37,87,40,1
213321,2391,1165,1226,1,4
213321,2144,1102,1042,2,1
213321,1987,1037,950,3,1
213321,500,273,227,4,1
213321,1487,764,723,5,1
213321,157,65,92,11,1
213321,247,63,184,12,3
213321,71,32,39,19,1
213321,1416,732,684,20,1
213321,1991,1023,968,21,4
213321,1925,1009,916,22,1
213321,1921,1006,915,23,1
213321,500,273,227,24,1
213321,1421,733,688,25,1
213321,4,3,1,31,1
213321,66,14,52,32,3
213321,71,32,39,39,1
213321,1350,701,649,40,1
213321,400,142,258,41,4
213321,219,93,126,42,1
213321,66,31,35,43,1
213321,66,31,35,45,1
213321,153,62,91,51,1
213321,181,49,132,52,3
213321,66,31,35,60,1
213330,19,1,18,1,4
213330,19,1,18,2,1
213330,19,1,18,3,1
213330,15,1,14,4,1
213330,4,0,4,5,1
213330,4,0,4,20,1
213330,19,1,18,21,4
213330,19,1,18,22,1
213330,19,1,18,23,1
213330,15,1,14,24,1
213330,4,0,4,25,1
213330,4,0,4,40,1
213349,9513,4009,5504,1,4
213349,8815,3829,4986,2,1
213349,8538,3755,4783,3,1
213349,1814,734,1080,4,1
213349,6724,3021,3703,5,1
213349,277,74,203,11,1
213349,698,180,518,12,3
213349,696,372,324,19,1
213349,6028,2649,3379,20,1
213349,8548,3643,4905,21,4
213349,8279,3567,4712,22,1
213349,8065,3522,4543,23,1
213349,1812,733,1079,24,1
213349,6253,2789,3464,25,1
213349,214,45,169,31,1
213349,269,76,193,32,3
213349,649,352,297,39,1
213349,5604,2437,3167,40,1
213349,965,366,599,41,4
213349,536,262,274,42,1
213349,473,233,240,43,1
213349,2,1,1,44,1
213349,471,232,239,45,1
213349,63,29,34,51,1
213349,429,104,325,52,3
213349,47,20,27,59,1
213349,424,212,212,60,1
213358,1481,616,865,1,4
213358,1363,585,778,2,1
213358,1344,580,764,3,1
213358,229,99,130,4,1
213358,1115,481,634,5,1
213358,19,5,14,11,1
213358,118,31,87,12,3
213358,167,59,108,19,1
213358,948,422,526,20,1
213358,1183,522,661,21,4
213358,1130,507,623,22,1
213358,1130,507,623,23,1
213358,229,99,130,24,1
213358,901,408,493,25,1
213358,53,15,38,32,3
213358,125,44,81,39,1
213358,776,364,412,40,1
213358,298,94,204,41,4
213358,233,78,155,42,1
213358,214,73,141,43,1
213358,214,73,141,45,1
213358,19,5,14,51,1
213358,65,16,49,52,3
213358,42,15,27,59,1
213358,172,58,114,60,1
213367,6436,2175,4261,1,4
213367,4409,1558,2851,2,1
213367,4228,1531,2697,3,1
213367,939,340,599,4,1
213367,3289,1191,2098,5,1
213367,181,27,154,11,1
213367,2027,617,1410,12,3
213367,232,83,149,19,1
213367,3057,1108,1949,20,1
213367,3948,1471,2477,21,4
213367,3542,1363,2179,22,1
213367,3538,1361,2177,23,1
213367,936,339,597,24,1
213367,2602,1022,1580,25,1
213367,4,2,2,31,1
213367,406,108,298,32,3
213367,169,71,98,39,1
213367,2433,951,1482,40,1
213367,2488,704,1784,41,4
213367,867,195,672,42,1
213367,690,170,520,43,1
213367,3,1,2,44,1
213367,687,169,518,45,1
213367,177,25,152,51,1
213367,1621,509,1112,52,3
213367,63,12,51,59,1
213367,624,157,467,60,1
213376,1454,776,678,1,4
213376,1454,776,678,2,1
213376,1313,716,597,3,1
213376,380,240,140,4,1
213376,933,476,457,5,1
213376,141,60,81,11,1
213376,141,72,69,19,1
213376,792,404,388,20,1
213376,1048,598,450,21,4
213376,1048,598,450,22,1
213376,1045,596,449,23,1
213376,337,222,115,24,1
213376,708,374,334,25,1
213376,3,2,1,31,1
213376,101,50,51,39,1
213376,607,324,283,40,1
213376,406,178,228,41,4
213376,406,178,228,42,1
213376,268,120,148,43,1
213376,43,18,25,44,1
213376,225,102,123,45,1
213376,138,58,80,51,1
213376,40,22,18,59,1
213376,185,80,105,60,1
213385,2486,1326,1160,1,4
213385,2486,1326,1160,2,1
213385,2452,1307,1145,3,1
213385,635,329,306,4,1
213385,1817,978,839,5,1
213385,34,19,15,11,1
213385,12,8,4,19,1
213385,1805,970,835,20,1
213385,2435,1297,1138,21,4
213385,2435,1297,1138,22,1
213385,2435,1297,1138,23,1
213385,635,329,306,24,1
213385,1800,968,832,25,1
213385,12,8,4,39,1
213385,1788,960,828,40,1
213385,51,29,22,41,4
213385,51,29,22,42,1
213385,17,10,7,43,1
213385,17,10,7,45,1
213385,34,19,15,51,1
213385,17,10,7,60,1
213400,1763,928,835,1,4
213400,1313,670,643,2,1
213400,1212,628,584,3,1
213400,152,62,90,4,1
213400,1060,566,494,5,1
213400,101,42,59,11,1
213400,450,258,192,12,3
213400,174,91,83,19,1
213400,886,475,411,20,1
213400,895,463,432,21,4
213400,814,411,403,22,1
213400,814,411,403,23,1
213400,134,53,81,24,1
213400,680,358,322,25,1
213400,81,52,29,32,3
213400,85,51,34,39,1
213400,595,307,288,40,1
213400,868,465,403,41,4
213400,499,259,240,42,1
213400,398,217,181,43,1
213400,18,9,9,44,1
213400,380,208,172,45,1
213400,101,42,59,51,1
213400,369,206,163,52,3
213400,89,40,49,59,1
213400,291,168,123,60,1
213446,128,62,66,1,4
213446,128,62,66,12,3
213446,82,41,41,21,4
213446,82,41,41,32,3
213446,46,21,25,41,4
213446,46,21,25,52,3
213455,195,1,194,1,4
213455,195,1,194,2,1
213455,195,1,194,3,1
213455,89,1,88,4,1
213455,106,0,106,5,1
213455,106,0,106,20,1
213455,26,0,26,21,4
213455,26,0,26,22,1
213455,26,0,26,23,1
213455,12,0,12,24,1
213455,14,0,14,25,1
213455,14,0,14,40,1
213455,169,1,168,41,4
213455,169,1,168,42,1
213455,169,1,168,43,1
213455,77,1,76,44,1
213455,92,0,92,45,1
213455,92,0,92,60,1
213473,382,87,295,1,4
213473,382,87,295,2,1
213473,382,87,295,3,1
213473,81,11,70,4,1
213473,301,76,225,5,1
213473,301,76,225,20,1
213473,186,49,137,21,4
213473,186,49,137,22,1
213473,186,49,137,23,1
213473,35,7,28,24,1
213473,151,42,109,25,1
213473,151,42,109,40,1
213473,196,38,158,41,4
213473,196,38,158,42,1
213473,196,38,158,43,1
213473,46,4,42,44,1
213473,150,34,116,45,1
213473,150,34,116,60,1
213491,68,3,65,1,4
213491,68,3,65,2,1
213491,68,3,65,3,1
213491,49,2,47,4,1
213491,19,1,18,5,1
213491,19,1,18,20,1
213491,30,2,28,21,4
213491,30,2,28,22,1
213491,30,2,28,23,1
213491,24,2,22,24,1
213491,6,0,6,25,1
213491,6,0,6,40,1
213491,38,1,37,41,4
213491,38,1,37,42,1
213491,38,1,37,43,1
213491,25,0,25,44,1
213491,13,1,12,45,1
213491,13,1,12,60,1
213507,2022,931,1091,1,4
213507,1766,827,939,2,1
213507,1698,793,905,3,1
213507,415,191,224,4,1
213507,1283,602,681,5,1
213507,68,34,34,11,1
213507,256,104,152,12,3
213507,61,29,32,19,1
213507,1222,573,649,20,1
213507,1725,789,936,21,4
213507,1648,769,879,22,1
213507,1644,766,878,23,1
213507,415,191,224,24,1
213507,1229,575,654,25,1
213507,4,3,1,31,1
213507,77,20,57,32,3
213507,61,29,32,39,1
213507,1168,546,622,40,1
213507,297,142,155,41,4
213507,118,58,60,42,1
213507,54,27,27,43,1
213507,54,27,27,45,1
213507,64,31,33,51,1
213507,179,84,95,52,3
213507,54,27,27,60,1
213525,7128,2820,4308,1,4
213525,7128,2820,4308,2,1
213525,5986,2320,3666,3,1
213525,1422,678,744,4,1
213525,4564,1642,2922,5,1
213525,1142,500,642,11,1
213525,643,228,415,19,1
213525,3921,1414,2507,20,1
213525,2544,1186,1358,21,4
213525,2544,1186,1358,22,1
213525,2536,1183,1353,23,1
213525,947,483,464,24,1
213525,1589,700,889,25,1
213525,8,3,5,31,1
213525,249,107,142,39,1
213525,1340,593,747,40,1
213525,4584,1634,2950,41,4
213525,4584,1634,2950,42,1
213525,3450,1137,2313,43,1
213525,475,195,280,44,1
213525,2975,942,2033,45,1
213525,1134,497,637,51,1
213525,394,121,273,59,1
213525,2581,821,1760,60,1
213534,976,303,673,1,4
213534,976,303,673,2,1
213534,976,303,673,3,1
213534,269,85,184,4,1
213534,707,218,489,5,1
213534,36,6,30,19,1
213534,671,212,459,20,1
213534,726,225,501,21,4
213534,726,225,501,22,1
213534,726,225,501,23,1
213534,219,72,147,24,1
213534,507,153,354,25,1
213534,29,5,24,39,1
213534,478,148,330,40,1
213534,250,78,172,41,4
213534,250,78,172,42,1
213534,250,78,172,43,1
213534,50,13,37,44,1
213534,200,65,135,45,1
213534,7,1,6,59,1
213534,193,64,129,60,1
213543,7096,3938,3158,1,4
213543,4931,2773,2158,2,1
213543,4904,2753,2151,3,1
213543,1198,680,518,4,1
213543,3706,2073,1633,5,1
213543,27,20,7,11,1
213543,2165,1165,1000,12,3
213543,41,23,18,19,1
213543,3665,2050,1615,20,1
213543,6148,3421,2727,21,4
213543,4862,2724,2138,22,1
213543,4842,2707,2135,23,1
213543,1198,680,518,24,1
213543,3644,2027,1617,25,1
213543,20,17,3,31,1
213543,1286,697,589,32,3
213543,41,23,18,39,1
213543,3603,2004,1599,40,1
213543,948,517,431,41,4
213543,69,49,20,42,1
213543,62,46,16,43,1
213543,62,46,16,45,1
213543,7,3,4,51,1
213543,879,468,411,52,3
213543,62,46,16,60,1
213552,84,9,75,1,4
213552,84,9,75,2,1
213552,84,9,75,3,1
213552,45,8,37,4,1
213552,39,1,38,5,1
213552,39,1,38,20,1
213552,49,8,41,21,4
213552,49,8,41,22,1
213552,49,8,41,23,1
213552,30,7,23,24,1
213552,19,1,18,25,1
213552,19,1,18,40,1
213552,35,1,34,41,4
213552,35,1,34,42,1
213552,35,1,34,43,1
213552,15,1,14,44,1
213552,20,0,20,45,1
213552,20,0,20,60,1
213570,568,163,405,1,4
213570,568,163,405,2,1
213570,568,163,405,3,1
213570,149,52,97,4,1
213570,419,111,308,5,1
213570,419,111,308,20,1
213570,568,163,405,21,4
213570,568,163,405,22,1
213570,568,163,405,23,1
213570,149,52,97,24,1
213570,419,111,308,25,1
213570,419,111,308,40,1
213589,273,256,17,1,4
213589,273,256,17,2,1
213589,273,256,17,3,1
213589,106,101,5,4,1
213589,167,155,12,5,1
213589,29,29,0,19,1
213589,138,126,12,20,1
213589,219,208,11,21,4
213589,219,208,11,22,1
213589,219,208,11,23,1
213589,82,79,3,24,1
213589,137,129,8,25,1
213589,19,19,0,39,1
213589,118,110,8,40,1
213589,54,48,6,41,4
213589,54,48,6,42,1
213589,54,48,6,43,1
213589,24,22,2,44,1
213589,30,26,4,45,1
213589,10,10,0,59,1
213589,20,16,4,60,1
213598,1963,791,1172,1,4
213598,1624,671,953,2,1
213598,1614,666,948,3,1
213598,333,136,197,4,1
213598,1281,530,751,5,1
213598,10,5,5,11,1
213598,339,120,219,12,3
213598,105,50,55,19,1
213598,1176,480,696,20,1
213598,1712,701,1011,21,4
213598,1488,622,866,22,1
213598,1485,620,865,23,1
213598,331,135,196,24,1
213598,1154,485,669,25,1
213598,3,2,1,31,1
213598,224,79,145,32,3
213598,63,35,28,39,1
213598,1091,450,641,40,1
213598,251,90,161,41,4
213598,136,49,87,42,1
213598,129,46,83,43,1
213598,2,1,1,44,1
213598,127,45,82,45,1
213598,7,3,4,51,1
213598,115,41,74,52,3
213598,42,15,27,59,1
213598,85,30,55,60,1
213613,5260,2206,3054,1,4
213613,4855,2096,2759,2,1
213613,4783,2059,2724,3,1
213613,1086,486,600,4,1
213613,3697,1573,2124,5,1
213613,72,37,35,11,1
213613,405,110,295,12,3
213613,211,90,121,19,1
213613,3486,1483,2003,20,1
213613,4723,2043,2680,21,4
213613,4519,1994,2525,22,1
213613,4496,1983,2513,23,1
213613,1081,485,596,24,1
213613,3415,1498,1917,25,1
213613,23,11,12,31,1
213613,204,49,155,32,3
213613,189,85,104,39,1
213613,3226,1413,1813,40,1
213613,537,163,374,41,4
213613,336,102,234,42,1
213613,287,76,211,43,1
213613,5,1,4,44,1
213613,282,75,207,45,1
213613,49,26,23,51,1
213613,201,61,140,52,3
213613,22,5,17,59,1
213613,260,70,190,60,1
213622,184,32,152,1,4
213622,184,32,152,2,1
213622,184,32,152,3,1
213622,9,2,7,4,1
213622,175,30,145,5,1
213622,175,30,145,20,1
213622,115,20,95,21,4
213622,115,20,95,22,1
213622,115,20,95,23,1
213622,9,2,7,24,1
213622,106,18,88,25,1
213622,106,18,88,40,1
213622,69,12,57,41,4
213622,69,12,57,42,1
213622,69,12,57,43,1
213622,69,12,57,45,1
213622,69,12,57,60,1
213631,122,54,68,1,4
213631,122,54,68,12,3
213631,85,35,50,21,4
213631,85,35,50,32,3
213631,37,19,18,41,4
213631,37,19,18,52,3
213640,230,113,117,1,4
213640,230,113,117,12,3
213640,81,48,33,21,4
213640,81,48,33,32,3
213640,149,65,84,41,4
213640,149,65,84,52,3
213659,6411,2564,3847,1,4
213659,6411,2564,3847,2,1
213659,6070,2431,3639,3,1
213659,1497,651,846,4,1
213659,4573,1780,2793,5,1
213659,341,133,208,11,1
213659,392,161,231,19,1
213659,4181,1619,2562,20,1
213659,3172,1414,1758,21,4
213659,3172,1414,1758,22,1
213659,3169,1412,1757,23,1
213659,1055,472,583,24,1
213659,2114,940,1174,25,1
213659,3,2,1,31,1
213659,226,103,123,39,1
213659,1888,837,1051,40,1
213659,3239,1150,2089,41,4
213659,3239,1150,2089,42,1
213659,2901,1019,1882,43,1
213659,442,179,263,44,1
213659,2459,840,1619,45,1
213659,338,131,207,51,1
213659,166,58,108,59,1
213659,2293,782,1511,60,1
213668,1307,572,735,1,4
213668,1307,572,735,2,1
213668,1288,561,727,3,1
213668,345,149,196,4,1
213668,943,412,531,5,1
213668,19,11,8,11,1
213668,24,15,9,19,1
213668,919,397,522,20,1
213668,1290,566,724,21,4
213668,1290,566,724,22,1
213668,1283,561,722,23,1
213668,345,149,196,24,1
213668,938,412,526,25,1
213668,7,5,2,31,1
213668,24,15,9,39,1
213668,914,397,517,40,1
213668,17,6,11,41,4
213668,17,6,11,42,1
213668,5,0,5,43,1
213668,5,0,5,45,1
213668,12,6,6,51,1
213668,5,0,5,60,1
213686,79,18,61,1,4
213686,79,18,61,2,1
213686,78,18,60,3,1
213686,16,7,9,4,1
213686,62,11,51,5,1
213686,1,0,1,11,1
213686,5,1,4,19,1
213686,57,10,47,20,1
213686,59,12,47,21,4
213686,59,12,47,22,1
213686,59,12,47,23,1
213686,12,5,7,24,1
213686,47,7,40,25,1
213686,2,0,2,39,1
213686,45,7,38,40,1
213686,20,6,14,41,4
213686,20,6,14,42,1
213686,19,6,13,43,1
213686,4,2,2,44,1
213686,15,4,11,45,1
213686,1,0,1,51,1
213686,3,1,2,59,1
213686,12,3,9,60,1
213774,858,187,671,1,4
213774,858,187,671,2,1
213774,816,178,638,3,1
213774,219,76,143,4,1
213774,597,102,495,5,1
213774,42,9,33,11,1
213774,117,19,98,19,1
213774,480,83,397,20,1
213774,467,117,350,21,4
213774,467,117,350,22,1
213774,467,117,350,23,1
213774,159,60,99,24,1
213774,308,57,251,25,1
213774,63,14,49,39,1
213774,245,43,202,40,1
213774,391,70,321,41,4
213774,391,70,321,42,1
213774,349,61,288,43,1
213774,60,16,44,44,1
213774,289,45,244,45,1
213774,42,9,33,51,1
213774,54,5,49,59,1
213774,235,40,195,60,1
213783,2970,1156,1814,1,4
213783,2717,1109,1608,2,1
213783,2640,1085,1555,3,1
213783,628,265,363,4,1
213783,2012,820,1192,5,1
213783,77,24,53,11,1
213783,253,47,206,12,3
213783,160,70,90,19,1
213783,1852,750,1102,20,1
213783,2477,1042,1435,21,4
213783,2453,1036,1417,22,1
213783,2445,1035,1410,23,1
213783,622,261,361,24,1
213783,1823,774,1049,25,1
213783,8,1,7,31,1
213783,24,6,18,32,3
213783,142,66,76,39,1
213783,1681,708,973,40,1
213783,493,114,379,41,4
213783,264,73,191,42,1
213783,195,50,145,43,1
213783,6,4,2,44,1
213783,189,46,143,45,1
213783,69,23,46,51,1
213783,229,41,188,52,3
213783,18,4,14,59,1
213783,171,42,129,60,1
213826,3175,967,2208,1,4
213826,2148,714,1434,2,1
213826,2034,673,1361,3,1
213826,405,135,270,4,1
213826,1629,538,1091,5,1
213826,114,41,73,11,1
213826,1027,253,774,12,3
213826,133,53,80,19,1
213826,1496,485,1011,20,1
213826,2580,784,1796,21,4
213826,2004,664,1340,22,1
213826,1956,642,1314,23,1
213826,405,135,270,24,1
213826,1551,507,1044,25,1
213826,48,22,26,31,1
213826,576,120,456,32,3
213826,126,50,76,39,1
213826,1425,457,968,40,1
213826,595,183,412,41,4
213826,144,50,94,42,1
213826,78,31,47,43,1
213826,78,31,47,45,1
213826,66,19,47,51,1
213826,451,133,318,52,3
213826,7,3,4,59,1
213826,71,28,43,60,1
213914,385,19,366,1,4
213914,385,19,366,2,1
213914,385,19,366,3,1
213914,100,3,97,4,1
213914,285,16,269,5,1
213914,95,7,88,19,1
213914,190,9,181,20,1
213914,385,19,366,21,4
213914,385,19,366,22,1
213914,385,19,366,23,1
213914,100,3,97,24,1
213914,285,16,269,25,1
213914,95,7,88,39,1
213914,190,9,181,40,1
213932,124,15,109,1,4
213932,124,15,109,2,1
213932,124,15,109,3,1
213932,124,15,109,5,1
213932,124,15,109,20,1
213932,124,15,109,21,4
213932,124,15,109,22,1
213932,124,15,109,23,1
213932,124,15,109,25,1
213932,124,15,109,40,1
213987,3011,1324,1687,1,4
213987,2680,1178,1502,2,1
213987,2679,1178,1501,3,1
213987,602,267,335,4,1
213987,2077,911,1166,5,1
213987,1,0,1,11,1
213987,331,146,185,12,3
213987,65,33,32,19,1
213987,2012,878,1134,20,1
213987,2706,1192,1514,21,4
213987,2552,1130,1422,22,1
213987,2552,1130,1422,23,1
213987,596,266,330,24,1
213987,1956,864,1092,25,1
213987,154,62,92,32,3
213987,62,32,30,39,1
213987,1894,832,1062,40,1
213987,305,132,173,41,4
213987,128,48,80,42,1
213987,127,48,79,43,1
213987,6,1,5,44,1
213987,121,47,74,45,1
213987,1,0,1,51,1
213987,177,84,93,52,3
213987,3,1,2,59,1
213987,118,46,72,60,1
213996,3084,1159,1925,1,4
213996,2772,1088,1684,2,1
213996,2739,1077,1662,3,1
213996,648,260,388,4,1
213996,2091,817,1274,5,1
213996,33,11,22,11,1
213996,312,71,241,12,3
213996,100,33,67,19,1
213996,1991,784,1207,20,1
213996,2760,1068,1692,21,4
213996,2701,1060,1641,22,1
213996,2700,1060,1640,23,1
213996,648,260,388,24,1
213996,2052,800,1252,25,1
213996,1,0,1,31,1
213996,59,8,51,32,3
213996,100,33,67,39,1
213996,1952,767,1185,40,1
213996,324,91,233,41,4
213996,71,28,43,42,1
213996,39,17,22,43,1
213996,39,17,22,45,1
213996,32,11,21,51,1
213996,253,63,190,52,3
213996,39,17,22,60,1
214023,96,61,35,1,4
214023,96,61,35,2,1
214023,96,61,35,3,1
214023,51,34,17,4,1
214023,45,27,18,5,1
214023,33,17,16,19,1
214023,12,10,2,20,1
214023,57,34,23,21,4
214023,57,34,23,22,1
214023,57,34,23,23,1
214023,29,19,10,24,1
214023,28,15,13,25,1
214023,24,12,12,39,1
214023,4,3,1,40,1
214023,39,27,12,41,4
214023,39,27,12,42,1
214023,39,27,12,43,1
214023,22,15,7,44,1
214023,17,12,5,45,1
214023,9,5,4,59,1
214023,8,7,1,60,1
214041,8279,3551,4728,1,4
214041,7388,3312,4076,2,1
214041,7313,3273,4040,3,1
214041,1299,559,740,4,1
214041,6014,2714,3300,5,1
214041,75,39,36,11,1
214041,891,239,652,12,3
214041,689,310,379,19,1
214041,5325,2404,2921,20,1
214041,6832,3029,3803,21,4
214041,6584,2952,3632,22,1
214041,6566,2942,3624,23,1
214041,1284,550,734,24,1
214041,5282,2392,2890,25,1
214041,18,10,8,31,1
214041,248,77,171,32,3
214041,563,265,298,39,1
214041,4719,2127,2592,40,1
214041,1447,522,925,41,4
214041,804,360,444,42,1
214041,747,331,416,43,1
214041,15,9,6,44,1
214041,732,322,410,45,1
214041,57,29,28,51,1
214041,643,162,481,52,3
214041,126,45,81,59,1
214041,606,277,329,60,1
214069,3026,941,2085,1,4
214069,2417,764,1653,2,1
214069,2362,745,1617,3,1
214069,438,172,266,4,1
214069,1924,573,1351,5,1
214069,55,19,36,11,1
214069,609,177,432,12,3
214069,194,63,131,19,1
214069,1730,510,1220,20,1
214069,2057,701,1356,21,4
214069,1790,620,1170,22,1
214069,1790,620,1170,23,1
214069,428,171,257,24,1
214069,1362,449,913,25,1
214069,267,81,186,32,3
214069,97,39,58,39,1
214069,1265,410,855,40,1
214069,969,240,729,41,4
214069,627,144,483,42,1
214069,572,125,447,43,1
214069,10,1,9,44,1
214069,562,124,438,45,1
214069,55,19,36,51,1
214069,342,96,246,52,3
214069,97,24,73,59,1
214069,465,100,365,60,1
214111,13122,5778,7344,1,4
214111,13122,5778,7344,2,1
214111,11680,5223,6457,3,1
214111,2566,1265,1301,4,1
214111,9114,3958,5156,5,1
214111,1442,555,887,11,1
214111,936,400,536,19,1
214111,8178,3558,4620,20,1
214111,4567,2371,2196,21,4
214111,4567,2371,2196,22,1
214111,4533,2354,2179,23,1
214111,1550,831,719,24,1
214111,2983,1523,1460,25,1
214111,34,17,17,31,1
214111,419,216,203,39,1
214111,2564,1307,1257,40,1
214111,8555,3407,5148,41,4
214111,8555,3407,5148,42,1
214111,7147,2869,4278,43,1
214111,1016,434,582,44,1
214111,6131,2435,3696,45,1
214111,1408,538,870,51,1
214111,517,184,333,59,1
214111,5614,2251,3363,60,1
214148,484,5,479,1,4
214148,437,0,437,2,1
214148,437,0,437,3,1
214148,75,0,75,4,1
214148,362,0,362,5,1
214148,47,5,42,12,3
214148,41,0,41,19,1
214148,321,0,321,20,1
214148,440,4,436,21,4
214148,411,0,411,22,1
214148,411,0,411,23,1
214148,74,0,74,24,1
214148,337,0,337,25,1
214148,29,4,25,32,3
214148,36,0,36,39,1
214148,301,0,301,40,1
214148,44,1,43,41,4
214148,26,0,26,42,1
214148,26,0,26,43,1
214148,1,0,1,44,1
214148,25,0,25,45,1
214148,18,1,17,52,3
214148,5,0,5,59,1
214148,20,0,20,60,1
214157,1837,712,1125,1,4
214157,1553,635,918,2,1
214157,1508,616,892,3,1
214157,355,149,206,4,1
214157,1153,467,686,5,1
214157,45,19,26,11,1
214157,284,77,207,12,3
214157,81,39,42,19,1
214157,1072,428,644,20,1
214157,1447,608,839,21,4
214157,1418,602,816,22,1
214157,1413,601,812,23,1
214157,355,149,206,24,1
214157,1058,452,606,25,1
214157,5,1,4,31,1
214157,29,6,23,32,3
214157,80,38,42,39,1
214157,978,414,564,40,1
214157,390,104,286,41,4
214157,135,33,102,42,1
214157,95,15,80,43,1
214157,95,15,80,45,1
214157,40,18,22,51,1
214157,255,71,184,52,3
214157,1,1,0,59,1
214157,94,14,80,60,1
214166,1835,517,1318,1,4
214166,1781,503,1278,2,1
214166,1571,423,1148,3,1
214166,394,116,278,4,1
214166,1177,307,870,5,1
214166,210,80,130,11,1
214166,54,14,40,12,3
214166,139,34,105,19,1
214166,1038,273,765,20,1
214166,1277,367,910,21,4
214166,1248,356,892,22,1
214166,1248,356,892,23,1
214166,387,114,273,24,1
214166,861,242,619,25,1
214166,29,11,18,32,3
214166,93,26,67,39,1
214166,768,216,552,40,1
214166,558,150,408,41,4
214166,533,147,386,42,1
214166,323,67,256,43,1
214166,7,2,5,44,1
214166,316,65,251,45,1
214166,210,80,130,51,1
214166,25,3,22,52,3
214166,46,8,38,59,1
214166,270,57,213,60,1
214175,2448,1009,1439,1,4
214175,2448,1009,1439,2,1
214175,2357,962,1395,3,1
214175,579,215,364,4,1
214175,1778,747,1031,5,1
214175,91,47,44,11,1
214175,22,9,13,19,1
214175,1756,738,1018,20,1
214175,2323,948,1375,21,4
214175,2323,948,1375,22,1
214175,2287,929,1358,23,1
214175,579,215,364,24,1
214175,1708,714,994,25,1
214175,36,19,17,31,1
214175,12,5,7,39,1
214175,1696,709,987,40,1
214175,125,61,64,41,4
214175,125,61,64,42,1
214175,70,33,37,43,1
214175,70,33,37,45,1
214175,55,28,27,51,1
214175,10,4,6,59,1
214175,60,29,31,60,1
214254,749,261,488,1,4
214254,749,261,488,2,1
214254,749,261,488,3,1
214254,190,62,128,4,1
214254,559,199,360,5,1
214254,25,5,20,19,1
214254,534,194,340,20,1
214254,749,261,488,21,4
214254,749,261,488,22,1
214254,749,261,488,23,1
214254,190,62,128,24,1
214254,559,199,360,25,1
214254,25,5,20,39,1
214254,534,194,340,40,1
214272,2956,1032,1924,1,4
214272,2573,917,1656,2,1
214272,2462,876,1586,3,1
214272,503,182,321,4,1
214272,1959,694,1265,5,1
214272,111,41,70,11,1
214272,383,115,268,12,3
214272,101,43,58,19,1
214272,1858,651,1207,20,1
214272,2173,800,1373,21,4
214272,2080,768,1312,22,1
214272,2060,762,1298,23,1
214272,501,181,320,24,1
214272,1559,581,978,25,1
214272,20,6,14,31,1
214272,93,32,61,32,3
214272,96,43,53,39,1
214272,1463,538,925,40,1
214272,783,232,551,41,4
214272,493,149,344,42,1
214272,402,114,288,43,1
214272,2,1,1,44,1
214272,400,113,287,45,1
214272,91,35,56,51,1
214272,290,83,207,52,3
214272,5,0,5,59,1
214272,395,113,282,60,1
214290,856,827,29,1,4
214290,856,827,29,2,1
214290,856,827,29,3,1
214290,281,272,9,4,1
214290,575,555,20,5,1
214290,575,555,20,20,1
214290,856,827,29,21,4
214290,856,827,29,22,1
214290,856,827,29,23,1
214290,281,272,9,24,1
214290,575,555,20,25,1
214290,575,555,20,40,1
214379,10666,4364,6302,1,4
214379,10666,4364,6302,2,1
214379,10114,4177,5937,3,1
214379,2162,1079,1083,4,1
214379,7952,3098,4854,5,1
214379,552,187,365,11,1
214379,851,318,533,19,1
214379,7101,2780,4321,20,1
214379,4679,2214,2465,21,4
214379,4679,2214,2465,22,1
214379,4652,2200,2452,23,1
214379,1498,782,716,24,1
214379,3154,1418,1736,25,1
214379,27,14,13,31,1
214379,406,177,229,39,1
214379,2748,1241,1507,40,1
214379,5987,2150,3837,41,4
214379,5987,2150,3837,42,1
214379,5462,1977,3485,43,1
214379,664,297,367,44,1
214379,4798,1680,3118,45,1
214379,525,173,352,51,1
214379,445,141,304,59,1
214379,4353,1539,2814,60,1
214476,75,15,60,1,4
214476,75,15,60,2,1
214476,75,15,60,3,1
214476,21,3,18,4,1
214476,54,12,42,5,1
214476,54,12,42,20,1
214476,44,12,32,21,4
214476,44,12,32,22,1
214476,44,12,32,23,1
214476,8,3,5,24,1
214476,36,9,27,25,1
214476,36,9,27,40,1
214476,31,3,28,41,4
214476,31,3,28,42,1
214476,31,3,28,43,1
214476,13,0,13,44,1
214476,18,3,15,45,1
214476,18,3,15,60,1
214528,548,427,121,1,4
214528,548,427,121,2,1
214528,548,427,121,3,1
214528,142,118,24,4,1
214528,406,309,97,5,1
214528,50,40,10,19,1
214528,356,269,87,20,1
214528,396,317,79,21,4
214528,396,317,79,22,1
214528,396,317,79,23,1
214528,116,93,23,24,1
214528,280,224,56,25,1
214528,36,27,9,39,1
214528,244,197,47,40,1
214528,152,110,42,41,4
214528,152,110,42,42,1
214528,152,110,42,43,1
214528,26,25,1,44,1
214528,126,85,41,45,1
214528,14,13,1,59,1
214528,112,72,40,60,1
214546,53,2,51,1,4
214546,53,2,51,2,1
214546,53,2,51,3,1
214546,19,1,18,4,1
214546,34,1,33,5,1
214546,34,1,33,20,1
214546,44,2,42,21,4
214546,44,2,42,22,1
214546,44,2,42,23,1
214546,15,1,14,24,1
214546,29,1,28,25,1
214546,29,1,28,40,1
214546,9,0,9,41,4
214546,9,0,9,42,1
214546,9,0,9,43,1
214546,4,0,4,44,1
214546,5,0,5,45,1
214546,5,0,5,60,1
214564,1011,291,720,1,4
214564,1011,291,720,12,3
214564,903,259,644,21,4
214564,903,259,644,32,3
214564,108,32,76,41,4
214564,108,32,76,52,3
214582,743,181,562,1,4
214582,743,181,562,2,1
214582,743,181,562,3,1
214582,589,134,455,4,1
214582,154,47,107,5,1
214582,154,47,107,20,1
214582,474,114,360,21,4
214582,474,114,360,22,1
214582,474,114,360,23,1
214582,396,93,303,24,1
214582,78,21,57,25,1
214582,78,21,57,40,1
214582,269,67,202,41,4
214582,269,67,202,42,1
214582,269,67,202,43,1
214582,193,41,152,44,1
214582,76,26,50,45,1
214582,76,26,50,60,1
214591,4057,2651,1406,1,4
214591,3943,2570,1373,2,1
214591,3797,2479,1318,3,1
214591,1113,699,414,4,1
214591,2684,1780,904,5,1
214591,146,91,55,11,1
214591,114,81,33,12,3
214591,138,79,59,19,1
214591,2546,1701,845,20,1
214591,3714,2436,1278,21,4
214591,3683,2415,1268,22,1
214591,3628,2378,1250,23,1
214591,1103,692,411,24,1
214591,2525,1686,839,25,1
214591,55,37,18,31,1
214591,31,21,10,32,3
214591,122,68,54,39,1
214591,2403,1618,785,40,1
214591,343,215,128,41,4
214591,260,155,105,42,1
214591,169,101,68,43,1
214591,10,7,3,44,1
214591,159,94,65,45,1
214591,91,54,37,51,1
214591,83,60,23,52,3
214591,16,11,5,59,1
214591,143,83,60,60,1
214607,473,322,151,1,4
214607,473,322,151,12,3
214607,60,39,21,21,4
214607,60,39,21,32,3
214607,413,283,130,41,4
214607,413,283,130,52,3
214616,797,389,408,1,4
214616,797,389,408,12,3
214616,759,376,383,21,4
214616,759,376,383,32,3
214616,38,13,25,41,4
214616,38,13,25,52,3
214625,680,395,285,1,4
214625,680,395,285,2,1
214625,615,365,250,3,1
214625,168,101,67,4,1
214625,447,264,183,5,1
214625,65,30,35,11,1
214625,58,26,32,19,1
214625,389,238,151,20,1
214625,524,324,200,21,4
214625,524,324,200,22,1
214625,508,315,193,23,1
214625,161,99,62,24,1
214625,347,216,131,25,1
214625,16,9,7,31,1
214625,45,21,24,39,1
214625,302,195,107,40,1
214625,156,71,85,41,4
214625,156,71,85,42,1
214625,107,50,57,43,1
214625,7,2,5,44,1
214625,100,48,52,45,1
214625,49,21,28,51,1
214625,13,5,8,59,1
214625,87,43,44,60,1
214634,568,185,383,1,4
214634,568,185,383,2,1
214634,490,155,335,3,1
214634,97,32,65,4,1
214634,393,123,270,5,1
214634,78,30,48,11,1
214634,58,14,44,19,1
214634,335,109,226,20,1
214634,315,108,207,21,4
214634,315,108,207,22,1
214634,304,104,200,23,1
214634,84,30,54,24,1
214634,220,74,146,25,1
214634,11,4,7,31,1
214634,13,4,9,39,1
214634,207,70,137,40,1
214634,253,77,176,41,4
214634,253,77,176,42,1
214634,186,51,135,43,1
214634,13,2,11,44,1
214634,173,49,124,45,1
214634,67,26,41,51,1
214634,45,10,35,59,1
214634,128,39,89,60,1
214643,613,443,170,1,4
214643,606,442,164,2,1
214643,534,406,128,3,1
214643,168,122,46,4,1
214643,366,284,82,5,1
214643,72,36,36,11,1
214643,7,1,6,12,3
214643,31,23,8,19,1
214643,335,261,74,20,1
214643,519,398,121,21,4
214643,519,398,121,22,1
214643,503,385,118,23,1
214643,167,121,46,24,1
214643,336,264,72,25,1
214643,16,13,3,31,1
214643,30,22,8,39,1
214643,306,242,64,40,1
214643,94,45,49,41,4
214643,87,44,43,42,1
214643,31,21,10,43,1
214643,1,1,0,44,1
214643,30,20,10,45,1
214643,56,23,33,51,1
214643,7,1,6,52,3
214643,1,1,0,59,1
214643,29,19,10,60,1
214652,1178,528,650,1,4
214652,1178,528,650,2,1
214652,1089,483,606,3,1
214652,257,138,119,4,1
214652,832,345,487,5,1
214652,89,45,44,11,1
214652,73,23,50,19,1
214652,759,322,437,20,1
214652,943,460,483,21,4
214652,943,460,483,22,1
214652,901,437,464,23,1
214652,250,136,114,24,1
214652,651,301,350,25,1
214652,42,23,19,31,1
214652,48,20,28,39,1
214652,603,281,322,40,1
214652,235,68,167,41,4
214652,235,68,167,42,1
214652,188,46,142,43,1
214652,7,2,5,44,1
214652,181,44,137,45,1
214652,47,22,25,51,1
214652,25,3,22,59,1
214652,156,41,115,60,1
214670,925,509,416,1,4
214670,889,505,384,2,1
214670,788,453,335,3,1
214670,233,147,86,4,1
214670,555,306,249,5,1
214670,101,52,49,11,1
214670,36,4,32,12,3
214670,81,33,48,19,1
214670,474,273,201,20,1
214670,719,414,305,21,4
214670,719,414,305,22,1
214670,702,403,299,23,1
214670,231,146,85,24,1
214670,471,257,214,25,1
214670,17,11,6,31,1
214670,66,25,41,39,1
214670,405,232,173,40,1
214670,206,95,111,41,4
214670,170,91,79,42,1
214670,86,50,36,43,1
214670,2,1,1,44,1
214670,84,49,35,45,1
214670,84,41,43,51,1
214670,36,4,32,52,3
214670,15,8,7,59,1
214670,69,41,28,60,1
214689,3861,2054,1807,1,4
214689,3861,2054,1807,2,1
214689,3779,2008,1771,3,1
214689,1423,769,654,4,1
214689,2356,1239,1117,5,1
214689,82,46,36,11,1
214689,113,53,60,19,1
214689,2243,1186,1057,20,1
214689,3645,1976,1669,21,4
214689,3645,1976,1669,22,1
214689,3603,1953,1650,23,1
214689,1415,763,652,24,1
214689,2188,1190,998,25,1
214689,42,23,19,31,1
214689,105,51,54,39,1
214689,2083,1139,944,40,1
214689,216,78,138,41,4
214689,216,78,138,42,1
214689,176,55,121,43,1
214689,8,6,2,44,1
214689,168,49,119,45,1
214689,40,23,17,51,1
214689,8,2,6,59,1
214689,160,47,113,60,1
214698,703,430,273,1,4
214698,703,430,273,2,1
214698,636,395,241,3,1
214698,241,159,82,4,1
214698,395,236,159,5,1
214698,67,35,32,11,1
214698,39,21,18,19,1
214698,356,215,141,20,1
214698,626,392,234,21,4
214698,626,392,234,22,1
214698,613,384,229,23,1
214698,241,159,82,24,1
214698,372,225,147,25,1
214698,13,8,5,31,1
214698,35,19,16,39,1
214698,337,206,131,40,1
214698,77,38,39,41,4
214698,77,38,39,42,1
214698,23,11,12,43,1
214698,23,11,12,45,1
214698,54,27,27,51,1
214698,4,2,2,59,1
214698,19,9,10,60,1
214704,2732,1528,1204,1,4
214704,2712,1525,1187,2,1
214704,2573,1444,1129,3,1
214704,807,443,364,4,1
214704,1766,1001,765,5,1
214704,139,81,58,11,1
214704,20,3,17,12,3
214704,149,84,65,19,1
214704,1617,917,700,20,1
214704,2402,1343,1059,21,4
214704,2402,1343,1059,22,1
214704,2360,1311,1049,23,1
214704,792,433,359,24,1
214704,1568,878,690,25,1
214704,42,32,10,31,1
214704,127,73,54,39,1
214704,1441,805,636,40,1
214704,330,185,145,41,4
214704,310,182,128,42,1
214704,213,133,80,43,1
214704,15,10,5,44,1
214704,198,123,75,45,1
214704,97,49,48,51,1
214704,20,3,17,52,3
214704,22,11,11,59,1
214704,176,112,64,60,1
214713,4441,2417,2024,1,4
214713,3577,2056,1521,2,1
214713,3461,1988,1473,3,1
214713,744,443,301,4,1
214713,2717,1545,1172,5,1
214713,116,68,48,11,1
214713,864,361,503,12,3
214713,303,147,156,19,1
214713,2414,1398,1016,20,1
214713,3329,1937,1392,21,4
214713,3121,1843,1278,22,1
214713,3085,1820,1265,23,1
214713,740,441,299,24,1
214713,2345,1379,966,25,1
214713,36,23,13,31,1
214713,208,94,114,32,3
214713,253,131,122,39,1
214713,2092,1248,844,40,1
214713,1112,480,632,41,4
214713,456,213,243,42,1
214713,376,168,208,43,1
214713,4,2,2,44,1
214713,372,166,206,45,1
214713,80,45,35,51,1
214713,656,267,389,52,3
214713,50,16,34,59,1
214713,322,150,172,60,1
214731,1492,847,645,1,4
214731,1492,847,645,2,1
214731,1327,747,580,3,1
214731,333,199,134,4,1
214731,994,548,446,5,1
214731,165,100,65,11,1
214731,63,35,28,19,1
214731,931,513,418,20,1
214731,1253,701,552,21,4
214731,1253,701,552,22,1
214731,1176,652,524,23,1
214731,326,195,131,24,1
214731,850,457,393,25,1
214731,77,49,28,31,1
214731,44,26,18,39,1
214731,806,431,375,40,1
214731,239,146,93,41,4
214731,239,146,93,42,1
214731,151,95,56,43,1
214731,7,4,3,44,1
214731,144,91,53,45,1
214731,88,51,37,51,1
214731,19,9,10,59,1
214731,125,82,43,60,1
214740,704,366,338,1,4
214740,704,366,338,2,1
214740,591,305,286,3,1
214740,191,111,80,4,1
214740,400,194,206,5,1
214740,113,61,52,11,1
214740,29,13,16,19,1
214740,371,181,190,20,1
214740,557,304,253,21,4
214740,557,304,253,22,1
214740,529,283,246,23,1
214740,184,109,75,24,1
214740,345,174,171,25,1
214740,28,21,7,31,1
214740,25,11,14,39,1
214740,320,163,157,40,1
214740,147,62,85,41,4
214740,147,62,85,42,1
214740,62,22,40,43,1
214740,7,2,5,44,1
214740,55,20,35,45,1
214740,85,40,45,51,1
214740,4,2,2,59,1
214740,51,18,33,60,1
214759,846,369,477,1,4
214759,846,369,477,2,1
214759,762,335,427,3,1
214759,202,90,112,4,1
214759,560,245,315,5,1
214759,84,34,50,11,1
214759,50,16,34,19,1
214759,510,229,281,20,1
214759,653,305,348,21,4
214759,653,305,348,22,1
214759,640,299,341,23,1
214759,198,90,108,24,1
214759,442,209,233,25,1
214759,13,6,7,31,1
214759,25,10,15,39,1
214759,417,199,218,40,1
214759,193,64,129,41,4
214759,193,64,129,42,1
214759,122,36,86,43,1
214759,4,0,4,44,1
214759,118,36,82,45,1
214759,71,28,43,51,1
214759,25,6,19,59,1
214759,93,30,63,60,1
214768,951,494,457,1,4
214768,951,494,457,2,1
214768,918,471,447,3,1
214768,363,182,181,4,1
214768,555,289,266,5,1
214768,33,23,10,11,1
214768,42,17,25,19,1
214768,513,272,241,20,1
214768,881,460,421,21,4
214768,881,460,421,22,1
214768,875,457,418,23,1
214768,360,180,180,24,1
214768,515,277,238,25,1
214768,6,3,3,31,1
214768,31,14,17,39,1
214768,484,263,221,40,1
214768,70,34,36,41,4
214768,70,34,36,42,1
214768,43,14,29,43,1
214768,3,2,1,44,1
214768,40,12,28,45,1
214768,27,20,7,51,1
214768,11,3,8,59,1
214768,29,9,20,60,1
214777,46615,25090,21525,1,4
214777,40085,21527,18558,2,1
214777,39460,21162,18298,3,1
214777,8043,4220,3823,4,1
214777,31417,16942,14475,5,1
214777,625,365,260,11,1
214777,6530,3563,2967,12,3
214777,498,268,230,19,1
214777,30919,16674,14245,20,1
214777,44639,24017,20622,21,4
214777,38826,20795,18031,22,1
214777,38543,20614,17929,23,1
214777,8005,4204,3801,24,1
214777,30538,16410,14128,25,1
214777,283,181,102,31,1
214777,5813,3222,2591,32,3
214777,477,255,222,39,1
214777,30061,16155,13906,40,1
214777,1976,1073,903,41,4
214777,1259,732,527,42,1
214777,917,548,369,43,1
214777,38,16,22,44,1
214777,879,532,347,45,1
214777,342,184,158,51,1
214777,717,341,376,52,3
214777,21,13,8,59,1
214777,858,519,339,60,1
214786,623,338,285,1,4
214786,623,338,285,2,1
214786,588,319,269,3,1
214786,193,96,97,4,1
214786,395,223,172,5,1
214786,35,19,16,11,1
214786,39,25,14,19,1
214786,356,198,158,20,1
214786,562,310,252,21,4
214786,562,310,252,22,1
214786,553,302,251,23,1
214786,191,96,95,24,1
214786,362,206,156,25,1
214786,9,8,1,31,1
214786,36,24,12,39,1
214786,326,182,144,40,1
214786,61,28,33,41,4
214786,61,28,33,42,1
214786,35,17,18,43,1
214786,2,0,2,44,1
214786,33,17,16,45,1
214786,26,11,15,51,1
214786,3,1,2,59,1
214786,30,16,14,60,1
214795,1023,409,614,1,4
214795,1022,409,613,2,1
214795,911,355,556,3,1
214795,321,129,192,4,1
214795,590,226,364,5,1
214795,111,54,57,11,1
214795,1,0,1,12,3
214795,44,14,30,19,1
214795,546,212,334,20,1
214795,737,320,417,21,4
214795,737,320,417,22,1
214795,719,310,409,23,1
214795,307,125,182,24,1
214795,412,185,227,25,1
214795,18,10,8,31,1
214795,20,11,9,39,1
214795,392,174,218,40,1
214795,286,89,197,41,4
214795,285,89,196,42,1
214795,192,45,147,43,1
214795,14,4,10,44,1
214795,178,41,137,45,1
214795,93,44,49,51,1
214795,1,0,1,52,3
214795,24,3,21,59,1
214795,154,38,116,60,1
214801,3694,1752,1942,1,4
214801,3690,1752,1938,2,1
214801,3231,1605,1626,3,1
214801,923,520,403,4,1
214801,2308,1085,1223,5,1
214801,459,147,312,11,1
214801,4,0,4,12,3
214801,210,95,115,19,1
214801,2098,990,1108,20,1
214801,2888,1484,1404,21,4
214801,2888,1484,1404,22,1
214801,2823,1451,1372,23,1
214801,917,516,401,24,1
214801,1906,935,971,25,1
214801,65,33,32,31,1
214801,167,87,80,39,1
214801,1739,848,891,40,1
214801,806,268,538,41,4
214801,802,268,534,42,1
214801,408,154,254,43,1
214801,6,4,2,44,1
214801,402,150,252,45,1
214801,394,114,280,51,1
214801,4,0,4,52,3
214801,43,8,35,59,1
214801,359,142,217,60,1
214810,837,328,509,1,4
214810,837,328,509,2,1
214810,796,308,488,3,1
214810,260,99,161,4,1
214810,536,209,327,5,1
214810,41,20,21,11,1
214810,49,16,33,19,1
214810,487,193,294,20,1
214810,658,284,374,21,4
214810,658,284,374,22,1
214810,640,273,367,23,1
214810,256,98,158,24,1
214810,384,175,209,25,1
214810,18,11,7,31,1
214810,36,14,22,39,1
214810,348,161,187,40,1
214810,179,44,135,41,4
214810,179,44,135,42,1
214810,156,35,121,43,1
214810,4,1,3,44,1
214810,152,34,118,45,1
214810,23,9,14,51,1
214810,13,2,11,59,1
214810,139,32,107,60,1
214829,1177,644,533,1,4
214829,1141,641,500,2,1
214829,943,547,396,3,1
214829,292,167,125,4,1
214829,651,380,271,5,1
214829,198,94,104,11,1
214829,36,3,33,12,3
214829,47,21,26,19,1
214829,604,359,245,20,1
214829,822,482,340,21,4
214829,822,482,340,22,1
214829,783,455,328,23,1
214829,284,163,121,24,1
214829,499,292,207,25,1
214829,39,27,12,31,1
214829,38,18,20,39,1
214829,461,274,187,40,1
214829,355,162,193,41,4
214829,319,159,160,42,1
214829,160,92,68,43,1
214829,8,4,4,44,1
214829,152,88,64,45,1
214829,159,67,92,51,1
214829,36,3,33,52,3
214829,9,3,6,59,1
214829,143,85,58,60,1
214838,65,14,51,1,4
214838,65,14,51,2,1
214838,65,14,51,3,1
214838,6,3,3,4,1
214838,59,11,48,5,1
214838,10,2,8,19,1
214838,49,9,40,20,1
214838,65,14,51,21,4
214838,65,14,51,22,1
214838,65,14,51,23,1
214838,6,3,3,24,1
214838,59,11,48,25,1
214838,10,2,8,39,1
214838,49,9,40,40,1
214883,1796,495,1301,1,4
214883,1759,485,1274,2,1
214883,1754,484,1270,3,1
214883,51,16,35,4,1
214883,1703,468,1235,5,1
214883,5,1,4,11,1
214883,37,10,27,12,3
214883,200,71,129,19,1
214883,1503,397,1106,20,1
214883,358,126,232,21,4
214883,358,126,232,22,1
214883,358,126,232,23,1
214883,12,4,8,24,1
214883,346,122,224,25,1
214883,60,25,35,39,1
214883,286,97,189,40,1
214883,1438,369,1069,41,4
214883,1401,359,1042,42,1
214883,1396,358,1038,43,1
214883,39,12,27,44,1
214883,1357,346,1011,45,1
214883,5,1,4,51,1
214883,37,10,27,52,3
214883,140,46,94,59,1
214883,1217,300,917,60,1
214892,346,108,238,1,4
214892,346,108,238,2,1
214892,346,108,238,3,1
214892,115,33,82,4,1
214892,231,75,156,5,1
214892,231,75,156,20,1
214892,346,108,238,21,4
214892,346,108,238,22,1
214892,346,108,238,23,1
214892,115,33,82,24,1
214892,231,75,156,25,1
214892,231,75,156,40,1
214944,551,504,47,1,4
214944,551,504,47,2,1
214944,551,504,47,3,1
214944,183,161,22,4,1
214944,368,343,25,5,1
214944,65,61,4,19,1
214944,303,282,21,20,1
214944,384,344,40,21,4
214944,384,344,40,22,1
214944,384,344,40,23,1
214944,148,126,22,24,1
214944,236,218,18,25,1
214944,48,44,4,39,1
214944,188,174,14,40,1
214944,167,160,7,41,4
214944,167,160,7,42,1
214944,167,160,7,43,1
214944,35,35,0,44,1
214944,132,125,7,45,1
214944,17,17,0,59,1
214944,115,108,7,60,1
214962,56,3,53,1,4
214962,56,3,53,2,1
214962,56,3,53,3,1
214962,20,0,20,4,1
214962,36,3,33,5,1
214962,36,3,33,20,1
214962,49,2,47,21,4
214962,49,2,47,22,1
214962,49,2,47,23,1
214962,17,0,17,24,1
214962,32,2,30,25,1
214962,32,2,30,40,1
214962,7,1,6,41,4
214962,7,1,6,42,1
214962,7,1,6,43,1
214962,3,0,3,44,1
214962,4,1,3,45,1
214962,4,1,3,60,1
214971,299,121,178,1,4
214971,198,81,117,2,1
214971,198,81,117,3,1
214971,39,16,23,4,1
214971,159,65,94,5,1
214971,101,40,61,12,3
214971,20,7,13,19,1
214971,139,58,81,20,1
214971,291,116,175,21,4
214971,190,76,114,22,1
214971,190,76,114,23,1
214971,39,16,23,24,1
214971,151,60,91,25,1
214971,101,40,61,32,3
214971,19,7,12,39,1
214971,132,53,79,40,1
214971,8,5,3,41,4
214971,8,5,3,42,1
214971,8,5,3,43,1
214971,8,5,3,45,1
214971,1,0,1,59,1
214971,7,5,2,60,1
215008,75,75,0,1,4
215008,75,75,0,2,1
215008,75,75,0,3,1
215008,13,13,0,4,1
215008,62,62,0,5,1
215008,62,62,0,20,1
215008,75,75,0,21,4
215008,75,75,0,22,1
215008,75,75,0,23,1
215008,13,13,0,24,1
215008,62,62,0,25,1
215008,62,62,0,40,1
215026,6,5,1,1,4
215026,6,5,1,2,1
215026,6,5,1,3,1
215026,6,5,1,5,1
215026,6,5,1,20,1
215026,6,5,1,21,4
215026,6,5,1,22,1
215026,6,5,1,23,1
215026,6,5,1,25,1
215026,6,5,1,40,1
215044,112,27,85,1,4
215044,112,27,85,2,1
215044,112,27,85,3,1
215044,53,11,42,4,1
215044,59,16,43,5,1
215044,59,16,43,20,1
215044,66,17,49,21,4
215044,66,17,49,22,1
215044,66,17,49,23,1
215044,27,7,20,24,1
215044,39,10,29,25,1
215044,39,10,29,40,1
215044,46,10,36,41,4
215044,46,10,36,42,1
215044,46,10,36,43,1
215044,26,4,22,44,1
215044,20,6,14,45,1
215044,20,6,14,60,1
215053,223,69,154,1,4
215053,223,69,154,2,1
215053,222,69,153,3,1
215053,52,17,35,4,1
215053,170,52,118,5,1
215053,1,0,1,11,1
215053,12,3,9,19,1
215053,158,49,109,20,1
215053,208,65,143,21,4
215053,208,65,143,22,1
215053,208,65,143,23,1
215053,51,17,34,24,1
215053,157,48,109,25,1
215053,9,2,7,39,1
215053,148,46,102,40,1
215053,15,4,11,41,4
215053,15,4,11,42,1
215053,14,4,10,43,1
215053,1,0,1,44,1
215053,13,4,9,45,1
215053,1,0,1,51,1
215053,3,1,2,59,1
215053,10,3,7,60,1
215062,24630,11698,12932,1,4
215062,11525,5578,5947,2,1
215062,10606,5190,5416,3,1
215062,2410,1181,1229,4,1
215062,8196,4009,4187,5,1
215062,919,388,531,11,1
215062,13105,6120,6985,12,3
215062,248,86,162,19,1
215062,7948,3923,4025,20,1
215062,21344,10405,10939,21,4
215062,10319,5063,5256,22,1
215062,10142,4963,5179,23,1
215062,2353,1152,1201,24,1
215062,7789,3811,3978,25,1
215062,177,100,77,31,1
215062,11025,5342,5683,32,3
215062,243,82,161,39,1
215062,7546,3729,3817,40,1
215062,3286,1293,1993,41,4
215062,1206,515,691,42,1
215062,464,227,237,43,1
215062,57,29,28,44,1
215062,407,198,209,45,1
215062,742,288,454,51,1
215062,2080,778,1302,52,3
215062,5,4,1,59,1
215062,402,194,208,60,1
215099,3523,1209,2314,1,4
215099,2811,975,1836,2,1
215099,2791,970,1821,3,1
215099,550,175,375,4,1
215099,2241,795,1446,5,1
215099,20,5,15,11,1
215099,712,234,478,12,3
215099,257,72,185,19,1
215099,1984,723,1261,20,1
215099,2916,1006,1910,21,4
215099,2531,895,1636,22,1
215099,2524,894,1630,23,1
215099,540,173,367,24,1
215099,1984,721,1263,25,1
215099,7,1,6,31,1
215099,385,111,274,32,3
215099,179,59,120,39,1
215099,1805,662,1143,40,1
215099,607,203,404,41,4
215099,280,80,200,42,1
215099,267,76,191,43,1
215099,10,2,8,44,1
215099,257,74,183,45,1
215099,13,4,9,51,1
215099,327,123,204,52,3
215099,78,13,65,59,1
215099,179,61,118,60,1
215105,2063,852,1211,1,4
215105,1890,800,1090,2,1
215105,1865,787,1078,3,1
215105,457,181,276,4,1
215105,1408,606,802,5,1
215105,25,13,12,11,1
215105,173,52,121,12,3
215105,106,53,53,19,1
215105,1302,553,749,20,1
215105,1983,818,1165,21,4
215105,1860,786,1074,22,1
215105,1843,774,1069,23,1
215105,457,181,276,24,1
215105,1386,593,793,25,1
215105,17,12,5,31,1
215105,123,32,91,32,3
215105,106,53,53,39,1
215105,1280,540,740,40,1
215105,80,34,46,41,4
215105,30,14,16,42,1
215105,22,13,9,43,1
215105,22,13,9,45,1
215105,8,1,7,51,1
215105,50,20,30,52,3
215105,22,13,9,60,1
215114,1093,492,601,1,4
215114,844,392,452,2,1
215114,840,392,448,3,1
215114,139,59,80,4,1
215114,701,333,368,5,1
215114,4,0,4,11,1
215114,249,100,149,12,3
215114,66,39,27,19,1
215114,635,294,341,20,1
215114,826,384,442,21,4
215114,779,360,419,22,1
215114,779,360,419,23,1
215114,137,58,79,24,1
215114,642,302,340,25,1
215114,47,24,23,32,3
215114,60,34,26,39,1
215114,582,268,314,40,1
215114,267,108,159,41,4
215114,65,32,33,42,1
215114,61,32,29,43,1
215114,2,1,1,44,1
215114,59,31,28,45,1
215114,4,0,4,51,1
215114,202,76,126,52,3
215114,6,5,1,59,1
215114,53,26,27,60,1
215123,2736,1204,1532,1,4
215123,2736,1204,1532,12,3
215123,2617,1180,1437,21,4
215123,2617,1180,1437,32,3
215123,119,24,95,41,4
215123,119,24,95,52,3
215132,2773,1081,1692,1,4
215132,1837,705,1132,2,1
215132,1830,703,1127,3,1
215132,440,176,264,4,1
215132,1390,527,863,5,1
215132,7,2,5,11,1
215132,936,376,560,12,3
215132,117,29,88,19,1
215132,1273,498,775,20,1
215132,2532,991,1541,21,4
215132,1814,698,1116,22,1
215132,1814,698,1116,23,1
215132,440,176,264,24,1
215132,1374,522,852,25,1
215132,718,293,425,32,3
215132,112,27,85,39,1
215132,1262,495,767,40,1
215132,241,90,151,41,4
215132,23,7,16,42,1
215132,16,5,11,43,1
215132,16,5,11,45,1
215132,7,2,5,51,1
215132,218,83,135,52,3
215132,5,2,3,59,1
215132,11,3,8,60,1
215239,19063,7222,11841,1,4
215239,19063,7222,11841,2,1
215239,18204,6911,11293,3,1
215239,4230,1856,2374,4,1
215239,13974,5055,8919,5,1
215239,859,311,548,11,1
215239,495,197,298,19,1
215239,13479,4858,8621,20,1
215239,5075,2257,2818,21,4
215239,5075,2257,2818,22,1
215239,5037,2240,2797,23,1
215239,1355,676,679,24,1
215239,3682,1564,2118,25,1
215239,38,17,21,31,1
215239,223,89,134,39,1
215239,3459,1475,1984,40,1
215239,13988,4965,9023,41,4
215239,13988,4965,9023,42,1
215239,13167,4671,8496,43,1
215239,2875,1180,1695,44,1
215239,10292,3491,6801,45,1
215239,821,294,527,51,1
215239,272,108,164,59,1
215239,10020,3383,6637,60,1
215266,1481,671,810,1,4
215266,1481,671,810,2,1
215266,1456,664,792,3,1
215266,391,188,203,4,1
215266,1065,476,589,5,1
215266,25,7,18,11,1
215266,123,50,73,19,1
215266,942,426,516,20,1
215266,1361,631,730,21,4
215266,1361,631,730,22,1
215266,1356,629,727,23,1
215266,389,188,201,24,1
215266,967,441,526,25,1
215266,5,2,3,31,1
215266,118,50,68,39,1
215266,849,391,458,40,1
215266,120,40,80,41,4
215266,120,40,80,42,1
215266,100,35,65,43,1
215266,2,0,2,44,1
215266,98,35,63,45,1
215266,20,5,15,51,1
215266,5,0,5,59,1
215266,93,35,58,60,1
215275,1677,848,829,1,4
215275,1677,848,829,2,1
215275,1677,848,829,3,1
215275,386,183,203,4,1
215275,1291,665,626,5,1
215275,154,88,66,19,1
215275,1137,577,560,20,1
215275,1564,781,783,21,4
215275,1564,781,783,22,1
215275,1564,781,783,23,1
215275,386,183,203,24,1
215275,1178,598,580,25,1
215275,128,73,55,39,1
215275,1050,525,525,40,1
215275,113,67,46,41,4
215275,113,67,46,42,1
215275,113,67,46,43,1
215275,113,67,46,45,1
215275,26,15,11,59,1
215275,87,52,35,60,1
215284,2840,1550,1290,1,4
215284,2840,1550,1290,2,1
215284,2837,1549,1288,3,1
215284,688,375,313,4,1
215284,2149,1174,975,5,1
215284,3,1,2,11,1
215284,145,79,66,19,1
215284,2004,1095,909,20,1
215284,2753,1498,1255,21,4
215284,2753,1498,1255,22,1
215284,2751,1497,1254,23,1
215284,688,375,313,24,1
215284,2063,1122,941,25,1
215284,2,1,1,31,1
215284,137,73,64,39,1
215284,1926,1049,877,40,1
215284,87,52,35,41,4
215284,87,52,35,42,1
215284,86,52,34,43,1
215284,86,52,34,45,1
215284,1,0,1,51,1
215284,8,6,2,59,1
215284,78,46,32,60,1
215293,28649,13873,14776,1,4
215293,18615,9262,9353,2,1
215293,18304,9146,9158,3,1
215293,3854,1825,2029,4,1
215293,14450,7321,7129,5,1
215293,311,116,195,11,1
215293,10034,4611,5423,12,3
215293,887,468,419,19,1
215293,13563,6853,6710,20,1
215293,25069,12259,12810,21,4
215293,17483,8691,8792,22,1
215293,17435,8677,8758,23,1
215293,3851,1824,2027,24,1
215293,13584,6853,6731,25,1
215293,48,14,34,31,1
215293,7586,3568,4018,32,3
215293,795,420,375,39,1
215293,12789,6433,6356,40,1
215293,3580,1614,1966,41,4
215293,1132,571,561,42,1
215293,869,469,400,43,1
215293,3,1,2,44,1
215293,866,468,398,45,1
215293,263,102,161,51,1
215293,2448,1043,1405,52,3
215293,92,48,44,59,1
215293,774,420,354,60,1
215309,367,129,238,1,4
215309,367,129,238,2,1
215309,363,128,235,3,1
215309,143,58,85,4,1
215309,220,70,150,5,1
215309,4,1,3,11,1
215309,29,8,21,19,1
215309,191,62,129,20,1
215309,297,118,179,21,4
215309,297,118,179,22,1
215309,294,117,177,23,1
215309,133,56,77,24,1
215309,161,61,100,25,1
215309,3,1,2,31,1
215309,26,8,18,39,1
215309,135,53,82,40,1
215309,70,11,59,41,4
215309,70,11,59,42,1
215309,69,11,58,43,1
215309,10,2,8,44,1
215309,59,9,50,45,1
215309,1,0,1,51,1
215309,3,0,3,59,1
215309,56,9,47,60,1
215336,49,1,48,1,4
215336,49,1,48,2,1
215336,49,1,48,3,1
215336,22,0,22,4,1
215336,27,1,26,5,1
215336,27,1,26,20,1
215336,49,1,48,21,4
215336,49,1,48,22,1
215336,49,1,48,23,1
215336,22,0,22,24,1
215336,27,1,26,25,1
215336,27,1,26,40,1
215381,354,337,17,1,4
215381,354,337,17,2,1
215381,354,337,17,3,1
215381,107,101,6,4,1
215381,247,236,11,5,1
215381,44,43,1,19,1
215381,203,193,10,20,1
215381,354,337,17,21,4
215381,354,337,17,22,1
215381,354,337,17,23,1
215381,107,101,6,24,1
215381,247,236,11,25,1
215381,44,43,1,39,1
215381,203,193,10,40,1
215390,232,109,123,1,4
215390,232,109,123,2,1
215390,232,109,123,3,1
215390,89,42,47,4,1
215390,143,67,76,5,1
215390,143,67,76,20,1
215390,119,51,68,21,4
215390,119,51,68,22,1
215390,119,51,68,23,1
215390,75,32,43,24,1
215390,44,19,25,25,1
215390,44,19,25,40,1
215390,113,58,55,41,4
215390,113,58,55,42,1
215390,113,58,55,43,1
215390,14,10,4,44,1
215390,99,48,51,45,1
215390,99,48,51,60,1
215415,1841,1055,786,1,4
215415,1841,1055,786,2,1
215415,1841,1055,786,3,1
215415,719,451,268,4,1
215415,1122,604,518,5,1
215415,261,113,148,19,1
215415,861,491,370,20,1
215415,1841,1055,786,21,4
215415,1841,1055,786,22,1
215415,1841,1055,786,23,1
215415,719,451,268,24,1
215415,1122,604,518,25,1
215415,261,113,148,39,1
215415,861,491,370,40,1
215424,246,156,90,1,4
215424,246,156,90,12,3
215424,199,138,61,21,4
215424,199,138,61,32,3
215424,47,18,29,41,4
215424,47,18,29,52,3
215433,315,55,260,1,4
215433,315,55,260,2,1
215433,315,55,260,3,1
215433,143,27,116,4,1
215433,172,28,144,5,1
215433,172,28,144,20,1
215433,262,51,211,21,4
215433,262,51,211,22,1
215433,262,51,211,23,1
215433,116,26,90,24,1
215433,146,25,121,25,1
215433,146,25,121,40,1
215433,53,4,49,41,4
215433,53,4,49,42,1
215433,53,4,49,43,1
215433,27,1,26,44,1
215433,26,3,23,45,1
215433,26,3,23,60,1
215442,3841,1656,2185,1,4
215442,3226,1383,1843,2,1
215442,3164,1379,1785,3,1
215442,548,197,351,4,1
215442,2616,1182,1434,5,1
215442,62,4,58,11,1
215442,615,273,342,12,3
215442,469,229,240,19,1
215442,2147,953,1194,20,1
215442,2801,1169,1632,21,4
215442,2551,1070,1481,22,1
215442,2551,1070,1481,23,1
215442,539,192,347,24,1
215442,2012,878,1134,25,1
215442,250,99,151,32,3
215442,338,172,166,39,1
215442,1674,706,968,40,1
215442,1040,487,553,41,4
215442,675,313,362,42,1
215442,613,309,304,43,1
215442,9,5,4,44,1
215442,604,304,300,45,1
215442,62,4,58,51,1
215442,365,174,191,52,3
215442,131,57,74,59,1
215442,473,247,226,60,1
215479,64,10,54,1,4
215479,64,10,54,2,1
215479,64,10,54,3,1
215479,64,10,54,5,1
215479,64,10,54,20,1
215479,64,10,54,21,4
215479,64,10,54,22,1
215479,64,10,54,23,1
215479,64,10,54,25,1
215479,64,10,54,40,1
215530,29,1,28,1,4
215530,29,1,28,2,1
215530,29,1,28,3,1
215530,18,1,17,4,1
215530,11,0,11,5,1
215530,11,0,11,20,1
215530,26,1,25,21,4
215530,26,1,25,22,1
215530,26,1,25,23,1
215530,17,1,16,24,1
215530,9,0,9,25,1
215530,9,0,9,40,1
215530,3,0,3,41,4
215530,3,0,3,42,1
215530,3,0,3,43,1
215530,1,0,1,44,1
215530,2,0,2,45,1
215530,2,0,2,60,1
215585,4538,1666,2872,1,4
215585,4538,1666,2872,2,1
215585,4028,1460,2568,3,1
215585,963,441,522,4,1
215585,3065,1019,2046,5,1
215585,510,206,304,11,1
215585,382,140,242,19,1
215585,2683,879,1804,20,1
215585,976,426,550,21,4
215585,976,426,550,22,1
215585,947,411,536,23,1
215585,251,125,126,24,1
215585,696,286,410,25,1
215585,29,15,14,31,1
215585,114,49,65,39,1
215585,582,237,345,40,1
215585,3562,1240,2322,41,4
215585,3562,1240,2322,42,1
215585,3081,1049,2032,43,1
215585,712,316,396,44,1
215585,2369,733,1636,45,1
215585,481,191,290,51,1
215585,268,91,177,59,1
215585,2101,642,1459,60,1
215594,367,56,311,1,4
215594,367,56,311,2,1
215594,367,56,311,3,1
215594,29,1,28,4,1
215594,338,55,283,5,1
215594,338,55,283,20,1
215594,169,28,141,21,4
215594,169,28,141,22,1
215594,169,28,141,23,1
215594,26,1,25,24,1
215594,143,27,116,25,1
215594,143,27,116,40,1
215594,198,28,170,41,4
215594,198,28,170,42,1
215594,198,28,170,43,1
215594,3,0,3,44,1
215594,195,28,167,45,1
215594,195,28,167,60,1
215619,48,18,30,1,4
215619,48,18,30,12,3
215619,43,15,28,21,4
215619,43,15,28,32,3
215619,5,3,2,41,4
215619,5,3,2,52,3
215628,81,73,8,1,4
215628,81,73,8,12,3
215628,37,35,2,21,4
215628,37,35,2,32,3
215628,44,38,6,41,4
215628,44,38,6,52,3
215637,427,197,230,1,4
215637,427,197,230,2,1
215637,427,197,230,3,1
215637,333,147,186,4,1
215637,94,50,44,5,1
215637,16,9,7,19,1
215637,78,41,37,20,1
215637,427,197,230,21,4
215637,427,197,230,22,1
215637,427,197,230,23,1
215637,333,147,186,24,1
215637,94,50,44,25,1
215637,16,9,7,39,1
215637,78,41,37,40,1
215646,519,251,268,1,4
215646,519,251,268,2,1
215646,510,251,259,3,1
215646,108,50,58,4,1
215646,402,201,201,5,1
215646,9,0,9,11,1
215646,29,9,20,19,1
215646,373,192,181,20,1
215646,519,251,268,21,4
215646,519,251,268,22,1
215646,510,251,259,23,1
215646,108,50,58,24,1
215646,402,201,201,25,1
215646,9,0,9,31,1
215646,29,9,20,39,1
215646,373,192,181,40,1
215655,5481,2926,2555,1,4
215655,4496,2435,2061,2,1
215655,4459,2425,2034,3,1
215655,994,579,415,4,1
215655,3465,1846,1619,5,1
215655,37,10,27,11,1
215655,985,491,494,12,3
215655,330,167,163,19,1
215655,3135,1679,1456,20,1
215655,3935,2225,1710,21,4
215655,3935,2225,1710,22,1
215655,3935,2225,1710,23,1
215655,988,576,412,24,1
215655,2947,1649,1298,25,1
215655,247,146,101,39,1
215655,2700,1503,1197,40,1
215655,1546,701,845,41,4
215655,561,210,351,42,1
215655,524,200,324,43,1
215655,6,3,3,44,1
215655,518,197,321,45,1
215655,37,10,27,51,1
215655,985,491,494,52,3
215655,83,21,62,59,1
215655,435,176,259,60,1
215682,684,636,48,1,4
215682,684,636,48,2,1
215682,684,636,48,3,1
215682,111,87,24,4,1
215682,573,549,24,5,1
215682,573,549,24,20,1
215682,684,636,48,21,4
215682,684,636,48,22,1
215682,684,636,48,23,1
215682,111,87,24,24,1
215682,573,549,24,25,1
215682,573,549,24,40,1
215691,957,270,687,1,4
215691,531,177,354,2,1
215691,511,175,336,3,1
215691,112,41,71,4,1
215691,399,134,265,5,1
215691,20,2,18,11,1
215691,426,93,333,12,3
215691,29,14,15,19,1
215691,370,120,250,20,1
215691,526,171,355,21,4
215691,411,148,263,22,1
215691,409,148,261,23,1
215691,112,41,71,24,1
215691,297,107,190,25,1
215691,2,0,2,31,1
215691,115,23,92,32,3
215691,29,14,15,39,1
215691,268,93,175,40,1
215691,431,99,332,41,4
215691,120,29,91,42,1
215691,102,27,75,43,1
215691,102,27,75,45,1
215691,18,2,16,51,1
215691,311,70,241,52,3
215691,102,27,75,60,1
215743,2344,842,1502,1,4
215743,1694,645,1049,2,1
215743,1665,631,1034,3,1
215743,403,157,246,4,1
215743,1262,474,788,5,1
215743,29,14,15,11,1
215743,650,197,453,12,3
215743,1,1,0,19,1
215743,1261,473,788,20,1
215743,1781,661,1120,21,4
215743,1547,593,954,22,1
215743,1541,591,950,23,1
215743,400,157,243,24,1
215743,1141,434,707,25,1
215743,6,2,4,31,1
215743,234,68,166,32,3
215743,1141,434,707,40,1
215743,563,181,382,41,4
215743,147,52,95,42,1
215743,124,40,84,43,1
215743,3,0,3,44,1
215743,121,40,81,45,1
215743,23,12,11,51,1
215743,416,129,287,52,3
215743,1,1,0,59,1
215743,120,39,81,60,1
215770,8954,3889,5065,1,4
215770,5374,2498,2876,2,1
215770,5265,2430,2835,3,1
215770,1275,588,687,4,1
215770,3990,1842,2148,5,1
215770,109,68,41,11,1
215770,3580,1391,2189,12,3
215770,211,88,123,19,1
215770,3779,1754,2025,20,1
215770,5124,2393,2731,21,4
215770,4489,2132,2357,22,1
215770,4485,2130,2355,23,1
215770,1272,586,686,24,1
215770,3213,1544,1669,25,1
215770,4,2,2,31,1
215770,635,261,374,32,3
215770,89,47,42,39,1
215770,3124,1497,1627,40,1
215770,3830,1496,2334,41,4
215770,885,366,519,42,1
215770,780,300,480,43,1
215770,3,2,1,44,1
215770,777,298,479,45,1
215770,105,66,39,51,1
215770,2945,1130,1815,52,3
215770,122,41,81,59,1
215770,655,257,398,60,1
215798,1813,909,904,1,4
215798,1596,822,774,2,1
215798,1532,798,734,3,1
215798,472,234,238,4,1
215798,1060,564,496,5,1
215798,64,24,40,11,1
215798,217,87,130,12,3
215798,43,28,15,19,1
215798,1017,536,481,20,1
215798,1654,852,802,21,4
215798,1532,790,742,22,1
215798,1515,787,728,23,1
215798,472,234,238,24,1
215798,1043,553,490,25,1
215798,17,3,14,31,1
215798,122,62,60,32,3
215798,43,28,15,39,1
215798,1000,525,475,40,1
215798,159,57,102,41,4
215798,64,32,32,42,1
215798,17,11,6,43,1
215798,17,11,6,45,1
215798,47,21,26,51,1
215798,95,25,70,52,3
215798,17,11,6,60,1
215813,56,55,1,1,4
215813,56,55,1,12,3
215813,47,47,0,21,4
215813,47,47,0,32,3
215813,9,8,1,41,4
215813,9,8,1,52,3
215886,86,35,51,1,4
215886,86,35,51,2,1
215886,86,35,51,3,1
215886,64,34,30,4,1
215886,22,1,21,5,1
215886,22,1,21,20,1
215886,84,33,51,21,4
215886,84,33,51,22,1
215886,84,33,51,23,1
215886,63,33,30,24,1
215886,21,0,21,25,1
215886,21,0,21,40,1
215886,2,2,0,41,4
215886,2,2,0,42,1
215886,2,2,0,43,1
215886,1,1,0,44,1
215886,1,1,0,45,1
215886,1,1,0,60,1
215929,5633,2444,3189,1,4
215929,3942,1760,2182,2,1
215929,3834,1705,2129,3,1
215929,881,348,533,4,1
215929,2953,1357,1596,5,1
215929,108,55,53,11,1
215929,1691,684,1007,12,3
215929,102,46,56,19,1
215929,2851,1311,1540,20,1
215929,4826,2075,2751,21,4
215929,3756,1663,2093,22,1
215929,3728,1654,2074,23,1
215929,878,347,531,24,1
215929,2850,1307,1543,25,1
215929,28,9,19,31,1
215929,1070,412,658,32,3
215929,96,44,52,39,1
215929,2754,1263,1491,40,1
215929,807,369,438,41,4
215929,186,97,89,42,1
215929,106,51,55,43,1
215929,3,1,2,44,1
215929,103,50,53,45,1
215929,80,46,34,51,1
215929,621,272,349,52,3
215929,6,2,4,59,1
215929,97,48,49,60,1
215947,2357,869,1488,1,4
215947,1958,731,1227,2,1
215947,1550,558,992,3,1
215947,386,137,249,4,1
215947,1164,421,743,5,1
215947,408,173,235,11,1
215947,399,138,261,12,3
215947,121,51,70,19,1
215947,1043,370,673,20,1
215947,1685,599,1086,21,4
215947,1415,508,907,22,1
215947,1379,490,889,23,1
215947,380,135,245,24,1
215947,999,355,644,25,1
215947,36,18,18,31,1
215947,270,91,179,32,3
215947,90,41,49,39,1
215947,909,314,595,40,1
215947,672,270,402,41,4
215947,543,223,320,42,1
215947,171,68,103,43,1
215947,6,2,4,44,1
215947,165,66,99,45,1
215947,372,155,217,51,1
215947,129,47,82,52,3
215947,31,10,21,59,1
215947,134,56,78,60,1
215974,346,59,287,1,4
215974,346,59,287,2,1
215974,346,59,287,3,1
215974,17,2,15,4,1
215974,329,57,272,5,1
215974,329,57,272,20,1
215974,269,49,220,21,4
215974,269,49,220,22,1
215974,269,49,220,23,1
215974,16,2,14,24,1
215974,253,47,206,25,1
215974,253,47,206,40,1
215974,77,10,67,41,4
215974,77,10,67,42,1
215974,77,10,67,43,1
215974,1,0,1,44,1
215974,76,10,66,45,1
215974,76,10,66,60,1
215983,35,16,19,1,4
215983,35,16,19,2,1
215983,35,16,19,3,1
215983,19,9,10,4,1
215983,16,7,9,5,1
215983,16,7,9,20,1
215983,35,16,19,21,4
215983,35,16,19,22,1
215983,35,16,19,23,1
215983,19,9,10,24,1
215983,16,7,9,25,1
215983,16,7,9,40,1
215992,285,62,223,1,4
215992,285,62,223,2,1
215992,285,62,223,3,1
215992,88,18,70,4,1
215992,197,44,153,5,1
215992,59,13,46,19,1
215992,138,31,107,20,1
215992,263,61,202,21,4
215992,263,61,202,22,1
215992,263,61,202,23,1
215992,83,18,65,24,1
215992,180,43,137,25,1
215992,54,13,41,39,1
215992,126,30,96,40,1
215992,22,1,21,41,4
215992,22,1,21,42,1
215992,22,1,21,43,1
215992,5,0,5,44,1
215992,17,1,16,45,1
215992,5,0,5,59,1
215992,12,1,11,60,1
216010,7548,3700,3848,1,4
216010,6550,3299,3251,2,1
216010,6493,3269,3224,3,1
216010,1522,775,747,4,1
216010,4971,2494,2477,5,1
216010,57,30,27,11,1
216010,998,401,597,12,3
216010,387,197,190,19,1
216010,4584,2297,2287,20,1
216010,6535,3265,3270,21,4
216010,6219,3144,3075,22,1
216010,6199,3135,3064,23,1
216010,1516,773,743,24,1
216010,4683,2362,2321,25,1
216010,20,9,11,31,1
216010,316,121,195,32,3
216010,346,189,157,39,1
216010,4337,2173,2164,40,1
216010,1013,435,578,41,4
216010,331,155,176,42,1
216010,294,134,160,43,1
216010,6,2,4,44,1
216010,288,132,156,45,1
216010,37,21,16,51,1
216010,682,280,402,52,3
216010,41,8,33,59,1
216010,247,124,123,60,1
216038,8347,3529,4818,1,4
216038,7595,3320,4275,2,1
216038,7544,3295,4249,3,1
216038,1408,563,845,4,1
216038,6136,2732,3404,5,1
216038,51,25,26,11,1
216038,752,209,543,12,3
216038,622,314,308,19,1
216038,5514,2418,3096,20,1
216038,7411,3259,4152,21,4
216038,7057,3147,3910,22,1
216038,7042,3137,3905,23,1
216038,1408,563,845,24,1
216038,5634,2574,3060,25,1
216038,15,10,5,31,1
216038,354,112,242,32,3
216038,545,303,242,39,1
216038,5089,2271,2818,40,1
216038,936,270,666,41,4
216038,538,173,365,42,1
216038,502,158,344,43,1
216038,502,158,344,45,1
216038,36,15,21,51,1
216038,398,97,301,52,3
216038,77,11,66,59,1
216038,425,147,278,60,1
216047,238,206,32,1,4
216047,84,78,6,2,1
216047,53,53,0,3,1
216047,10,10,0,4,1
216047,43,43,0,5,1
216047,31,25,6,11,1
216047,154,128,26,12,3
216047,8,8,0,19,1
216047,35,35,0,20,1
216047,150,138,12,21,4
216047,74,74,0,22,1
216047,53,53,0,23,1
216047,10,10,0,24,1
216047,43,43,0,25,1
216047,21,21,0,31,1
216047,76,64,12,32,3
216047,8,8,0,39,1
216047,35,35,0,40,1
216047,88,68,20,41,4
216047,10,4,6,42,1
216047,10,4,6,51,1
216047,78,64,14,52,3
216074,92,4,88,1,4
216074,92,4,88,2,1
216074,92,4,88,3,1
216074,81,4,77,4,1
216074,11,0,11,5,1
216074,11,0,11,20,1
216074,31,2,29,21,4
216074,31,2,29,22,1
216074,31,2,29,23,1
216074,26,2,24,24,1
216074,5,0,5,25,1
216074,5,0,5,40,1
216074,61,2,59,41,4
216074,61,2,59,42,1
216074,61,2,59,43,1
216074,55,2,53,44,1
216074,6,0,6,45,1
216074,6,0,6,60,1
216083,665,229,436,1,4
216083,665,229,436,2,1
216083,662,227,435,3,1
216083,308,117,191,4,1
216083,354,110,244,5,1
216083,3,2,1,11,1
216083,43,14,29,19,1
216083,311,96,215,20,1
216083,607,206,401,21,4
216083,607,206,401,22,1
216083,605,205,400,23,1
216083,292,112,180,24,1
216083,313,93,220,25,1
216083,2,1,1,31,1
216083,32,11,21,39,1
216083,281,82,199,40,1
216083,58,23,35,41,4
216083,58,23,35,42,1
216083,57,22,35,43,1
216083,16,5,11,44,1
216083,41,17,24,45,1
216083,1,1,0,51,1
216083,11,3,8,59,1
216083,30,14,16,60,1
216162,139,26,113,1,4
216162,139,26,113,2,1
216162,139,26,113,3,1
216162,139,26,113,5,1
216162,139,26,113,20,1
216162,139,26,113,21,4
216162,139,26,113,22,1
216162,139,26,113,23,1
216162,139,26,113,25,1
216162,139,26,113,40,1
216223,44,3,41,1,4
216223,44,3,41,2,1
216223,44,3,41,3,1
216223,29,3,26,4,1
216223,15,0,15,5,1
216223,15,0,15,20,1
216223,35,2,33,21,4
216223,35,2,33,22,1
216223,35,2,33,23,1
216223,23,2,21,24,1
216223,12,0,12,25,1
216223,12,0,12,40,1
216223,9,1,8,41,4
216223,9,1,8,42,1
216223,9,1,8,43,1
216223,6,1,5,44,1
216223,3,0,3,45,1
216223,3,0,3,60,1
216278,2187,971,1216,1,4
216278,2187,971,1216,2,1
216278,2138,958,1180,3,1
216278,589,260,329,4,1
216278,1549,698,851,5,1
216278,49,13,36,11,1
216278,30,17,13,19,1
216278,1519,681,838,20,1
216278,2129,953,1176,21,4
216278,2129,953,1176,22,1
216278,2122,949,1173,23,1
216278,589,260,329,24,1
216278,1533,689,844,25,1
216278,7,4,3,31,1
216278,30,17,13,39,1
216278,1503,672,831,40,1
216278,58,18,40,41,4
216278,58,18,40,42,1
216278,16,9,7,43,1
216278,16,9,7,45,1
216278,42,9,33,51,1
216278,16,9,7,60,1
216287,1534,753,781,1,4
216287,1534,753,781,2,1
216287,1524,750,774,3,1
216287,388,194,194,4,1
216287,1136,556,580,5,1
216287,10,3,7,11,1
216287,11,6,5,19,1
216287,1125,550,575,20,1
216287,1526,751,775,21,4
216287,1526,751,775,22,1
216287,1524,750,774,23,1
216287,388,194,194,24,1
216287,1136,556,580,25,1
216287,2,1,1,31,1
216287,11,6,5,39,1
216287,1125,550,575,40,1
216287,8,2,6,41,4
216287,8,2,6,42,1
216287,8,2,6,51,1
216296,883,822,61,1,4
216296,883,822,61,2,1
216296,883,822,61,3,1
216296,403,376,27,4,1
216296,480,446,34,5,1
216296,44,39,5,19,1
216296,436,407,29,20,1
216296,875,815,60,21,4
216296,875,815,60,22,1
216296,875,815,60,23,1
216296,402,375,27,24,1
216296,473,440,33,25,1
216296,44,39,5,39,1
216296,429,401,28,40,1
216296,8,7,1,41,4
216296,8,7,1,42,1
216296,8,7,1,43,1
216296,1,1,0,44,1
216296,7,6,1,45,1
216296,7,6,1,60,1
216311,124,124,0,1,4
216311,124,124,0,2,1
216311,124,124,0,3,1
216311,38,38,0,4,1
216311,86,86,0,5,1
216311,86,86,0,20,1
216311,124,124,0,21,4
216311,124,124,0,22,1
216311,124,124,0,23,1
216311,38,38,0,24,1
216311,86,86,0,25,1
216311,86,86,0,40,1
216339,37270,17917,19353,1,4
216339,28068,13811,14257,2,1
216339,27511,13534,13977,3,1
216339,4390,2028,2362,4,1
216339,23121,11506,11615,5,1
216339,557,277,280,11,1
216339,9202,4106,5096,12,3
216339,2716,1378,1338,19,1
216339,20405,10128,10277,20,1
216339,31436,15217,16219,21,4
216339,24743,12062,12681,22,1
216339,24601,12014,12587,23,1
216339,4380,2023,2357,24,1
216339,20221,9991,10230,25,1
216339,142,48,94,31,1
216339,6693,3155,3538,32,3
216339,2391,1234,1157,39,1
216339,17830,8757,9073,40,1
216339,5834,2700,3134,41,4
216339,3325,1749,1576,42,1
216339,2910,1520,1390,43,1
216339,10,5,5,44,1
216339,2900,1515,1385,45,1
216339,415,229,186,51,1
216339,2509,951,1558,52,3
216339,325,144,181,59,1
216339,2575,1371,1204,60,1
216348,27,20,7,1,4
216348,27,20,7,12,3
216348,16,14,2,21,4
216348,16,14,2,32,3
216348,11,6,5,41,4
216348,11,6,5,52,3
216357,1100,549,551,1,4
216357,1100,549,551,2,1
216357,1045,541,504,3,1
216357,303,155,148,4,1
216357,742,386,356,5,1
216357,55,8,47,11,1
216357,30,13,17,19,1
216357,712,373,339,20,1
216357,1061,532,529,21,4
216357,1061,532,529,22,1
216357,1030,531,499,23,1
216357,303,155,148,24,1
216357,727,376,351,25,1
216357,31,1,30,31,1
216357,26,10,16,39,1
216357,701,366,335,40,1
216357,39,17,22,41,4
216357,39,17,22,42,1
216357,15,10,5,43,1
216357,15,10,5,45,1
216357,24,7,17,51,1
216357,4,3,1,59,1
216357,11,7,4,60,1
216366,3635,1170,2465,1,4
216366,888,165,723,2,1
216366,664,116,548,3,1
216366,664,116,548,5,1
216366,224,49,175,11,1
216366,2747,1005,1742,12,3
216366,392,74,318,19,1
216366,272,42,230,20,1
216366,2496,917,1579,21,4
216366,596,103,493,22,1
216366,596,103,493,23,1
216366,596,103,493,25,1
216366,1900,814,1086,32,3
216366,379,70,309,39,1
216366,217,33,184,40,1
216366,1139,253,886,41,4
216366,292,62,230,42,1
216366,68,13,55,43,1
216366,68,13,55,45,1
216366,224,49,175,51,1
216366,847,191,656,52,3
216366,13,4,9,59,1
216366,55,9,46,60,1
216418,851,378,473,1,4
216418,851,378,473,2,1
216418,851,378,473,3,1
216418,101,43,58,4,1
216418,750,335,415,5,1
216418,69,22,47,19,1
216418,681,313,368,20,1
216418,465,191,274,21,4
216418,465,191,274,22,1
216418,465,191,274,23,1
216418,54,20,34,24,1
216418,411,171,240,25,1
216418,42,8,34,39,1
216418,369,163,206,40,1
216418,386,187,199,41,4
216418,386,187,199,42,1
216418,386,187,199,43,1
216418,47,23,24,44,1
216418,339,164,175,45,1
216418,27,14,13,59,1
216418,312,150,162,60,1
216427,74,71,3,1,4
216427,74,71,3,2,1
216427,74,71,3,3,1
216427,42,40,2,4,1
216427,32,31,1,5,1
216427,32,31,1,20,1
216427,74,71,3,21,4
216427,74,71,3,22,1
216427,74,71,3,23,1
216427,42,40,2,24,1
216427,32,31,1,25,1
216427,32,31,1,40,1
216436,251,242,9,1,4
216436,251,242,9,2,1
216436,251,242,9,3,1
216436,107,105,2,4,1
216436,144,137,7,5,1
216436,1,1,0,19,1
216436,143,136,7,20,1
216436,251,242,9,21,4
216436,251,242,9,22,1
216436,251,242,9,23,1
216436,107,105,2,24,1
216436,144,137,7,25,1
216436,1,1,0,39,1
216436,143,136,7,40,1
216445,171,168,3,1,4
216445,171,168,3,2,1
216445,171,168,3,3,1
216445,46,46,0,4,1
216445,125,122,3,5,1
216445,12,12,0,19,1
216445,113,110,3,20,1
216445,171,168,3,21,4
216445,171,168,3,22,1
216445,171,168,3,23,1
216445,46,46,0,24,1
216445,125,122,3,25,1
216445,12,12,0,39,1
216445,113,110,3,40,1
216454,184,172,12,1,4
216454,184,172,12,2,1
216454,184,172,12,3,1
216454,82,79,3,4,1
216454,102,93,9,5,1
216454,17,13,4,19,1
216454,85,80,5,20,1
216454,184,172,12,21,4
216454,184,172,12,22,1
216454,184,172,12,23,1
216454,82,79,3,24,1
216454,102,93,9,25,1
216454,17,13,4,39,1
216454,85,80,5,40,1
216463,154,102,52,1,4
216463,154,102,52,12,3
216463,76,62,14,21,4
216463,76,62,14,32,3
216463,78,40,38,41,4
216463,78,40,38,52,3
216524,1596,783,813,1,4
216524,1596,783,813,2,1
216524,1578,776,802,3,1
216524,425,208,217,4,1
216524,1153,568,585,5,1
216524,18,7,11,11,1
216524,8,7,1,19,1
216524,1145,561,584,20,1
216524,1582,781,801,21,4
216524,1582,781,801,22,1
216524,1574,776,798,23,1
216524,425,208,217,24,1
216524,1149,568,581,25,1
216524,8,5,3,31,1
216524,8,7,1,39,1
216524,1141,561,580,40,1
216524,14,2,12,41,4
216524,14,2,12,42,1
216524,4,0,4,43,1
216524,4,0,4,45,1
216524,10,2,8,51,1
216524,4,0,4,60,1
216542,1004,513,491,1,4
216542,964,484,480,2,1
216542,767,399,368,3,1
216542,134,65,69,4,1
216542,633,334,299,5,1
216542,197,85,112,11,1
216542,40,29,11,12,3
216542,10,4,6,19,1
216542,623,330,293,20,1
216542,694,368,326,21,4
216542,684,359,325,22,1
216542,671,353,318,23,1
216542,134,65,69,24,1
216542,537,288,249,25,1
216542,13,6,7,31,1
216542,10,9,1,32,3
216542,6,4,2,39,1
216542,531,284,247,40,1
216542,310,145,165,41,4
216542,280,125,155,42,1
216542,96,46,50,43,1
216542,96,46,50,45,1
216542,184,79,105,51,1
216542,30,20,10,52,3
216542,4,0,4,59,1
216542,92,46,46,60,1
216551,268,240,28,1,4
216551,268,240,28,2,1
216551,268,240,28,3,1
216551,166,145,21,4,1
216551,102,95,7,5,1
216551,18,16,2,19,1
216551,84,79,5,20,1
216551,268,240,28,21,4
216551,268,240,28,22,1
216551,268,240,28,23,1
216551,166,145,21,24,1
216551,102,95,7,25,1
216551,18,16,2,39,1
216551,84,79,5,40,1
216579,112,3,109,1,4
216579,112,3,109,2,1
216579,112,3,109,3,1
216579,55,1,54,4,1
216579,57,2,55,5,1
216579,57,2,55,20,1
216579,112,3,109,21,4
216579,112,3,109,22,1
216579,112,3,109,23,1
216579,55,1,54,24,1
216579,57,2,55,25,1
216579,57,2,55,40,1
216597,10696,5236,5460,1,4
216597,7042,3415,3627,2,1
216597,6856,3319,3537,3,1
216597,1660,794,866,4,1
216597,5196,2525,2671,5,1
216597,186,96,90,11,1
216597,3654,1821,1833,12,3
216597,115,34,81,19,1
216597,5081,2491,2590,20,1
216597,7876,3848,4028,21,4
216597,6547,3163,3384,22,1
216597,6539,3158,3381,23,1
216597,1659,793,866,24,1
216597,4880,2365,2515,25,1
216597,8,5,3,31,1
216597,1329,685,644,32,3
216597,74,27,47,39,1
216597,4806,2338,2468,40,1
216597,2820,1388,1432,41,4
216597,495,252,243,42,1
216597,317,161,156,43,1
216597,1,1,0,44,1
216597,316,160,156,45,1
216597,178,91,87,51,1
216597,2325,1136,1189,52,3
216597,41,7,34,59,1
216597,275,153,122,60,1
216630,76,7,69,1,4
216630,76,7,69,2,1
216630,76,7,69,3,1
216630,76,7,69,5,1
216630,76,7,69,20,1
216630,76,7,69,21,4
216630,76,7,69,22,1
216630,76,7,69,23,1
216630,76,7,69,25,1
216630,76,7,69,40,1
216649,25,9,16,1,4
216649,25,9,16,2,1
216649,25,9,16,3,1
216649,25,9,16,5,1
216649,25,9,16,20,1
216649,25,9,16,21,4
216649,25,9,16,22,1
216649,25,9,16,23,1
216649,25,9,16,25,1
216649,25,9,16,40,1
216667,1328,654,674,1,4
216667,1328,654,674,2,1
216667,1300,641,659,3,1
216667,326,168,158,4,1
216667,974,473,501,5,1
216667,28,13,15,11,1
216667,11,6,5,19,1
216667,963,467,496,20,1
216667,1318,649,669,21,4
216667,1318,649,669,22,1
216667,1294,639,655,23,1
216667,326,168,158,24,1
216667,968,471,497,25,1
216667,24,10,14,31,1
216667,11,6,5,39,1
216667,957,465,492,40,1
216667,10,5,5,41,4
216667,10,5,5,42,1
216667,6,2,4,43,1
216667,6,2,4,45,1
216667,4,3,1,51,1
216667,6,2,4,60,1
216694,2190,799,1391,1,4
216694,1598,618,980,2,1
216694,1559,613,946,3,1
216694,407,170,237,4,1
216694,1152,443,709,5,1
216694,39,5,34,11,1
216694,592,181,411,12,3
216694,41,15,26,19,1
216694,1111,428,683,20,1
216694,1563,615,948,21,4
216694,1481,595,886,22,1
216694,1478,594,884,23,1
216694,407,170,237,24,1
216694,1071,424,647,25,1
216694,3,1,2,31,1
216694,82,20,62,32,3
216694,41,15,26,39,1
216694,1030,409,621,40,1
216694,627,184,443,41,4
216694,117,23,94,42,1
216694,81,19,62,43,1
216694,81,19,62,45,1
216694,36,4,32,51,1
216694,510,161,349,52,3
216694,81,19,62,60,1
216746,88,85,3,1,4
216746,88,85,3,2,1
216746,88,85,3,3,1
216746,42,40,2,4,1
216746,46,45,1,5,1
216746,46,45,1,20,1
216746,70,69,1,21,4
216746,70,69,1,22,1
216746,70,69,1,23,1
216746,32,32,0,24,1
216746,38,37,1,25,1
216746,38,37,1,40,1
216746,18,16,2,41,4
216746,18,16,2,42,1
216746,18,16,2,43,1
216746,10,8,2,44,1
216746,8,8,0,45,1
216746,8,8,0,60,1
216764,15845,6209,9636,1,4
216764,13711,5542,8169,2,1
216764,13456,5432,8024,3,1
216764,2298,812,1486,4,1
216764,11158,4620,6538,5,1
216764,255,110,145,11,1
216764,2134,667,1467,12,3
216764,1304,586,718,19,1
216764,9854,4034,5820,20,1
216764,13250,5194,8056,21,4
216764,12463,4963,7500,22,1
216764,12432,4954,7478,23,1
216764,2292,810,1482,24,1
216764,10140,4144,5996,25,1
216764,31,9,22,31,1
216764,787,231,556,32,3
216764,1144,528,616,39,1
216764,8996,3616,5380,40,1
216764,2595,1015,1580,41,4
216764,1248,579,669,42,1
216764,1024,478,546,43,1
216764,6,2,4,44,1
216764,1018,476,542,45,1
216764,224,101,123,51,1
216764,1347,436,911,52,3
216764,160,58,102,59,1
216764,858,418,440,60,1
216773,95,20,75,1,4
216773,95,20,75,2,1
216773,95,20,75,3,1
216773,6,1,5,4,1
216773,89,19,70,5,1
216773,89,19,70,20,1
216773,95,20,75,21,4
216773,95,20,75,22,1
216773,95,20,75,23,1
216773,6,1,5,24,1
216773,89,19,70,25,1
216773,89,19,70,40,1
216782,438,52,386,1,4
216782,438,52,386,2,1
216782,438,52,386,3,1
216782,29,2,27,4,1
216782,409,50,359,5,1
216782,24,1,23,19,1
216782,385,49,336,20,1
216782,243,27,216,21,4
216782,243,27,216,22,1
216782,243,27,216,23,1
216782,26,2,24,24,1
216782,217,25,192,25,1
216782,20,1,19,39,1
216782,197,24,173,40,1
216782,195,25,170,41,4
216782,195,25,170,42,1
216782,195,25,170,43,1
216782,3,0,3,44,1
216782,192,25,167,45,1
216782,4,0,4,59,1
216782,188,25,163,60,1
216807,1366,560,806,1,4
216807,1313,536,777,2,1
216807,1313,536,777,3,1
216807,309,123,186,4,1
216807,1004,413,591,5,1
216807,53,24,29,12,3
216807,1004,413,591,20,1
216807,1264,514,750,21,4
216807,1254,511,743,22,1
216807,1254,511,743,23,1
216807,302,119,183,24,1
216807,952,392,560,25,1
216807,10,3,7,32,3
216807,952,392,560,40,1
216807,102,46,56,41,4
216807,59,25,34,42,1
216807,59,25,34,43,1
216807,7,4,3,44,1
216807,52,21,31,45,1
216807,43,21,22,52,3
216807,52,21,31,60,1
216816,588,454,134,1,4
216816,588,454,134,12,3
216816,274,224,50,21,4
216816,274,224,50,32,3
216816,314,230,84,41,4
216816,314,230,84,52,3
216825,6104,2194,3910,1,4
216825,6104,2194,3910,2,1
216825,5471,1971,3500,3,1
216825,1512,629,883,4,1
216825,3959,1342,2617,5,1
216825,633,223,410,11,1
216825,208,88,120,19,1
216825,3751,1254,2497,20,1
216825,2967,1209,1758,21,4
216825,2967,1209,1758,22,1
216825,2876,1161,1715,23,1
216825,1072,458,614,24,1
216825,1804,703,1101,25,1
216825,91,48,43,31,1
216825,117,53,64,39,1
216825,1687,650,1037,40,1
216825,3137,985,2152,41,4
216825,3137,985,2152,42,1
216825,2595,810,1785,43,1
216825,440,171,269,44,1
216825,2155,639,1516,45,1
216825,542,175,367,51,1
216825,91,35,56,59,1
216825,2064,604,1460,60,1
216852,5025,1948,3077,1,4
216852,3424,1541,1883,2,1
216852,3188,1431,1757,3,1
216852,828,415,413,4,1
216852,2360,1016,1344,5,1
216852,236,110,126,11,1
216852,1601,407,1194,12,3
216852,152,61,91,19,1
216852,2208,955,1253,20,1
216852,3573,1505,2068,21,4
216852,2875,1340,1535,22,1
216852,2845,1321,1524,23,1
216852,827,414,413,24,1
216852,2018,907,1111,25,1
216852,30,19,11,31,1
216852,698,165,533,32,3
216852,138,58,80,39,1
216852,1880,849,1031,40,1
216852,1452,443,1009,41,4
216852,549,201,348,42,1
216852,343,110,233,43,1
216852,1,1,0,44,1
216852,342,109,233,45,1
216852,206,91,115,51,1
216852,903,242,661,52,3
216852,14,3,11,59,1
216852,328,106,222,60,1
216931,4665,1970,2695,1,4
216931,2388,1262,1126,2,1
216931,2281,1206,1075,3,1
216931,586,306,280,4,1
216931,1695,900,795,5,1
216931,107,56,51,11,1
216931,2277,708,1569,12,3
216931,166,90,76,19,1
216931,1529,810,719,20,1
216931,2670,1353,1317,21,4
216931,2181,1157,1024,22,1
216931,2178,1155,1023,23,1
216931,584,305,279,24,1
216931,1594,850,744,25,1
216931,3,2,1,31,1
216931,489,196,293,32,3
216931,158,86,72,39,1
216931,1436,764,672,40,1
216931,1995,617,1378,41,4
216931,207,105,102,42,1
216931,103,51,52,43,1
216931,2,1,1,44,1
216931,101,50,51,45,1
216931,104,54,50,51,1
216931,1788,512,1276,52,3
216931,8,4,4,59,1
216931,93,46,47,60,1
217013,662,80,582,1,4
217013,571,66,505,2,1
217013,468,34,434,3,1
217013,71,2,69,4,1
217013,397,32,365,5,1
217013,103,32,71,11,1
217013,91,14,77,12,3
217013,20,1,19,19,1
217013,377,31,346,20,1
217013,332,20,312,21,4
217013,330,19,311,22,1
217013,317,12,305,23,1
217013,70,2,68,24,1
217013,247,10,237,25,1
217013,13,7,6,31,1
217013,2,1,1,32,3
217013,18,1,17,39,1
217013,229,9,220,40,1
217013,330,60,270,41,4
217013,241,47,194,42,1
217013,151,22,129,43,1
217013,1,0,1,44,1
217013,150,22,128,45,1
217013,90,25,65,51,1
217013,89,13,76,52,3
217013,2,0,2,59,1
217013,148,22,126,60,1
217040,52,52,0,1,4
217040,52,52,0,2,1
217040,52,52,0,3,1
217040,17,17,0,4,1
217040,35,35,0,5,1
217040,1,1,0,19,1
217040,34,34,0,20,1
217040,52,52,0,21,4
217040,52,52,0,22,1
217040,52,52,0,23,1
217040,17,17,0,24,1
217040,35,35,0,25,1
217040,1,1,0,39,1
217040,34,34,0,40,1
217059,5250,2356,2894,1,4
217059,5010,2265,2745,2,1
217059,4847,2191,2656,3,1
217059,1071,496,575,4,1
217059,3776,1695,2081,5,1
217059,163,74,89,11,1
217059,240,91,149,12,3
217059,236,101,135,19,1
217059,3540,1594,1946,20,1
217059,4492,2059,2433,21,4
217059,4453,2052,2401,22,1
217059,4453,2052,2401,23,1
217059,1070,496,574,24,1
217059,3383,1556,1827,25,1
217059,39,7,32,32,3
217059,208,94,114,39,1
217059,3175,1462,1713,40,1
217059,758,297,461,41,4
217059,557,213,344,42,1
217059,394,139,255,43,1
217059,1,0,1,44,1
217059,393,139,254,45,1
217059,163,74,89,51,1
217059,201,84,117,52,3
217059,28,7,21,59,1
217059,365,132,233,60,1
217077,2027,941,1086,1,4
217077,2027,941,1086,2,1
217077,2027,941,1086,3,1
217077,609,288,321,4,1
217077,1418,653,765,5,1
217077,190,69,121,19,1
217077,1228,584,644,20,1
217077,2027,941,1086,21,4
217077,2027,941,1086,22,1
217077,2027,941,1086,23,1
217077,609,288,321,24,1
217077,1418,653,765,25,1
217077,190,69,121,39,1
217077,1228,584,644,40,1
217086,122,30,92,1,4
217086,122,30,92,2,1
217086,122,30,92,3,1
217086,35,9,26,4,1
217086,87,21,66,5,1
217086,87,21,66,20,1
217086,115,30,85,21,4
217086,115,30,85,22,1
217086,115,30,85,23,1
217086,35,9,26,24,1
217086,80,21,59,25,1
217086,80,21,59,40,1
217086,7,0,7,41,4
217086,7,0,7,42,1
217086,7,0,7,43,1
217086,7,0,7,45,1
217086,7,0,7,60,1
217095,135,11,124,1,4
217095,135,11,124,2,1
217095,135,11,124,3,1
217095,40,2,38,4,1
217095,95,9,86,5,1
217095,95,9,86,20,1
217095,100,10,90,21,4
217095,100,10,90,22,1
217095,100,10,90,23,1
217095,35,2,33,24,1
217095,65,8,57,25,1
217095,65,8,57,40,1
217095,35,1,34,41,4
217095,35,1,34,42,1
217095,35,1,34,43,1
217095,5,0,5,44,1
217095,30,1,29,45,1
217095,30,1,29,60,1
217156,8943,4347,4596,1,4
217156,6455,3101,3354,2,1
217156,6182,3002,3180,3,1
217156,1542,754,788,4,1
217156,4640,2248,2392,5,1
217156,273,99,174,11,1
217156,2488,1246,1242,12,3
217156,77,49,28,19,1
217156,4563,2199,2364,20,1
217156,8527,4198,4329,21,4
217156,6168,2998,3170,22,1
217156,6147,2982,3165,23,1
217156,1542,754,788,24,1
217156,4605,2228,2377,25,1
217156,21,16,5,31,1
217156,2359,1200,1159,32,3
217156,77,49,28,39,1
217156,4528,2179,2349,40,1
217156,416,149,267,41,4
217156,287,103,184,42,1
217156,35,20,15,43,1
217156,35,20,15,45,1
217156,252,83,169,51,1
217156,129,46,83,52,3
217156,35,20,15,60,1
217165,3454,2014,1440,1,4
217165,3287,1922,1365,2,1
217165,3263,1910,1353,3,1
217165,890,510,380,4,1
217165,2373,1400,973,5,1
217165,24,12,12,11,1
217165,167,92,75,12,3
217165,91,56,35,19,1
217165,2282,1344,938,20,1
217165,3276,1915,1361,21,4
217165,3200,1876,1324,22,1
217165,3200,1876,1324,23,1
217165,890,510,380,24,1
217165,2310,1366,944,25,1
217165,76,39,37,32,3
217165,83,53,30,39,1
217165,2227,1313,914,40,1
217165,178,99,79,41,4
217165,87,46,41,42,1
217165,63,34,29,43,1
217165,63,34,29,45,1
217165,24,12,12,51,1
217165,91,53,38,52,3
217165,8,3,5,59,1
217165,55,31,24,60,1
217235,10369,4321,6048,1,4
217235,9401,3943,5458,2,1
217235,9067,3763,5304,3,1
217235,1995,743,1252,4,1
217235,7072,3020,4052,5,1
217235,334,180,154,11,1
217235,968,378,590,12,3
217235,543,230,313,19,1
217235,6529,2790,3739,20,1
217235,9594,3999,5595,21,4
217235,8754,3678,5076,22,1
217235,8451,3505,4946,23,1
217235,1957,721,1236,24,1
217235,6494,2784,3710,25,1
217235,303,173,130,31,1
217235,840,321,519,32,3
217235,474,208,266,39,1
217235,6020,2576,3444,40,1
217235,775,322,453,41,4
217235,647,265,382,42,1
217235,616,258,358,43,1
217235,38,22,16,44,1
217235,578,236,342,45,1
217235,31,7,24,51,1
217235,128,57,71,52,3
217235,69,22,47,59,1
217235,509,214,295,60,1
217244,125,7,118,1,4
217244,125,7,118,2,1
217244,125,7,118,3,1
217244,125,7,118,5,1
217244,125,7,118,20,1
217244,125,7,118,21,4
217244,125,7,118,22,1
217244,125,7,118,23,1
217244,125,7,118,25,1
217244,125,7,118,40,1
217305,2933,2010,923,1,4
217305,2860,1982,878,2,1
217305,2860,1982,878,3,1
217305,498,393,105,4,1
217305,2362,1589,773,5,1
217305,73,28,45,12,3
217305,147,84,63,19,1
217305,2215,1505,710,20,1
217305,2436,1701,735,21,4
217305,2396,1695,701,22,1
217305,2396,1695,701,23,1
217305,498,393,105,24,1
217305,1898,1302,596,25,1
217305,40,6,34,32,3
217305,147,84,63,39,1
217305,1751,1218,533,40,1
217305,497,309,188,41,4
217305,464,287,177,42,1
217305,464,287,177,43,1
217305,464,287,177,45,1
217305,33,22,11,52,3
217305,464,287,177,60,1
217323,157,150,7,1,4
217323,157,150,7,2,1
217323,157,150,7,3,1
217323,133,126,7,4,1
217323,24,24,0,5,1
217323,24,24,0,20,1
217323,157,150,7,21,4
217323,157,150,7,22,1
217323,157,150,7,23,1
217323,133,126,7,24,1
217323,24,24,0,25,1
217323,24,24,0,40,1
217350,36,1,35,1,4
217350,36,1,35,2,1
217350,36,1,35,3,1
217350,4,0,4,4,1
217350,32,1,31,5,1
217350,32,1,31,20,1
217350,36,1,35,41,4
217350,36,1,35,42,1
217350,36,1,35,43,1
217350,4,0,4,44,1
217350,32,1,31,45,1
217350,32,1,31,60,1
217402,4665,2026,2639,1,4
217402,4135,1808,2327,2,1
217402,3969,1743,2226,3,1
217402,1027,452,575,4,1
217402,2942,1291,1651,5,1
217402,166,65,101,11,1
217402,530,218,312,12,3
217402,95,51,44,19,1
217402,2847,1240,1607,20,1
217402,3982,1754,2228,21,4
217402,3798,1668,2130,22,1
217402,3791,1663,2128,23,1
217402,1027,452,575,24,1
217402,2764,1211,1553,25,1
217402,7,5,2,31,1
217402,184,86,98,32,3
217402,54,34,20,39,1
217402,2710,1177,1533,40,1
217402,683,272,411,41,4
217402,337,140,197,42,1
217402,178,80,98,43,1
217402,178,80,98,45,1
217402,159,60,99,51,1
217402,346,132,214,52,3
217402,41,17,24,59,1
217402,137,63,74,60,1
217420,8700,2744,5956,1,4
217420,7505,2501,5004,2,1
217420,7253,2389,4864,3,1
217420,1141,334,807,4,1
217420,6112,2055,4057,5,1
217420,252,112,140,11,1
217420,1195,243,952,12,3
217420,646,213,433,19,1
217420,5466,1842,3624,20,1
217420,5802,1904,3898,21,4
217420,5600,1863,3737,22,1
217420,5535,1830,3705,23,1
217420,1128,328,800,24,1
217420,4407,1502,2905,25,1
217420,65,33,32,31,1
217420,202,41,161,32,3
217420,478,169,309,39,1
217420,3929,1333,2596,40,1
217420,2898,840,2058,41,4
217420,1905,638,1267,42,1
217420,1718,559,1159,43,1
217420,13,6,7,44,1
217420,1705,553,1152,45,1
217420,187,79,108,51,1
217420,993,202,791,52,3
217420,168,44,124,59,1
217420,1537,509,1028,60,1
217475,17699,7223,10476,1,4
217475,17699,7223,10476,2,1
217475,16856,6866,9990,3,1
217475,3376,1667,1709,4,1
217475,13480,5199,8281,5,1
217475,843,357,486,11,1
217475,4451,1544,2907,19,1
217475,9029,3655,5374,20,1
217475,5459,2683,2776,21,4
217475,5459,2683,2776,22,1
217475,5368,2656,2712,23,1
217475,1657,887,770,24,1
217475,3711,1769,1942,25,1
217475,91,27,64,31,1
217475,1148,527,621,39,1
217475,2563,1242,1321,40,1
217475,12240,4540,7700,41,4
217475,12240,4540,7700,42,1
217475,11488,4210,7278,43,1
217475,1719,780,939,44,1
217475,9769,3430,6339,45,1
217475,752,330,422,51,1
217475,3303,1017,2286,59,1
217475,6466,2413,4053,60,1
217484,16387,7455,8932,1,4
217484,13354,6170,7184,2,1
217484,13008,6008,7000,3,1
217484,2991,1320,1671,4,1
217484,10017,4688,5329,5,1
217484,346,162,184,11,1
217484,3033,1285,1748,12,3
217484,604,319,285,19,1
217484,9413,4369,5044,20,1
217484,13662,6229,7433,21,4
217484,11829,5478,6351,22,1
217484,11728,5431,6297,23,1
217484,2970,1309,1661,24,1
217484,8758,4122,4636,25,1
217484,101,47,54,31,1
217484,1833,751,1082,32,3
217484,521,281,240,39,1
217484,8237,3841,4396,40,1
217484,2725,1226,1499,41,4
217484,1525,692,833,42,1
217484,1280,577,703,43,1
217484,21,11,10,44,1
217484,1259,566,693,45,1
217484,245,115,130,51,1
217484,1200,534,666,52,3
217484,83,38,45,59,1
217484,1176,528,648,60,1
217493,2420,837,1583,1,4
217493,2005,687,1318,2,1
217493,2005,687,1318,3,1
217493,455,144,311,4,1
217493,1550,543,1007,5,1
217493,415,150,265,12,3
217493,64,26,38,19,1
217493,1486,517,969,20,1
217493,2420,837,1583,21,4
217493,2005,687,1318,22,1
217493,2005,687,1318,23,1
217493,455,144,311,24,1
217493,1550,543,1007,25,1
217493,415,150,265,32,3
217493,64,26,38,39,1
217493,1486,517,969,40,1
217518,4732,2369,2363,1,4
217518,4411,2225,2186,2,1
217518,4403,2222,2181,3,1
217518,1116,496,620,4,1
217518,3287,1726,1561,5,1
217518,8,3,5,11,1
217518,321,144,177,12,3
217518,182,91,91,19,1
217518,3105,1635,1470,20,1
217518,4041,2005,2036,21,4
217518,3875,1937,1938,22,1
217518,3870,1935,1935,23,1
217518,1102,494,608,24,1
217518,2768,1441,1327,25,1
217518,5,2,3,31,1
217518,166,68,98,32,3
217518,118,64,54,39,1
217518,2650,1377,1273,40,1
217518,691,364,327,41,4
217518,536,288,248,42,1
217518,533,287,246,43,1
217518,14,2,12,44,1
217518,519,285,234,45,1
217518,3,1,2,51,1
217518,155,76,79,52,3
217518,64,27,37,59,1
217518,455,258,197,60,1
217536,2603,824,1779,1,4
217536,2026,600,1426,2,1
217536,1989,583,1406,3,1
217536,463,132,331,4,1
217536,1526,451,1075,5,1
217536,37,17,20,11,1
217536,577,224,353,12,3
217536,41,18,23,19,1
217536,1485,433,1052,20,1
217536,1981,601,1380,21,4
217536,1876,562,1314,22,1
217536,1876,562,1314,23,1
217536,463,132,331,24,1
217536,1413,430,983,25,1
217536,105,39,66,32,3
217536,41,18,23,39,1
217536,1372,412,960,40,1
217536,622,223,399,41,4
217536,150,38,112,42,1
217536,113,21,92,43,1
217536,113,21,92,45,1
217536,37,17,20,51,1
217536,472,185,287,52,3
217536,113,21,92,60,1
217572,122,20,102,1,4
217572,122,20,102,2,1
217572,122,20,102,3,1
217572,1,1,0,4,1
217572,121,19,102,5,1
217572,121,19,102,20,1
217572,122,20,102,21,4
217572,122,20,102,22,1
217572,122,20,102,23,1
217572,1,1,0,24,1
217572,121,19,102,25,1
217572,121,19,102,40,1
217581,88,1,87,1,4
217581,88,1,87,2,1
217581,88,1,87,3,1
217581,28,1,27,4,1
217581,60,0,60,5,1
217581,60,0,60,20,1
217581,62,1,61,21,4
217581,62,1,61,22,1
217581,62,1,61,23,1
217581,21,1,20,24,1
217581,41,0,41,25,1
217581,41,0,41,40,1
217581,26,0,26,41,4
217581,26,0,26,42,1
217581,26,0,26,43,1
217581,7,0,7,44,1
217581,19,0,19,45,1
217581,19,0,19,60,1
217606,409,229,180,1,4
217606,396,223,173,2,1
217606,358,212,146,3,1
217606,45,25,20,4,1
217606,313,187,126,5,1
217606,38,11,27,11,1
217606,13,6,7,12,3
217606,63,39,24,19,1
217606,250,148,102,20,1
217606,320,191,129,21,4
217606,315,187,128,22,1
217606,315,187,128,23,1
217606,42,24,18,24,1
217606,273,163,110,25,1
217606,5,4,1,32,3
217606,59,38,21,39,1
217606,214,125,89,40,1
217606,89,38,51,41,4
217606,81,36,45,42,1
217606,43,25,18,43,1
217606,3,1,2,44,1
217606,40,24,16,45,1
217606,38,11,27,51,1
217606,8,2,6,52,3
217606,4,1,3,59,1
217606,36,23,13,60,1
217615,2583,931,1652,1,4
217615,2583,931,1652,2,1
217615,2490,894,1596,3,1
217615,514,226,288,4,1
217615,1976,668,1308,5,1
217615,93,37,56,11,1
217615,252,88,164,19,1
217615,1724,580,1144,20,1
217615,955,398,557,21,4
217615,955,398,557,22,1
217615,953,396,557,23,1
217615,254,118,136,24,1
217615,699,278,421,25,1
217615,2,2,0,31,1
217615,93,43,50,39,1
217615,606,235,371,40,1
217615,1628,533,1095,41,4
217615,1628,533,1095,42,1
217615,1537,498,1039,43,1
217615,260,108,152,44,1
217615,1277,390,887,45,1
217615,91,35,56,51,1
217615,159,45,114,59,1
217615,1118,345,773,60,1
217624,651,250,401,1,4
217624,651,250,401,2,1
217624,651,250,401,3,1
217624,180,68,112,4,1
217624,471,182,289,5,1
217624,53,20,33,19,1
217624,418,162,256,20,1
217624,635,243,392,21,4
217624,635,243,392,22,1
217624,635,243,392,23,1
217624,179,68,111,24,1
217624,456,175,281,25,1
217624,53,20,33,39,1
217624,403,155,248,40,1
217624,16,7,9,41,4
217624,16,7,9,42,1
217624,16,7,9,43,1
217624,1,0,1,44,1
217624,15,7,8,45,1
217624,15,7,8,60,1
217633,2966,1035,1931,1,4
217633,2652,882,1770,2,1
217633,2381,819,1562,3,1
217633,505,174,331,4,1
217633,1876,645,1231,5,1
217633,271,63,208,11,1
217633,314,153,161,12,3
217633,162,62,100,19,1
217633,1714,583,1131,20,1
217633,2156,737,1419,21,4
217633,2131,732,1399,22,1
217633,2131,732,1399,23,1
217633,502,172,330,24,1
217633,1629,560,1069,25,1
217633,25,5,20,32,3
217633,126,49,77,39,1
217633,1503,511,992,40,1
217633,810,298,512,41,4
217633,521,150,371,42,1
217633,250,87,163,43,1
217633,3,2,1,44,1
217633,247,85,162,45,1
217633,271,63,208,51,1
217633,289,148,141,52,3
217633,36,13,23,59,1
217633,211,72,139,60,1
217688,3269,1166,2103,1,4
217688,2912,1034,1878,2,1
217688,2904,1032,1872,3,1
217688,656,230,426,4,1
217688,2248,802,1446,5,1
217688,8,2,6,11,1
217688,357,132,225,12,3
217688,347,125,222,19,1
217688,1901,677,1224,20,1
217688,2661,947,1714,21,4
217688,2601,934,1667,22,1
217688,2601,934,1667,23,1
217688,656,230,426,24,1
217688,1945,704,1241,25,1
217688,60,13,47,32,3
217688,291,110,181,39,1
217688,1654,594,1060,40,1
217688,608,219,389,41,4
217688,311,100,211,42,1
217688,303,98,205,43,1
217688,303,98,205,45,1
217688,8,2,6,51,1
217688,297,119,178,52,3
217688,56,15,41,59,1
217688,247,83,164,60,1
217712,2427,693,1734,1,4
217712,2427,693,1734,2,1
217712,2262,631,1631,3,1
217712,435,172,263,4,1
217712,1827,459,1368,5,1
217712,165,62,103,11,1
217712,315,80,235,19,1
217712,1512,379,1133,20,1
217712,732,263,469,21,4
217712,732,263,469,22,1
217712,708,253,455,23,1
217712,174,85,89,24,1
217712,534,168,366,25,1
217712,24,10,14,31,1
217712,104,28,76,39,1
217712,430,140,290,40,1
217712,1695,430,1265,41,4
217712,1695,430,1265,42,1
217712,1554,378,1176,43,1
217712,261,87,174,44,1
217712,1293,291,1002,45,1
217712,141,52,89,51,1
217712,211,52,159,59,1
217712,1082,239,843,60,1
217721,2512,1256,1256,1,4
217721,2512,1256,1256,2,1
217721,2512,1256,1256,3,1
217721,555,307,248,4,1
217721,1957,949,1008,5,1
217721,109,75,34,19,1
217721,1848,874,974,20,1
217721,2470,1238,1232,21,4
217721,2470,1238,1232,22,1
217721,2470,1238,1232,23,1
217721,554,307,247,24,1
217721,1916,931,985,25,1
217721,106,73,33,39,1
217721,1810,858,952,40,1
217721,42,18,24,41,4
217721,42,18,24,42,1
217721,42,18,24,43,1
217721,1,0,1,44,1
217721,41,18,23,45,1
217721,3,2,1,59,1
217721,38,16,22,60,1
217749,3364,1483,1881,1,4
217749,2913,1232,1681,2,1
217749,2755,1175,1580,3,1
217749,678,293,385,4,1
217749,2077,882,1195,5,1
217749,158,57,101,11,1
217749,451,251,200,12,3
217749,86,38,48,19,1
217749,1991,844,1147,20,1
217749,2830,1213,1617,21,4
217749,2691,1149,1542,22,1
217749,2691,1149,1542,23,1
217749,667,289,378,24,1
217749,2024,860,1164,25,1
217749,139,64,75,32,3
217749,86,38,48,39,1
217749,1938,822,1116,40,1
217749,534,270,264,41,4
217749,222,83,139,42,1
217749,64,26,38,43,1
217749,11,4,7,44,1
217749,53,22,31,45,1
217749,158,57,101,51,1
217749,312,187,125,52,3
217749,53,22,31,60,1
217776,1701,623,1078,1,4
217776,1333,521,812,2,1
217776,1314,512,802,3,1
217776,162,74,88,4,1
217776,1152,438,714,5,1
217776,19,9,10,11,1
217776,368,102,266,12,3
217776,134,70,64,19,1
217776,1018,368,650,20,1
217776,1672,611,1061,21,4
217776,1304,509,795,22,1
217776,1304,509,795,23,1
217776,162,74,88,24,1
217776,1142,435,707,25,1
217776,368,102,266,32,3
217776,133,69,64,39,1
217776,1009,366,643,40,1
217776,29,12,17,41,4
217776,29,12,17,42,1
217776,10,3,7,43,1
217776,10,3,7,45,1
217776,19,9,10,51,1
217776,1,1,0,59,1
217776,9,2,7,60,1
217794,106,8,98,1,4
217794,106,8,98,2,1
217794,106,8,98,3,1
217794,20,2,18,4,1
217794,86,6,80,5,1
217794,86,6,80,20,1
217794,87,7,80,21,4
217794,87,7,80,22,1
217794,87,7,80,23,1
217794,16,2,14,24,1
217794,71,5,66,25,1
217794,71,5,66,40,1
217794,19,1,18,41,4
217794,19,1,18,42,1
217794,19,1,18,43,1
217794,4,0,4,44,1
217794,15,1,14,45,1
217794,15,1,14,60,1
217819,11619,4224,7395,1,4
217819,10488,3957,6531,2,1
217819,10150,3795,6355,3,1
217819,2116,690,1426,4,1
217819,8034,3105,4929,5,1
217819,338,162,176,11,1
217819,1131,267,864,12,3
217819,747,333,414,19,1
217819,7287,2772,4515,20,1
217819,10022,3690,6332,21,4
217819,9708,3573,6135,22,1
217819,9621,3526,6095,23,1
217819,2110,687,1423,24,1
217819,7511,2839,4672,25,1
217819,87,47,40,31,1
217819,314,117,197,32,3
217819,688,298,390,39,1
217819,6823,2541,4282,40,1
217819,1597,534,1063,41,4
217819,780,384,396,42,1
217819,529,269,260,43,1
217819,6,3,3,44,1
217819,523,266,257,45,1
217819,251,115,136,51,1
217819,817,150,667,52,3
217819,59,35,24,59,1
217819,464,231,233,60,1
217828,59,2,57,1,4
217828,59,2,57,2,1
217828,59,2,57,3,1
217828,46,2,44,4,1
217828,13,0,13,5,1
217828,13,0,13,20,1
217828,42,2,40,21,4
217828,42,2,40,22,1
217828,42,2,40,23,1
217828,36,2,34,24,1
217828,6,0,6,25,1
217828,6,0,6,40,1
217828,17,0,17,41,4
217828,17,0,17,42,1
217828,17,0,17,43,1
217828,10,0,10,44,1
217828,7,0,7,45,1
217828,7,0,7,60,1
217837,1153,413,740,1,4
217837,1153,413,740,2,1
217837,1022,351,671,3,1
217837,272,127,145,4,1
217837,750,224,526,5,1
217837,131,62,69,11,1
217837,79,26,53,19,1
217837,671,198,473,20,1
217837,612,262,350,21,4
217837,612,262,350,22,1
217837,604,258,346,23,1
217837,211,97,114,24,1
217837,393,161,232,25,1
217837,8,4,4,31,1
217837,49,23,26,39,1
217837,344,138,206,40,1
217837,541,151,390,41,4
217837,541,151,390,42,1
217837,418,93,325,43,1
217837,61,30,31,44,1
217837,357,63,294,45,1
217837,123,58,65,51,1
217837,30,3,27,59,1
217837,327,60,267,60,1
217864,3598,2852,746,1,4
217864,2735,2482,253,2,1
217864,2660,2454,206,3,1
217864,645,610,35,4,1
217864,2015,1844,171,5,1
217864,75,28,47,11,1
217864,863,370,493,12,3
217864,117,93,24,19,1
217864,1898,1751,147,20,1
217864,2668,2409,259,21,4
217864,2517,2353,164,22,1
217864,2517,2353,164,23,1
217864,645,610,35,24,1
217864,1872,1743,129,25,1
217864,151,56,95,32,3
217864,84,74,10,39,1
217864,1788,1669,119,40,1
217864,930,443,487,41,4
217864,218,129,89,42,1
217864,143,101,42,43,1
217864,143,101,42,45,1
217864,75,28,47,51,1
217864,712,314,398,52,3
217864,33,19,14,59,1
217864,110,82,28,60,1
217873,1884,690,1194,1,4
217873,1834,670,1164,2,1
217873,1803,659,1144,3,1
217873,385,137,248,4,1
217873,1418,522,896,5,1
217873,31,11,20,11,1
217873,50,20,30,12,3
217873,99,48,51,19,1
217873,1319,474,845,20,1
217873,1807,662,1145,21,4
217873,1767,645,1122,22,1
217873,1765,644,1121,23,1
217873,385,137,248,24,1
217873,1380,507,873,25,1
217873,2,1,1,31,1
217873,40,17,23,32,3
217873,98,47,51,39,1
217873,1282,460,822,40,1
217873,77,28,49,41,4
217873,67,25,42,42,1
217873,38,15,23,43,1
217873,38,15,23,45,1
217873,29,10,19,51,1
217873,10,3,7,52,3
217873,1,1,0,59,1
217873,37,14,23,60,1
217882,21303,11574,9729,1,4
217882,16931,9156,7775,2,1
217882,16801,9084,7717,3,1
217882,3289,1691,1598,4,1
217882,13512,7393,6119,5,1
217882,130,72,58,11,1
217882,4372,2418,1954,12,3
217882,1144,679,465,19,1
217882,12368,6714,5654,20,1
217882,18963,10340,8623,21,4
217882,16050,8590,7460,22,1
217882,15993,8557,7436,23,1
217882,3286,1689,1597,24,1
217882,12707,6868,5839,25,1
217882,57,33,24,31,1
217882,2913,1750,1163,32,3
217882,1106,663,443,39,1
217882,11601,6205,5396,40,1
217882,2340,1234,1106,41,4
217882,881,566,315,42,1
217882,808,527,281,43,1
217882,3,2,1,44,1
217882,805,525,280,45,1
217882,73,39,34,51,1
217882,1459,668,791,52,3
217882,38,16,22,59,1
217882,767,509,258,60,1
217891,185,116,69,1,4
217891,185,116,69,2,1
217891,185,116,69,3,1
217891,78,42,36,4,1
217891,107,74,33,5,1
217891,12,8,4,19,1
217891,95,66,29,20,1
217891,182,113,69,21,4
217891,182,113,69,22,1
217891,182,113,69,23,1
217891,78,42,36,24,1
217891,104,71,33,25,1
217891,12,8,4,39,1
217891,92,63,29,40,1
217891,3,3,0,41,4
217891,3,3,0,42,1
217891,3,3,0,43,1
217891,3,3,0,45,1
217891,3,3,0,60,1
217907,1172,443,729,1,4
217907,1144,426,718,2,1
217907,1131,424,707,3,1
217907,251,123,128,4,1
217907,880,301,579,5,1
217907,13,2,11,11,1
217907,28,17,11,12,3
217907,121,52,69,19,1
217907,759,249,510,20,1
217907,1010,391,619,21,4
217907,1007,390,617,22,1
217907,1007,390,617,23,1
217907,245,120,125,24,1
217907,762,270,492,25,1
217907,3,1,2,32,3
217907,112,50,62,39,1
217907,650,220,430,40,1
217907,162,52,110,41,4
217907,137,36,101,42,1
217907,124,34,90,43,1
217907,6,3,3,44,1
217907,118,31,87,45,1
217907,13,2,11,51,1
217907,25,16,9,52,3
217907,9,2,7,59,1
217907,109,29,80,60,1
217925,1154,633,521,1,4
217925,584,314,270,2,1
217925,574,311,263,3,1
217925,103,58,45,4,1
217925,471,253,218,5,1
217925,10,3,7,11,1
217925,570,319,251,12,3
217925,61,36,25,19,1
217925,410,217,193,20,1
217925,754,381,373,21,4
217925,511,261,250,22,1
217925,511,261,250,23,1
217925,102,58,44,24,1
217925,409,203,206,25,1
217925,243,120,123,32,3
217925,57,32,25,39,1
217925,352,171,181,40,1
217925,400,252,148,41,4
217925,73,53,20,42,1
217925,63,50,13,43,1
217925,1,0,1,44,1
217925,62,50,12,45,1
217925,10,3,7,51,1
217925,327,199,128,52,3
217925,4,4,0,59,1
217925,58,46,12,60,1
217934,1169,66,1103,1,4
217934,1010,46,964,2,1
217934,995,44,951,3,1
217934,128,0,128,4,1
217934,867,44,823,5,1
217934,15,2,13,11,1
217934,159,20,139,12,3
217934,143,15,128,19,1
217934,724,29,695,20,1
217934,867,33,834,21,4
217934,723,15,708,22,1
217934,721,15,706,23,1
217934,127,0,127,24,1
217934,594,15,579,25,1
217934,2,0,2,31,1
217934,144,18,126,32,3
217934,55,2,53,39,1
217934,539,13,526,40,1
217934,302,33,269,41,4
217934,287,31,256,42,1
217934,274,29,245,43,1
217934,1,0,1,44,1
217934,273,29,244,45,1
217934,13,2,11,51,1
217934,15,2,13,52,3
217934,88,13,75,59,1
217934,185,16,169,60,1
217961,1333,139,1194,1,4
217961,746,0,746,2,1
217961,744,0,744,3,1
217961,232,0,232,4,1
217961,512,0,512,5,1
217961,2,0,2,11,1
217961,587,139,448,12,3
217961,39,0,39,19,1
217961,473,0,473,20,1
217961,775,15,760,21,4
217961,671,0,671,22,1
217961,669,0,669,23,1
217961,231,0,231,24,1
217961,438,0,438,25,1
217961,2,0,2,31,1
217961,104,15,89,32,3
217961,30,0,30,39,1
217961,408,0,408,40,1
217961,558,124,434,41,4
217961,75,0,75,42,1
217961,75,0,75,43,1
217961,1,0,1,44,1
217961,74,0,74,45,1
217961,483,124,359,52,3
217961,9,0,9,59,1
217961,65,0,65,60,1
217989,1838,739,1099,1,4
217989,1838,739,1099,2,1
217989,1804,720,1084,3,1
217989,449,213,236,4,1
217989,1355,507,848,5,1
217989,34,19,15,11,1
217989,28,7,21,19,1
217989,1327,500,827,20,1
217989,1415,575,840,21,4
217989,1415,575,840,22,1
217989,1406,572,834,23,1
217989,350,168,182,24,1
217989,1056,404,652,25,1
217989,9,3,6,31,1
217989,21,6,15,39,1
217989,1035,398,637,40,1
217989,423,164,259,41,4
217989,423,164,259,42,1
217989,398,148,250,43,1
217989,99,45,54,44,1
217989,299,103,196,45,1
217989,25,16,9,51,1
217989,7,1,6,59,1
217989,292,102,190,60,1
217998,815,475,340,1,4
217998,605,314,291,2,1
217998,574,295,279,3,1
217998,212,106,106,4,1
217998,362,189,173,5,1
217998,31,19,12,11,1
217998,210,161,49,12,3
217998,8,4,4,19,1
217998,354,185,169,20,1
217998,744,432,312,21,4
217998,565,290,275,22,1
217998,565,290,275,23,1
217998,207,104,103,24,1
217998,358,186,172,25,1
217998,179,142,37,32,3
217998,8,4,4,39,1
217998,350,182,168,40,1
217998,71,43,28,41,4
217998,40,24,16,42,1
217998,9,5,4,43,1
217998,5,2,3,44,1
217998,4,3,1,45,1
217998,31,19,12,51,1
217998,31,19,12,52,3
217998,4,3,1,60,1
218025,5991,2069,3922,1,4
218025,5991,2069,3922,2,1
218025,5913,2039,3874,3,1
218025,1447,655,792,4,1
218025,4466,1384,3082,5,1
218025,78,30,48,11,1
218025,500,155,345,19,1
218025,3966,1229,2737,20,1
218025,2848,1158,1690,21,4
218025,2848,1158,1690,22,1
218025,2842,1154,1688,23,1
218025,827,383,444,24,1
218025,2015,771,1244,25,1
218025,6,4,2,31,1
218025,265,106,159,39,1
218025,1750,665,1085,40,1
218025,3143,911,2232,41,4
218025,3143,911,2232,42,1
218025,3071,885,2186,43,1
218025,620,272,348,44,1
218025,2451,613,1838,45,1
218025,72,26,46,51,1
218025,235,49,186,59,1
218025,2216,564,1652,60,1
218043,135,11,124,1,4
218043,135,11,124,2,1
218043,135,11,124,3,1
218043,36,3,33,4,1
218043,99,8,91,5,1
218043,25,2,23,19,1
218043,74,6,68,20,1
218043,97,7,90,21,4
218043,97,7,90,22,1
218043,97,7,90,23,1
218043,28,1,27,24,1
218043,69,6,63,25,1
218043,17,2,15,39,1
218043,52,4,48,40,1
218043,38,4,34,41,4
218043,38,4,34,42,1
218043,38,4,34,43,1
218043,8,2,6,44,1
218043,30,2,28,45,1
218043,8,0,8,59,1
218043,22,2,20,60,1
218061,4058,1228,2830,1,4
218061,3714,1164,2550,2,1
218061,3380,1084,2296,3,1
218061,744,231,513,4,1
218061,2636,853,1783,5,1
218061,334,80,254,11,1
218061,344,64,280,12,3
218061,240,80,160,19,1
218061,2396,773,1623,20,1
218061,3388,1054,2334,21,4
218061,3316,1044,2272,22,1
218061,3241,1026,2215,23,1
218061,743,230,513,24,1
218061,2498,796,1702,25,1
218061,75,18,57,31,1
218061,72,10,62,32,3
218061,222,75,147,39,1
218061,2276,721,1555,40,1
218061,670,174,496,41,4
218061,398,120,278,42,1
218061,139,58,81,43,1
218061,1,1,0,44,1
218061,138,57,81,45,1
218061,259,62,197,51,1
218061,272,54,218,52,3
218061,18,5,13,59,1
218061,120,52,68,60,1
218070,2953,1226,1727,1,4
218070,2797,1189,1608,2,1
218070,2777,1178,1599,3,1
218070,756,334,422,4,1
218070,2021,844,1177,5,1
218070,20,11,9,11,1
218070,156,37,119,12,3
218070,46,23,23,19,1
218070,1975,821,1154,20,1
218070,2722,1154,1568,21,4
218070,2677,1141,1536,22,1
218070,2671,1139,1532,23,1
218070,755,333,422,24,1
218070,1916,806,1110,25,1
218070,6,2,4,31,1
218070,45,13,32,32,3
218070,28,15,13,39,1
218070,1888,791,1097,40,1
218070,231,72,159,41,4
218070,120,48,72,42,1
218070,106,39,67,43,1
218070,1,1,0,44,1
218070,105,38,67,45,1
218070,14,9,5,51,1
218070,111,24,87,52,3
218070,18,8,10,59,1
218070,87,30,57,60,1
218089,156,70,86,1,4
218089,124,57,67,2,1
218089,122,56,66,3,1
218089,11,6,5,4,1
218089,111,50,61,5,1
218089,2,1,1,11,1
218089,32,13,19,12,3
218089,26,10,16,19,1
218089,85,40,45,20,1
218089,128,54,74,21,4
218089,101,44,57,22,1
218089,99,43,56,23,1
218089,5,2,3,24,1
218089,94,41,53,25,1
218089,2,1,1,31,1
218089,27,10,17,32,3
218089,25,9,16,39,1
218089,69,32,37,40,1
218089,28,16,12,41,4
218089,23,13,10,42,1
218089,23,13,10,43,1
218089,6,4,2,44,1
218089,17,9,8,45,1
218089,5,3,2,52,3
218089,1,1,0,59,1
218089,16,8,8,60,1
218113,13448,5588,7860,1,4
218113,13448,5588,7860,2,1
218113,12087,4948,7139,3,1
218113,2275,1100,1175,4,1
218113,9812,3848,5964,5,1
218113,1361,640,721,11,1
218113,557,231,326,19,1
218113,9255,3617,5638,20,1
218113,5452,2530,2922,21,4
218113,5452,2530,2922,22,1
218113,5403,2512,2891,23,1
218113,1570,775,795,24,1
218113,3833,1737,2096,25,1
218113,49,18,31,31,1
218113,315,146,169,39,1
218113,3518,1591,1927,40,1
218113,7996,3058,4938,41,4
218113,7996,3058,4938,42,1
218113,6684,2436,4248,43,1
218113,705,325,380,44,1
218113,5979,2111,3868,45,1
218113,1312,622,690,51,1
218113,242,85,157,59,1
218113,5737,2026,3711,60,1
218140,7660,2723,4937,1,4
218140,7660,2723,4937,2,1
218140,7002,2438,4564,3,1
218140,1105,544,561,4,1
218140,5897,1894,4003,5,1
218140,658,285,373,11,1
218140,548,201,347,19,1
218140,5349,1693,3656,20,1
218140,2911,1259,1652,21,4
218140,2911,1259,1652,22,1
218140,2894,1253,1641,23,1
218140,617,333,284,24,1
218140,2277,920,1357,25,1
218140,17,6,11,31,1
218140,273,119,154,39,1
218140,2004,801,1203,40,1
218140,4749,1464,3285,41,4
218140,4749,1464,3285,42,1
218140,4108,1185,2923,43,1
218140,488,211,277,44,1
218140,3620,974,2646,45,1
218140,641,279,362,51,1
218140,275,82,193,59,1
218140,3345,892,2453,60,1
218159,85,8,77,1,4
218159,85,8,77,2,1
218159,85,8,77,3,1
218159,8,1,7,4,1
218159,77,7,70,5,1
218159,77,7,70,20,1
218159,59,7,52,21,4
218159,59,7,52,22,1
218159,59,7,52,23,1
218159,6,1,5,24,1
218159,53,6,47,25,1
218159,53,6,47,40,1
218159,26,1,25,41,4
218159,26,1,25,42,1
218159,26,1,25,43,1
218159,2,0,2,44,1
218159,24,1,23,45,1
218159,24,1,23,60,1
218195,83,2,81,1,4
218195,83,2,81,2,1
218195,83,2,81,3,1
218195,8,0,8,4,1
218195,75,2,73,5,1
218195,75,2,73,20,1
218195,47,2,45,21,4
218195,47,2,45,22,1
218195,47,2,45,23,1
218195,5,0,5,24,1
218195,42,2,40,25,1
218195,42,2,40,40,1
218195,36,0,36,41,4
218195,36,0,36,42,1
218195,36,0,36,43,1
218195,3,0,3,44,1
218195,33,0,33,45,1
218195,33,0,33,60,1
218229,2877,871,2006,1,4
218229,2792,859,1933,2,1
218229,2750,850,1900,3,1
218229,517,157,360,4,1
218229,2233,693,1540,5,1
218229,42,9,33,11,1
218229,85,12,73,12,3
218229,194,88,106,19,1
218229,2039,605,1434,20,1
218229,2592,797,1795,21,4
218229,2586,797,1789,22,1
218229,2584,797,1787,23,1
218229,516,156,360,24,1
218229,2068,641,1427,25,1
218229,2,0,2,31,1
218229,6,0,6,32,3
218229,175,83,92,39,1
218229,1893,558,1335,40,1
218229,285,74,211,41,4
218229,206,62,144,42,1
218229,166,53,113,43,1
218229,1,1,0,44,1
218229,165,52,113,45,1
218229,40,9,31,51,1
218229,79,12,67,52,3
218229,19,5,14,59,1
218229,146,47,99,60,1
218238,3307,1426,1881,1,4
218238,3241,1398,1843,2,1
218238,3150,1358,1792,3,1
218238,470,324,146,4,1
218238,2680,1034,1646,5,1
218238,91,40,51,11,1
218238,66,28,38,12,3
218238,406,154,252,19,1
218238,2274,880,1394,20,1
218238,2390,1091,1299,21,4
218238,2386,1088,1298,22,1
218238,2383,1086,1297,23,1
218238,448,316,132,24,1
218238,1935,770,1165,25,1
218238,3,2,1,31,1
218238,4,3,1,32,3
218238,302,123,179,39,1
218238,1633,647,986,40,1
218238,917,335,582,41,4
218238,855,310,545,42,1
218238,767,272,495,43,1
218238,22,8,14,44,1
218238,745,264,481,45,1
218238,88,38,50,51,1
218238,62,25,37,52,3
218238,104,31,73,59,1
218238,641,233,408,60,1
218265,107,62,45,1,4
218265,107,62,45,12,3
218265,70,40,30,21,4
218265,70,40,30,32,3
218265,37,22,15,41,4
218265,37,22,15,52,3
218335,2775,1037,1738,1,4
218335,205,49,156,2,1
218335,205,49,156,3,1
218335,205,49,156,5,1
218335,2570,988,1582,12,3
218335,72,17,55,19,1
218335,133,32,101,20,1
218335,2593,1000,1593,21,4
218335,203,47,156,22,1
218335,203,47,156,23,1
218335,203,47,156,25,1
218335,2390,953,1437,32,3
218335,72,17,55,39,1
218335,131,30,101,40,1
218335,182,37,145,41,4
218335,2,2,0,42,1
218335,2,2,0,43,1
218335,2,2,0,45,1
218335,180,35,145,52,3
218335,2,2,0,60,1
218353,11634,4720,6914,1,4
218353,11634,4720,6914,2,1
218353,11214,4542,6672,3,1
218353,2361,1150,1211,4,1
218353,8853,3392,5461,5,1
218353,420,178,242,11,1
218353,1224,505,719,19,1
218353,7629,2887,4742,20,1
218353,5248,2525,2723,21,4
218353,5248,2525,2723,22,1
218353,5219,2502,2717,23,1
218353,1568,786,782,24,1
218353,3651,1716,1935,25,1
218353,29,23,6,31,1
218353,688,316,372,39,1
218353,2963,1400,1563,40,1
218353,6386,2195,4191,41,4
218353,6386,2195,4191,42,1
218353,5995,2040,3955,43,1
218353,793,364,429,44,1
218353,5202,1676,3526,45,1
218353,391,155,236,51,1
218353,536,189,347,59,1
218353,4666,1487,3179,60,1
218399,824,367,457,1,4
218399,824,367,457,2,1
218399,822,366,456,3,1
218399,250,102,148,4,1
218399,572,264,308,5,1
218399,2,1,1,11,1
218399,48,26,22,19,1
218399,524,238,286,20,1
218399,817,363,454,21,4
218399,817,363,454,22,1
218399,817,363,454,23,1
218399,250,102,148,24,1
218399,567,261,306,25,1
218399,48,26,22,39,1
218399,519,235,284,40,1
218399,7,4,3,41,4
218399,7,4,3,42,1
218399,5,3,2,43,1
218399,5,3,2,45,1
218399,2,1,1,51,1
218399,5,3,2,60,1
218414,1039,558,481,1,4
218414,1039,558,481,2,1
218414,1032,555,477,3,1
218414,237,127,110,4,1
218414,795,428,367,5,1
218414,7,3,4,11,1
218414,73,27,46,19,1
218414,722,401,321,20,1
218414,1007,544,463,21,4
218414,1007,544,463,22,1
218414,1007,544,463,23,1
218414,237,127,110,24,1
218414,770,417,353,25,1
218414,72,26,46,39,1
218414,698,391,307,40,1
218414,32,14,18,41,4
218414,32,14,18,42,1
218414,25,11,14,43,1
218414,25,11,14,45,1
218414,7,3,4,51,1
218414,1,1,0,59,1
218414,24,10,14,60,1
218441,2466,1262,1204,1,4
218441,2257,1132,1125,2,1
218441,2068,1074,994,3,1
218441,504,258,246,4,1
218441,1564,816,748,5,1
218441,189,58,131,11,1
218441,209,130,79,12,3
218441,125,71,54,19,1
218441,1439,745,694,20,1
218441,2102,1103,999,21,4
218441,1993,1032,961,22,1
218441,1993,1032,961,23,1
218441,503,257,246,24,1
218441,1490,775,715,25,1
218441,109,71,38,32,3
218441,117,66,51,39,1
218441,1373,709,664,40,1
218441,364,159,205,41,4
218441,264,100,164,42,1
218441,75,42,33,43,1
218441,1,1,0,44,1
218441,74,41,33,45,1
218441,189,58,131,51,1
218441,100,59,41,52,3
218441,8,5,3,59,1
218441,66,36,30,60,1
218487,2718,988,1730,1,4
218487,2718,988,1730,2,1
218487,2399,837,1562,3,1
218487,609,321,288,4,1
218487,1790,516,1274,5,1
218487,319,151,168,11,1
218487,268,63,205,19,1
218487,1522,453,1069,20,1
218487,1244,533,711,21,4
218487,1244,533,711,22,1
218487,1236,528,708,23,1
218487,437,238,199,24,1
218487,799,290,509,25,1
218487,8,5,3,31,1
218487,144,38,106,39,1
218487,655,252,403,40,1
218487,1474,455,1019,41,4
218487,1474,455,1019,42,1
218487,1163,309,854,43,1
218487,172,83,89,44,1
218487,991,226,765,45,1
218487,311,146,165,51,1
218487,124,25,99,59,1
218487,867,201,666,60,1
218520,6171,2026,4145,1,4
218520,6171,2026,4145,2,1
218520,5399,1707,3692,3,1
218520,1170,491,679,4,1
218520,4229,1216,3013,5,1
218520,772,319,453,11,1
218520,303,97,206,19,1
218520,3926,1119,2807,20,1
218520,2596,1022,1574,21,4
218520,2596,1022,1574,22,1
218520,2481,965,1516,23,1
218520,741,319,422,24,1
218520,1740,646,1094,25,1
218520,115,57,58,31,1
218520,159,59,100,39,1
218520,1581,587,994,40,1
218520,3575,1004,2571,41,4
218520,3575,1004,2571,42,1
218520,2918,742,2176,43,1
218520,429,172,257,44,1
218520,2489,570,1919,45,1
218520,657,262,395,51,1
218520,144,38,106,59,1
218520,2345,532,1813,60,1
218539,1433,600,833,1,4
218539,1123,508,615,2,1
218539,1069,493,576,3,1
218539,296,141,155,4,1
218539,773,352,421,5,1
218539,54,15,39,11,1
218539,310,92,218,12,3
218539,12,6,6,19,1
218539,761,346,415,20,1
218539,1395,583,812,21,4
218539,1087,492,595,22,1
218539,1061,486,575,23,1
218539,296,141,155,24,1
218539,765,345,420,25,1
218539,26,6,20,31,1
218539,308,91,217,32,3
218539,12,6,6,39,1
218539,753,339,414,40,1
218539,38,17,21,41,4
218539,36,16,20,42,1
218539,8,7,1,43,1
218539,8,7,1,45,1
218539,28,9,19,51,1
218539,2,1,1,52,3
218539,8,7,1,60,1
218645,3299,1189,2110,1,4
218645,3175,1161,2014,2,1
218645,2956,1091,1865,3,1
218645,643,232,411,4,1
218645,2313,859,1454,5,1
218645,219,70,149,11,1
218645,124,28,96,12,3
218645,223,92,131,19,1
218645,2090,767,1323,20,1
218645,2430,882,1548,21,4
218645,2406,876,1530,22,1
218645,2406,876,1530,23,1
218645,594,210,384,24,1
218645,1812,666,1146,25,1
218645,24,6,18,32,3
218645,152,66,86,39,1
218645,1660,600,1060,40,1
218645,869,307,562,41,4
218645,769,285,484,42,1
218645,550,215,335,43,1
218645,49,22,27,44,1
218645,501,193,308,45,1
218645,219,70,149,51,1
218645,100,22,78,52,3
218645,71,26,45,59,1
218645,430,167,263,60,1
218654,1724,671,1053,1,4
218654,1724,671,1053,2,1
218654,1716,668,1048,3,1
218654,400,165,235,4,1
218654,1316,503,813,5,1
218654,8,3,5,11,1
218654,150,61,89,19,1
218654,1166,442,724,20,1
218654,1376,540,836,21,4
218654,1376,540,836,22,1
218654,1376,540,836,23,1
218654,371,154,217,24,1
218654,1005,386,619,25,1
218654,102,45,57,39,1
218654,903,341,562,40,1
218654,348,131,217,41,4
218654,348,131,217,42,1
218654,340,128,212,43,1
218654,29,11,18,44,1
218654,311,117,194,45,1
218654,8,3,5,51,1
218654,48,16,32,59,1
218654,263,101,162,60,1
218663,31964,14338,17626,1,4
218663,24180,11050,13130,2,1
218663,23987,10947,13040,3,1
218663,5046,2251,2795,4,1
218663,18941,8696,10245,5,1
218663,193,103,90,11,1
218663,7784,3288,4496,12,3
218663,1353,629,724,19,1
218663,17588,8067,9521,20,1
218663,28022,12617,15405,21,4
218663,22533,10171,12362,22,1
218663,22408,10103,12305,23,1
218663,5003,2224,2779,24,1
218663,17405,7879,9526,25,1
218663,125,68,57,31,1
218663,5489,2446,3043,32,3
218663,1195,559,636,39,1
218663,16210,7320,8890,40,1
218663,3942,1721,2221,41,4
218663,1647,879,768,42,1
218663,1579,844,735,43,1
218663,43,27,16,44,1
218663,1536,817,719,45,1
218663,68,35,33,51,1
218663,2295,842,1453,52,3
218663,158,70,88,59,1
218663,1378,747,631,60,1
218672,1811,798,1013,1,4
218672,1811,798,1013,2,1
218672,1053,436,617,3,1
218672,374,191,183,4,1
218672,679,245,434,5,1
218672,758,362,396,11,1
218672,77,34,43,19,1
218672,602,211,391,20,1
218672,787,375,412,21,4
218672,787,375,412,22,1
218672,782,370,412,23,1
218672,341,180,161,24,1
218672,441,190,251,25,1
218672,5,5,0,31,1
218672,54,22,32,39,1
218672,387,168,219,40,1
218672,1024,423,601,41,4
218672,1024,423,601,42,1
218672,271,66,205,43,1
218672,33,11,22,44,1
218672,238,55,183,45,1
218672,753,357,396,51,1
218672,23,12,11,59,1
218672,215,43,172,60,1
218681,1021,370,651,1,4
218681,1021,370,651,2,1
218681,773,296,477,3,1
218681,306,136,170,4,1
218681,467,160,307,5,1
218681,248,74,174,11,1
218681,56,21,35,19,1
218681,411,139,272,20,1
218681,600,251,349,21,4
218681,600,251,349,22,1
218681,597,249,348,23,1
218681,275,126,149,24,1
218681,322,123,199,25,1
218681,3,2,1,31,1
218681,41,17,24,39,1
218681,281,106,175,40,1
218681,421,119,302,41,4
218681,421,119,302,42,1
218681,176,47,129,43,1
218681,31,10,21,44,1
218681,145,37,108,45,1
218681,245,72,173,51,1
218681,15,4,11,59,1
218681,130,33,97,60,1
218690,924,420,504,1,4
218690,924,420,504,2,1
218690,672,300,372,3,1
218690,227,99,128,4,1
218690,445,201,244,5,1
218690,252,120,132,11,1
218690,77,27,50,19,1
218690,368,174,194,20,1
218690,526,245,281,21,4
218690,526,245,281,22,1
218690,526,245,281,23,1
218690,215,97,118,24,1
218690,311,148,163,25,1
218690,53,20,33,39,1
218690,258,128,130,40,1
218690,398,175,223,41,4
218690,398,175,223,42,1
218690,146,55,91,43,1
218690,12,2,10,44,1
218690,134,53,81,45,1
218690,252,120,132,51,1
218690,24,7,17,59,1
218690,110,46,64,60,1
218706,484,210,274,1,4
218706,484,210,274,2,1
218706,285,119,166,3,1
218706,116,59,57,4,1
218706,169,60,109,5,1
218706,199,91,108,11,1
218706,28,8,20,19,1
218706,141,52,89,20,1
218706,236,106,130,21,4
218706,236,106,130,22,1
218706,218,91,127,23,1
218706,99,49,50,24,1
218706,119,42,77,25,1
218706,18,15,3,31,1
218706,21,6,15,39,1
218706,98,36,62,40,1
218706,248,104,144,41,4
218706,248,104,144,42,1
218706,67,28,39,43,1
218706,17,10,7,44,1
218706,50,18,32,45,1
218706,181,76,105,51,1
218706,7,2,5,59,1
218706,43,16,27,60,1
218724,9478,4275,5203,1,4
218724,8867,4097,4770,2,1
218724,8570,3999,4571,3,1
218724,2095,951,1144,4,1
218724,6475,3048,3427,5,1
218724,297,98,199,11,1
218724,611,178,433,12,3
218724,779,382,397,19,1
218724,5696,2666,3030,20,1
218724,8199,3831,4368,21,4
218724,8032,3762,4270,22,1
218724,8004,3747,4257,23,1
218724,2084,945,1139,24,1
218724,5920,2802,3118,25,1
218724,28,15,13,31,1
218724,167,69,98,32,3
218724,697,355,342,39,1
218724,5223,2447,2776,40,1
218724,1279,444,835,41,4
218724,835,335,500,42,1
218724,566,252,314,43,1
218724,11,6,5,44,1
218724,555,246,309,45,1
218724,269,83,186,51,1
218724,444,109,335,52,3
218724,82,27,55,59,1
218724,473,219,254,60,1
218733,3463,1533,1930,1,4
218733,2937,1416,1521,2,1
218733,2876,1384,1492,3,1
218733,566,283,283,4,1
218733,2310,1101,1209,5,1
218733,61,32,29,11,1
218733,526,117,409,12,3
218733,143,74,69,19,1
218733,2167,1027,1140,20,1
218733,2945,1367,1578,21,4
218733,2714,1314,1400,22,1
218733,2710,1312,1398,23,1
218733,559,282,277,24,1
218733,2151,1030,1121,25,1
218733,4,2,2,31,1
218733,231,53,178,32,3
218733,132,67,65,39,1
218733,2019,963,1056,40,1
218733,518,166,352,41,4
218733,223,102,121,42,1
218733,166,72,94,43,1
218733,7,1,6,44,1
218733,159,71,88,45,1
218733,57,30,27,51,1
218733,295,64,231,52,3
218733,11,7,4,59,1
218733,148,64,84,60,1
218742,5445,1894,3551,1,4
218742,5308,1875,3433,2,1
218742,4952,1755,3197,3,1
218742,782,284,498,4,1
218742,4170,1471,2699,5,1
218742,356,120,236,11,1
218742,137,19,118,12,3
218742,690,269,421,19,1
218742,3480,1202,2278,20,1
218742,4236,1464,2772,21,4
218742,4226,1458,2768,22,1
218742,4167,1443,2724,23,1
218742,755,278,477,24,1
218742,3412,1165,2247,25,1
218742,59,15,44,31,1
218742,10,6,4,32,3
218742,531,203,328,39,1
218742,2881,962,1919,40,1
218742,1209,430,779,41,4
218742,1082,417,665,42,1
218742,785,312,473,43,1
218742,27,6,21,44,1
218742,758,306,452,45,1
218742,297,105,192,51,1
218742,127,13,114,52,3
218742,159,66,93,59,1
218742,599,240,359,60,1
218751,286,162,124,1,4
218751,286,162,124,12,3
218751,286,162,124,21,4
218751,286,162,124,32,3
218821,818,426,392,1,4
218821,818,426,392,2,1
218821,813,423,390,3,1
218821,469,250,219,4,1
218821,344,173,171,5,1
218821,5,3,2,11,1
218821,45,28,17,19,1
218821,299,145,154,20,1
218821,798,417,381,21,4
218821,798,417,381,22,1
218821,798,417,381,23,1
218821,469,250,219,24,1
218821,329,167,162,25,1
218821,42,26,16,39,1
218821,287,141,146,40,1
218821,20,9,11,41,4
218821,20,9,11,42,1
218821,15,6,9,43,1
218821,15,6,9,45,1
218821,5,3,2,51,1
218821,3,2,1,59,1
218821,12,4,8,60,1
218830,5864,2383,3481,1,4
218830,5864,2383,3481,2,1
218830,5034,2036,2998,3,1
218830,1251,605,646,4,1
218830,3783,1431,2352,5,1
218830,830,347,483,11,1
218830,493,194,299,19,1
218830,3290,1237,2053,20,1
218830,2789,1247,1542,21,4
218830,2789,1247,1542,22,1
218830,2771,1235,1536,23,1
218830,889,451,438,24,1
218830,1882,784,1098,25,1
218830,18,12,6,31,1
218830,273,111,162,39,1
218830,1609,673,936,40,1
218830,3075,1136,1939,41,4
218830,3075,1136,1939,42,1
218830,2263,801,1462,43,1
218830,362,154,208,44,1
218830,1901,647,1254,45,1
218830,812,335,477,51,1
218830,220,83,137,59,1
218830,1681,564,1117,60,1
218858,4456,1467,2989,1,4
218858,4456,1467,2989,2,1
218858,4014,1298,2716,3,1
218858,786,314,472,4,1
218858,3228,984,2244,5,1
218858,442,169,273,11,1
218858,283,95,188,19,1
218858,2945,889,2056,20,1
218858,1349,594,755,21,4
218858,1349,594,755,22,1
218858,1336,586,750,23,1
218858,399,183,216,24,1
218858,937,403,534,25,1
218858,13,8,5,31,1
218858,106,44,62,39,1
218858,831,359,472,40,1
218858,3107,873,2234,41,4
218858,3107,873,2234,42,1
218858,2678,712,1966,43,1
218858,387,131,256,44,1
218858,2291,581,1710,45,1
218858,429,161,268,51,1
218858,177,51,126,59,1
218858,2114,530,1584,60,1
218867,28,0,28,1,4
218867,28,0,28,2,1
218867,28,0,28,3,1
218867,7,0,7,4,1
218867,21,0,21,5,1
218867,21,0,21,20,1
218867,28,0,28,21,4
218867,28,0,28,22,1
218867,28,0,28,23,1
218867,7,0,7,24,1
218867,21,0,21,25,1
218867,21,0,21,40,1
218885,6553,3017,3536,1,4
218885,6553,3017,3536,2,1
218885,5830,2708,3122,3,1
218885,2034,1090,944,4,1
218885,3796,1618,2178,5,1
218885,723,309,414,11,1
218885,430,169,261,19,1
218885,3366,1449,1917,20,1
218885,3681,1934,1747,21,4
218885,3681,1934,1747,22,1
218885,3647,1923,1724,23,1
218885,1788,969,819,24,1
218885,1859,954,905,25,1
218885,34,11,23,31,1
218885,261,120,141,39,1
218885,1598,834,764,40,1
218885,2872,1083,1789,41,4
218885,2872,1083,1789,42,1
218885,2183,785,1398,43,1
218885,246,121,125,44,1
218885,1937,664,1273,45,1
218885,689,298,391,51,1
218885,169,49,120,59,1
218885,1768,615,1153,60,1
218894,17489,6921,10568,1,4
218894,17489,6921,10568,2,1
218894,15747,6175,9572,3,1
218894,2768,1357,1411,4,1
218894,12979,4818,8161,5,1
218894,1742,746,996,11,1
218894,144,55,89,19,1
218894,12835,4763,8072,20,1
218894,7521,3212,4309,21,4
218894,7521,3212,4309,22,1
218894,7428,3171,4257,23,1
218894,1893,899,994,24,1
218894,5535,2272,3263,25,1
218894,93,41,52,31,1
218894,66,24,42,39,1
218894,5469,2248,3221,40,1
218894,9968,3709,6259,41,4
218894,9968,3709,6259,42,1
218894,8319,3004,5315,43,1
218894,875,458,417,44,1
218894,7444,2546,4898,45,1
218894,1649,705,944,51,1
218894,78,31,47,59,1
218894,7366,2515,4851,60,1
218919,536,236,300,1,4
218919,536,236,300,2,1
218919,536,236,300,3,1
218919,141,62,79,4,1
218919,395,174,221,5,1
218919,84,50,34,19,1
218919,311,124,187,20,1
218919,516,229,287,21,4
218919,516,229,287,22,1
218919,516,229,287,23,1
218919,138,61,77,24,1
218919,378,168,210,25,1
218919,78,46,32,39,1
218919,300,122,178,40,1
218919,20,7,13,41,4
218919,20,7,13,42,1
218919,20,7,13,43,1
218919,3,1,2,44,1
218919,17,6,11,45,1
218919,6,4,2,59,1
218919,11,2,9,60,1
218955,729,285,444,1,4
218955,729,285,444,2,1
218955,713,281,432,3,1
218955,277,139,138,4,1
218955,436,142,294,5,1
218955,16,4,12,11,1
218955,42,8,34,19,1
218955,394,134,260,20,1
218955,287,122,165,21,4
218955,287,122,165,22,1
218955,287,122,165,23,1
218955,96,45,51,24,1
218955,191,77,114,25,1
218955,17,6,11,39,1
218955,174,71,103,40,1
218955,442,163,279,41,4
218955,442,163,279,42,1
218955,426,159,267,43,1
218955,181,94,87,44,1
218955,245,65,180,45,1
218955,16,4,12,51,1
218955,25,2,23,59,1
218955,220,63,157,60,1
218964,6130,1901,4229,1,4
218964,5048,1650,3398,2,1
218964,4704,1556,3148,3,1
218964,1096,332,764,4,1
218964,3608,1224,2384,5,1
218964,344,94,250,11,1
218964,1082,251,831,12,3
218964,367,144,223,19,1
218964,3241,1080,2161,20,1
218964,4928,1578,3350,21,4
218964,4432,1467,2965,22,1
218964,4428,1466,2962,23,1
218964,1096,332,764,24,1
218964,3332,1134,2198,25,1
218964,4,1,3,31,1
218964,496,111,385,32,3
218964,336,133,203,39,1
218964,2996,1001,1995,40,1
218964,1202,323,879,41,4
218964,616,183,433,42,1
218964,276,90,186,43,1
218964,276,90,186,45,1
218964,340,93,247,51,1
218964,586,140,446,52,3
218964,31,11,20,59,1
218964,245,79,166,60,1
218973,1615,832,783,1,4
218973,1615,832,783,2,1
218973,1610,831,779,3,1
218973,415,210,205,4,1
218973,1195,621,574,5,1
218973,5,1,4,11,1
218973,19,15,4,19,1
218973,1176,606,570,20,1
218973,1598,821,777,21,4
218973,1598,821,777,22,1
218973,1598,821,777,23,1
218973,415,210,205,24,1
218973,1183,611,572,25,1
218973,19,15,4,39,1
218973,1164,596,568,40,1
218973,17,11,6,41,4
218973,17,11,6,42,1
218973,12,10,2,43,1
218973,12,10,2,45,1
218973,5,1,4,51,1
218973,12,10,2,60,1
218991,5030,2055,2975,1,4
218991,5030,2055,2975,2,1
218991,4821,1976,2845,3,1
218991,1266,620,646,4,1
218991,3555,1356,2199,5,1
218991,209,79,130,11,1
218991,466,169,297,19,1
218991,3089,1187,1902,20,1
218991,2478,1156,1322,21,4
218991,2478,1156,1322,22,1
218991,2472,1154,1318,23,1
218991,865,442,423,24,1
218991,1607,712,895,25,1
218991,6,2,4,31,1
218991,257,104,153,39,1
218991,1350,608,742,40,1
218991,2552,899,1653,41,4
218991,2552,899,1653,42,1
218991,2349,822,1527,43,1
218991,401,178,223,44,1
218991,1948,644,1304,45,1
218991,203,77,126,51,1
218991,209,65,144,59,1
218991,1739,579,1160,60,1
219000,1765,709,1056,1,4
219000,1697,688,1009,2,1
219000,1615,645,970,3,1
219000,367,160,207,4,1
219000,1248,485,763,5,1
219000,82,43,39,11,1
219000,68,21,47,12,3
219000,62,20,42,19,1
219000,1186,465,721,20,1
219000,1586,636,950,21,4
219000,1585,635,950,22,1
219000,1549,620,929,23,1
219000,367,160,207,24,1
219000,1182,460,722,25,1
219000,36,15,21,31,1
219000,1,1,0,32,3
219000,55,18,37,39,1
219000,1127,442,685,40,1
219000,179,73,106,41,4
219000,112,53,59,42,1
219000,66,25,41,43,1
219000,66,25,41,45,1
219000,46,28,18,51,1
219000,67,20,47,52,3
219000,7,2,5,59,1
219000,59,23,36,60,1
219037,112,2,110,1,4
219037,112,2,110,2,1
219037,112,2,110,3,1
219037,24,1,23,4,1
219037,88,1,87,5,1
219037,88,1,87,20,1
219037,112,2,110,21,4
219037,112,2,110,22,1
219037,112,2,110,23,1
219037,24,1,23,24,1
219037,88,1,87,25,1
219037,88,1,87,40,1
219046,4464,1611,2853,1,4
219046,4002,1485,2517,2,1
219046,3156,1203,1953,3,1
219046,619,228,391,4,1
219046,2537,975,1562,5,1
219046,846,282,564,11,1
219046,462,126,336,12,3
219046,432,166,266,19,1
219046,2105,809,1296,20,1
219046,2526,966,1560,21,4
219046,2487,952,1535,22,1
219046,2386,933,1453,23,1
219046,559,203,356,24,1
219046,1827,730,1097,25,1
219046,101,19,82,31,1
219046,39,14,25,32,3
219046,313,118,195,39,1
219046,1514,612,902,40,1
219046,1938,645,1293,41,4
219046,1515,533,982,42,1
219046,770,270,500,43,1
219046,60,25,35,44,1
219046,710,245,465,45,1
219046,745,263,482,51,1
219046,423,112,311,52,3
219046,119,48,71,59,1
219046,591,197,394,60,1
219055,253,68,185,1,4
219055,253,68,185,2,1
219055,213,52,161,3,1
219055,33,11,22,4,1
219055,180,41,139,5,1
219055,40,16,24,11,1
219055,32,8,24,19,1
219055,148,33,115,20,1
219055,34,8,26,21,4
219055,34,8,26,22,1
219055,34,8,26,23,1
219055,10,1,9,24,1
219055,24,7,17,25,1
219055,6,1,5,39,1
219055,18,6,12,40,1
219055,219,60,159,41,4
219055,219,60,159,42,1
219055,179,44,135,43,1
219055,23,10,13,44,1
219055,156,34,122,45,1
219055,40,16,24,51,1
219055,26,7,19,59,1
219055,130,27,103,60,1
219082,3129,1661,1468,1,4
219082,2876,1485,1391,2,1
219082,1743,1061,682,3,1
219082,318,210,108,4,1
219082,1425,851,574,5,1
219082,1133,424,709,11,1
219082,253,176,77,12,3
219082,259,143,116,19,1
219082,1166,708,458,20,1
219082,1244,811,433,21,4
219082,1190,770,420,22,1
219082,1178,763,415,23,1
219082,286,194,92,24,1
219082,892,569,323,25,1
219082,12,7,5,31,1
219082,54,41,13,32,3
219082,118,72,46,39,1
219082,774,497,277,40,1
219082,1885,850,1035,41,4
219082,1686,715,971,42,1
219082,565,298,267,43,1
219082,32,16,16,44,1
219082,533,282,251,45,1
219082,1121,417,704,51,1
219082,199,135,64,52,3
219082,141,71,70,59,1
219082,392,211,181,60,1
219091,879,398,481,1,4
219091,810,366,444,2,1
219091,754,344,410,3,1
219091,168,93,75,4,1
219091,586,251,335,5,1
219091,56,22,34,11,1
219091,69,32,37,12,3
219091,84,24,60,19,1
219091,502,227,275,20,1
219091,714,343,371,21,4
219091,699,336,363,22,1
219091,698,336,362,23,1
219091,168,93,75,24,1
219091,530,243,287,25,1
219091,1,0,1,31,1
219091,15,7,8,32,3
219091,68,23,45,39,1
219091,462,220,242,40,1
219091,165,55,110,41,4
219091,111,30,81,42,1
219091,56,8,48,43,1
219091,56,8,48,45,1
219091,55,22,33,51,1
219091,54,25,29,52,3
219091,16,1,15,59,1
219091,40,7,33,60,1
219125,81,1,80,1,4
219125,81,1,80,2,1
219125,81,1,80,3,1
219125,23,1,22,4,1
219125,58,0,58,5,1
219125,58,0,58,20,1
219125,81,1,80,21,4
219125,81,1,80,22,1
219125,81,1,80,23,1
219125,23,1,22,24,1
219125,58,0,58,25,1
219125,58,0,58,40,1
219143,1559,821,738,1,4
219143,1559,821,738,2,1
219143,1533,818,715,3,1
219143,696,386,310,4,1
219143,837,432,405,5,1
219143,26,3,23,11,1
219143,837,432,405,20,1
219143,1366,765,601,21,4
219143,1366,765,601,22,1
219143,1365,764,601,23,1
219143,657,376,281,24,1
219143,708,388,320,25,1
219143,1,1,0,31,1
219143,708,388,320,40,1
219143,193,56,137,41,4
219143,193,56,137,42,1
219143,168,54,114,43,1
219143,39,10,29,44,1
219143,129,44,85,45,1
219143,25,2,23,51,1
219143,129,44,85,60,1
219170,20,5,15,1,4
219170,20,5,15,2,1
219170,20,5,15,3,1
219170,20,5,15,5,1
219170,20,5,15,20,1
219170,20,5,15,21,4
219170,20,5,15,22,1
219170,20,5,15,23,1
219170,20,5,15,25,1
219170,20,5,15,40,1
219189,1203,783,420,1,4
219189,1203,783,420,2,1
219189,1136,743,393,3,1
219189,397,298,99,4,1
219189,739,445,294,5,1
219189,67,40,27,11,1
219189,133,78,55,19,1
219189,606,367,239,20,1
219189,918,647,271,21,4
219189,918,647,271,22,1
219189,918,647,271,23,1
219189,374,292,82,24,1
219189,544,355,189,25,1
219189,120,77,43,39,1
219189,424,278,146,40,1
219189,285,136,149,41,4
219189,285,136,149,42,1
219189,218,96,122,43,1
219189,23,6,17,44,1
219189,195,90,105,45,1
219189,67,40,27,51,1
219189,13,1,12,59,1
219189,182,89,93,60,1
219198,1225,449,776,1,4
219198,1068,405,663,2,1
219198,676,249,427,3,1
219198,126,57,69,4,1
219198,550,192,358,5,1
219198,392,156,236,11,1
219198,157,44,113,12,3
219198,68,28,40,19,1
219198,482,164,318,20,1
219198,652,201,451,21,4
219198,522,160,362,22,1
219198,520,160,360,23,1
219198,107,39,68,24,1
219198,413,121,292,25,1
219198,2,0,2,31,1
219198,130,41,89,32,3
219198,54,20,34,39,1
219198,359,101,258,40,1
219198,573,248,325,41,4
219198,546,245,301,42,1
219198,156,89,67,43,1
219198,19,18,1,44,1
219198,137,71,66,45,1
219198,390,156,234,51,1
219198,27,3,24,52,3
219198,14,8,6,59,1
219198,123,63,60,60,1
219204,2306,614,1692,1,4
219204,1926,487,1439,2,1
219204,1913,480,1433,3,1
219204,200,73,127,4,1
219204,1713,407,1306,5,1
219204,13,7,6,11,1
219204,380,127,253,12,3
219204,510,128,382,19,1
219204,1203,279,924,20,1
219204,321,108,213,21,4
219204,196,59,137,22,1
219204,195,58,137,23,1
219204,13,2,11,24,1
219204,182,56,126,25,1
219204,1,1,0,31,1
219204,125,49,76,32,3
219204,38,14,24,39,1
219204,144,42,102,40,1
219204,1985,506,1479,41,4
219204,1730,428,1302,42,1
219204,1718,422,1296,43,1
219204,187,71,116,44,1
219204,1531,351,1180,45,1
219204,12,6,6,51,1
219204,255,78,177,52,3
219204,472,114,358,59,1
219204,1059,237,822,60,1
219213,659,134,525,1,4
219213,659,134,525,2,1
219213,658,134,524,3,1
219213,60,18,42,4,1
219213,598,116,482,5,1
219213,1,0,1,11,1
219213,104,23,81,19,1
219213,494,93,401,20,1
219213,78,17,61,21,4
219213,78,17,61,22,1
219213,78,17,61,23,1
219213,4,2,2,24,1
219213,74,15,59,25,1
219213,7,2,5,39,1
219213,67,13,54,40,1
219213,581,117,464,41,4
219213,581,117,464,42,1
219213,580,117,463,43,1
219213,56,16,40,44,1
219213,524,101,423,45,1
219213,1,0,1,51,1
219213,97,21,76,59,1
219213,427,80,347,60,1
219240,143,81,62,1,4
219240,143,81,62,12,3
219240,54,30,24,21,4
219240,54,30,24,32,3
219240,89,51,38,41,4
219240,89,51,38,52,3
219259,3275,1303,1972,1,4
219259,2826,1191,1635,2,1
219259,1758,791,967,3,1
219259,387,181,206,4,1
219259,1371,610,761,5,1
219259,1068,400,668,11,1
219259,449,112,337,12,3
219259,142,64,78,19,1
219259,1229,546,683,20,1
219259,1588,726,862,21,4
219259,1531,703,828,22,1
219259,1421,660,761,23,1
219259,356,163,193,24,1
219259,1065,497,568,25,1
219259,110,43,67,31,1
219259,57,23,34,32,3
219259,109,53,56,39,1
219259,956,444,512,40,1
219259,1687,577,1110,41,4
219259,1295,488,807,42,1
219259,337,131,206,43,1
219259,31,18,13,44,1
219259,306,113,193,45,1
219259,958,357,601,51,1
219259,392,89,303,52,3
219259,33,11,22,59,1
219259,273,102,171,60,1
219277,1551,519,1032,1,4
219277,1517,515,1002,2,1
219277,1450,498,952,3,1
219277,226,103,123,4,1
219277,1224,395,829,5,1
219277,67,17,50,11,1
219277,34,4,30,12,3
219277,88,33,55,19,1
219277,1136,362,774,20,1
219277,884,347,537,21,4
219277,884,347,537,22,1
219277,877,345,532,23,1
219277,186,87,99,24,1
219277,691,258,433,25,1
219277,7,2,5,31,1
219277,55,25,30,39,1
219277,636,233,403,40,1
219277,667,172,495,41,4
219277,633,168,465,42,1
219277,573,153,420,43,1
219277,40,16,24,44,1
219277,533,137,396,45,1
219277,60,15,45,51,1
219277,34,4,30,52,3
219277,33,8,25,59,1
219277,500,129,371,60,1
219295,791,244,547,1,4
219295,791,244,547,2,1
219295,728,226,502,3,1
219295,131,67,64,4,1
219295,597,159,438,5,1
219295,63,18,45,11,1
219295,153,47,106,19,1
219295,444,112,332,20,1
219295,536,205,331,21,4
219295,536,205,331,22,1
219295,536,205,331,23,1
219295,130,67,63,24,1
219295,406,138,268,25,1
219295,110,42,68,39,1
219295,296,96,200,40,1
219295,255,39,216,41,4
219295,255,39,216,42,1
219295,192,21,171,43,1
219295,1,0,1,44,1
219295,191,21,170,45,1
219295,63,18,45,51,1
219295,43,5,38,59,1
219295,148,16,132,60,1
219338,18,4,14,1,4
219338,18,4,14,2,1
219338,18,4,14,3,1
219338,18,4,14,5,1
219338,18,4,14,20,1
219338,18,4,14,21,4
219338,18,4,14,22,1
219338,18,4,14,23,1
219338,18,4,14,25,1
219338,18,4,14,40,1
219347,2640,2031,609,1,4
219347,2328,1792,536,2,1
219347,2194,1732,462,3,1
219347,553,456,97,4,1
219347,1641,1276,365,5,1
219347,134,60,74,11,1
219347,312,239,73,12,3
219347,131,99,32,19,1
219347,1510,1177,333,20,1
219347,2136,1683,453,21,4
219347,1950,1541,409,22,1
219347,1939,1533,406,23,1
219347,546,450,96,24,1
219347,1393,1083,310,25,1
219347,11,8,3,31,1
219347,186,142,44,32,3
219347,115,87,28,39,1
219347,1278,996,282,40,1
219347,504,348,156,41,4
219347,378,251,127,42,1
219347,255,199,56,43,1
219347,7,6,1,44,1
219347,248,193,55,45,1
219347,123,52,71,51,1
219347,126,97,29,52,3
219347,16,12,4,59,1
219347,232,181,51,60,1
219356,12525,5925,6600,1,4
219356,10969,5231,5738,2,1
219356,10048,4900,5148,3,1
219356,2300,1155,1145,4,1
219356,7748,3745,4003,5,1
219356,921,331,590,11,1
219356,1556,694,862,12,3
219356,566,266,300,19,1
219356,7182,3479,3703,20,1
219356,9146,4617,4529,21,4
219356,8646,4383,4263,22,1
219356,8621,4368,4253,23,1
219356,2188,1114,1074,24,1
219356,6433,3254,3179,25,1
219356,25,15,10,31,1
219356,500,234,266,32,3
219356,397,217,180,39,1
219356,6036,3037,2999,40,1
219356,3379,1308,2071,41,4
219356,2323,848,1475,42,1
219356,1427,532,895,43,1
219356,112,41,71,44,1
219356,1315,491,824,45,1
219356,896,316,580,51,1
219356,1056,460,596,52,3
219356,169,49,120,59,1
219356,1146,442,704,60,1
219374,689,203,486,1,4
219374,577,173,404,2,1
219374,550,163,387,3,1
219374,180,61,119,4,1
219374,370,102,268,5,1
219374,27,10,17,11,1
219374,112,30,82,12,3
219374,68,14,54,19,1
219374,302,88,214,20,1
219374,268,90,178,21,4
219374,253,83,170,22,1
219374,252,82,170,23,1
219374,95,32,63,24,1
219374,157,50,107,25,1
219374,1,1,0,31,1
219374,15,7,8,32,3
219374,32,6,26,39,1
219374,125,44,81,40,1
219374,421,113,308,41,4
219374,324,90,234,42,1
219374,298,81,217,43,1
219374,85,29,56,44,1
219374,213,52,161,45,1
219374,26,9,17,51,1
219374,97,23,74,52,3
219374,36,8,28,59,1
219374,177,44,133,60,1
219383,1408,569,839,1,4
219383,1100,448,652,2,1
219383,1075,439,636,3,1
219383,237,89,148,4,1
219383,838,350,488,5,1
219383,25,9,16,11,1
219383,308,121,187,12,3
219383,87,46,41,19,1
219383,751,304,447,20,1
219383,938,384,554,21,4
219383,929,378,551,22,1
219383,926,377,549,23,1
219383,236,88,148,24,1
219383,690,289,401,25,1
219383,3,1,2,31,1
219383,9,6,3,32,3
219383,74,40,34,39,1
219383,616,249,367,40,1
219383,470,185,285,41,4
219383,171,70,101,42,1
219383,149,62,87,43,1
219383,1,1,0,44,1
219383,148,61,87,45,1
219383,22,8,14,51,1
219383,299,115,184,52,3
219383,13,6,7,59,1
219383,135,55,80,60,1
219392,24,6,18,1,4
219392,24,6,18,2,1
219392,24,6,18,3,1
219392,24,6,18,5,1
219392,24,6,18,20,1
219392,24,6,18,21,4
219392,24,6,18,22,1
219392,24,6,18,23,1
219392,24,6,18,25,1
219392,24,6,18,40,1
219408,194,51,143,1,4
219408,194,51,143,2,1
219408,189,50,139,3,1
219408,55,17,38,4,1
219408,134,33,101,5,1
219408,5,1,4,11,1
219408,1,0,1,19,1
219408,133,33,100,20,1
219408,151,41,110,21,4
219408,151,41,110,22,1
219408,151,41,110,23,1
219408,50,16,34,24,1
219408,101,25,76,25,1
219408,1,0,1,39,1
219408,100,25,75,40,1
219408,43,10,33,41,4
219408,43,10,33,42,1
219408,38,9,29,43,1
219408,5,1,4,44,1
219408,33,8,25,45,1
219408,5,1,4,51,1
219408,33,8,25,60,1
219426,2467,1187,1280,1,4
219426,2467,1187,1280,2,1
219426,2405,1168,1237,3,1
219426,565,302,263,4,1
219426,1840,866,974,5,1
219426,62,19,43,11,1
219426,350,138,212,19,1
219426,1490,728,762,20,1
219426,1683,879,804,21,4
219426,1683,879,804,22,1
219426,1683,879,804,23,1
219426,472,265,207,24,1
219426,1211,614,597,25,1
219426,237,103,134,39,1
219426,974,511,463,40,1
219426,784,308,476,41,4
219426,784,308,476,42,1
219426,722,289,433,43,1
219426,93,37,56,44,1
219426,629,252,377,45,1
219426,62,19,43,51,1
219426,113,35,78,59,1
219426,516,217,299,60,1
219453,142,2,140,1,4
219453,142,2,140,2,1
219453,142,2,140,3,1
219453,78,1,77,4,1
219453,64,1,63,5,1
219453,64,1,63,20,1
219453,142,2,140,21,4
219453,142,2,140,22,1
219453,142,2,140,23,1
219453,78,1,77,24,1
219453,64,1,63,25,1
219453,64,1,63,40,1
219471,10235,3947,6288,1,4
219471,7633,2822,4811,2,1
219471,6449,2375,4074,3,1
219471,1342,530,812,4,1
219471,5107,1845,3262,5,1
219471,1184,447,737,11,1
219471,2602,1125,1477,12,3
219471,635,194,441,19,1
219471,4472,1651,2821,20,1
219471,6031,2528,3503,21,4
219471,4732,1927,2805,22,1
219471,4700,1915,2785,23,1
219471,1225,486,739,24,1
219471,3475,1429,2046,25,1
219471,32,12,20,31,1
219471,1299,601,698,32,3
219471,337,132,205,39,1
219471,3138,1297,1841,40,1
219471,4204,1419,2785,41,4
219471,2901,895,2006,42,1
219471,1749,460,1289,43,1
219471,117,44,73,44,1
219471,1632,416,1216,45,1
219471,1152,435,717,51,1
219471,1303,524,779,52,3
219471,298,62,236,59,1
219471,1334,354,980,60,1
219480,1030,525,505,1,4
219480,1030,525,505,2,1
219480,1004,511,493,3,1
219480,260,152,108,4,1
219480,744,359,385,5,1
219480,26,14,12,11,1
219480,157,77,80,19,1
219480,587,282,305,20,1
219480,795,450,345,21,4
219480,795,450,345,22,1
219480,785,441,344,23,1
219480,226,136,90,24,1
219480,559,305,254,25,1
219480,10,9,1,31,1
219480,127,65,62,39,1
219480,432,240,192,40,1
219480,235,75,160,41,4
219480,235,75,160,42,1
219480,219,70,149,43,1
219480,34,16,18,44,1
219480,185,54,131,45,1
219480,16,5,11,51,1
219480,30,12,18,59,1
219480,155,42,113,60,1
219505,144,101,43,1,4
219505,141,101,40,2,1
219505,141,101,40,3,1
219505,10,6,4,4,1
219505,131,95,36,5,1
219505,3,0,3,12,3
219505,13,3,10,19,1
219505,118,92,26,20,1
219505,99,76,23,21,4
219505,98,76,22,22,1
219505,98,76,22,23,1
219505,9,5,4,24,1
219505,89,71,18,25,1
219505,1,0,1,32,3
219505,8,2,6,39,1
219505,81,69,12,40,1
219505,45,25,20,41,4
219505,43,25,18,42,1
219505,43,25,18,43,1
219505,1,1,0,44,1
219505,42,24,18,45,1
219505,2,0,2,52,3
219505,5,1,4,59,1
219505,37,23,14,60,1
219578,574,99,475,1,4
219578,505,93,412,2,1
219578,486,89,397,3,1
219578,37,6,31,4,1
219578,449,83,366,5,1
219578,19,4,15,11,1
219578,69,6,63,12,3
219578,87,16,71,19,1
219578,362,67,295,20,1
219578,220,36,184,21,4
219578,189,36,153,22,1
219578,184,36,148,23,1
219578,34,6,28,24,1
219578,150,30,120,25,1
219578,5,0,5,31,1
219578,31,0,31,32,3
219578,38,7,31,39,1
219578,112,23,89,40,1
219578,354,63,291,41,4
219578,316,57,259,42,1
219578,302,53,249,43,1
219578,3,0,3,44,1
219578,299,53,246,45,1
219578,14,4,10,51,1
219578,38,6,32,52,3
219578,49,9,40,59,1
219578,250,44,206,60,1
219587,72,1,71,1,4
219587,72,1,71,2,1
219587,72,1,71,3,1
219587,21,1,20,4,1
219587,51,0,51,5,1
219587,51,0,51,20,1
219587,72,1,71,21,4
219587,72,1,71,22,1
219587,72,1,71,23,1
219587,21,1,20,24,1
219587,51,0,51,25,1
219587,51,0,51,40,1
219596,202,131,71,1,4
219596,202,131,71,2,1
219596,202,131,71,3,1
219596,57,37,20,4,1
219596,145,94,51,5,1
219596,145,94,51,20,1
219596,202,131,71,21,4
219596,202,131,71,22,1
219596,202,131,71,23,1
219596,57,37,20,24,1
219596,145,94,51,25,1
219596,145,94,51,40,1
219602,10399,4073,6326,1,4
219602,9550,3847,5703,2,1
219602,9271,3755,5516,3,1
219602,1582,656,926,4,1
219602,7689,3099,4590,5,1
219602,279,92,187,11,1
219602,849,226,623,12,3
219602,899,370,529,19,1
219602,6790,2729,4061,20,1
219602,7150,2844,4306,21,4
219602,6866,2769,4097,22,1
219602,6855,2765,4090,23,1
219602,1237,523,714,24,1
219602,5618,2242,3376,25,1
219602,11,4,7,31,1
219602,284,75,209,32,3
219602,551,219,332,39,1
219602,5067,2023,3044,40,1
219602,3249,1229,2020,41,4
219602,2684,1078,1606,42,1
219602,2416,990,1426,43,1
219602,345,133,212,44,1
219602,2071,857,1214,45,1
219602,268,88,180,51,1
219602,565,151,414,52,3
219602,348,151,197,59,1
219602,1723,706,1017,60,1
219639,1101,103,998,1,4
219639,1101,103,998,2,1
219639,1101,103,998,3,1
219639,88,11,77,4,1
219639,1013,92,921,5,1
219639,203,18,185,19,1
219639,810,74,736,20,1
219639,482,49,433,21,4
219639,482,49,433,22,1
219639,482,49,433,23,1
219639,88,11,77,24,1
219639,394,38,356,25,1
219639,130,14,116,39,1
219639,264,24,240,40,1
219639,619,54,565,41,4
219639,619,54,565,42,1
219639,619,54,565,43,1
219639,619,54,565,45,1
219639,73,4,69,59,1
219639,546,50,496,60,1
219709,6915,2718,4197,1,4
219709,5506,2216,3290,2,1
219709,5465,2199,3266,3,1
219709,1248,480,768,4,1
219709,4217,1719,2498,5,1
219709,41,17,24,11,1
219709,1409,502,907,12,3
219709,466,174,292,19,1
219709,3751,1545,2206,20,1
219709,6102,2394,3708,21,4
219709,5117,2066,3051,22,1
219709,5107,2064,3043,23,1
219709,1243,480,763,24,1
219709,3864,1584,2280,25,1
219709,10,2,8,31,1
219709,985,328,657,32,3
219709,402,151,251,39,1
219709,3462,1433,2029,40,1
219709,813,324,489,41,4
219709,389,150,239,42,1
219709,358,135,223,43,1
219709,5,0,5,44,1
219709,353,135,218,45,1
219709,31,15,16,51,1
219709,424,174,250,52,3
219709,64,23,41,59,1
219709,289,112,177,60,1
219718,6634,2749,3885,1,4
219718,5124,2244,2880,2,1
219718,5063,2212,2851,3,1
219718,613,287,326,4,1
219718,4450,1925,2525,5,1
219718,61,32,29,11,1
219718,1510,505,1005,12,3
219718,526,237,289,19,1
219718,3924,1688,2236,20,1
219718,5282,2207,3075,21,4
219718,3971,1775,2196,22,1
219718,3971,1775,2196,23,1
219718,550,265,285,24,1
219718,3421,1510,1911,25,1
219718,1311,432,879,32,3
219718,468,214,254,39,1
219718,2953,1296,1657,40,1
219718,1352,542,810,41,4
219718,1153,469,684,42,1
219718,1092,437,655,43,1
219718,63,22,41,44,1
219718,1029,415,614,45,1
219718,61,32,29,51,1
219718,199,73,126,52,3
219718,58,23,35,59,1
219718,971,392,579,60,1
219790,1704,765,939,1,4
219790,1573,697,876,2,1
219790,1209,546,663,3,1
219790,187,89,98,4,1
219790,1022,457,565,5,1
219790,364,151,213,11,1
219790,131,68,63,12,3
219790,31,19,12,19,1
219790,991,438,553,20,1
219790,1249,559,690,21,4
219790,1129,496,633,22,1
219790,1103,484,619,23,1
219790,187,89,98,24,1
219790,916,395,521,25,1
219790,26,12,14,31,1
219790,120,63,57,32,3
219790,31,19,12,39,1
219790,885,376,509,40,1
219790,455,206,249,41,4
219790,444,201,243,42,1
219790,106,62,44,43,1
219790,106,62,44,45,1
219790,338,139,199,51,1
219790,11,5,6,52,3
219790,106,62,44,60,1
219806,2045,884,1161,1,4
219806,1713,771,942,2,1
219806,1688,763,925,3,1
219806,480,216,264,4,1
219806,1208,547,661,5,1
219806,25,8,17,11,1
219806,332,113,219,12,3
219806,116,65,51,19,1
219806,1092,482,610,20,1
219806,1761,798,963,21,4
219806,1658,756,902,22,1
219806,1633,748,885,23,1
219806,480,216,264,24,1
219806,1153,532,621,25,1
219806,25,8,17,31,1
219806,103,42,61,32,3
219806,116,65,51,39,1
219806,1037,467,570,40,1
219806,284,86,198,41,4
219806,55,15,40,42,1
219806,55,15,40,43,1
219806,55,15,40,45,1
219806,229,71,158,52,3
219806,55,15,40,60,1
219824,9910,3949,5961,1,4
219824,9910,3949,5961,2,1
219824,8224,3272,4952,3,1
219824,1638,673,965,4,1
219824,6586,2599,3987,5,1
219824,1686,677,1009,11,1
219824,658,279,379,19,1
219824,5928,2320,3608,20,1
219824,4414,1910,2504,21,4
219824,4414,1910,2504,22,1
219824,4267,1848,2419,23,1
219824,1156,493,663,24,1
219824,3111,1355,1756,25,1
219824,147,62,85,31,1
219824,303,143,160,39,1
219824,2808,1212,1596,40,1
219824,5496,2039,3457,41,4
219824,5496,2039,3457,42,1
219824,3957,1424,2533,43,1
219824,482,180,302,44,1
219824,3475,1244,2231,45,1
219824,1539,615,924,51,1
219824,355,136,219,59,1
219824,3120,1108,2012,60,1
219833,1577,704,873,1,4
219833,1168,532,636,2,1
219833,1156,524,632,3,1
219833,263,140,123,4,1
219833,893,384,509,5,1
219833,12,8,4,11,1
219833,409,172,237,12,3
219833,69,26,43,19,1
219833,824,358,466,20,1
219833,1135,523,612,21,4
219833,1021,489,532,22,1
219833,1018,486,532,23,1
219833,262,140,122,24,1
219833,756,346,410,25,1
219833,3,3,0,31,1
219833,114,34,80,32,3
219833,45,22,23,39,1
219833,711,324,387,40,1
219833,442,181,261,41,4
219833,147,43,104,42,1
219833,138,38,100,43,1
219833,1,0,1,44,1
219833,137,38,99,45,1
219833,9,5,4,51,1
219833,295,138,157,52,3
219833,24,4,20,59,1
219833,113,34,79,60,1
219842,205,152,53,1,4
219842,205,152,53,12,3
219842,121,88,33,21,4
219842,121,88,33,32,3
219842,84,64,20,41,4
219842,84,64,20,52,3
219879,3790,1511,2279,1,4
219879,3790,1511,2279,2,1
219879,2978,1172,1806,3,1
219879,743,324,419,4,1
219879,2235,848,1387,5,1
219879,812,339,473,11,1
219879,197,76,121,19,1
219879,2038,772,1266,20,1
219879,1885,831,1054,21,4
219879,1885,831,1054,22,1
219879,1870,820,1050,23,1
219879,669,296,373,24,1
219879,1201,524,677,25,1
219879,15,11,4,31,1
219879,132,60,72,39,1
219879,1069,464,605,40,1
219879,1905,680,1225,41,4
219879,1905,680,1225,42,1
219879,1108,352,756,43,1
219879,74,28,46,44,1
219879,1034,324,710,45,1
219879,797,328,469,51,1
219879,65,16,49,59,1
219879,969,308,661,60,1
219888,5225,1863,3362,1,4
219888,5225,1863,3362,2,1
219888,4317,1513,2804,3,1
219888,982,377,605,4,1
219888,3335,1136,2199,5,1
219888,908,350,558,11,1
219888,311,109,202,19,1
219888,3024,1027,1997,20,1
219888,2264,865,1399,21,4
219888,2264,865,1399,22,1
219888,2233,851,1382,23,1
219888,750,270,480,24,1
219888,1483,581,902,25,1
219888,31,14,17,31,1
219888,132,60,72,39,1
219888,1351,521,830,40,1
219888,2961,998,1963,41,4
219888,2961,998,1963,42,1
219888,2084,662,1422,43,1
219888,232,107,125,44,1
219888,1852,555,1297,45,1
219888,877,336,541,51,1
219888,179,49,130,59,1
219888,1673,506,1167,60,1
219903,1313,122,1191,1,4
219903,1313,122,1191,2,1
219903,1313,122,1191,3,1
219903,328,28,300,4,1
219903,985,94,891,5,1
219903,985,94,891,20,1
219903,1313,122,1191,21,4
219903,1313,122,1191,22,1
219903,1313,122,1191,23,1
219903,328,28,300,24,1
219903,985,94,891,25,1
219903,985,94,891,40,1
219921,203,143,60,1,4
219921,203,143,60,2,1
219921,203,143,60,3,1
219921,60,51,9,4,1
219921,143,92,51,5,1
219921,143,92,51,20,1
219921,114,82,32,21,4
219921,114,82,32,22,1
219921,114,82,32,23,1
219921,47,41,6,24,1
219921,67,41,26,25,1
219921,67,41,26,40,1
219921,89,61,28,41,4
219921,89,61,28,42,1
219921,89,61,28,43,1
219921,13,10,3,44,1
219921,76,51,25,45,1
219921,76,51,25,60,1
219949,1501,689,812,1,4
219949,1269,585,684,2,1
219949,1198,551,647,3,1
219949,212,128,84,4,1
219949,986,423,563,5,1
219949,71,34,37,11,1
219949,232,104,128,12,3
219949,210,58,152,19,1
219949,776,365,411,20,1
219949,1099,530,569,21,4
219949,1056,514,542,22,1
219949,1056,514,542,23,1
219949,212,128,84,24,1
219949,844,386,458,25,1
219949,43,16,27,32,3
219949,161,46,115,39,1
219949,683,340,343,40,1
219949,402,159,243,41,4
219949,213,71,142,42,1
219949,142,37,105,43,1
219949,142,37,105,45,1
219949,71,34,37,51,1
219949,189,88,101,52,3
219949,49,12,37,59,1
219949,93,25,68,60,1
219976,4580,1734,2846,1,4
219976,2890,1157,1733,2,1
219976,2874,1146,1728,3,1
219976,684,257,427,4,1
219976,2190,889,1301,5,1
219976,16,11,5,11,1
219976,1690,577,1113,12,3
219976,176,71,105,19,1
219976,2014,818,1196,20,1
219976,3403,1363,2040,21,4
219976,2590,1041,1549,22,1
219976,2586,1038,1548,23,1
219976,683,257,426,24,1
219976,1903,781,1122,25,1
219976,4,3,1,31,1
219976,813,322,491,32,3
219976,148,62,86,39,1
219976,1755,719,1036,40,1
219976,1177,371,806,41,4
219976,300,116,184,42,1
219976,288,108,180,43,1
219976,1,0,1,44,1
219976,287,108,179,45,1
219976,12,8,4,51,1
219976,877,255,622,52,3
219976,28,9,19,59,1
219976,259,99,160,60,1
219994,481,273,208,1,4
219994,481,273,208,2,1
219994,481,273,208,3,1
219994,289,187,102,4,1
219994,192,86,106,5,1
219994,192,86,106,20,1
219994,445,248,197,21,4
219994,445,248,197,22,1
219994,445,248,197,23,1
219994,270,174,96,24,1
219994,175,74,101,25,1
219994,175,74,101,40,1
219994,36,25,11,41,4
219994,36,25,11,42,1
219994,36,25,11,43,1
219994,19,13,6,44,1
219994,17,12,5,45,1
219994,17,12,5,60,1
220002,141,45,96,1,4
220002,141,45,96,2,1
220002,141,45,96,3,1
220002,11,4,7,4,1
220002,130,41,89,5,1
220002,29,5,24,19,1
220002,101,36,65,20,1
220002,108,33,75,21,4
220002,108,33,75,22,1
220002,108,33,75,23,1
220002,11,4,7,24,1
220002,97,29,68,25,1
220002,28,5,23,39,1
220002,69,24,45,40,1
220002,33,12,21,41,4
220002,33,12,21,42,1
220002,33,12,21,43,1
220002,33,12,21,45,1
220002,1,0,1,59,1
220002,32,12,20,60,1
220057,3258,1093,2165,1,4
220057,3258,1093,2165,2,1
220057,2362,728,1634,3,1
220057,628,248,380,4,1
220057,1734,480,1254,5,1
220057,896,365,531,11,1
220057,167,58,109,19,1
220057,1567,422,1145,20,1
220057,1292,462,830,21,4
220057,1292,462,830,22,1
220057,1281,456,825,23,1
220057,407,172,235,24,1
220057,874,284,590,25,1
220057,11,6,5,31,1
220057,101,39,62,39,1
220057,773,245,528,40,1
220057,1966,631,1335,41,4
220057,1966,631,1335,42,1
220057,1081,272,809,43,1
220057,221,76,145,44,1
220057,860,196,664,45,1
220057,885,359,526,51,1
220057,66,19,47,59,1
220057,794,177,617,60,1
220075,14691,6122,8569,1,4
220075,11820,5099,6721,2,1
220075,11399,4905,6494,3,1
220075,1881,805,1076,4,1
220075,9518,4100,5418,5,1
220075,421,194,227,11,1
220075,2871,1023,1848,12,3
220075,1132,456,676,19,1
220075,8386,3644,4742,20,1
220075,11577,4970,6607,21,4
220075,9727,4201,5526,22,1
220075,9682,4183,5499,23,1
220075,1849,786,1063,24,1
220075,7833,3397,4436,25,1
220075,45,18,27,31,1
220075,1850,769,1081,32,3
220075,893,391,502,39,1
220075,6940,3006,3934,40,1
220075,3114,1152,1962,41,4
220075,2093,898,1195,42,1
220075,1717,722,995,43,1
220075,32,19,13,44,1
220075,1685,703,982,45,1
220075,376,176,200,51,1
220075,1021,254,767,52,3
220075,239,65,174,59,1
220075,1446,638,808,60,1
220118,345,55,290,1,4
220118,345,55,290,2,1
220118,220,45,175,3,1
220118,28,5,23,4,1
220118,192,40,152,5,1
220118,125,10,115,11,1
220118,192,40,152,20,1
220118,345,55,290,21,4
220118,345,55,290,22,1
220118,220,45,175,23,1
220118,28,5,23,24,1
220118,192,40,152,25,1
220118,125,10,115,31,1
220118,192,40,152,40,1
220127,533,234,299,1,4
220127,533,234,299,2,1
220127,521,228,293,3,1
220127,192,74,118,4,1
220127,329,154,175,5,1
220127,12,6,6,11,1
220127,329,154,175,20,1
220127,435,194,241,21,4
220127,435,194,241,22,1
220127,435,194,241,23,1
220127,160,70,90,24,1
220127,275,124,151,25,1
220127,275,124,151,40,1
220127,98,40,58,41,4
220127,98,40,58,42,1
220127,86,34,52,43,1
220127,32,4,28,44,1
220127,54,30,24,45,1
220127,12,6,6,51,1
220127,54,30,24,60,1
220136,124,89,35,1,4
220136,124,89,35,12,3
220136,51,35,16,21,4
220136,51,35,16,32,3
220136,73,54,19,41,4
220136,73,54,19,52,3
220163,71,3,68,1,4
220163,71,3,68,2,1
220163,71,3,68,3,1
220163,42,2,40,4,1
220163,29,1,28,5,1
220163,29,1,28,20,1
220163,14,1,13,21,4
220163,14,1,13,22,1
220163,14,1,13,23,1
220163,13,1,12,24,1
220163,1,0,1,25,1
220163,1,0,1,40,1
220163,57,2,55,41,4
220163,57,2,55,42,1
220163,57,2,55,43,1
220163,29,1,28,44,1
220163,28,1,27,45,1
220163,28,1,27,60,1
220181,646,223,423,1,4
220181,611,205,406,2,1
220181,611,205,406,3,1
220181,232,75,157,4,1
220181,379,130,249,5,1
220181,35,18,17,12,3
220181,49,22,27,19,1
220181,330,108,222,20,1
220181,612,200,412,21,4
220181,589,188,401,22,1
220181,589,188,401,23,1
220181,230,74,156,24,1
220181,359,114,245,25,1
220181,23,12,11,32,3
220181,49,22,27,39,1
220181,310,92,218,40,1
220181,34,23,11,41,4
220181,22,17,5,42,1
220181,22,17,5,43,1
220181,2,1,1,44,1
220181,20,16,4,45,1
220181,12,6,6,52,3
220181,20,16,4,60,1
220206,338,175,163,1,4
220206,338,175,163,2,1
220206,270,141,129,3,1
220206,63,31,32,4,1
220206,207,110,97,5,1
220206,68,34,34,11,1
220206,30,19,11,19,1
220206,177,91,86,20,1
220206,234,119,115,21,4
220206,234,119,115,22,1
220206,234,119,115,23,1
220206,62,30,32,24,1
220206,172,89,83,25,1
220206,26,15,11,39,1
220206,146,74,72,40,1
220206,104,56,48,41,4
220206,104,56,48,42,1
220206,36,22,14,43,1
220206,1,1,0,44,1
220206,35,21,14,45,1
220206,68,34,34,51,1
220206,4,4,0,59,1
220206,31,17,14,60,1
220215,1811,765,1046,1,4
220215,1385,579,806,2,1
220215,1290,546,744,3,1
220215,356,141,215,4,1
220215,934,405,529,5,1
220215,95,33,62,11,1
220215,426,186,240,12,3
220215,65,36,29,19,1
220215,869,369,500,20,1
220215,1363,580,783,21,4
220215,1262,537,725,22,1
220215,1262,537,725,23,1
220215,355,141,214,24,1
220215,907,396,511,25,1
220215,101,43,58,32,3
220215,63,36,27,39,1
220215,844,360,484,40,1
220215,448,185,263,41,4
220215,123,42,81,42,1
220215,28,9,19,43,1
220215,1,0,1,44,1
220215,27,9,18,45,1
220215,95,33,62,51,1
220215,325,143,182,52,3
220215,2,0,2,59,1
220215,25,9,16,60,1
220251,250,137,113,1,4
220251,250,137,113,2,1
220251,250,137,113,3,1
220251,202,113,89,4,1
220251,48,24,24,5,1
220251,48,24,24,20,1
220251,227,135,92,21,4
220251,227,135,92,22,1
220251,227,135,92,23,1
220251,201,113,88,24,1
220251,26,22,4,25,1
220251,26,22,4,40,1
220251,23,2,21,41,4
220251,23,2,21,42,1
220251,23,2,21,43,1
220251,1,0,1,44,1
220251,22,2,20,45,1
220251,22,2,20,60,1
220279,558,287,271,1,4
220279,558,287,271,2,1
220279,269,161,108,3,1
220279,106,55,51,4,1
220279,163,106,57,5,1
220279,289,126,163,11,1
220279,163,106,57,20,1
220279,216,110,106,21,4
220279,216,110,106,22,1
220279,216,110,106,23,1
220279,88,37,51,24,1
220279,128,73,55,25,1
220279,128,73,55,40,1
220279,342,177,165,41,4
220279,342,177,165,42,1
220279,53,51,2,43,1
220279,18,18,0,44,1
220279,35,33,2,45,1
220279,289,126,163,51,1
220279,35,33,2,60,1
220312,364,159,205,1,4
220312,364,159,205,2,1
220312,222,108,114,3,1
220312,83,33,50,4,1
220312,139,75,64,5,1
220312,142,51,91,11,1
220312,30,17,13,19,1
220312,109,58,51,20,1
220312,207,104,103,21,4
220312,207,104,103,22,1
220312,207,104,103,23,1
220312,80,32,48,24,1
220312,127,72,55,25,1
220312,27,15,12,39,1
220312,100,57,43,40,1
220312,157,55,102,41,4
220312,157,55,102,42,1
220312,15,4,11,43,1
220312,3,1,2,44,1
220312,12,3,9,45,1
220312,142,51,91,51,1
220312,3,2,1,59,1
220312,9,1,8,60,1
220321,363,223,140,1,4
220321,363,223,140,2,1
220321,363,223,140,3,1
220321,62,32,30,4,1
220321,301,191,110,5,1
220321,301,191,110,20,1
220321,309,178,131,21,4
220321,309,178,131,22,1
220321,309,178,131,23,1
220321,61,31,30,24,1
220321,248,147,101,25,1
220321,248,147,101,40,1
220321,54,45,9,41,4
220321,54,45,9,42,1
220321,54,45,9,43,1
220321,1,1,0,44,1
220321,53,44,9,45,1
220321,53,44,9,60,1
220394,246,128,118,1,4
220394,246,128,118,2,1
220394,246,128,118,3,1
220394,99,52,47,4,1
220394,147,76,71,5,1
220394,147,76,71,20,1
220394,223,122,101,21,4
220394,223,122,101,22,1
220394,223,122,101,23,1
220394,81,49,32,24,1
220394,142,73,69,25,1
220394,142,73,69,40,1
220394,23,6,17,41,4
220394,23,6,17,42,1
220394,23,6,17,43,1
220394,18,3,15,44,1
220394,5,3,2,45,1
220394,5,3,2,60,1
220400,4587,1559,3028,1,4
220400,4587,1559,3028,2,1
220400,3413,1161,2252,3,1
220400,874,329,545,4,1
220400,2539,832,1707,5,1
220400,1174,398,776,11,1
220400,249,82,167,19,1
220400,2290,750,1540,20,1
220400,2020,748,1272,21,4
220400,2020,748,1272,22,1
220400,2000,739,1261,23,1
220400,725,271,454,24,1
220400,1275,468,807,25,1
220400,20,9,11,31,1
220400,163,59,104,39,1
220400,1112,409,703,40,1
220400,2567,811,1756,41,4
220400,2567,811,1756,42,1
220400,1413,422,991,43,1
220400,149,58,91,44,1
220400,1264,364,900,45,1
220400,1154,389,765,51,1
220400,86,23,63,59,1
220400,1178,341,837,60,1
220464,122,57,65,1,4
220464,122,57,65,2,1
220464,122,57,65,3,1
220464,23,11,12,4,1
220464,99,46,53,5,1
220464,63,28,35,19,1
220464,36,18,18,20,1
220464,72,34,38,21,4
220464,72,34,38,22,1
220464,72,34,38,23,1
220464,21,9,12,24,1
220464,51,25,26,25,1
220464,40,18,22,39,1
220464,11,7,4,40,1
220464,50,23,27,41,4
220464,50,23,27,42,1
220464,50,23,27,43,1
220464,2,2,0,44,1
220464,48,21,27,45,1
220464,23,10,13,59,1
220464,25,11,14,60,1
220473,1031,531,500,1,4
220473,830,421,409,2,1
220473,826,419,407,3,1
220473,162,80,82,4,1
220473,664,339,325,5,1
220473,4,2,2,11,1
220473,201,110,91,12,3
220473,76,37,39,19,1
220473,588,302,286,20,1
220473,859,441,418,21,4
220473,781,396,385,22,1
220473,781,396,385,23,1
220473,162,80,82,24,1
220473,619,316,303,25,1
220473,78,45,33,32,3
220473,72,35,37,39,1
220473,547,281,266,40,1
220473,172,90,82,41,4
220473,49,25,24,42,1
220473,45,23,22,43,1
220473,45,23,22,45,1
220473,4,2,2,51,1
220473,123,65,58,52,3
220473,4,2,2,59,1
220473,41,21,20,60,1
220491,168,6,162,1,4
220491,168,6,162,2,1
220491,168,6,162,3,1
220491,7,0,7,4,1
220491,161,6,155,5,1
220491,161,6,155,20,1
220491,138,5,133,21,4
220491,138,5,133,22,1
220491,138,5,133,23,1
220491,6,0,6,24,1
220491,132,5,127,25,1
220491,132,5,127,40,1
220491,30,1,29,41,4
220491,30,1,29,42,1
220491,30,1,29,43,1
220491,1,0,1,44,1
220491,29,1,28,45,1
220491,29,1,28,60,1
220516,2575,878,1697,1,4
220516,2191,756,1435,2,1
220516,2121,722,1399,3,1
220516,237,102,135,4,1
220516,1884,620,1264,5,1
220516,70,34,36,11,1
220516,384,122,262,12,3
220516,523,144,379,19,1
220516,1361,476,885,20,1
220516,2369,809,1560,21,4
220516,2040,693,1347,22,1
220516,2037,692,1345,23,1
220516,233,100,133,24,1
220516,1804,592,1212,25,1
220516,3,1,2,31,1
220516,329,116,213,32,3
220516,508,140,368,39,1
220516,1296,452,844,40,1
220516,206,69,137,41,4
220516,151,63,88,42,1
220516,84,30,54,43,1
220516,4,2,2,44,1
220516,80,28,52,45,1
220516,67,33,34,51,1
220516,55,6,49,52,3
220516,15,4,11,59,1
220516,65,24,41,60,1
220552,1116,316,800,1,4
220552,710,182,528,2,1
220552,708,182,526,3,1
220552,183,44,139,4,1
220552,525,138,387,5,1
220552,2,0,2,11,1
220552,406,134,272,12,3
220552,525,138,387,20,1
220552,1116,316,800,21,4
220552,710,182,528,22,1
220552,708,182,526,23,1
220552,183,44,139,24,1
220552,525,138,387,25,1
220552,2,0,2,31,1
220552,406,134,272,32,3
220552,525,138,387,40,1
220570,40,28,12,1,4
220570,40,28,12,2,1
220570,40,28,12,3,1
220570,11,6,5,4,1
220570,29,22,7,5,1
220570,29,22,7,20,1
220570,23,22,1,21,4
220570,23,22,1,22,1
220570,23,22,1,23,1
220570,5,4,1,24,1
220570,18,18,0,25,1
220570,18,18,0,40,1
220570,17,6,11,41,4
220570,17,6,11,42,1
220570,17,6,11,43,1
220570,6,2,4,44,1
220570,11,4,7,45,1
220570,11,4,7,60,1
220598,1554,804,750,1,4
220598,1554,804,750,2,1
220598,1554,804,750,3,1
220598,405,220,185,4,1
220598,1149,584,565,5,1
220598,144,86,58,19,1
220598,1005,498,507,20,1
220598,1534,792,742,21,4
220598,1534,792,742,22,1
220598,1534,792,742,23,1
220598,405,220,185,24,1
220598,1129,572,557,25,1
220598,142,86,56,39,1
220598,987,486,501,40,1
220598,20,12,8,41,4
220598,20,12,8,42,1
220598,20,12,8,43,1
220598,20,12,8,45,1
220598,2,0,2,59,1
220598,18,12,6,60,1
220604,1023,365,658,1,4
220604,1023,365,658,2,1
220604,1009,361,648,3,1
220604,159,71,88,4,1
220604,850,290,560,5,1
220604,14,4,10,11,1
220604,125,38,87,19,1
220604,725,252,473,20,1
220604,879,317,562,21,4
220604,879,317,562,22,1
220604,877,316,561,23,1
220604,149,66,83,24,1
220604,728,250,478,25,1
220604,2,1,1,31,1
220604,106,33,73,39,1
220604,622,217,405,40,1
220604,144,48,96,41,4
220604,144,48,96,42,1
220604,132,45,87,43,1
220604,10,5,5,44,1
220604,122,40,82,45,1
220604,12,3,9,51,1
220604,19,5,14,59,1
220604,103,35,68,60,1
220613,4922,2106,2816,1,4
220613,4550,1958,2592,2,1
220613,4143,1784,2359,3,1
220613,812,307,505,4,1
220613,3331,1477,1854,5,1
220613,407,174,233,11,1
220613,372,148,224,12,3
220613,272,131,141,19,1
220613,3059,1346,1713,20,1
220613,3997,1665,2332,21,4
220613,3830,1613,2217,22,1
220613,3828,1612,2216,23,1
220613,808,304,504,24,1
220613,3020,1308,1712,25,1
220613,2,1,1,31,1
220613,167,52,115,32,3
220613,259,127,132,39,1
220613,2761,1181,1580,40,1
220613,925,441,484,41,4
220613,720,345,375,42,1
220613,315,172,143,43,1
220613,4,3,1,44,1
220613,311,169,142,45,1
220613,405,173,232,51,1
220613,205,96,109,52,3
220613,13,4,9,59,1
220613,298,165,133,60,1
220631,3952,1418,2534,1,4
220631,1713,501,1212,2,1
220631,1632,454,1178,3,1
220631,191,73,118,4,1
220631,1441,381,1060,5,1
220631,81,47,34,11,1
220631,2239,917,1322,12,3
220631,271,55,216,19,1
220631,1170,326,844,20,1
220631,2983,1100,1883,21,4
220631,1185,341,844,22,1
220631,1173,333,840,23,1
220631,121,38,83,24,1
220631,1052,295,757,25,1
220631,12,8,4,31,1
220631,1798,759,1039,32,3
220631,169,33,136,39,1
220631,883,262,621,40,1
220631,969,318,651,41,4
220631,528,160,368,42,1
220631,459,121,338,43,1
220631,70,35,35,44,1
220631,389,86,303,45,1
220631,69,39,30,51,1
220631,441,158,283,52,3
220631,102,22,80,59,1
220631,287,64,223,60,1
220640,442,200,242,1,4
220640,442,200,242,2,1
220640,319,183,136,3,1
220640,109,60,49,4,1
220640,210,123,87,5,1
220640,123,17,106,11,1
220640,210,123,87,20,1
220640,247,116,131,21,4
220640,247,116,131,22,1
220640,247,116,131,23,1
220640,95,50,45,24,1
220640,152,66,86,25,1
220640,152,66,86,40,1
220640,195,84,111,41,4
220640,195,84,111,42,1
220640,72,67,5,43,1
220640,14,10,4,44,1
220640,58,57,1,45,1
220640,123,17,106,51,1
220640,58,57,1,60,1
220701,1144,437,707,1,4
220701,1144,437,707,2,1
220701,1144,437,707,3,1
220701,338,150,188,4,1
220701,806,287,519,5,1
220701,104,41,63,19,1
220701,702,246,456,20,1
220701,1016,393,623,21,4
220701,1016,393,623,22,1
220701,1016,393,623,23,1
220701,335,149,186,24,1
220701,681,244,437,25,1
220701,98,40,58,39,1
220701,583,204,379,40,1
220701,128,44,84,41,4
220701,128,44,84,42,1
220701,128,44,84,43,1
220701,3,1,2,44,1
220701,125,43,82,45,1
220701,6,1,5,59,1
220701,119,42,77,60,1
220710,1168,519,649,1,4
220710,1168,519,649,2,1
220710,1139,506,633,3,1
220710,349,172,177,4,1
220710,790,334,456,5,1
220710,29,13,16,11,1
220710,60,25,35,19,1
220710,730,309,421,20,1
220710,1132,503,629,21,4
220710,1132,503,629,22,1
220710,1132,503,629,23,1
220710,349,172,177,24,1
220710,783,331,452,25,1
220710,60,25,35,39,1
220710,723,306,417,40,1
220710,36,16,20,41,4
220710,36,16,20,42,1
220710,7,3,4,43,1
220710,7,3,4,45,1
220710,29,13,16,51,1
220710,7,3,4,60,1
220756,168,132,36,1,4
220756,168,132,36,2,1
220756,168,132,36,3,1
220756,42,32,10,4,1
220756,126,100,26,5,1
220756,126,100,26,20,1
220756,166,132,34,21,4
220756,166,132,34,22,1
220756,166,132,34,23,1
220756,42,32,10,24,1
220756,124,100,24,25,1
220756,124,100,24,40,1
220756,2,0,2,41,4
220756,2,0,2,42,1
220756,2,0,2,43,1
220756,2,0,2,45,1
220756,2,0,2,60,1
220765,518,96,422,1,4
220765,518,96,422,2,1
220765,518,96,422,3,1
220765,156,29,127,4,1
220765,362,67,295,5,1
220765,362,67,295,20,1
220765,465,87,378,21,4
220765,465,87,378,22,1
220765,465,87,378,23,1
220765,139,24,115,24,1
220765,326,63,263,25,1
220765,326,63,263,40,1
220765,53,9,44,41,4
220765,53,9,44,42,1
220765,53,9,44,43,1
220765,17,5,12,44,1
220765,36,4,32,45,1
220765,36,4,32,60,1
220792,801,324,477,1,4
220792,801,324,477,12,3
220792,801,324,477,21,4
220792,801,324,477,32,3
220808,428,149,279,1,4
220808,368,124,244,2,1
220808,367,124,243,3,1
220808,115,33,82,4,1
220808,252,91,161,5,1
220808,1,0,1,11,1
220808,60,25,35,12,3
220808,25,11,14,19,1
220808,227,80,147,20,1
220808,353,120,233,21,4
220808,325,106,219,22,1
220808,325,106,219,23,1
220808,111,31,80,24,1
220808,214,75,139,25,1
220808,28,14,14,32,3
220808,18,9,9,39,1
220808,196,66,130,40,1
220808,75,29,46,41,4
220808,43,18,25,42,1
220808,42,18,24,43,1
220808,4,2,2,44,1
220808,38,16,22,45,1
220808,1,0,1,51,1
220808,32,11,21,52,3
220808,7,2,5,59,1
220808,31,14,17,60,1
220853,817,559,258,1,4
220853,817,559,258,2,1
220853,817,559,258,3,1
220853,328,183,145,4,1
220853,489,376,113,5,1
220853,489,376,113,20,1
220853,688,473,215,21,4
220853,688,473,215,22,1
220853,688,473,215,23,1
220853,270,155,115,24,1
220853,418,318,100,25,1
220853,418,318,100,40,1
220853,129,86,43,41,4
220853,129,86,43,42,1
220853,129,86,43,43,1
220853,58,28,30,44,1
220853,71,58,13,45,1
220853,71,58,13,60,1
220862,21480,8575,12905,1,4
220862,17223,6821,10402,2,1
220862,16178,6397,9781,3,1
220862,2078,855,1223,4,1
220862,14100,5542,8558,5,1
220862,1045,424,621,11,1
220862,4257,1754,2503,12,3
220862,1441,545,896,19,1
220862,12659,4997,7662,20,1
220862,14385,6095,8290,21,4
220862,12318,5112,7206,22,1
220862,12281,5092,7189,23,1
220862,2025,827,1198,24,1
220862,10256,4265,5991,25,1
220862,37,20,17,31,1
220862,2067,983,1084,32,3
220862,1030,414,616,39,1
220862,9226,3851,5375,40,1
220862,7095,2480,4615,41,4
220862,4905,1709,3196,42,1
220862,3897,1305,2592,43,1
220862,53,28,25,44,1
220862,3844,1277,2567,45,1
220862,1008,404,604,51,1
220862,2190,771,1419,52,3
220862,411,131,280,59,1
220862,3433,1146,2287,60,1
220871,292,172,120,1,4
220871,292,172,120,12,3
220871,181,110,71,21,4
220871,181,110,71,32,3
220871,111,62,49,41,4
220871,111,62,49,52,3
220941,2496,959,1537,1,4
220941,2456,952,1504,2,1
220941,2456,952,1504,3,1
220941,531,255,276,4,1
220941,1925,697,1228,5,1
220941,40,7,33,12,3
220941,304,119,185,19,1
220941,1621,578,1043,20,1
220941,1452,670,782,21,4
220941,1420,664,756,22,1
220941,1420,664,756,23,1
220941,235,157,78,24,1
220941,1185,507,678,25,1
220941,32,6,26,32,3
220941,212,104,108,39,1
220941,973,403,570,40,1
220941,1044,289,755,41,4
220941,1036,288,748,42,1
220941,1036,288,748,43,1
220941,296,98,198,44,1
220941,740,190,550,45,1
220941,8,1,7,52,3
220941,92,15,77,59,1
220941,648,175,473,60,1
220978,23881,10906,12975,1,4
220978,21162,9867,11295,2,1
220978,20914,9711,11203,3,1
220978,3179,1457,1722,4,1
220978,17735,8254,9481,5,1
220978,248,156,92,11,1
220978,2719,1039,1680,12,3
220978,1907,833,1074,19,1
220978,15828,7421,8407,20,1
220978,18280,8511,9769,21,4
220978,17381,8106,9275,22,1
220978,17354,8091,9263,23,1
220978,3129,1433,1696,24,1
220978,14225,6658,7567,25,1
220978,27,15,12,31,1
220978,899,405,494,32,3
220978,1489,678,811,39,1
220978,12736,5980,6756,40,1
220978,5601,2395,3206,41,4
220978,3781,1761,2020,42,1
220978,3560,1620,1940,43,1
220978,50,24,26,44,1
220978,3510,1596,1914,45,1
220978,221,141,80,51,1
220978,1820,634,1186,52,3
220978,418,155,263,59,1
220978,3092,1441,1651,60,1
220996,142,66,76,1,4
220996,142,66,76,12,3
220996,142,66,76,21,4
220996,142,66,76,32,3
221014,1198,433,765,1,4
221014,973,367,606,2,1
221014,933,351,582,3,1
221014,206,91,115,4,1
221014,727,260,467,5,1
221014,40,16,24,11,1
221014,225,66,159,12,3
221014,81,37,44,19,1
221014,646,223,423,20,1
221014,1086,390,696,21,4
221014,884,332,552,22,1
221014,880,330,550,23,1
221014,206,91,115,24,1
221014,674,239,435,25,1
221014,4,2,2,31,1
221014,202,58,144,32,3
221014,71,34,37,39,1
221014,603,205,398,40,1
221014,112,43,69,41,4
221014,89,35,54,42,1
221014,53,21,32,43,1
221014,53,21,32,45,1
221014,36,14,22,51,1
221014,23,8,15,52,3
221014,10,3,7,59,1
221014,43,18,25,60,1
221050,638,425,213,1,4
221050,638,425,213,2,1
221050,638,425,213,3,1
221050,135,71,64,4,1
221050,503,354,149,5,1
221050,503,354,149,20,1
221050,436,279,157,21,4
221050,436,279,157,22,1
221050,436,279,157,23,1
221050,108,54,54,24,1
221050,328,225,103,25,1
221050,328,225,103,40,1
221050,202,146,56,41,4
221050,202,146,56,42,1
221050,202,146,56,43,1
221050,27,17,10,44,1
221050,175,129,46,45,1
221050,175,129,46,60,1
221096,4900,1920,2980,1,4
221096,4900,1920,2980,2,1
221096,3901,1514,2387,3,1
221096,1143,462,681,4,1
221096,2758,1052,1706,5,1
221096,999,406,593,11,1
221096,349,150,199,19,1
221096,2409,902,1507,20,1
221096,1979,796,1183,21,4
221096,1979,796,1183,22,1
221096,1951,784,1167,23,1
221096,852,341,511,24,1
221096,1099,443,656,25,1
221096,28,12,16,31,1
221096,135,67,68,39,1
221096,964,376,588,40,1
221096,2921,1124,1797,41,4
221096,2921,1124,1797,42,1
221096,1950,730,1220,43,1
221096,291,121,170,44,1
221096,1659,609,1050,45,1
221096,971,394,577,51,1
221096,214,83,131,59,1
221096,1445,526,919,60,1
221102,335,160,175,1,4
221102,335,160,175,2,1
221102,335,160,175,3,1
221102,274,140,134,4,1
221102,61,20,41,5,1
221102,61,20,41,20,1
221102,270,118,152,21,4
221102,270,118,152,22,1
221102,270,118,152,23,1
221102,216,104,112,24,1
221102,54,14,40,25,1
221102,54,14,40,40,1
221102,65,42,23,41,4
221102,65,42,23,42,1
221102,65,42,23,43,1
221102,58,36,22,44,1
221102,7,6,1,45,1
221102,7,6,1,60,1
221148,1856,1815,41,1,4
221148,1856,1815,41,2,1
221148,1856,1815,41,3,1
221148,242,236,6,4,1
221148,1614,1579,35,5,1
221148,37,37,0,19,1
221148,1577,1542,35,20,1
221148,1856,1815,41,21,4
221148,1856,1815,41,22,1
221148,1856,1815,41,23,1
221148,242,236,6,24,1
221148,1614,1579,35,25,1
221148,37,37,0,39,1
221148,1577,1542,35,40,1
221157,164,4,160,1,4
221157,164,4,160,2,1
221157,164,4,160,3,1
221157,62,2,60,4,1
221157,102,2,100,5,1
221157,102,2,100,20,1
221157,164,4,160,21,4
221157,164,4,160,22,1
221157,164,4,160,23,1
221157,62,2,60,24,1
221157,102,2,100,25,1
221157,102,2,100,40,1
221184,10007,3961,6046,1,4
221184,10007,3961,6046,2,1
221184,8349,3298,5051,3,1
221184,1507,668,839,4,1
221184,6842,2630,4212,5,1
221184,1658,663,995,11,1
221184,875,342,533,19,1
221184,5967,2288,3679,20,1
221184,3343,1461,1882,21,4
221184,3343,1461,1882,22,1
221184,3262,1418,1844,23,1
221184,844,393,451,24,1
221184,2418,1025,1393,25,1
221184,81,43,38,31,1
221184,383,156,227,39,1
221184,2035,869,1166,40,1
221184,6664,2500,4164,41,4
221184,6664,2500,4164,42,1
221184,5087,1880,3207,43,1
221184,663,275,388,44,1
221184,4424,1605,2819,45,1
221184,1577,620,957,51,1
221184,492,186,306,59,1
221184,3932,1419,2513,60,1
221236,340,181,159,1,4
221236,340,181,159,2,1
221236,240,137,103,3,1
221236,117,50,67,4,1
221236,123,87,36,5,1
221236,100,44,56,11,1
221236,123,87,36,20,1
221236,202,132,70,21,4
221236,202,132,70,22,1
221236,202,132,70,23,1
221236,84,49,35,24,1
221236,118,83,35,25,1
221236,118,83,35,40,1
221236,138,49,89,41,4
221236,138,49,89,42,1
221236,38,5,33,43,1
221236,33,1,32,44,1
221236,5,4,1,45,1
221236,100,44,56,51,1
221236,5,4,1,60,1
221254,180,20,160,1,4
221254,180,20,160,2,1
221254,179,20,159,3,1
221254,27,1,26,4,1
221254,152,19,133,5,1
221254,1,0,1,11,1
221254,7,1,6,19,1
221254,145,18,127,20,1
221254,146,18,128,21,4
221254,146,18,128,22,1
221254,146,18,128,23,1
221254,26,1,25,24,1
221254,120,17,103,25,1
221254,6,1,5,39,1
221254,114,16,98,40,1
221254,34,2,32,41,4
221254,34,2,32,42,1
221254,33,2,31,43,1
221254,1,0,1,44,1
221254,32,2,30,45,1
221254,1,0,1,51,1
221254,1,0,1,59,1
221254,31,2,29,60,1
221281,272,106,166,1,4
221281,272,106,166,2,1
221281,271,105,166,3,1
221281,63,31,32,4,1
221281,208,74,134,5,1
221281,1,1,0,11,1
221281,208,74,134,20,1
221281,246,104,142,21,4
221281,246,104,142,22,1
221281,246,104,142,23,1
221281,62,31,31,24,1
221281,184,73,111,25,1
221281,184,73,111,40,1
221281,26,2,24,41,4
221281,26,2,24,42,1
221281,25,1,24,43,1
221281,1,0,1,44,1
221281,24,1,23,45,1
221281,1,1,0,51,1
221281,24,1,23,60,1
221290,137,4,133,1,4
221290,137,4,133,2,1
221290,137,4,133,3,1
221290,44,1,43,4,1
221290,93,3,90,5,1
221290,93,3,90,20,1
221290,72,2,70,21,4
221290,72,2,70,22,1
221290,72,2,70,23,1
221290,27,1,26,24,1
221290,45,1,44,25,1
221290,45,1,44,40,1
221290,65,2,63,41,4
221290,65,2,63,42,1
221290,65,2,63,43,1
221290,17,0,17,44,1
221290,48,2,46,45,1
221290,48,2,46,60,1
221333,697,411,286,1,4
221333,697,411,286,2,1
221333,200,142,58,3,1
221333,57,37,20,4,1
221333,143,105,38,5,1
221333,497,269,228,11,1
221333,143,105,38,20,1
221333,177,119,58,21,4
221333,177,119,58,22,1
221333,177,119,58,23,1
221333,49,29,20,24,1
221333,128,90,38,25,1
221333,128,90,38,40,1
221333,520,292,228,41,4
221333,520,292,228,42,1
221333,23,23,0,43,1
221333,8,8,0,44,1
221333,15,15,0,45,1
221333,497,269,228,51,1
221333,15,15,0,60,1
221351,2040,855,1185,1,4
221351,2027,845,1182,2,1
221351,2012,841,1171,3,1
221351,545,245,300,4,1
221351,1467,596,871,5,1
221351,15,4,11,11,1
221351,13,10,3,12,3
221351,17,9,8,19,1
221351,1450,587,863,20,1
221351,2027,849,1178,21,4
221351,2014,839,1175,22,1
221351,2006,838,1168,23,1
221351,545,245,300,24,1
221351,1461,593,868,25,1
221351,8,1,7,31,1
221351,13,10,3,32,3
221351,17,9,8,39,1
221351,1444,584,860,40,1
221351,13,6,7,41,4
221351,13,6,7,42,1
221351,6,3,3,43,1
221351,6,3,3,45,1
221351,7,3,4,51,1
221351,6,3,3,60,1
221388,176,91,85,1,4
221388,176,91,85,2,1
221388,126,45,81,3,1
221388,39,16,23,4,1
221388,87,29,58,5,1
221388,50,46,4,11,1
221388,87,29,58,20,1
221388,115,35,80,21,4
221388,115,35,80,22,1
221388,115,35,80,23,1
221388,35,13,22,24,1
221388,80,22,58,25,1
221388,80,22,58,40,1
221388,61,56,5,41,4
221388,61,56,5,42,1
221388,11,10,1,43,1
221388,4,3,1,44,1
221388,7,7,0,45,1
221388,50,46,4,51,1
221388,7,7,0,60,1
221397,6214,2143,4071,1,4
221397,6214,2143,4071,2,1
221397,4952,1698,3254,3,1
221397,1304,514,790,4,1
221397,3648,1184,2464,5,1
221397,1262,445,817,11,1
221397,326,115,211,19,1
221397,3322,1069,2253,20,1
221397,2535,974,1561,21,4
221397,2535,974,1561,22,1
221397,2524,969,1555,23,1
221397,888,365,523,24,1
221397,1636,604,1032,25,1
221397,11,5,6,31,1
221397,128,50,78,39,1
221397,1508,554,954,40,1
221397,3679,1169,2510,41,4
221397,3679,1169,2510,42,1
221397,2428,729,1699,43,1
221397,416,149,267,44,1
221397,2012,580,1432,45,1
221397,1251,440,811,51,1
221397,198,65,133,59,1
221397,1814,515,1299,60,1
221430,249,149,100,1,4
221430,249,149,100,2,1
221430,210,121,89,3,1
221430,105,48,57,4,1
221430,105,73,32,5,1
221430,39,28,11,11,1
221430,105,73,32,20,1
221430,205,116,89,21,4
221430,205,116,89,22,1
221430,202,115,87,23,1
221430,100,44,56,24,1
221430,102,71,31,25,1
221430,3,1,2,31,1
221430,102,71,31,40,1
221430,44,33,11,41,4
221430,44,33,11,42,1
221430,8,6,2,43,1
221430,5,4,1,44,1
221430,3,2,1,45,1
221430,36,27,9,51,1
221430,3,2,1,60,1
221485,10817,4102,6715,1,4
221485,10817,4102,6715,2,1
221485,10217,3875,6342,3,1
221485,2212,922,1290,4,1
221485,8005,2953,5052,5,1
221485,600,227,373,11,1
221485,679,291,388,19,1
221485,7326,2662,4664,20,1
221485,4732,1910,2822,21,4
221485,4732,1910,2822,22,1
221485,4689,1887,2802,23,1
221485,1366,559,807,24,1
221485,3323,1328,1995,25,1
221485,43,23,20,31,1
221485,317,142,175,39,1
221485,3006,1186,1820,40,1
221485,6085,2192,3893,41,4
221485,6085,2192,3893,42,1
221485,5528,1988,3540,43,1
221485,846,363,483,44,1
221485,4682,1625,3057,45,1
221485,557,204,353,51,1
221485,362,149,213,59,1
221485,4320,1476,2844,60,1
221494,436,310,126,1,4
221494,436,310,126,2,1
221494,436,310,126,3,1
221494,194,125,69,4,1
221494,242,185,57,5,1
221494,242,185,57,20,1
221494,330,244,86,21,4
221494,330,244,86,22,1
221494,330,244,86,23,1
221494,163,106,57,24,1
221494,167,138,29,25,1
221494,167,138,29,40,1
221494,106,66,40,41,4
221494,106,66,40,42,1
221494,106,66,40,43,1
221494,31,19,12,44,1
221494,75,47,28,45,1
221494,75,47,28,60,1
221519,1701,842,859,1,4
221519,1620,799,821,2,1
221519,1599,791,808,3,1
221519,488,251,237,4,1
221519,1111,540,571,5,1
221519,21,8,13,11,1
221519,81,43,38,12,3
221519,21,10,11,19,1
221519,1090,530,560,20,1
221519,1669,826,843,21,4
221519,1602,791,811,22,1
221519,1597,789,808,23,1
221519,488,251,237,24,1
221519,1109,538,571,25,1
221519,5,2,3,31,1
221519,67,35,32,32,3
221519,21,10,11,39,1
221519,1088,528,560,40,1
221519,32,16,16,41,4
221519,18,8,10,42,1
221519,2,2,0,43,1
221519,2,2,0,45,1
221519,16,6,10,51,1
221519,14,8,6,52,3
221519,2,2,0,60,1
221582,322,166,156,1,4
221582,322,166,156,2,1
221582,322,166,156,3,1
221582,176,88,88,4,1
221582,146,78,68,5,1
221582,146,78,68,20,1
221582,151,71,80,21,4
221582,151,71,80,22,1
221582,151,71,80,23,1
221582,70,26,44,24,1
221582,81,45,36,25,1
221582,81,45,36,40,1
221582,171,95,76,41,4
221582,171,95,76,42,1
221582,171,95,76,43,1
221582,106,62,44,44,1
221582,65,33,32,45,1
221582,65,33,32,60,1
221591,297,183,114,1,4
221591,297,183,114,2,1
221591,270,170,100,3,1
221591,167,117,50,4,1
221591,103,53,50,5,1
221591,27,13,14,11,1
221591,103,53,50,20,1
221591,239,161,78,21,4
221591,239,161,78,22,1
221591,239,161,78,23,1
221591,148,110,38,24,1
221591,91,51,40,25,1
221591,91,51,40,40,1
221591,58,22,36,41,4
221591,58,22,36,42,1
221591,31,9,22,43,1
221591,19,7,12,44,1
221591,12,2,10,45,1
221591,27,13,14,51,1
221591,12,2,10,60,1
221607,270,127,143,1,4
221607,270,127,143,2,1
221607,188,114,74,3,1
221607,83,58,25,4,1
221607,105,56,49,5,1
221607,82,13,69,11,1
221607,105,56,49,20,1
221607,160,92,68,21,4
221607,160,92,68,22,1
221607,160,92,68,23,1
221607,73,48,25,24,1
221607,87,44,43,25,1
221607,87,44,43,40,1
221607,110,35,75,41,4
221607,110,35,75,42,1
221607,28,22,6,43,1
221607,10,10,0,44,1
221607,18,12,6,45,1
221607,82,13,69,51,1
221607,18,12,6,60,1
221616,425,282,143,1,4
221616,425,282,143,2,1
221616,425,282,143,3,1
221616,207,138,69,4,1
221616,218,144,74,5,1
221616,218,144,74,20,1
221616,425,282,143,21,4
221616,425,282,143,22,1
221616,425,282,143,23,1
221616,207,138,69,24,1
221616,218,144,74,25,1
221616,218,144,74,40,1
221625,760,236,524,1,4
221625,760,236,524,2,1
221625,760,236,524,3,1
221625,342,54,288,4,1
221625,418,182,236,5,1
221625,418,182,236,20,1
221625,536,208,328,21,4
221625,536,208,328,22,1
221625,536,208,328,23,1
221625,182,38,144,24,1
221625,354,170,184,25,1
221625,354,170,184,40,1
221625,224,28,196,41,4
221625,224,28,196,42,1
221625,224,28,196,43,1
221625,160,16,144,44,1
221625,64,12,52,45,1
221625,64,12,52,60,1
221634,184,110,74,1,4
221634,184,110,74,2,1
221634,184,110,74,3,1
221634,52,37,15,4,1
221634,132,73,59,5,1
221634,132,73,59,20,1
221634,174,102,72,21,4
221634,174,102,72,22,1
221634,174,102,72,23,1
221634,49,34,15,24,1
221634,125,68,57,25,1
221634,125,68,57,40,1
221634,10,8,2,41,4
221634,10,8,2,42,1
221634,10,8,2,43,1
221634,3,3,0,44,1
221634,7,5,2,45,1
221634,7,5,2,60,1
221643,10704,5001,5703,1,4
221643,10704,5001,5703,2,1
221643,8776,4146,4630,3,1
221643,2142,1037,1105,4,1
221643,6634,3109,3525,5,1
221643,1928,855,1073,11,1
221643,699,338,361,19,1
221643,5935,2771,3164,20,1
221643,5211,2569,2642,21,4
221643,5211,2569,2642,22,1
221643,5149,2530,2619,23,1
221643,1767,860,907,24,1
221643,3382,1670,1712,25,1
221643,62,39,23,31,1
221643,401,206,195,39,1
221643,2981,1464,1517,40,1
221643,5493,2432,3061,41,4
221643,5493,2432,3061,42,1
221643,3627,1616,2011,43,1
221643,375,177,198,44,1
221643,3252,1439,1813,45,1
221643,1866,816,1050,51,1
221643,298,132,166,59,1
221643,2954,1307,1647,60,1
221661,3255,1366,1889,1,4
221661,2825,1243,1582,2,1
221661,2693,1185,1508,3,1
221661,490,210,280,4,1
221661,2203,975,1228,5,1
221661,132,58,74,11,1
221661,430,123,307,12,3
221661,221,95,126,19,1
221661,1982,880,1102,20,1
221661,2544,1110,1434,21,4
221661,2348,1059,1289,22,1
221661,2347,1059,1288,23,1
221661,480,207,273,24,1
221661,1867,852,1015,25,1
221661,1,0,1,31,1
221661,196,51,145,32,3
221661,185,89,96,39,1
221661,1682,763,919,40,1
221661,711,256,455,41,4
221661,477,184,293,42,1
221661,346,126,220,43,1
221661,10,3,7,44,1
221661,336,123,213,45,1
221661,131,58,73,51,1
221661,234,72,162,52,3
221661,36,6,30,59,1
221661,300,117,183,60,1
221670,508,223,285,1,4
221670,508,223,285,12,3
221670,508,223,285,21,4
221670,508,223,285,32,3
221731,1084,410,674,1,4
221731,1068,407,661,2,1
221731,1068,407,661,3,1
221731,211,91,120,4,1
221731,857,316,541,5,1
221731,16,3,13,12,3
221731,178,73,105,19,1
221731,679,243,436,20,1
221731,991,377,614,21,4
221731,991,377,614,22,1
221731,991,377,614,23,1
221731,208,88,120,24,1
221731,783,289,494,25,1
221731,157,63,94,39,1
221731,626,226,400,40,1
221731,93,33,60,41,4
221731,77,30,47,42,1
221731,77,30,47,43,1
221731,3,3,0,44,1
221731,74,27,47,45,1
221731,16,3,13,52,3
221731,21,10,11,59,1
221731,53,17,36,60,1
221740,11674,5237,6437,1,4
221740,10297,4615,5682,2,1
221740,10184,4562,5622,3,1
221740,2342,1004,1338,4,1
221740,7842,3558,4284,5,1
221740,113,53,60,11,1
221740,1377,622,755,12,3
221740,829,371,458,19,1
221740,7013,3187,3826,20,1
221740,9676,4301,5375,21,4
221740,9066,4029,5037,22,1
221740,9043,4022,5021,23,1
221740,2335,1000,1335,24,1
221740,6708,3022,3686,25,1
221740,23,7,16,31,1
221740,610,272,338,32,3
221740,623,291,332,39,1
221740,6085,2731,3354,40,1
221740,1998,936,1062,41,4
221740,1231,586,645,42,1
221740,1141,540,601,43,1
221740,7,4,3,44,1
221740,1134,536,598,45,1
221740,90,46,44,51,1
221740,767,350,417,52,3
221740,206,80,126,59,1
221740,928,456,472,60,1
221759,30030,14871,15159,1,4
221759,21182,10744,10438,2,1
221759,20948,10637,10311,3,1
221759,4276,2088,2188,4,1
221759,16672,8549,8123,5,1
221759,234,107,127,11,1
221759,8848,4127,4721,12,3
221759,1528,748,780,19,1
221759,15144,7801,7343,20,1
221759,26283,13042,13241,21,4
221759,19799,10030,9769,22,1
221759,19685,9977,9708,23,1
221759,4261,2082,2179,24,1
221759,15424,7895,7529,25,1
221759,114,53,61,31,1
221759,6484,3012,3472,32,3
221759,1357,685,672,39,1
221759,14067,7210,6857,40,1
221759,3747,1829,1918,41,4
221759,1383,714,669,42,1
221759,1263,660,603,43,1
221759,15,6,9,44,1
221759,1248,654,594,45,1
221759,120,54,66,51,1
221759,2364,1115,1249,52,3
221759,171,63,108,59,1
221759,1077,591,486,60,1
221768,7423,3106,4317,1,4
221768,7025,2978,4047,2,1
221768,6554,2805,3749,3,1
221768,1308,603,705,4,1
221768,5246,2202,3044,5,1
221768,471,173,298,11,1
221768,398,128,270,12,3
221768,421,185,236,19,1
221768,4825,2017,2808,20,1
221768,5988,2627,3361,21,4
221768,5927,2605,3322,22,1
221768,5919,2602,3317,23,1
221768,1301,600,701,24,1
221768,4618,2002,2616,25,1
221768,8,3,5,31,1
221768,61,22,39,32,3
221768,366,171,195,39,1
221768,4252,1831,2421,40,1
221768,1435,479,956,41,4
221768,1098,373,725,42,1
221768,635,203,432,43,1
221768,7,3,4,44,1
221768,628,200,428,45,1
221768,463,170,293,51,1
221768,337,106,231,52,3
221768,55,14,41,59,1
221768,573,186,387,60,1
221795,180,150,30,1,4
221795,180,150,30,2,1
221795,180,150,30,3,1
221795,51,37,14,4,1
221795,129,113,16,5,1
221795,47,45,2,19,1
221795,82,68,14,20,1
221795,180,150,30,21,4
221795,180,150,30,22,1
221795,180,150,30,23,1
221795,51,37,14,24,1
221795,129,113,16,25,1
221795,47,45,2,39,1
221795,82,68,14,40,1
221829,173,6,167,1,4
221829,173,6,167,2,1
221829,173,6,167,3,1
221829,68,1,67,4,1
221829,105,5,100,5,1
221829,105,5,100,20,1
221829,173,6,167,21,4
221829,173,6,167,22,1
221829,173,6,167,23,1
221829,68,1,67,24,1
221829,105,5,100,25,1
221829,105,5,100,40,1
221838,8883,3289,5594,1,4
221838,6816,2665,4151,2,1
221838,6669,2586,4083,3,1
221838,1363,560,803,4,1
221838,5306,2026,3280,5,1
221838,147,79,68,11,1
221838,2067,624,1443,12,3
221838,657,236,421,19,1
221838,4649,1790,2859,20,1
221838,6269,2463,3806,21,4
221838,5427,2188,3239,22,1
221838,5408,2178,3230,23,1
221838,1326,541,785,24,1
221838,4082,1637,2445,25,1
221838,19,10,9,31,1
221838,842,275,567,32,3
221838,403,166,237,39,1
221838,3679,1471,2208,40,1
221838,2614,826,1788,41,4
221838,1389,477,912,42,1
221838,1261,408,853,43,1
221838,37,19,18,44,1
221838,1224,389,835,45,1
221838,128,69,59,51,1
221838,1225,349,876,52,3
221838,254,70,184,59,1
221838,970,319,651,60,1
221847,11118,6042,5076,1,4
221847,10052,5600,4452,2,1
221847,9827,5490,4337,3,1
221847,2175,1243,932,4,1
221847,7652,4247,3405,5,1
221847,225,110,115,11,1
221847,1066,442,624,12,3
221847,652,307,345,19,1
221847,7000,3940,3060,20,1
221847,9521,5310,4211,21,4
221847,9140,5125,4015,22,1
221847,9123,5120,4003,23,1
221847,2161,1234,927,24,1
221847,6962,3886,3076,25,1
221847,17,5,12,31,1
221847,381,185,196,32,3
221847,593,286,307,39,1
221847,6369,3600,2769,40,1
221847,1597,732,865,41,4
221847,912,475,437,42,1
221847,704,370,334,43,1
221847,14,9,5,44,1
221847,690,361,329,45,1
221847,208,105,103,51,1
221847,685,257,428,52,3
221847,59,21,38,59,1
221847,631,340,291,60,1
221856,1010,539,471,1,4
221856,743,345,398,2,1
221856,704,329,375,3,1
221856,186,82,104,4,1
221856,518,247,271,5,1
221856,39,16,23,11,1
221856,267,194,73,12,3
221856,89,37,52,19,1
221856,429,210,219,20,1
221856,576,331,245,21,4
221856,451,237,214,22,1
221856,451,237,214,23,1
221856,130,68,62,24,1
221856,321,169,152,25,1
221856,125,94,31,32,3
221856,55,28,27,39,1
221856,266,141,125,40,1
221856,434,208,226,41,4
221856,292,108,184,42,1
221856,253,92,161,43,1
221856,56,14,42,44,1
221856,197,78,119,45,1
221856,39,16,23,51,1
221856,142,100,42,52,3
221856,34,9,25,59,1
221856,163,69,94,60,1
221892,2406,959,1447,1,4
221892,1492,667,825,2,1
221892,1448,646,802,3,1
221892,246,109,137,4,1
221892,1202,537,665,5,1
221892,44,21,23,11,1
221892,914,292,622,12,3
221892,73,33,40,19,1
221892,1129,504,625,20,1
221892,1687,685,1002,21,4
221892,1016,471,545,22,1
221892,999,461,538,23,1
221892,245,109,136,24,1
221892,754,352,402,25,1
221892,17,10,7,31,1
221892,671,214,457,32,3
221892,71,32,39,39,1
221892,683,320,363,40,1
221892,719,274,445,41,4
221892,476,196,280,42,1
221892,449,185,264,43,1
221892,1,0,1,44,1
221892,448,185,263,45,1
221892,27,11,16,51,1
221892,243,78,165,52,3
221892,2,1,1,59,1
221892,446,184,262,60,1
221908,5893,2779,3114,1,4
221908,5893,2779,3114,2,1
221908,5052,2330,2722,3,1
221908,1019,486,533,4,1
221908,4033,1844,2189,5,1
221908,841,449,392,11,1
221908,336,157,179,19,1
221908,3697,1687,2010,20,1
221908,3111,1466,1645,21,4
221908,3111,1466,1645,22,1
221908,3090,1460,1630,23,1
221908,855,400,455,24,1
221908,2235,1060,1175,25,1
221908,21,6,15,31,1
221908,205,106,99,39,1
221908,2030,954,1076,40,1
221908,2782,1313,1469,41,4
221908,2782,1313,1469,42,1
221908,1962,870,1092,43,1
221908,164,86,78,44,1
221908,1798,784,1014,45,1
221908,820,443,377,51,1
221908,131,51,80,59,1
221908,1667,733,934,60,1
221953,2055,877,1178,1,4
221953,1844,794,1050,2,1
221953,1844,794,1050,3,1
221953,318,174,144,4,1
221953,1526,620,906,5,1
221953,211,83,128,12,3
221953,74,43,31,19,1
221953,1452,577,875,20,1
221953,1928,838,1090,21,4
221953,1741,764,977,22,1
221953,1741,764,977,23,1
221953,313,172,141,24,1
221953,1428,592,836,25,1
221953,187,74,113,32,3
221953,72,43,29,39,1
221953,1356,549,807,40,1
221953,127,39,88,41,4
221953,103,30,73,42,1
221953,103,30,73,43,1
221953,5,2,3,44,1
221953,98,28,70,45,1
221953,24,9,15,52,3
221953,2,0,2,59,1
221953,96,28,68,60,1
221971,3993,1532,2461,1,4
221971,2826,1104,1722,2,1
221971,2565,975,1590,3,1
221971,366,149,217,4,1
221971,2199,826,1373,5,1
221971,261,129,132,11,1
221971,1167,428,739,12,3
221971,747,203,544,19,1
221971,1452,623,829,20,1
221971,3047,1102,1945,21,4
221971,2175,795,1380,22,1
221971,2174,795,1379,23,1
221971,315,107,208,24,1
221971,1859,688,1171,25,1
221971,1,0,1,31,1
221971,872,307,565,32,3
221971,559,164,395,39,1
221971,1300,524,776,40,1
221971,946,430,516,41,4
221971,651,309,342,42,1
221971,391,180,211,43,1
221971,51,42,9,44,1
221971,340,138,202,45,1
221971,260,129,131,51,1
221971,295,121,174,52,3
221971,188,39,149,59,1
221971,152,99,53,60,1
221980,124,2,122,1,4
221980,124,2,122,2,1
221980,124,2,122,3,1
221980,104,2,102,4,1
221980,20,0,20,5,1
221980,20,0,20,20,1
221980,2,0,2,21,4
221980,2,0,2,22,1
221980,2,0,2,23,1
221980,1,0,1,24,1
221980,1,0,1,25,1
221980,1,0,1,40,1
221980,122,2,120,41,4
221980,122,2,120,42,1
221980,122,2,120,43,1
221980,103,2,101,44,1
221980,19,0,19,45,1
221980,19,0,19,60,1
221999,12757,5975,6782,1,4
221999,6835,3429,3406,2,1
221999,6794,3409,3385,3,1
221999,1613,784,829,4,1
221999,5181,2625,2556,5,1
221999,41,20,21,11,1
221999,5922,2546,3376,12,3
221999,206,93,113,19,1
221999,4975,2532,2443,20,1
221999,11965,5774,6191,21,4
221999,6764,3387,3377,22,1
221999,6755,3384,3371,23,1
221999,1613,784,829,24,1
221999,5142,2600,2542,25,1
221999,9,3,6,31,1
221999,5201,2387,2814,32,3
221999,205,92,113,39,1
221999,4937,2508,2429,40,1
221999,792,201,591,41,4
221999,71,42,29,42,1
221999,39,25,14,43,1
221999,39,25,14,45,1
221999,32,17,15,51,1
221999,721,159,562,52,3
221999,1,1,0,59,1
221999,38,24,14,60,1
222026,59,1,58,1,4
222026,59,1,58,2,1
222026,59,1,58,3,1
222026,13,1,12,4,1
222026,46,0,46,5,1
222026,46,0,46,20,1
222026,33,1,32,21,4
222026,33,1,32,22,1
222026,33,1,32,23,1
222026,4,1,3,24,1
222026,29,0,29,25,1
222026,29,0,29,40,1
222026,26,0,26,41,4
222026,26,0,26,42,1
222026,26,0,26,43,1
222026,9,0,9,44,1
222026,17,0,17,45,1
222026,17,0,17,60,1
222053,8153,3158,4995,1,4
222053,8153,3158,4995,2,1
222053,6415,2492,3923,3,1
222053,1563,658,905,4,1
222053,4852,1834,3018,5,1
222053,1738,666,1072,11,1
222053,532,204,328,19,1
222053,4320,1630,2690,20,1
222053,3447,1458,1989,21,4
222053,3447,1458,1989,22,1
222053,3420,1450,1970,23,1
222053,1142,492,650,24,1
222053,2278,958,1320,25,1
222053,27,8,19,31,1
222053,278,117,161,39,1
222053,2000,841,1159,40,1
222053,4706,1700,3006,41,4
222053,4706,1700,3006,42,1
222053,2995,1042,1953,43,1
222053,421,166,255,44,1
222053,2574,876,1698,45,1
222053,1711,658,1053,51,1
222053,254,87,167,59,1
222053,2320,789,1531,60,1
222062,6265,2423,3842,1,4
222062,6265,2423,3842,2,1
222062,4789,1872,2917,3,1
222062,1363,583,780,4,1
222062,3426,1289,2137,5,1
222062,1476,551,925,11,1
222062,178,74,104,19,1
222062,3248,1215,2033,20,1
222062,3171,1299,1872,21,4
222062,3171,1299,1872,22,1
222062,3129,1280,1849,23,1
222062,1196,501,695,24,1
222062,1933,779,1154,25,1
222062,42,19,23,31,1
222062,104,48,56,39,1
222062,1829,731,1098,40,1
222062,3094,1124,1970,41,4
222062,3094,1124,1970,42,1
222062,1660,592,1068,43,1
222062,167,82,85,44,1
222062,1493,510,983,45,1
222062,1434,532,902,51,1
222062,74,26,48,59,1
222062,1419,484,935,60,1
222099,212,9,203,1,4
222099,212,9,203,2,1
222099,212,9,203,3,1
222099,93,5,88,4,1
222099,119,4,115,5,1
222099,119,4,115,20,1
222099,209,9,200,21,4
222099,209,9,200,22,1
222099,209,9,200,23,1
222099,93,5,88,24,1
222099,116,4,112,25,1
222099,116,4,112,40,1
222099,3,0,3,41,4
222099,3,0,3,42,1
222099,3,0,3,43,1
222099,3,0,3,45,1
222099,3,0,3,60,1
222105,219,217,2,1,4
222105,219,217,2,2,1
222105,219,217,2,3,1
222105,133,133,0,4,1
222105,86,84,2,5,1
222105,86,84,2,20,1
222105,86,85,1,21,4
222105,86,85,1,22,1
222105,86,85,1,23,1
222105,61,61,0,24,1
222105,25,24,1,25,1
222105,25,24,1,40,1
222105,133,132,1,41,4
222105,133,132,1,42,1
222105,133,132,1,43,1
222105,72,72,0,44,1
222105,61,60,1,45,1
222105,61,60,1,60,1
222178,4461,1893,2568,1,4
222178,3727,1599,2128,2,1
222178,3647,1564,2083,3,1
222178,1030,401,629,4,1
222178,2617,1163,1454,5,1
222178,80,35,45,11,1
222178,734,294,440,12,3
222178,116,65,51,19,1
222178,2501,1098,1403,20,1
222178,3831,1615,2216,21,4
222178,3510,1500,2010,22,1
222178,3502,1498,2004,23,1
222178,1026,398,628,24,1
222178,2476,1100,1376,25,1
222178,8,2,6,31,1
222178,321,115,206,32,3
222178,115,64,51,39,1
222178,2361,1036,1325,40,1
222178,630,278,352,41,4
222178,217,99,118,42,1
222178,145,66,79,43,1
222178,4,3,1,44,1
222178,141,63,78,45,1
222178,72,33,39,51,1
222178,413,179,234,52,3
222178,1,1,0,59,1
222178,140,62,78,60,1
222567,5118,2142,2976,1,4
222567,5118,2142,2976,2,1
222567,4227,1751,2476,3,1
222567,1106,482,624,4,1
222567,3121,1269,1852,5,1
222567,891,391,500,11,1
222567,1511,587,924,19,1
222567,1610,682,928,20,1
222567,1459,647,812,21,4
222567,1459,647,812,22,1
222567,1332,595,737,23,1
222567,431,182,249,24,1
222567,901,413,488,25,1
222567,127,52,75,31,1
222567,440,212,228,39,1
222567,461,201,260,40,1
222567,3659,1495,2164,41,4
222567,3659,1495,2164,42,1
222567,2895,1156,1739,43,1
222567,675,300,375,44,1
222567,2220,856,1364,45,1
222567,764,339,425,51,1
222567,1071,375,696,59,1
222567,1149,481,668,60,1
222576,10873,4242,6631,1,4
222576,10873,4242,6631,2,1
222576,10009,3909,6100,3,1
222576,1485,667,818,4,1
222576,8524,3242,5282,5,1
222576,864,333,531,11,1
222576,305,110,195,19,1
222576,8219,3132,5087,20,1
222576,3175,1359,1816,21,4
222576,3175,1359,1816,22,1
222576,3012,1294,1718,23,1
222576,838,390,448,24,1
222576,2174,904,1270,25,1
222576,163,65,98,31,1
222576,123,51,72,39,1
222576,2051,853,1198,40,1
222576,7698,2883,4815,41,4
222576,7698,2883,4815,42,1
222576,6997,2615,4382,43,1
222576,647,277,370,44,1
222576,6350,2338,4012,45,1
222576,701,268,433,51,1
222576,182,59,123,59,1
222576,6168,2279,3889,60,1
222628,1403,485,918,1,4
222628,261,102,159,2,1
222628,261,102,159,3,1
222628,261,102,159,5,1
222628,1142,383,759,12,3
222628,67,33,34,19,1
222628,194,69,125,20,1
222628,653,98,555,21,4
222628,143,56,87,22,1
222628,143,56,87,23,1
222628,143,56,87,25,1
222628,510,42,468,32,3
222628,37,18,19,39,1
222628,106,38,68,40,1
222628,750,387,363,41,4
222628,118,46,72,42,1
222628,118,46,72,43,1
222628,118,46,72,45,1
222628,632,341,291,52,3
222628,30,15,15,59,1
222628,88,31,57,60,1
222673,81,4,77,1,4
222673,81,4,77,2,1
222673,81,4,77,3,1
222673,70,4,66,4,1
222673,11,0,11,5,1
222673,11,0,11,20,1
222673,57,2,55,21,4
222673,57,2,55,22,1
222673,57,2,55,23,1
222673,49,2,47,24,1
222673,8,0,8,25,1
222673,8,0,8,40,1
222673,24,2,22,41,4
222673,24,2,22,42,1
222673,24,2,22,43,1
222673,21,2,19,44,1
222673,3,0,3,45,1
222673,3,0,3,60,1
222707,23,0,23,1,4
222707,23,0,23,2,1
222707,23,0,23,3,1
222707,17,0,17,4,1
222707,6,0,6,5,1
222707,6,0,6,20,1
222707,13,0,13,21,4
222707,13,0,13,22,1
222707,13,0,13,23,1
222707,11,0,11,24,1
222707,2,0,2,25,1
222707,2,0,2,40,1
222707,10,0,10,41,4
222707,10,0,10,42,1
222707,10,0,10,43,1
222707,6,0,6,44,1
222707,4,0,4,45,1
222707,4,0,4,60,1
222822,5490,1995,3495,1,4
222822,5490,1995,3495,2,1
222822,4203,1486,2717,3,1
222822,1208,521,687,4,1
222822,2995,965,2030,5,1
222822,1287,509,778,11,1
222822,275,111,164,19,1
222822,2720,854,1866,20,1
222822,2081,797,1284,21,4
222822,2081,797,1284,22,1
222822,2023,775,1248,23,1
222822,796,339,457,24,1
222822,1227,436,791,25,1
222822,58,22,36,31,1
222822,123,55,68,39,1
222822,1104,381,723,40,1
222822,3409,1198,2211,41,4
222822,3409,1198,2211,42,1
222822,2180,711,1469,43,1
222822,412,182,230,44,1
222822,1768,529,1239,45,1
222822,1229,487,742,51,1
222822,152,56,96,59,1
222822,1616,473,1143,60,1
222831,6536,2884,3652,1,4
222831,5473,2533,2940,2,1
222831,5430,2518,2912,3,1
222831,1220,574,646,4,1
222831,4210,1944,2266,5,1
222831,43,15,28,11,1
222831,1063,351,712,12,3
222831,537,231,306,19,1
222831,3673,1713,1960,20,1
222831,5177,2356,2821,21,4
222831,4698,2195,2503,22,1
222831,4698,2195,2503,23,1
222831,1207,563,644,24,1
222831,3491,1632,1859,25,1
222831,479,161,318,32,3
222831,458,204,254,39,1
222831,3033,1428,1605,40,1
222831,1359,528,831,41,4
222831,775,338,437,42,1
222831,732,323,409,43,1
222831,13,11,2,44,1
222831,719,312,407,45,1
222831,43,15,28,51,1
222831,584,190,394,52,3
222831,79,27,52,59,1
222831,640,285,355,60,1
222877,245,162,83,1,4
222877,231,153,78,2,1
222877,230,153,77,3,1
222877,44,25,19,4,1
222877,186,128,58,5,1
222877,1,0,1,11,1
222877,14,9,5,12,3
222877,28,20,8,19,1
222877,158,108,50,20,1
222877,218,144,74,21,4
222877,207,138,69,22,1
222877,207,138,69,23,1
222877,43,25,18,24,1
222877,164,113,51,25,1
222877,11,6,5,32,3
222877,26,18,8,39,1
222877,138,95,43,40,1
222877,27,18,9,41,4
222877,24,15,9,42,1
222877,23,15,8,43,1
222877,1,0,1,44,1
222877,22,15,7,45,1
222877,1,0,1,51,1
222877,3,3,0,52,3
222877,2,2,0,59,1
222877,20,13,7,60,1
222886,235,11,224,1,4
222886,235,11,224,2,1
222886,235,11,224,3,1
222886,166,10,156,4,1
222886,69,1,68,5,1
222886,69,1,68,20,1
222886,186,11,175,21,4
222886,186,11,175,22,1
222886,186,11,175,23,1
222886,134,10,124,24,1
222886,52,1,51,25,1
222886,52,1,51,40,1
222886,49,0,49,41,4
222886,49,0,49,42,1
222886,49,0,49,43,1
222886,32,0,32,44,1
222886,17,0,17,45,1
222886,17,0,17,60,1
222938,2338,1157,1181,1,4
222938,2338,1157,1181,2,1
222938,2300,1140,1160,3,1
222938,464,240,224,4,1
222938,1836,900,936,5,1
222938,38,17,21,11,1
222938,359,159,200,19,1
222938,1477,741,736,20,1
222938,1680,864,816,21,4
222938,1680,864,816,22,1
222938,1680,864,816,23,1
222938,379,199,180,24,1
222938,1301,665,636,25,1
222938,276,126,150,39,1
222938,1025,539,486,40,1
222938,658,293,365,41,4
222938,658,293,365,42,1
222938,620,276,344,43,1
222938,85,41,44,44,1
222938,535,235,300,45,1
222938,38,17,21,51,1
222938,83,33,50,59,1
222938,452,202,250,60,1
222983,1223,598,625,1,4
222983,1207,590,617,2,1
222983,1206,589,617,3,1
222983,364,181,183,4,1
222983,842,408,434,5,1
222983,1,1,0,11,1
222983,16,8,8,12,3
222983,25,12,13,19,1
222983,817,396,421,20,1
222983,1220,596,624,21,4
222983,1204,588,616,22,1
222983,1204,588,616,23,1
222983,364,181,183,24,1
222983,840,407,433,25,1
222983,16,8,8,32,3
222983,25,12,13,39,1
222983,815,395,420,40,1
222983,3,2,1,41,4
222983,3,2,1,42,1
222983,2,1,1,43,1
222983,2,1,1,45,1
222983,1,1,0,51,1
222983,2,1,1,60,1
222992,41627,18510,23117,1,4
222992,41627,18510,23117,2,1
222992,32715,14679,18036,3,1
222992,5650,2747,2903,4,1
222992,27065,11932,15133,5,1
222992,8912,3831,5081,11,1
222992,3691,1792,1899,19,1
222992,23374,10140,13234,20,1
222992,9476,5009,4467,21,4
222992,9476,5009,4467,22,1
222992,9054,4780,4274,23,1
222992,2396,1212,1184,24,1
222992,6658,3568,3090,25,1
222992,422,229,193,31,1
222992,1331,760,571,39,1
222992,5327,2808,2519,40,1
222992,32151,13501,18650,41,4
222992,32151,13501,18650,42,1
222992,23661,9899,13762,43,1
222992,3254,1535,1719,44,1
222992,20407,8364,12043,45,1
222992,8490,3602,4888,51,1
222992,2360,1032,1328,59,1
222992,18047,7332,10715,60,1
223001,140,60,80,1,4
223001,140,60,80,12,3
223001,101,45,56,21,4
223001,101,45,56,32,3
223001,39,15,24,41,4
223001,39,15,24,52,3
223056,76,8,68,1,4
223056,76,8,68,2,1
223056,76,8,68,3,1
223056,71,8,63,4,1
223056,5,0,5,5,1
223056,5,0,5,20,1
223056,76,8,68,21,4
223056,76,8,68,22,1
223056,76,8,68,23,1
223056,71,8,63,24,1
223056,5,0,5,25,1
223056,5,0,5,40,1
223083,444,93,351,1,4
223083,444,93,351,2,1
223083,444,93,351,3,1
223083,444,93,351,5,1
223083,78,21,57,19,1
223083,366,72,294,20,1
223083,444,93,351,21,4
223083,444,93,351,22,1
223083,444,93,351,23,1
223083,444,93,351,25,1
223083,78,21,57,39,1
223083,366,72,294,40,1
223117,123,106,17,1,4
223117,55,43,12,2,1
223117,55,43,12,3,1
223117,5,4,1,4,1
223117,50,39,11,5,1
223117,68,63,5,12,3
223117,12,12,0,19,1
223117,38,27,11,20,1
223117,41,37,4,21,4
223117,19,16,3,22,1
223117,19,16,3,23,1
223117,19,16,3,25,1
223117,22,21,1,32,3
223117,6,6,0,39,1
223117,13,10,3,40,1
223117,82,69,13,41,4
223117,36,27,9,42,1
223117,36,27,9,43,1
223117,5,4,1,44,1
223117,31,23,8,45,1
223117,46,42,4,52,3
223117,6,6,0,59,1
223117,25,17,8,60,1
223214,2417,1047,1370,1,4
223214,243,20,223,2,1
223214,243,20,223,3,1
223214,243,20,223,5,1
223214,2174,1027,1147,12,3
223214,30,1,29,19,1
223214,213,19,194,20,1
223214,2277,1005,1272,21,4
223214,243,20,223,22,1
223214,243,20,223,23,1
223214,243,20,223,25,1
223214,2034,985,1049,32,3
223214,30,1,29,39,1
223214,213,19,194,40,1
223214,140,42,98,41,4
223214,140,42,98,52,3
223223,1552,762,790,1,4
223223,1552,762,790,12,3
223223,1552,762,790,21,4
223223,1552,762,790,32,3
223232,15616,6806,8810,1,4
223232,13292,5566,7726,2,1
223232,13221,5535,7686,3,1
223232,3190,1341,1849,4,1
223232,10031,4194,5837,5,1
223232,71,31,40,11,1
223232,2324,1240,1084,12,3
223232,487,244,243,19,1
223232,9544,3950,5594,20,1
223232,15016,6505,8511,21,4
223232,13059,5442,7617,22,1
223232,13033,5432,7601,23,1
223232,3189,1340,1849,24,1
223232,9844,4092,5752,25,1
223232,26,10,16,31,1
223232,1957,1063,894,32,3
223232,484,242,242,39,1
223232,9360,3850,5510,40,1
223232,600,301,299,41,4
223232,233,124,109,42,1
223232,188,103,85,43,1
223232,1,1,0,44,1
223232,187,102,85,45,1
223232,45,21,24,51,1
223232,367,177,190,52,3
223232,3,2,1,59,1
223232,184,100,84,60,1
223320,3533,1310,2223,1,4
223320,3533,1310,2223,2,1
223320,2284,763,1521,3,1
223320,463,199,264,4,1
223320,1821,564,1257,5,1
223320,1249,547,702,11,1
223320,195,90,105,19,1
223320,1626,474,1152,20,1
223320,1374,512,862,21,4
223320,1374,512,862,22,1
223320,1308,484,824,23,1
223320,350,158,192,24,1
223320,958,326,632,25,1
223320,66,28,38,31,1
223320,127,58,69,39,1
223320,831,268,563,40,1
223320,2159,798,1361,41,4
223320,2159,798,1361,42,1
223320,976,279,697,43,1
223320,113,41,72,44,1
223320,863,238,625,45,1
223320,1183,519,664,51,1
223320,68,32,36,59,1
223320,795,206,589,60,1
223427,18561,9012,9549,1,4
223427,18561,9012,9549,2,1
223427,16664,8150,8514,3,1
223427,9119,4538,4581,4,1
223427,7545,3612,3933,5,1
223427,1897,862,1035,11,1
223427,334,158,176,19,1
223427,7211,3454,3757,20,1
223427,9503,4794,4709,21,4
223427,9503,4794,4709,22,1
223427,9416,4758,4658,23,1
223427,5592,2816,2776,24,1
223427,3824,1942,1882,25,1
223427,87,36,51,31,1
223427,148,84,64,39,1
223427,3676,1858,1818,40,1
223427,9058,4218,4840,41,4
223427,9058,4218,4840,42,1
223427,7248,3392,3856,43,1
223427,3527,1722,1805,44,1
223427,3721,1670,2051,45,1
223427,1810,826,984,51,1
223427,186,74,112,59,1
223427,3535,1596,1939,60,1
223463,904,225,679,1,4
223463,904,225,679,2,1
223463,904,225,679,3,1
223463,330,74,256,4,1
223463,574,151,423,5,1
223463,13,4,9,19,1
223463,561,147,414,20,1
223463,904,225,679,21,4
223463,904,225,679,22,1
223463,904,225,679,23,1
223463,330,74,256,24,1
223463,574,151,423,25,1
223463,13,4,9,39,1
223463,561,147,414,40,1
223472,196,17,179,1,4
223472,196,17,179,2,1
223472,196,17,179,3,1
223472,23,3,20,4,1
223472,173,14,159,5,1
223472,43,5,38,19,1
223472,130,9,121,20,1
223472,196,17,179,21,4
223472,196,17,179,22,1
223472,196,17,179,23,1
223472,23,3,20,24,1
223472,173,14,159,25,1
223472,43,5,38,39,1
223472,130,9,121,40,1
223506,4127,2127,2000,1,4
223506,4127,2127,2000,2,1
223506,3217,1713,1504,3,1
223506,639,373,266,4,1
223506,2578,1340,1238,5,1
223506,910,414,496,11,1
223506,230,131,99,19,1
223506,2348,1209,1139,20,1
223506,966,496,470,21,4
223506,966,496,470,22,1
223506,945,486,459,23,1
223506,262,148,114,24,1
223506,683,338,345,25,1
223506,21,10,11,31,1
223506,77,35,42,39,1
223506,606,303,303,40,1
223506,3161,1631,1530,41,4
223506,3161,1631,1530,42,1
223506,2272,1227,1045,43,1
223506,377,225,152,44,1
223506,1895,1002,893,45,1
223506,889,404,485,51,1
223506,153,96,57,59,1
223506,1742,906,836,60,1
223524,12319,5141,7178,1,4
223524,12319,5141,7178,2,1
223524,10365,4267,6098,3,1
223524,1511,720,791,4,1
223524,8854,3547,5307,5,1
223524,1954,874,1080,11,1
223524,979,411,568,19,1
223524,7875,3136,4739,20,1
223524,2342,1177,1165,21,4
223524,2342,1177,1165,22,1
223524,2107,1046,1061,23,1
223524,586,291,295,24,1
223524,1521,755,766,25,1
223524,235,131,104,31,1
223524,203,102,101,39,1
223524,1318,653,665,40,1
223524,9977,3964,6013,41,4
223524,9977,3964,6013,42,1
223524,8258,3221,5037,43,1
223524,925,429,496,44,1
223524,7333,2792,4541,45,1
223524,1719,743,976,51,1
223524,776,309,467,59,1
223524,6557,2483,4074,60,1
223658,165,155,10,1,4
223658,165,155,10,2,1
223658,165,155,10,3,1
223658,70,64,6,4,1
223658,95,91,4,5,1
223658,95,91,4,20,1
223658,165,155,10,21,4
223658,165,155,10,22,1
223658,165,155,10,23,1
223658,70,64,6,24,1
223658,95,91,4,25,1
223658,95,91,4,40,1
223667,10,1,9,1,4
223667,10,1,9,2,1
223667,10,1,9,3,1
223667,1,1,0,4,1
223667,9,0,9,5,1
223667,9,0,9,20,1
223667,10,1,9,21,4
223667,10,1,9,22,1
223667,10,1,9,23,1
223667,1,1,0,24,1
223667,9,0,9,25,1
223667,9,0,9,40,1
223773,6676,2631,4045,1,4
223773,6676,2631,4045,2,1
223773,5833,2238,3595,3,1
223773,815,373,442,4,1
223773,5018,1865,3153,5,1
223773,843,393,450,11,1
223773,498,195,303,19,1
223773,4520,1670,2850,20,1
223773,1564,815,749,21,4
223773,1564,815,749,22,1
223773,1396,716,680,23,1
223773,399,210,189,24,1
223773,997,506,491,25,1
223773,168,99,69,31,1
223773,166,81,85,39,1
223773,831,425,406,40,1
223773,5112,1816,3296,41,4
223773,5112,1816,3296,42,1
223773,4437,1522,2915,43,1
223773,416,163,253,44,1
223773,4021,1359,2662,45,1
223773,675,294,381,51,1
223773,332,114,218,59,1
223773,3689,1245,2444,60,1
223816,21647,11508,10139,1,4
223816,21647,11508,10139,2,1
223816,16076,9068,7008,3,1
223816,3515,2305,1210,4,1
223816,12561,6763,5798,5,1
223816,5571,2440,3131,11,1
223816,1854,1055,799,19,1
223816,10707,5708,4999,20,1
223816,3754,1631,2123,21,4
223816,3754,1631,2123,22,1
223816,2713,1160,1553,23,1
223816,588,278,310,24,1
223816,2125,882,1243,25,1
223816,1041,471,570,31,1
223816,311,112,199,39,1
223816,1814,770,1044,40,1
223816,17893,9877,8016,41,4
223816,17893,9877,8016,42,1
223816,13363,7908,5455,43,1
223816,2927,2027,900,44,1
223816,10436,5881,4555,45,1
223816,4530,1969,2561,51,1
223816,1543,943,600,59,1
223816,8893,4938,3955,60,1
223852,19,0,19,1,4
223852,19,0,19,2,1
223852,19,0,19,3,1
223852,14,0,14,4,1
223852,5,0,5,5,1
223852,5,0,5,20,1
223852,19,0,19,21,4
223852,19,0,19,22,1
223852,19,0,19,23,1
223852,14,0,14,24,1
223852,5,0,5,25,1
223852,5,0,5,40,1
223898,3617,1423,2194,1,4
223898,3617,1423,2194,2,1
223898,3496,1376,2120,3,1
223898,1026,474,552,4,1
223898,2470,902,1568,5,1
223898,121,47,74,11,1
223898,304,125,179,19,1
223898,2166,777,1389,20,1
223898,1603,649,954,21,4
223898,1603,649,954,22,1
223898,1560,632,928,23,1
223898,426,204,222,24,1
223898,1134,428,706,25,1
223898,43,17,26,31,1
223898,166,75,91,39,1
223898,968,353,615,40,1
223898,2014,774,1240,41,4
223898,2014,774,1240,42,1
223898,1936,744,1192,43,1
223898,600,270,330,44,1
223898,1336,474,862,45,1
223898,78,30,48,51,1
223898,138,50,88,59,1
223898,1198,424,774,60,1
223922,1214,508,706,1,4
223922,1214,508,706,2,1
223922,1214,508,706,3,1
223922,517,235,282,4,1
223922,697,273,424,5,1
223922,87,37,50,19,1
223922,610,236,374,20,1
223922,576,260,316,21,4
223922,576,260,316,22,1
223922,576,260,316,23,1
223922,250,135,115,24,1
223922,326,125,201,25,1
223922,34,17,17,39,1
223922,292,108,184,40,1
223922,638,248,390,41,4
223922,638,248,390,42,1
223922,638,248,390,43,1
223922,267,100,167,44,1
223922,371,148,223,45,1
223922,53,20,33,59,1
223922,318,128,190,60,1
224004,2565,767,1798,1,4
224004,1531,543,988,2,1
224004,1493,534,959,3,1
224004,192,84,108,4,1
224004,1301,450,851,5,1
224004,38,9,29,11,1
224004,1034,224,810,12,3
224004,195,79,116,19,1
224004,1106,371,735,20,1
224004,1145,432,713,21,4
224004,1118,428,690,22,1
224004,1117,428,689,23,1
224004,180,84,96,24,1
224004,937,344,593,25,1
224004,1,0,1,31,1
224004,27,4,23,32,3
224004,152,66,86,39,1
224004,785,278,507,40,1
224004,1420,335,1085,41,4
224004,413,115,298,42,1
224004,376,106,270,43,1
224004,12,0,12,44,1
224004,364,106,258,45,1
224004,37,9,28,51,1
224004,1007,220,787,52,3
224004,43,13,30,59,1
224004,321,93,228,60,1
224013,51,2,49,1,4
224013,51,2,49,2,1
224013,51,2,49,3,1
224013,37,0,37,4,1
224013,14,2,12,5,1
224013,14,2,12,20,1
224013,32,1,31,21,4
224013,32,1,31,22,1
224013,32,1,31,23,1
224013,27,0,27,24,1
224013,5,1,4,25,1
224013,5,1,4,40,1
224013,19,1,18,41,4
224013,19,1,18,42,1
224013,19,1,18,43,1
224013,10,0,10,44,1
224013,9,1,8,45,1
224013,9,1,8,60,1
224110,10335,4350,5985,1,4
224110,10335,4350,5985,2,1
224110,10141,4269,5872,3,1
224110,2663,1212,1451,4,1
224110,7478,3057,4421,5,1
224110,194,81,113,11,1
224110,1257,576,681,19,1
224110,6221,2481,3740,20,1
224110,3792,1660,2132,21,4
224110,3792,1660,2132,22,1
224110,3772,1651,2121,23,1
224110,971,463,508,24,1
224110,2801,1188,1613,25,1
224110,20,9,11,31,1
224110,479,224,255,39,1
224110,2322,964,1358,40,1
224110,6543,2690,3853,41,4
224110,6543,2690,3853,42,1
224110,6369,2618,3751,43,1
224110,1692,749,943,44,1
224110,4677,1869,2808,45,1
224110,174,72,102,51,1
224110,778,352,426,59,1
224110,3899,1517,2382,60,1
224147,10913,4385,6528,1,4
224147,9152,3843,5309,2,1
224147,9137,3835,5302,3,1
224147,2087,922,1165,4,1
224147,7050,2913,4137,5,1
224147,15,8,7,11,1
224147,1761,542,1219,12,3
224147,907,355,552,19,1
224147,6143,2558,3585,20,1
224147,7841,3307,4534,21,4
224147,7237,3070,4167,22,1
224147,7234,3068,4166,23,1
224147,2033,894,1139,24,1
224147,5201,2174,3027,25,1
224147,3,2,1,31,1
224147,604,237,367,32,3
224147,593,248,345,39,1
224147,4608,1926,2682,40,1
224147,3072,1078,1994,41,4
224147,1915,773,1142,42,1
224147,1903,767,1136,43,1
224147,54,28,26,44,1
224147,1849,739,1110,45,1
224147,12,6,6,51,1
224147,1157,305,852,52,3
224147,314,107,207,59,1
224147,1535,632,903,60,1
224156,215,7,208,1,4
224156,215,7,208,2,1
224156,215,7,208,3,1
224156,72,4,68,4,1
224156,143,3,140,5,1
224156,143,3,140,20,1
224156,215,7,208,21,4
224156,215,7,208,22,1
224156,215,7,208,23,1
224156,72,4,68,24,1
224156,143,3,140,25,1
224156,143,3,140,40,1
224183,183,13,170,1,4
224183,183,13,170,2,1
224183,183,13,170,3,1
224183,8,0,8,4,1
224183,175,13,162,5,1
224183,175,13,162,20,1
224183,13,0,13,21,4
224183,13,0,13,22,1
224183,13,0,13,23,1
224183,6,0,6,24,1
224183,7,0,7,25,1
224183,7,0,7,40,1
224183,170,13,157,41,4
224183,170,13,157,42,1
224183,170,13,157,43,1
224183,2,0,2,44,1
224183,168,13,155,45,1
224183,168,13,155,60,1
224226,5422,2192,3230,1,4
224226,3435,1433,2002,2,1
224226,3375,1410,1965,3,1
224226,492,204,288,4,1
224226,2883,1206,1677,5,1
224226,60,23,37,11,1
224226,1987,759,1228,12,3
224226,285,119,166,19,1
224226,2598,1087,1511,20,1
224226,3113,1340,1773,21,4
224226,2463,1057,1406,22,1
224226,2448,1050,1398,23,1
224226,488,203,285,24,1
224226,1960,847,1113,25,1
224226,15,7,8,31,1
224226,650,283,367,32,3
224226,250,104,146,39,1
224226,1710,743,967,40,1
224226,2309,852,1457,41,4
224226,972,376,596,42,1
224226,927,360,567,43,1
224226,4,1,3,44,1
224226,923,359,564,45,1
224226,45,16,29,51,1
224226,1337,476,861,52,3
224226,35,15,20,59,1
224226,888,344,544,60,1
224244,316,184,132,1,4
224244,316,184,132,2,1
224244,316,184,132,3,1
224244,48,26,22,4,1
224244,268,158,110,5,1
224244,56,31,25,19,1
224244,212,127,85,20,1
224244,229,135,94,21,4
224244,229,135,94,22,1
224244,229,135,94,23,1
224244,43,22,21,24,1
224244,186,113,73,25,1
224244,42,25,17,39,1
224244,144,88,56,40,1
224244,87,49,38,41,4
224244,87,49,38,42,1
224244,87,49,38,43,1
224244,5,4,1,44,1
224244,82,45,37,45,1
224244,14,6,8,59,1
224244,68,39,29,60,1
224271,114,52,62,1,4
224271,114,52,62,2,1
224271,114,52,62,3,1
224271,25,10,15,4,1
224271,89,42,47,5,1
224271,23,15,8,19,1
224271,66,27,39,20,1
224271,114,52,62,21,4
224271,114,52,62,22,1
224271,114,52,62,23,1
224271,25,10,15,24,1
224271,89,42,47,25,1
224271,23,15,8,39,1
224271,66,27,39,40,1
224305,2111,1427,684,1,4
224305,2111,1427,684,12,3
224305,901,649,252,21,4
224305,901,649,252,32,3
224305,1210,778,432,41,4
224305,1210,778,432,52,3
224323,2598,1364,1234,1,4
224323,1380,641,739,2,1
224323,1374,637,737,3,1
224323,380,171,209,4,1
224323,994,466,528,5,1
224323,6,4,2,11,1
224323,1218,723,495,12,3
224323,54,29,25,19,1
224323,940,437,503,20,1
224323,1705,834,871,21,4
224323,1365,632,733,22,1
224323,1363,631,732,23,1
224323,380,171,209,24,1
224323,983,460,523,25,1
224323,2,1,1,31,1
224323,340,202,138,32,3
224323,54,29,25,39,1
224323,929,431,498,40,1
224323,893,530,363,41,4
224323,15,9,6,42,1
224323,11,6,5,43,1
224323,11,6,5,45,1
224323,4,3,1,51,1
224323,878,521,357,52,3
224323,11,6,5,60,1
224350,10502,4559,5943,1,4
224350,10502,4559,5943,2,1
224350,10502,4559,5943,3,1
224350,1218,588,630,4,1
224350,9284,3971,5313,5,1
224350,560,253,307,19,1
224350,8724,3718,5006,20,1
224350,3048,1481,1567,21,4
224350,3048,1481,1567,22,1
224350,3048,1481,1567,23,1
224350,560,275,285,24,1
224350,2488,1206,1282,25,1
224350,248,126,122,39,1
224350,2240,1080,1160,40,1
224350,7454,3078,4376,41,4
224350,7454,3078,4376,42,1
224350,7454,3078,4376,43,1
224350,658,313,345,44,1
224350,6796,2765,4031,45,1
224350,312,127,185,59,1
224350,6484,2638,3846,60,1
224439,1208,100,1108,1,4
224439,1208,100,1108,2,1
224439,529,61,468,3,1
224439,529,61,468,4,1
224439,679,39,640,11,1
224439,1208,100,1108,21,4
224439,1208,100,1108,22,1
224439,529,61,468,23,1
224439,529,61,468,24,1
224439,679,39,640,31,1
224527,1247,591,656,1,4
224527,1196,564,632,2,1
224527,1132,534,598,3,1
224527,345,163,182,4,1
224527,787,371,416,5,1
224527,64,30,34,11,1
224527,51,27,24,12,3
224527,82,41,41,19,1
224527,705,330,375,20,1
224527,1086,514,572,21,4
224527,1066,505,561,22,1
224527,1064,504,560,23,1
224527,340,159,181,24,1
224527,724,345,379,25,1
224527,2,1,1,31,1
224527,20,9,11,32,3
224527,78,38,40,39,1
224527,646,307,339,40,1
224527,161,77,84,41,4
224527,130,59,71,42,1
224527,68,30,38,43,1
224527,5,4,1,44,1
224527,63,26,37,45,1
224527,62,29,33,51,1
224527,31,18,13,52,3
224527,4,3,1,59,1
224527,59,23,36,60,1
224545,1842,633,1209,1,4
224545,1401,498,903,2,1
224545,1391,493,898,3,1
224545,158,73,85,4,1
224545,1233,420,813,5,1
224545,10,5,5,11,1
224545,441,135,306,12,3
224545,262,107,155,19,1
224545,971,313,658,20,1
224545,1002,389,613,21,4
224545,924,363,561,22,1
224545,923,362,561,23,1
224545,155,72,83,24,1
224545,768,290,478,25,1
224545,1,1,0,31,1
224545,78,26,52,32,3
224545,191,82,109,39,1
224545,577,208,369,40,1
224545,840,244,596,41,4
224545,477,135,342,42,1
224545,468,131,337,43,1
224545,3,1,2,44,1
224545,465,130,335,45,1
224545,9,4,5,51,1
224545,363,109,254,52,3
224545,71,25,46,59,1
224545,394,105,289,60,1
224554,11591,4766,6825,1,4
224554,6969,2883,4086,2,1
224554,6951,2873,4078,3,1
224554,939,439,500,4,1
224554,6012,2434,3578,5,1
224554,18,10,8,11,1
224554,4622,1883,2739,12,3
224554,1131,442,689,19,1
224554,4881,1992,2889,20,1
224554,6549,2738,3811,21,4
224554,5178,2189,2989,22,1
224554,5173,2187,2986,23,1
224554,920,431,489,24,1
224554,4253,1756,2497,25,1
224554,5,2,3,31,1
224554,1371,549,822,32,3
224554,787,323,464,39,1
224554,3466,1433,2033,40,1
224554,5042,2028,3014,41,4
224554,1791,694,1097,42,1
224554,1778,686,1092,43,1
224554,19,8,11,44,1
224554,1759,678,1081,45,1
224554,13,8,5,51,1
224554,3251,1334,1917,52,3
224554,344,119,225,59,1
224554,1415,559,856,60,1
224572,14529,5832,8697,1,4
224572,14529,5832,8697,2,1
224572,12113,4738,7375,3,1
224572,1925,930,995,4,1
224572,10188,3808,6380,5,1
224572,2416,1094,1322,11,1
224572,778,323,455,19,1
224572,9410,3485,5925,20,1
224572,3338,1534,1804,21,4
224572,3338,1534,1804,22,1
224572,2970,1339,1631,23,1
224572,813,426,387,24,1
224572,2157,913,1244,25,1
224572,368,195,173,31,1
224572,215,110,105,39,1
224572,1942,803,1139,40,1
224572,11191,4298,6893,41,4
224572,11191,4298,6893,42,1
224572,9143,3399,5744,43,1
224572,1112,504,608,44,1
224572,8031,2895,5136,45,1
224572,2048,899,1149,51,1
224572,563,213,350,59,1
224572,7468,2682,4786,60,1
224615,10771,3768,7003,1,4
224615,10771,3768,7003,2,1
224615,8854,2914,5940,3,1
224615,1206,424,782,4,1
224615,7648,2490,5158,5,1
224615,1917,854,1063,11,1
224615,653,254,399,19,1
224615,6995,2236,4759,20,1
224615,1992,764,1228,21,4
224615,1992,764,1228,22,1
224615,1788,649,1139,23,1
224615,419,147,272,24,1
224615,1369,502,867,25,1
224615,204,115,89,31,1
224615,167,90,77,39,1
224615,1202,412,790,40,1
224615,8779,3004,5775,41,4
224615,8779,3004,5775,42,1
224615,7066,2265,4801,43,1
224615,787,277,510,44,1
224615,6279,1988,4291,45,1
224615,1713,739,974,51,1
224615,486,164,322,59,1
224615,5793,1824,3969,60,1
224642,30468,13068,17400,1,4
224642,30468,13068,17400,2,1
224642,29390,12608,16782,3,1
224642,4918,2326,2592,4,1
224642,24472,10282,14190,5,1
224642,1078,460,618,11,1
224642,1668,746,922,19,1
224642,22804,9536,13268,20,1
224642,9792,4439,5353,21,4
224642,9792,4439,5353,22,1
224642,9702,4394,5308,23,1
224642,2798,1340,1458,24,1
224642,6904,3054,3850,25,1
224642,90,45,45,31,1
224642,649,301,348,39,1
224642,6255,2753,3502,40,1
224642,20676,8629,12047,41,4
224642,20676,8629,12047,42,1
224642,19688,8214,11474,43,1
224642,2120,986,1134,44,1
224642,17568,7228,10340,45,1
224642,988,415,573,51,1
224642,1019,445,574,59,1
224642,16549,6783,9766,60,1
224660,651,333,318,1,4
224660,651,333,318,2,1
224660,651,333,318,3,1
224660,246,126,120,4,1
224660,405,207,198,5,1
224660,142,76,66,19,1
224660,263,131,132,20,1
224660,500,240,260,21,4
224660,500,240,260,22,1
224660,500,240,260,23,1
224660,185,94,91,24,1
224660,315,146,169,25,1
224660,120,61,59,39,1
224660,195,85,110,40,1
224660,151,93,58,41,4
224660,151,93,58,42,1
224660,151,93,58,43,1
224660,61,32,29,44,1
224660,90,61,29,45,1
224660,22,15,7,59,1
224660,68,46,22,60,1
224679,815,730,85,1,4
224679,815,730,85,2,1
224679,815,730,85,3,1
224679,183,157,26,4,1
224679,632,573,59,5,1
224679,28,25,3,19,1
224679,604,548,56,20,1
224679,649,572,77,21,4
224679,649,572,77,22,1
224679,649,572,77,23,1
224679,161,135,26,24,1
224679,488,437,51,25,1
224679,26,23,3,39,1
224679,462,414,48,40,1
224679,166,158,8,41,4
224679,166,158,8,42,1
224679,166,158,8,43,1
224679,22,22,0,44,1
224679,144,136,8,45,1
224679,2,2,0,59,1
224679,142,134,8,60,1
224712,102,34,68,1,4
224712,102,34,68,12,3
224712,43,25,18,21,4
224712,43,25,18,32,3
224712,59,9,50,41,4
224712,59,9,50,52,3
224758,58,3,55,1,4
224758,58,3,55,2,1
224758,58,3,55,3,1
224758,28,1,27,4,1
224758,30,2,28,5,1
224758,30,2,28,20,1
224758,42,1,41,21,4
224758,42,1,41,22,1
224758,42,1,41,23,1
224758,24,1,23,24,1
224758,18,0,18,25,1
224758,18,0,18,40,1
224758,16,2,14,41,4
224758,16,2,14,42,1
224758,16,2,14,43,1
224758,4,0,4,44,1
224758,12,2,10,45,1
224758,12,2,10,60,1
224776,1423,705,718,1,4
224776,1408,698,710,2,1
224776,1408,698,710,3,1
224776,343,204,139,4,1
224776,1065,494,571,5,1
224776,15,7,8,12,3
224776,186,77,109,19,1
224776,879,417,462,20,1
224776,1089,552,537,21,4
224776,1089,552,537,22,1
224776,1089,552,537,23,1
224776,309,185,124,24,1
224776,780,367,413,25,1
224776,144,61,83,39,1
224776,636,306,330,40,1
224776,334,153,181,41,4
224776,319,146,173,42,1
224776,319,146,173,43,1
224776,34,19,15,44,1
224776,285,127,158,45,1
224776,15,7,8,52,3
224776,42,16,26,59,1
224776,243,111,132,60,1
224828,60,2,58,1,4
224828,60,2,58,2,1
224828,60,2,58,3,1
224828,58,2,56,4,1
224828,2,0,2,5,1
224828,2,0,2,20,1
224828,27,1,26,21,4
224828,27,1,26,22,1
224828,27,1,26,23,1
224828,26,1,25,24,1
224828,1,0,1,25,1
224828,1,0,1,40,1
224828,33,1,32,41,4
224828,33,1,32,42,1
224828,33,1,32,43,1
224828,32,1,31,44,1
224828,1,0,1,45,1
224828,1,0,1,60,1
224891,1148,535,613,1,4
224891,1148,535,613,2,1
224891,567,287,280,3,1
224891,156,77,79,4,1
224891,411,210,201,5,1
224891,581,248,333,11,1
224891,75,37,38,19,1
224891,336,173,163,20,1
224891,501,249,252,21,4
224891,501,249,252,22,1
224891,360,186,174,23,1
224891,138,69,69,24,1
224891,222,117,105,25,1
224891,141,63,78,31,1
224891,58,28,30,39,1
224891,164,89,75,40,1
224891,647,286,361,41,4
224891,647,286,361,42,1
224891,207,101,106,43,1
224891,18,8,10,44,1
224891,189,93,96,45,1
224891,440,185,255,51,1
224891,17,9,8,59,1
224891,172,84,88,60,1
224907,106,19,87,1,4
224907,106,19,87,2,1
224907,106,19,87,3,1
224907,41,8,33,4,1
224907,65,11,54,5,1
224907,65,11,54,20,1
224907,75,11,64,21,4
224907,75,11,64,22,1
224907,75,11,64,23,1
224907,33,7,26,24,1
224907,42,4,38,25,1
224907,42,4,38,40,1
224907,31,8,23,41,4
224907,31,8,23,42,1
224907,31,8,23,43,1
224907,8,1,7,44,1
224907,23,7,16,45,1
224907,23,7,16,60,1
224961,2131,917,1214,1,4
224961,2131,917,1214,2,1
224961,1858,798,1060,3,1
224961,305,161,144,4,1
224961,1553,637,916,5,1
224961,273,119,154,11,1
224961,275,134,141,19,1
224961,1278,503,775,20,1
224961,577,328,249,21,4
224961,577,328,249,22,1
224961,576,328,248,23,1
224961,161,98,63,24,1
224961,415,230,185,25,1
224961,1,0,1,31,1
224961,121,70,51,39,1
224961,294,160,134,40,1
224961,1554,589,965,41,4
224961,1554,589,965,42,1
224961,1282,470,812,43,1
224961,144,63,81,44,1
224961,1138,407,731,45,1
224961,272,119,153,51,1
224961,154,64,90,59,1
224961,984,343,641,60,1
225070,5014,2012,3002,1,4
225070,5014,2012,3002,2,1
225070,3967,1570,2397,3,1
225070,865,417,448,4,1
225070,3102,1153,1949,5,1
225070,1047,442,605,11,1
225070,357,138,219,19,1
225070,2745,1015,1730,20,1
225070,2101,897,1204,21,4
225070,2101,897,1204,22,1
225070,2012,856,1156,23,1
225070,611,281,330,24,1
225070,1401,575,826,25,1
225070,89,41,48,31,1
225070,206,81,125,39,1
225070,1195,494,701,40,1
225070,2913,1115,1798,41,4
225070,2913,1115,1798,42,1
225070,1955,714,1241,43,1
225070,254,136,118,44,1
225070,1701,578,1123,45,1
225070,958,401,557,51,1
225070,151,57,94,59,1
225070,1550,521,1029,60,1
225201,735,450,285,1,4
225201,729,449,280,2,1
225201,713,436,277,3,1
225201,81,48,33,4,1
225201,632,388,244,5,1
225201,16,13,3,11,1
225201,6,1,5,12,3
225201,106,61,45,19,1
225201,526,327,199,20,1
225201,735,450,285,21,4
225201,729,449,280,22,1
225201,713,436,277,23,1
225201,81,48,33,24,1
225201,632,388,244,25,1
225201,16,13,3,31,1
225201,6,1,5,32,3
225201,106,61,45,39,1
225201,526,327,199,40,1
225247,2220,1071,1149,1,4
225247,1772,850,922,2,1
225247,1690,808,882,3,1
225247,414,213,201,4,1
225247,1276,595,681,5,1
225247,82,42,40,11,1
225247,448,221,227,12,3
225247,139,59,80,19,1
225247,1137,536,601,20,1
225247,1792,857,935,21,4
225247,1556,749,807,22,1
225247,1556,749,807,23,1
225247,413,212,201,24,1
225247,1143,537,606,25,1
225247,236,108,128,32,3
225247,128,56,72,39,1
225247,1015,481,534,40,1
225247,428,214,214,41,4
225247,216,101,115,42,1
225247,134,59,75,43,1
225247,1,1,0,44,1
225247,133,58,75,45,1
225247,82,42,40,51,1
225247,212,113,99,52,3
225247,11,3,8,59,1
225247,122,55,67,60,1
225308,5172,1978,3194,1,4
225308,5172,1978,3194,2,1
225308,4958,1912,3046,3,1
225308,1320,650,670,4,1
225308,3638,1262,2376,5,1
225308,214,66,148,11,1
225308,755,267,488,19,1
225308,2883,995,1888,20,1
225308,2685,1020,1665,21,4
225308,2685,1020,1665,22,1
225308,2642,1011,1631,23,1
225308,894,392,502,24,1
225308,1748,619,1129,25,1
225308,43,9,34,31,1
225308,365,148,217,39,1
225308,1383,471,912,40,1
225308,2487,958,1529,41,4
225308,2487,958,1529,42,1
225308,2316,901,1415,43,1
225308,426,258,168,44,1
225308,1890,643,1247,45,1
225308,171,57,114,51,1
225308,390,119,271,59,1
225308,1500,524,976,60,1
225371,4495,1749,2746,1,4
225371,4495,1749,2746,2,1
225371,3580,1368,2212,3,1
225371,730,343,387,4,1
225371,2850,1025,1825,5,1
225371,915,381,534,11,1
225371,427,185,242,19,1
225371,2423,840,1583,20,1
225371,1928,793,1135,21,4
225371,1928,793,1135,22,1
225371,1886,777,1109,23,1
225371,547,262,285,24,1
225371,1339,515,824,25,1
225371,42,16,26,31,1
225371,223,96,127,39,1
225371,1116,419,697,40,1
225371,2567,956,1611,41,4
225371,2567,956,1611,42,1
225371,1694,591,1103,43,1
225371,183,81,102,44,1
225371,1511,510,1001,45,1
225371,873,365,508,51,1
225371,204,89,115,59,1
225371,1307,421,886,60,1
225399,2910,993,1917,1,4
225399,2171,793,1378,2,1
225399,2165,790,1375,3,1
225399,568,232,336,4,1
225399,1597,558,1039,5,1
225399,6,3,3,11,1
225399,739,200,539,12,3
225399,226,95,131,19,1
225399,1371,463,908,20,1
225399,2315,828,1487,21,4
225399,2005,738,1267,22,1
225399,2004,738,1266,23,1
225399,567,232,335,24,1
225399,1437,506,931,25,1
225399,1,0,1,31,1
225399,310,90,220,32,3
225399,220,91,129,39,1
225399,1217,415,802,40,1
225399,595,165,430,41,4
225399,166,55,111,42,1
225399,161,52,109,43,1
225399,1,0,1,44,1
225399,160,52,108,45,1
225399,5,3,2,51,1
225399,429,110,319,52,3
225399,6,4,2,59,1
225399,154,48,106,60,1
225414,8164,2918,5246,1,4
225414,4853,1578,3275,2,1
225414,4691,1524,3167,3,1
225414,4691,1524,3167,5,1
225414,162,54,108,11,1
225414,3311,1340,1971,12,3
225414,1036,333,703,19,1
225414,3655,1191,2464,20,1
225414,3711,1459,2252,21,4
225414,2130,739,1391,22,1
225414,2101,732,1369,23,1
225414,2101,732,1369,25,1
225414,29,7,22,31,1
225414,1581,720,861,32,3
225414,494,175,319,39,1
225414,1607,557,1050,40,1
225414,4453,1459,2994,41,4
225414,2723,839,1884,42,1
225414,2590,792,1798,43,1
225414,2590,792,1798,45,1
225414,133,47,86,51,1
225414,1730,620,1110,52,3
225414,542,158,384,59,1
225414,2048,634,1414,60,1
225423,57978,24574,33404,1,4
225423,57978,24574,33404,2,1
225423,57742,24465,33277,3,1
225423,8621,3937,4684,4,1
225423,49121,20528,28593,5,1
225423,236,109,127,11,1
225423,4364,1844,2520,19,1
225423,44757,18684,26073,20,1
225423,17728,8027,9701,21,4
225423,17728,8027,9701,22,1
225423,17701,8011,9690,23,1
225423,3791,1801,1990,24,1
225423,13910,6210,7700,25,1
225423,27,16,11,31,1
225423,1685,770,915,39,1
225423,12225,5440,6785,40,1
225423,40250,16547,23703,41,4
225423,40250,16547,23703,42,1
225423,40041,16454,23587,43,1
225423,4830,2136,2694,44,1
225423,35211,14318,20893,45,1
225423,209,93,116,51,1
225423,2679,1074,1605,59,1
225423,32532,13244,19288,60,1
225432,13757,5568,8189,1,4
225432,13486,5445,8041,2,1
225432,13297,5373,7924,3,1
225432,1130,507,623,4,1
225432,12167,4866,7301,5,1
225432,189,72,117,11,1
225432,271,123,148,12,3
225432,2287,878,1409,19,1
225432,9880,3988,5892,20,1
225432,6937,2836,4101,21,4
225432,6896,2827,4069,22,1
225432,6875,2820,4055,23,1
225432,1007,442,565,24,1
225432,5868,2378,3490,25,1
225432,21,7,14,31,1
225432,41,9,32,32,3
225432,1075,421,654,39,1
225432,4793,1957,2836,40,1
225432,6820,2732,4088,41,4
225432,6590,2618,3972,42,1
225432,6422,2553,3869,43,1
225432,123,65,58,44,1
225432,6299,2488,3811,45,1
225432,168,65,103,51,1
225432,230,114,116,52,3
225432,1212,457,755,59,1
225432,5087,2031,3056,60,1
225502,4491,1607,2884,1,4
225502,2889,996,1893,2,1
225502,2879,993,1886,3,1
225502,288,119,169,4,1
225502,2591,874,1717,5,1
225502,10,3,7,11,1
225502,1602,611,991,12,3
225502,485,181,304,19,1
225502,2106,693,1413,20,1
225502,1848,691,1157,21,4
225502,1466,555,911,22,1
225502,1464,555,909,23,1
225502,281,115,166,24,1
225502,1183,440,743,25,1
225502,2,0,2,31,1
225502,382,136,246,32,3
225502,232,103,129,39,1
225502,951,337,614,40,1
225502,2643,916,1727,41,4
225502,1423,441,982,42,1
225502,1415,438,977,43,1
225502,7,4,3,44,1
225502,1408,434,974,45,1
225502,8,3,5,51,1
225502,1220,475,745,52,3
225502,253,78,175,59,1
225502,1155,356,799,60,1
225511,39540,19854,19686,1,4
225511,31706,15954,15752,2,1
225511,30357,15253,15104,3,1
225511,3434,1730,1704,4,1
225511,26923,13523,13400,5,1
225511,1349,701,648,11,1
225511,7834,3900,3934,12,3
225511,3394,1598,1796,19,1
225511,23529,11925,11604,20,1
225511,28486,13998,14488,21,4
225511,22829,11297,11532,22,1
225511,22475,11100,11375,23,1
225511,3321,1677,1644,24,1
225511,19154,9423,9731,25,1
225511,354,197,157,31,1
225511,5657,2701,2956,32,3
225511,2291,1048,1243,39,1
225511,16863,8375,8488,40,1
225511,11054,5856,5198,41,4
225511,8877,4657,4220,42,1
225511,7882,4153,3729,43,1
225511,113,53,60,44,1
225511,7769,4100,3669,45,1
225511,995,504,491,51,1
225511,2177,1199,978,52,3
225511,1103,550,553,59,1
225511,6666,3550,3116,60,1
225520,4130,1502,2628,1,4
225520,4130,1502,2628,2,1
225520,4044,1478,2566,3,1
225520,574,228,346,4,1
225520,3470,1250,2220,5,1
225520,86,24,62,11,1
225520,257,91,166,19,1
225520,3213,1159,2054,20,1
225520,1095,394,701,21,4
225520,1095,394,701,22,1
225520,1062,383,679,23,1
225520,346,142,204,24,1
225520,716,241,475,25,1
225520,33,11,22,31,1
225520,93,38,55,39,1
225520,623,203,420,40,1
225520,3035,1108,1927,41,4
225520,3035,1108,1927,42,1
225520,2982,1095,1887,43,1
225520,228,86,142,44,1
225520,2754,1009,1745,45,1
225520,53,13,40,51,1
225520,164,53,111,59,1
225520,2590,956,1634,60,1
225548,1170,623,547,1,4
225548,1100,578,522,2,1
225548,1059,560,499,3,1
225548,347,213,134,4,1
225548,712,347,365,5,1
225548,41,18,23,11,1
225548,70,45,25,12,3
225548,61,35,26,19,1
225548,651,312,339,20,1
225548,1020,550,470,21,4
225548,983,527,456,22,1
225548,981,526,455,23,1
225548,342,209,133,24,1
225548,639,317,322,25,1
225548,2,1,1,31,1
225548,37,23,14,32,3
225548,50,29,21,39,1
225548,589,288,301,40,1
225548,150,73,77,41,4
225548,117,51,66,42,1
225548,78,34,44,43,1
225548,5,4,1,44,1
225548,73,30,43,45,1
225548,39,17,22,51,1
225548,33,22,11,52,3
225548,11,6,5,59,1
225548,62,24,38,60,1
225575,973,448,525,1,4
225575,926,432,494,2,1
225575,924,430,494,3,1
225575,228,108,120,4,1
225575,696,322,374,5,1
225575,2,2,0,11,1
225575,47,16,31,12,3
225575,135,65,70,19,1
225575,561,257,304,20,1
225575,840,398,442,21,4
225575,840,398,442,22,1
225575,839,397,442,23,1
225575,223,104,119,24,1
225575,616,293,323,25,1
225575,1,1,0,31,1
225575,122,59,63,39,1
225575,494,234,260,40,1
225575,133,50,83,41,4
225575,86,34,52,42,1
225575,85,33,52,43,1
225575,5,4,1,44,1
225575,80,29,51,45,1
225575,1,1,0,51,1
225575,47,16,31,52,3
225575,13,6,7,59,1
225575,67,23,44,60,1
225627,8685,3386,5299,1,4
225627,6491,2518,3973,2,1
225627,6346,2463,3883,3,1
225627,1045,404,641,4,1
225627,5301,2059,3242,5,1
225627,145,55,90,11,1
225627,2194,868,1326,12,3
225627,744,317,427,19,1
225627,4557,1742,2815,20,1
225627,5254,2035,3219,21,4
225627,4201,1609,2592,22,1
225627,4158,1592,2566,23,1
225627,997,381,616,24,1
225627,3161,1211,1950,25,1
225627,43,17,26,31,1
225627,1053,426,627,32,3
225627,264,124,140,39,1
225627,2897,1087,1810,40,1
225627,3431,1351,2080,41,4
225627,2290,909,1381,42,1
225627,2188,871,1317,43,1
225627,48,23,25,44,1
225627,2140,848,1292,45,1
225627,102,38,64,51,1
225627,1141,442,699,52,3
225627,480,193,287,59,1
225627,1660,655,1005,60,1
225779,196,84,112,1,4
225779,196,84,112,2,1
225779,196,84,112,3,1
225779,117,56,61,4,1
225779,79,28,51,5,1
225779,79,28,51,20,1
225779,167,66,101,21,4
225779,167,66,101,22,1
225779,167,66,101,23,1
225779,96,42,54,24,1
225779,71,24,47,25,1
225779,71,24,47,40,1
225779,29,18,11,41,4
225779,29,18,11,42,1
225779,29,18,11,43,1
225779,21,14,7,44,1
225779,8,4,4,45,1
225779,8,4,4,60,1
225788,195,88,107,1,4
225788,195,88,107,2,1
225788,195,88,107,3,1
225788,168,74,94,4,1
225788,27,14,13,5,1
225788,27,14,13,20,1
225788,111,46,65,21,4
225788,111,46,65,22,1
225788,111,46,65,23,1
225788,95,36,59,24,1
225788,16,10,6,25,1
225788,16,10,6,40,1
225788,84,42,42,41,4
225788,84,42,42,42,1
225788,84,42,42,43,1
225788,73,38,35,44,1
225788,11,4,7,45,1
225788,11,4,7,60,1
225849,612,508,104,1,4
225849,612,508,104,2,1
225849,612,508,104,3,1
225849,93,70,23,4,1
225849,519,438,81,5,1
225849,17,12,5,19,1
225849,502,426,76,20,1
225849,498,415,83,21,4
225849,498,415,83,22,1
225849,498,415,83,23,1
225849,82,62,20,24,1
225849,416,353,63,25,1
225849,14,11,3,39,1
225849,402,342,60,40,1
225849,114,93,21,41,4
225849,114,93,21,42,1
225849,114,93,21,43,1
225849,11,8,3,44,1
225849,103,85,18,45,1
225849,3,1,2,59,1
225849,100,84,16,60,1
225858,609,527,82,1,4
225858,609,527,82,2,1
225858,609,527,82,3,1
225858,98,84,14,4,1
225858,511,443,68,5,1
225858,8,4,4,19,1
225858,503,439,64,20,1
225858,550,477,73,21,4
225858,550,477,73,22,1
225858,550,477,73,23,1
225858,93,80,13,24,1
225858,457,397,60,25,1
225858,7,3,4,39,1
225858,450,394,56,40,1
225858,59,50,9,41,4
225858,59,50,9,42,1
225858,59,50,9,43,1
225858,5,4,1,44,1
225858,54,46,8,45,1
225858,1,1,0,59,1
225858,53,45,8,60,1
225876,524,233,291,1,4
225876,524,233,291,2,1
225876,296,138,158,3,1
225876,147,78,69,4,1
225876,149,60,89,5,1
225876,228,95,133,11,1
225876,26,9,17,19,1
225876,123,51,72,20,1
225876,266,131,135,21,4
225876,266,131,135,22,1
225876,266,131,135,23,1
225876,139,76,63,24,1
225876,127,55,72,25,1
225876,20,8,12,39,1
225876,107,47,60,40,1
225876,258,102,156,41,4
225876,258,102,156,42,1
225876,30,7,23,43,1
225876,8,2,6,44,1
225876,22,5,17,45,1
225876,228,95,133,51,1
225876,6,1,5,59,1
225876,16,4,12,60,1
225885,609,327,282,1,4
225885,609,327,282,2,1
225885,578,321,257,3,1
225885,138,77,61,4,1
225885,440,244,196,5,1
225885,31,6,25,11,1
225885,62,40,22,19,1
225885,378,204,174,20,1
225885,569,317,252,21,4
225885,569,317,252,22,1
225885,569,317,252,23,1
225885,136,76,60,24,1
225885,433,241,192,25,1
225885,61,39,22,39,1
225885,372,202,170,40,1
225885,40,10,30,41,4
225885,40,10,30,42,1
225885,9,4,5,43,1
225885,2,1,1,44,1
225885,7,3,4,45,1
225885,31,6,25,51,1
225885,1,1,0,59,1
225885,6,2,4,60,1
225991,153,84,69,1,4
225991,153,84,69,2,1
225991,153,84,69,3,1
225991,24,11,13,4,1
225991,129,73,56,5,1
225991,42,22,20,19,1
225991,87,51,36,20,1
225991,153,84,69,21,4
225991,153,84,69,22,1
225991,153,84,69,23,1
225991,24,11,13,24,1
225991,129,73,56,25,1
225991,42,22,20,39,1
225991,87,51,36,40,1
226019,5867,2302,3565,1,4
226019,5867,2302,3565,2,1
226019,5764,2266,3498,3,1
226019,1179,545,634,4,1
226019,4585,1721,2864,5,1
226019,103,36,67,11,1
226019,372,170,202,19,1
226019,4213,1551,2662,20,1
226019,2623,1122,1501,21,4
226019,2623,1122,1501,22,1
226019,2604,1118,1486,23,1
226019,847,379,468,24,1
226019,1757,739,1018,25,1
226019,19,4,15,31,1
226019,221,113,108,39,1
226019,1536,626,910,40,1
226019,3244,1180,2064,41,4
226019,3244,1180,2064,42,1
226019,3160,1148,2012,43,1
226019,332,166,166,44,1
226019,2828,982,1846,45,1
226019,84,32,52,51,1
226019,151,57,94,59,1
226019,2677,925,1752,60,1
226091,14035,5474,8561,1,4
226091,9382,3946,5436,2,1
226091,9175,3868,5307,3,1
226091,1451,678,773,4,1
226091,7724,3190,4534,5,1
226091,207,78,129,11,1
226091,4653,1528,3125,12,3
226091,742,292,450,19,1
226091,6982,2898,4084,20,1
226091,7356,3360,3996,21,4
226091,6604,2955,3649,22,1
226091,6604,2955,3649,23,1
226091,1400,651,749,24,1
226091,5204,2304,2900,25,1
226091,752,405,347,32,3
226091,422,191,231,39,1
226091,4782,2113,2669,40,1
226091,6679,2114,4565,41,4
226091,2778,991,1787,42,1
226091,2571,913,1658,43,1
226091,51,27,24,44,1
226091,2520,886,1634,45,1
226091,207,78,129,51,1
226091,3901,1123,2778,52,3
226091,320,101,219,59,1
226091,2200,785,1415,60,1
226107,2426,747,1679,1,4
226107,2426,747,1679,2,1
226107,1938,553,1385,3,1
226107,434,168,266,4,1
226107,1504,385,1119,5,1
226107,488,194,294,11,1
226107,145,38,107,19,1
226107,1359,347,1012,20,1
226107,992,304,688,21,4
226107,992,304,688,22,1
226107,989,304,685,23,1
226107,325,123,202,24,1
226107,664,181,483,25,1
226107,3,0,3,31,1
226107,78,18,60,39,1
226107,586,163,423,40,1
226107,1434,443,991,41,4
226107,1434,443,991,42,1
226107,949,249,700,43,1
226107,109,45,64,44,1
226107,840,204,636,45,1
226107,485,194,291,51,1
226107,67,20,47,59,1
226107,773,184,589,60,1
226116,2721,776,1945,1,4
226116,2721,776,1945,2,1
226116,1811,422,1389,3,1
226116,294,86,208,4,1
226116,1517,336,1181,5,1
226116,910,354,556,11,1
226116,141,30,111,19,1
226116,1376,306,1070,20,1
226116,955,292,663,21,4
226116,955,292,663,22,1
226116,637,183,454,23,1
226116,208,57,151,24,1
226116,429,126,303,25,1
226116,318,109,209,31,1
226116,48,13,35,39,1
226116,381,113,268,40,1
226116,1766,484,1282,41,4
226116,1766,484,1282,42,1
226116,1174,239,935,43,1
226116,86,29,57,44,1
226116,1088,210,878,45,1
226116,592,245,347,51,1
226116,93,17,76,59,1
226116,995,193,802,60,1
226125,283,18,265,1,4
226125,283,18,265,2,1
226125,283,18,265,3,1
226125,125,9,116,4,1
226125,158,9,149,5,1
226125,158,9,149,20,1
226125,283,18,265,21,4
226125,283,18,265,22,1
226125,283,18,265,23,1
226125,125,9,116,24,1
226125,158,9,149,25,1
226125,158,9,149,40,1
226134,8726,3824,4902,1,4
226134,8726,3824,4902,2,1
226134,8048,3500,4548,3,1
226134,1691,842,849,4,1
226134,6357,2658,3699,5,1
226134,678,324,354,11,1
226134,138,68,70,19,1
226134,6219,2590,3629,20,1
226134,3228,1565,1663,21,4
226134,3228,1565,1663,22,1
226134,3031,1459,1572,23,1
226134,964,498,466,24,1
226134,2067,961,1106,25,1
226134,197,106,91,31,1
226134,61,36,25,39,1
226134,2006,925,1081,40,1
226134,5498,2259,3239,41,4
226134,5498,2259,3239,42,1
226134,5017,2041,2976,43,1
226134,727,344,383,44,1
226134,4290,1697,2593,45,1
226134,481,218,263,51,1
226134,77,32,45,59,1
226134,4213,1665,2548,60,1
226152,7431,3084,4347,1,4
226152,6585,2764,3821,2,1
226152,6560,2748,3812,3,1
226152,831,371,460,4,1
226152,5729,2377,3352,5,1
226152,25,16,9,11,1
226152,846,320,526,12,3
226152,467,187,280,19,1
226152,5262,2190,3072,20,1
226152,4184,1828,2356,21,4
226152,4022,1759,2263,22,1
226152,4010,1750,2260,23,1
226152,821,365,456,24,1
226152,3189,1385,1804,25,1
226152,12,9,3,31,1
226152,162,69,93,32,3
226152,292,131,161,39,1
226152,2897,1254,1643,40,1
226152,3247,1256,1991,41,4
226152,2563,1005,1558,42,1
226152,2550,998,1552,43,1
226152,10,6,4,44,1
226152,2540,992,1548,45,1
226152,13,7,6,51,1
226152,684,251,433,52,3
226152,175,56,119,59,1
226152,2365,936,1429,60,1
226204,5911,3023,2888,1,4
226204,5911,3023,2888,2,1
226204,5775,2965,2810,3,1
226204,1040,603,437,4,1
226204,4735,2362,2373,5,1
226204,136,58,78,11,1
226204,269,158,111,19,1
226204,4466,2204,2262,20,1
226204,1452,689,763,21,4
226204,1452,689,763,22,1
226204,1428,678,750,23,1
226204,445,212,233,24,1
226204,983,466,517,25,1
226204,24,11,13,31,1
226204,86,54,32,39,1
226204,897,412,485,40,1
226204,4459,2334,2125,41,4
226204,4459,2334,2125,42,1
226204,4347,2287,2060,43,1
226204,595,391,204,44,1
226204,3752,1896,1856,45,1
226204,112,47,65,51,1
226204,183,104,79,59,1
226204,3569,1792,1777,60,1
226231,2729,1310,1419,1,4
226231,2305,1218,1087,2,1
226231,2173,1152,1021,3,1
226231,339,218,121,4,1
226231,1834,934,900,5,1
226231,132,66,66,11,1
226231,424,92,332,12,3
226231,274,99,175,19,1
226231,1560,835,725,20,1
226231,1392,939,453,21,4
226231,1333,925,408,22,1
226231,1324,918,406,23,1
226231,302,207,95,24,1
226231,1022,711,311,25,1
226231,9,7,2,31,1
226231,59,14,45,32,3
226231,96,52,44,39,1
226231,926,659,267,40,1
226231,1337,371,966,41,4
226231,972,293,679,42,1
226231,849,234,615,43,1
226231,37,11,26,44,1
226231,812,223,589,45,1
226231,123,59,64,51,1
226231,365,78,287,52,3
226231,178,47,131,59,1
226231,634,176,458,60,1
226277,867,842,25,1,4
226277,867,842,25,2,1
226277,867,842,25,3,1
226277,164,156,8,4,1
226277,703,686,17,5,1
226277,11,11,0,19,1
226277,692,675,17,20,1
226277,867,842,25,21,4
226277,867,842,25,22,1
226277,867,842,25,23,1
226277,164,156,8,24,1
226277,703,686,17,25,1
226277,11,11,0,39,1
226277,692,675,17,40,1
226374,49,40,9,1,4
226374,49,40,9,2,1
226374,49,40,9,3,1
226374,32,26,6,4,1
226374,17,14,3,5,1
226374,17,14,3,20,1
226374,49,40,9,21,4
226374,49,40,9,22,1
226374,49,40,9,23,1
226374,32,26,6,24,1
226374,17,14,3,25,1
226374,17,14,3,40,1
226383,2002,722,1280,1,4
226383,1531,593,938,2,1
226383,1466,560,906,3,1
226383,255,92,163,4,1
226383,1211,468,743,5,1
226383,65,33,32,11,1
226383,471,129,342,12,3
226383,176,53,123,19,1
226383,1035,415,620,20,1
226383,1332,507,825,21,4
226383,1258,490,768,22,1
226383,1258,490,768,23,1
226383,255,92,163,24,1
226383,1003,398,605,25,1
226383,74,17,57,32,3
226383,134,47,87,39,1
226383,869,351,518,40,1
226383,670,215,455,41,4
226383,273,103,170,42,1
226383,208,70,138,43,1
226383,208,70,138,45,1
226383,65,33,32,51,1
226383,397,112,285,52,3
226383,42,6,36,59,1
226383,166,64,102,60,1
226408,4188,1741,2447,1,4
226408,4188,1741,2447,2,1
226408,4188,1741,2447,3,1
226408,561,260,301,4,1
226408,3627,1481,2146,5,1
226408,203,95,108,19,1
226408,3424,1386,2038,20,1
226408,1121,521,600,21,4
226408,1121,521,600,22,1
226408,1121,521,600,23,1
226408,233,113,120,24,1
226408,888,408,480,25,1
226408,72,43,29,39,1
226408,816,365,451,40,1
226408,3067,1220,1847,41,4
226408,3067,1220,1847,42,1
226408,3067,1220,1847,43,1
226408,328,147,181,44,1
226408,2739,1073,1666,45,1
226408,131,52,79,59,1
226408,2608,1021,1587,60,1
226471,3492,1346,2146,1,4
226471,3063,1163,1900,2,1
226471,3006,1134,1872,3,1
226471,675,261,414,4,1
226471,2331,873,1458,5,1
226471,57,29,28,11,1
226471,429,183,246,12,3
226471,301,114,187,19,1
226471,2030,759,1271,20,1
226471,2998,1117,1881,21,4
226471,2793,1058,1735,22,1
226471,2773,1045,1728,23,1
226471,672,259,413,24,1
226471,2101,786,1315,25,1
226471,20,13,7,31,1
226471,205,59,146,32,3
226471,256,103,153,39,1
226471,1845,683,1162,40,1
226471,494,229,265,41,4
226471,270,105,165,42,1
226471,233,89,144,43,1
226471,3,2,1,44,1
226471,230,87,143,45,1
226471,37,16,21,51,1
226471,224,124,100,52,3
226471,45,11,34,59,1
226471,185,76,109,60,1
226578,8555,2987,5568,1,4
226578,8555,2987,5568,2,1
226578,7302,2460,4842,3,1
226578,1399,548,851,4,1
226578,5903,1912,3991,5,1
226578,1253,527,726,11,1
226578,502,221,281,19,1
226578,5401,1691,3710,20,1
226578,3846,1433,2413,21,4
226578,3846,1433,2413,22,1
226578,3798,1412,2386,23,1
226578,1044,417,627,24,1
226578,2754,995,1759,25,1
226578,48,21,27,31,1
226578,279,120,159,39,1
226578,2475,875,1600,40,1
226578,4709,1554,3155,41,4
226578,4709,1554,3155,42,1
226578,3504,1048,2456,43,1
226578,355,131,224,44,1
226578,3149,917,2232,45,1
226578,1205,506,699,51,1
226578,223,101,122,59,1
226578,2926,816,2110,60,1
226587,1216,624,592,1,4
226587,1212,624,588,2,1
226587,1157,580,577,3,1
226587,250,133,117,4,1
226587,907,447,460,5,1
226587,55,44,11,11,1
226587,4,0,4,12,3
226587,138,77,61,19,1
226587,769,370,399,20,1
226587,1034,513,521,21,4
226587,1032,513,519,22,1
226587,1032,513,519,23,1
226587,249,133,116,24,1
226587,783,380,403,25,1
226587,2,0,2,32,3
226587,113,59,54,39,1
226587,670,321,349,40,1
226587,182,111,71,41,4
226587,180,111,69,42,1
226587,125,67,58,43,1
226587,1,0,1,44,1
226587,124,67,57,45,1
226587,55,44,11,51,1
226587,2,0,2,52,3
226587,25,18,7,59,1
226587,99,49,50,60,1
226675,310,47,263,1,4
226675,310,47,263,2,1
226675,310,47,263,3,1
226675,310,47,263,5,1
226675,310,47,263,20,1
226675,310,47,263,21,4
226675,310,47,263,22,1
226675,310,47,263,23,1
226675,310,47,263,25,1
226675,310,47,263,40,1
226772,58,3,55,1,4
226772,58,3,55,2,1
226772,58,3,55,3,1
226772,23,1,22,4,1
226772,35,2,33,5,1
226772,35,2,33,20,1
226772,32,2,30,21,4
226772,32,2,30,22,1
226772,32,2,30,23,1
226772,13,1,12,24,1
226772,19,1,18,25,1
226772,19,1,18,40,1
226772,26,1,25,41,4
226772,26,1,25,42,1
226772,26,1,25,43,1
226772,10,0,10,44,1
226772,16,1,15,45,1
226772,16,1,15,60,1
226806,5233,2137,3096,1,4
226806,5233,2137,3096,2,1
226806,3406,1298,2108,3,1
226806,758,341,417,4,1
226806,2648,957,1691,5,1
226806,1827,839,988,11,1
226806,249,100,149,19,1
226806,2399,857,1542,20,1
226806,1537,610,927,21,4
226806,1537,610,927,22,1
226806,1360,526,834,23,1
226806,434,198,236,24,1
226806,926,328,598,25,1
226806,177,84,93,31,1
226806,108,43,65,39,1
226806,818,285,533,40,1
226806,3696,1527,2169,41,4
226806,3696,1527,2169,42,1
226806,2046,772,1274,43,1
226806,324,143,181,44,1
226806,1722,629,1093,45,1
226806,1650,755,895,51,1
226806,141,57,84,59,1
226806,1581,572,1009,60,1
226833,5870,2402,3468,1,4
226833,5193,2190,3003,2,1
226833,5192,2190,3002,3,1
226833,818,362,456,4,1
226833,4374,1828,2546,5,1
226833,1,0,1,11,1
226833,677,212,465,12,3
226833,576,220,356,19,1
226833,3798,1608,2190,20,1
226833,3984,1699,2285,21,4
226833,3861,1646,2215,22,1
226833,3861,1646,2215,23,1
226833,802,356,446,24,1
226833,3059,1290,1769,25,1
226833,123,53,70,32,3
226833,382,161,221,39,1
226833,2677,1129,1548,40,1
226833,1886,703,1183,41,4
226833,1332,544,788,42,1
226833,1331,544,787,43,1
226833,16,6,10,44,1
226833,1315,538,777,45,1
226833,1,0,1,51,1
226833,554,159,395,52,3
226833,194,59,135,59,1
226833,1121,479,642,60,1
226860,53,3,50,1,4
226860,53,3,50,2,1
226860,53,3,50,3,1
226860,12,0,12,4,1
226860,41,3,38,5,1
226860,41,3,38,20,1
226860,53,3,50,21,4
226860,53,3,50,22,1
226860,53,3,50,23,1
226860,12,0,12,24,1
226860,41,3,38,25,1
226860,41,3,38,40,1
226879,201,32,169,1,4
226879,201,32,169,2,1
226879,201,32,169,3,1
226879,44,8,36,4,1
226879,157,24,133,5,1
226879,46,6,40,19,1
226879,111,18,93,20,1
226879,162,25,137,21,4
226879,162,25,137,22,1
226879,162,25,137,23,1
226879,43,8,35,24,1
226879,119,17,102,25,1
226879,40,5,35,39,1
226879,79,12,67,40,1
226879,39,7,32,41,4
226879,39,7,32,42,1
226879,39,7,32,43,1
226879,1,0,1,44,1
226879,38,7,31,45,1
226879,6,1,5,59,1
226879,32,6,26,60,1
226903,316,51,265,1,4
226903,316,51,265,2,1
226903,316,51,265,3,1
226903,255,39,216,4,1
226903,61,12,49,5,1
226903,61,12,49,20,1
226903,316,51,265,21,4
226903,316,51,265,22,1
226903,316,51,265,23,1
226903,255,39,216,24,1
226903,61,12,49,25,1
226903,61,12,49,40,1
226930,8797,3693,5104,1,4
226930,8797,3693,5104,2,1
226930,7419,3028,4391,3,1
226930,1393,634,759,4,1
226930,6026,2394,3632,5,1
226930,1378,665,713,11,1
226930,439,199,240,19,1
226930,5587,2195,3392,20,1
226930,1954,974,980,21,4
226930,1954,974,980,22,1
226930,1773,861,912,23,1
226930,730,353,377,24,1
226930,1043,508,535,25,1
226930,181,113,68,31,1
226930,85,48,37,39,1
226930,958,460,498,40,1
226930,6843,2719,4124,41,4
226930,6843,2719,4124,42,1
226930,5646,2167,3479,43,1
226930,663,281,382,44,1
226930,4983,1886,3097,45,1
226930,1197,552,645,51,1
226930,354,151,203,59,1
226930,4629,1735,2894,60,1
227003,493,252,241,1,4
227003,493,252,241,2,1
227003,493,252,241,3,1
227003,138,70,68,4,1
227003,355,182,173,5,1
227003,355,182,173,20,1
227003,493,252,241,21,4
227003,493,252,241,22,1
227003,493,252,241,23,1
227003,138,70,68,24,1
227003,355,182,173,25,1
227003,355,182,173,40,1
227058,108,3,105,1,4
227058,108,3,105,2,1
227058,108,3,105,3,1
227058,103,3,100,4,1
227058,5,0,5,5,1
227058,5,0,5,20,1
227058,86,3,83,21,4
227058,86,3,83,22,1
227058,86,3,83,23,1
227058,83,3,80,24,1
227058,3,0,3,25,1
227058,3,0,3,40,1
227058,22,0,22,41,4
227058,22,0,22,42,1
227058,22,0,22,43,1
227058,20,0,20,44,1
227058,2,0,2,45,1
227058,2,0,2,60,1
227146,10256,4154,6102,1,4
227146,10256,4154,6102,2,1
227146,10256,4154,6102,3,1
227146,2032,950,1082,4,1
227146,8224,3204,5020,5,1
227146,654,262,392,19,1
227146,7570,2942,4628,20,1
227146,4448,1909,2539,21,4
227146,4448,1909,2539,22,1
227146,4448,1909,2539,23,1
227146,1523,718,805,24,1
227146,2925,1191,1734,25,1
227146,358,154,204,39,1
227146,2567,1037,1530,40,1
227146,5808,2245,3563,41,4
227146,5808,2245,3563,42,1
227146,5808,2245,3563,43,1
227146,509,232,277,44,1
227146,5299,2013,3286,45,1
227146,296,108,188,59,1
227146,5003,1905,3098,60,1
227155,51,1,50,1,4
227155,51,1,50,2,1
227155,51,1,50,3,1
227155,48,0,48,4,1
227155,3,1,2,5,1
227155,3,1,2,20,1
227155,12,0,12,21,4
227155,12,0,12,22,1
227155,12,0,12,23,1
227155,10,0,10,24,1
227155,2,0,2,25,1
227155,2,0,2,40,1
227155,39,1,38,41,4
227155,39,1,38,42,1
227155,39,1,38,43,1
227155,38,0,38,44,1
227155,1,1,0,45,1
227155,1,1,0,60,1
227182,64072,25797,38275,1,4
227182,64072,25797,38275,2,1
227182,56288,22729,33559,3,1
227182,12309,5506,6803,4,1
227182,43979,17223,26756,5,1
227182,7784,3068,4716,11,1
227182,3675,1482,2193,19,1
227182,40304,15741,24563,20,1
227182,19815,8675,11140,21,4
227182,19815,8675,11140,22,1
227182,19515,8573,10942,23,1
227182,6261,2823,3438,24,1
227182,13254,5750,7504,25,1
227182,300,102,198,31,1
227182,1501,690,811,39,1
227182,11753,5060,6693,40,1
227182,44257,17122,27135,41,4
227182,44257,17122,27135,42,1
227182,36773,14156,22617,43,1
227182,6048,2683,3365,44,1
227182,30725,11473,19252,45,1
227182,7484,2966,4518,51,1
227182,2174,792,1382,59,1
227182,28551,10681,17870,60,1
227191,11365,5143,6222,1,4
227191,11365,5143,6222,2,1
227191,9319,4135,5184,3,1
227191,1572,781,791,4,1
227191,7747,3354,4393,5,1
227191,2046,1008,1038,11,1
227191,947,419,528,19,1
227191,6800,2935,3865,20,1
227191,2526,1366,1160,21,4
227191,2526,1366,1160,22,1
227191,2289,1232,1057,23,1
227191,739,398,341,24,1
227191,1550,834,716,25,1
227191,237,134,103,31,1
227191,282,163,119,39,1
227191,1268,671,597,40,1
227191,8839,3777,5062,41,4
227191,8839,3777,5062,42,1
227191,7030,2903,4127,43,1
227191,833,383,450,44,1
227191,6197,2520,3677,45,1
227191,1809,874,935,51,1
227191,665,256,409,59,1
227191,5532,2264,3268,60,1
227216,38315,17621,20694,1,4
227216,31243,14748,16495,2,1
227216,31243,14748,16495,3,1
227216,4596,2091,2505,4,1
227216,26647,12657,13990,5,1
227216,7072,2873,4199,12,3
227216,4521,2153,2368,19,1
227216,22126,10504,11622,20,1
227216,27282,12841,14441,21,4
227216,24126,11361,12765,22,1
227216,24126,11361,12765,23,1
227216,4518,2055,2463,24,1
227216,19608,9306,10302,25,1
227216,3156,1480,1676,32,3
227216,3325,1600,1725,39,1
227216,16283,7706,8577,40,1
227216,11033,4780,6253,41,4
227216,7117,3387,3730,42,1
227216,7117,3387,3730,43,1
227216,78,36,42,44,1
227216,7039,3351,3688,45,1
227216,3916,1393,2523,52,3
227216,1196,553,643,59,1
227216,5843,2798,3045,60,1
227225,3225,1227,1998,1,4
227225,3225,1227,1998,2,1
227225,3020,1151,1869,3,1
227225,774,327,447,4,1
227225,2246,824,1422,5,1
227225,205,76,129,11,1
227225,129,56,73,19,1
227225,2117,768,1349,20,1
227225,1106,433,673,21,4
227225,1106,433,673,22,1
227225,1052,410,642,23,1
227225,438,195,243,24,1
227225,614,215,399,25,1
227225,54,23,31,31,1
227225,51,25,26,39,1
227225,563,190,373,40,1
227225,2119,794,1325,41,4
227225,2119,794,1325,42,1
227225,1968,741,1227,43,1
227225,336,132,204,44,1
227225,1632,609,1023,45,1
227225,151,53,98,51,1
227225,78,31,47,59,1
227225,1554,578,976,60,1
227243,713,379,334,1,4
227243,648,344,304,2,1
227243,645,344,301,3,1
227243,87,54,33,4,1
227243,558,290,268,5,1
227243,3,0,3,11,1
227243,65,35,30,12,3
227243,109,55,54,19,1
227243,449,235,214,20,1
227243,535,300,235,21,4
227243,524,295,229,22,1
227243,524,295,229,23,1
227243,87,54,33,24,1
227243,437,241,196,25,1
227243,11,5,6,32,3
227243,79,45,34,39,1
227243,358,196,162,40,1
227243,178,79,99,41,4
227243,124,49,75,42,1
227243,121,49,72,43,1
227243,121,49,72,45,1
227243,3,0,3,51,1
227243,54,30,24,52,3
227243,30,10,20,59,1
227243,91,39,52,60,1
227289,125,96,29,1,4
227289,125,96,29,12,3
227289,70,68,2,21,4
227289,70,68,2,32,3
227289,55,28,27,41,4
227289,55,28,27,52,3
227298,360,349,11,1,4
227298,360,349,11,2,1
227298,360,349,11,3,1
227298,157,157,0,4,1
227298,203,192,11,5,1
227298,203,192,11,20,1
227298,360,349,11,21,4
227298,360,349,11,22,1
227298,360,349,11,23,1
227298,157,157,0,24,1
227298,203,192,11,25,1
227298,203,192,11,40,1
227304,5059,1900,3159,1,4
227304,5059,1900,3159,2,1
227304,3781,1342,2439,3,1
227304,850,349,501,4,1
227304,2931,993,1938,5,1
227304,1278,558,720,11,1
227304,797,285,512,19,1
227304,2134,708,1426,20,1
227304,1423,481,942,21,4
227304,1423,481,942,22,1
227304,1362,458,904,23,1
227304,397,149,248,24,1
227304,965,309,656,25,1
227304,61,23,38,31,1
227304,267,105,162,39,1
227304,698,204,494,40,1
227304,3636,1419,2217,41,4
227304,3636,1419,2217,42,1
227304,2419,884,1535,43,1
227304,453,200,253,44,1
227304,1966,684,1282,45,1
227304,1217,535,682,51,1
227304,530,180,350,59,1
227304,1436,504,932,60,1
227313,212,8,204,1,4
227313,212,8,204,2,1
227313,212,8,204,3,1
227313,85,2,83,4,1
227313,127,6,121,5,1
227313,127,6,121,20,1
227313,149,6,143,21,4
227313,149,6,143,22,1
227313,149,6,143,23,1
227313,62,1,61,24,1
227313,87,5,82,25,1
227313,87,5,82,40,1
227313,63,2,61,41,4
227313,63,2,61,42,1
227313,63,2,61,43,1
227313,23,1,22,44,1
227313,40,1,39,45,1
227313,40,1,39,60,1
227322,223,10,213,1,4
227322,223,10,213,2,1
227322,223,10,213,3,1
227322,83,2,81,4,1
227322,140,8,132,5,1
227322,140,8,132,20,1
227322,145,7,138,21,4
227322,145,7,138,22,1
227322,145,7,138,23,1
227322,53,2,51,24,1
227322,92,5,87,25,1
227322,92,5,87,40,1
227322,78,3,75,41,4
227322,78,3,75,42,1
227322,78,3,75,43,1
227322,30,0,30,44,1
227322,48,3,45,45,1
227322,48,3,45,60,1
227331,2927,778,2149,1,4
227331,1555,432,1123,2,1
227331,1509,426,1083,3,1
227331,338,115,223,4,1
227331,1171,311,860,5,1
227331,46,6,40,11,1
227331,1372,346,1026,12,3
227331,185,49,136,19,1
227331,986,262,724,20,1
227331,2498,662,1836,21,4
227331,1312,360,952,22,1
227331,1285,358,927,23,1
227331,335,113,222,24,1
227331,950,245,705,25,1
227331,27,2,25,31,1
227331,1186,302,884,32,3
227331,165,44,121,39,1
227331,785,201,584,40,1
227331,429,116,313,41,4
227331,243,72,171,42,1
227331,224,68,156,43,1
227331,3,2,1,44,1
227331,221,66,155,45,1
227331,19,4,15,51,1
227331,186,44,142,52,3
227331,20,5,15,59,1
227331,201,61,140,60,1
227368,20053,8825,11228,1,4
227368,17230,7686,9544,2,1
227368,17200,7676,9524,3,1
227368,3501,1573,1928,4,1
227368,13699,6103,7596,5,1
227368,30,10,20,11,1
227368,2823,1139,1684,12,3
227368,1252,517,735,19,1
227368,12447,5586,6861,20,1
227368,14138,6151,7987,21,4
227368,13119,5751,7368,22,1
227368,13117,5750,7367,23,1
227368,3269,1447,1822,24,1
227368,9848,4303,5545,25,1
227368,2,1,1,31,1
227368,1019,400,619,32,3
227368,878,372,506,39,1
227368,8970,3931,5039,40,1
227368,5915,2674,3241,41,4
227368,4111,1935,2176,42,1
227368,4083,1926,2157,43,1
227368,232,126,106,44,1
227368,3851,1800,2051,45,1
227368,28,9,19,51,1
227368,1804,739,1065,52,3
227368,374,145,229,59,1
227368,3477,1655,1822,60,1
227377,12285,5153,7132,1,4
227377,11220,4792,6428,2,1
227377,10379,4428,5951,3,1
227377,1777,807,970,4,1
227377,8602,3621,4981,5,1
227377,841,364,477,11,1
227377,1065,361,704,12,3
227377,825,357,468,19,1
227377,7777,3264,4513,20,1
227377,6018,2682,3336,21,4
227377,5814,2606,3208,22,1
227377,5610,2516,3094,23,1
227377,1275,580,695,24,1
227377,4335,1936,2399,25,1
227377,204,90,114,31,1
227377,204,76,128,32,3
227377,377,181,196,39,1
227377,3958,1755,2203,40,1
227377,6267,2471,3796,41,4
227377,5406,2186,3220,42,1
227377,4769,1912,2857,43,1
227377,502,227,275,44,1
227377,4267,1685,2582,45,1
227377,637,274,363,51,1
227377,861,285,576,52,3
227377,448,176,272,59,1
227377,3819,1509,2310,60,1
227386,2699,947,1752,1,4
227386,2699,947,1752,2,1
227386,2699,947,1752,3,1
227386,455,212,243,4,1
227386,2244,735,1509,5,1
227386,329,97,232,19,1
227386,1915,638,1277,20,1
227386,1327,518,809,21,4
227386,1327,518,809,22,1
227386,1327,518,809,23,1
227386,380,185,195,24,1
227386,947,333,614,25,1
227386,213,81,132,39,1
227386,734,252,482,40,1
227386,1372,429,943,41,4
227386,1372,429,943,42,1
227386,1372,429,943,43,1
227386,75,27,48,44,1
227386,1297,402,895,45,1
227386,116,16,100,59,1
227386,1181,386,795,60,1
227401,5301,2160,3141,1,4
227401,5301,2160,3141,2,1
227401,3964,1563,2401,3,1
227401,1221,547,674,4,1
227401,2743,1016,1727,5,1
227401,1337,597,740,11,1
227401,294,121,173,19,1
227401,2449,895,1554,20,1
227401,2470,1053,1417,21,4
227401,2470,1053,1417,22,1
227401,2452,1050,1402,23,1
227401,970,444,526,24,1
227401,1482,606,876,25,1
227401,18,3,15,31,1
227401,166,73,93,39,1
227401,1316,533,783,40,1
227401,2831,1107,1724,41,4
227401,2831,1107,1724,42,1
227401,1512,513,999,43,1
227401,251,103,148,44,1
227401,1261,410,851,45,1
227401,1319,594,725,51,1
227401,128,48,80,59,1
227401,1133,362,771,60,1
227429,243,111,132,1,4
227429,243,111,132,2,1
227429,243,111,132,3,1
227429,70,33,37,4,1
227429,173,78,95,5,1
227429,42,22,20,19,1
227429,131,56,75,20,1
227429,216,102,114,21,4
227429,216,102,114,22,1
227429,216,102,114,23,1
227429,69,33,36,24,1
227429,147,69,78,25,1
227429,37,20,17,39,1
227429,110,49,61,40,1
227429,27,9,18,41,4
227429,27,9,18,42,1
227429,27,9,18,43,1
227429,1,0,1,44,1
227429,26,9,17,45,1
227429,5,2,3,59,1
227429,21,7,14,60,1
227526,8283,3257,5026,1,4
227526,6731,2805,3926,2,1
227526,6731,2805,3926,3,1
227526,1466,611,855,4,1
227526,5265,2194,3071,5,1
227526,1552,452,1100,12,3
227526,449,218,231,19,1
227526,4816,1976,2840,20,1
227526,6828,2790,4038,21,4
227526,6234,2593,3641,22,1
227526,6234,2593,3641,23,1
227526,1463,610,853,24,1
227526,4771,1983,2788,25,1
227526,594,197,397,32,3
227526,394,190,204,39,1
227526,4377,1793,2584,40,1
227526,1455,467,988,41,4
227526,497,212,285,42,1
227526,497,212,285,43,1
227526,3,1,2,44,1
227526,494,211,283,45,1
227526,958,255,703,52,3
227526,55,28,27,59,1
227526,439,183,256,60,1
227687,1893,812,1081,1,4
227687,1893,812,1081,2,1
227687,1738,753,985,3,1
227687,748,358,390,4,1
227687,990,395,595,5,1
227687,155,59,96,11,1
227687,212,91,121,19,1
227687,778,304,474,20,1
227687,982,425,557,21,4
227687,982,425,557,22,1
227687,924,406,518,23,1
227687,369,190,179,24,1
227687,555,216,339,25,1
227687,58,19,39,31,1
227687,147,65,82,39,1
227687,408,151,257,40,1
227687,911,387,524,41,4
227687,911,387,524,42,1
227687,814,347,467,43,1
227687,379,168,211,44,1
227687,435,179,256,45,1
227687,97,40,57,51,1
227687,65,26,39,59,1
227687,370,153,217,60,1
227748,251,232,19,1,4
227748,251,232,19,2,1
227748,251,232,19,3,1
227748,37,33,4,4,1
227748,214,199,15,5,1
227748,214,199,15,20,1
227748,246,227,19,21,4
227748,246,227,19,22,1
227748,246,227,19,23,1
227748,36,32,4,24,1
227748,210,195,15,25,1
227748,210,195,15,40,1
227748,5,5,0,41,4
227748,5,5,0,42,1
227748,5,5,0,43,1
227748,1,1,0,44,1
227748,4,4,0,45,1
227748,4,4,0,60,1
227757,6628,3743,2885,1,4
227757,3965,2041,1924,2,1
227757,3920,2010,1910,3,1
227757,976,511,465,4,1
227757,2944,1499,1445,5,1
227757,45,31,14,11,1
227757,2663,1702,961,12,3
227757,57,34,23,19,1
227757,2887,1465,1422,20,1
227757,6356,3597,2759,21,4
227757,3904,1995,1909,22,1
227757,3867,1969,1898,23,1
227757,976,511,465,24,1
227757,2891,1458,1433,25,1
227757,37,26,11,31,1
227757,2452,1602,850,32,3
227757,57,34,23,39,1
227757,2834,1424,1410,40,1
227757,272,146,126,41,4
227757,61,46,15,42,1
227757,53,41,12,43,1
227757,53,41,12,45,1
227757,8,5,3,51,1
227757,211,100,111,52,3
227757,53,41,12,60,1
227766,19287,8675,10612,1,4
227766,19287,8675,10612,2,1
227766,15979,7173,8806,3,1
227766,2411,1217,1194,4,1
227766,13568,5956,7612,5,1
227766,3308,1502,1806,11,1
227766,1106,495,611,19,1
227766,12462,5461,7001,20,1
227766,4613,2362,2251,21,4
227766,4613,2362,2251,22,1
227766,4099,2093,2006,23,1
227766,982,515,467,24,1
227766,3117,1578,1539,25,1
227766,514,269,245,31,1
227766,256,141,115,39,1
227766,2861,1437,1424,40,1
227766,14674,6313,8361,41,4
227766,14674,6313,8361,42,1
227766,11880,5080,6800,43,1
227766,1429,702,727,44,1
227766,10451,4378,6073,45,1
227766,2794,1233,1561,51,1
227766,850,354,496,59,1
227766,9601,4024,5577,60,1
227836,540,147,393,1,4
227836,540,147,393,2,1
227836,538,147,391,3,1
227836,152,34,118,4,1
227836,386,113,273,5,1
227836,2,0,2,11,1
227836,14,6,8,19,1
227836,372,107,265,20,1
227836,540,147,393,21,4
227836,540,147,393,22,1
227836,538,147,391,23,1
227836,152,34,118,24,1
227836,386,113,273,25,1
227836,2,0,2,31,1
227836,14,6,8,39,1
227836,372,107,265,40,1
227845,4861,1886,2975,1,4
227845,4089,1604,2485,2,1
227845,4077,1601,2476,3,1
227845,791,311,480,4,1
227845,3286,1290,1996,5,1
227845,12,3,9,11,1
227845,772,282,490,12,3
227845,310,119,191,19,1
227845,2976,1171,1805,20,1
227845,3651,1444,2207,21,4
227845,3442,1357,2085,22,1
227845,3441,1356,2085,23,1
227845,791,311,480,24,1
227845,2650,1045,1605,25,1
227845,1,1,0,31,1
227845,209,87,122,32,3
227845,251,100,151,39,1
227845,2399,945,1454,40,1
227845,1210,442,768,41,4
227845,647,247,400,42,1
227845,636,245,391,43,1
227845,636,245,391,45,1
227845,11,2,9,51,1
227845,563,195,368,52,3
227845,59,19,40,59,1
227845,577,226,351,60,1
227854,10238,4540,5698,1,4
227854,10238,4540,5698,2,1
227854,7898,3424,4474,3,1
227854,1130,595,535,4,1
227854,6768,2829,3939,5,1
227854,2340,1116,1224,11,1
227854,612,266,346,19,1
227854,6156,2563,3593,20,1
227854,1769,883,886,21,4
227854,1769,883,886,22,1
227854,1591,783,808,23,1
227854,481,246,235,24,1
227854,1110,537,573,25,1
227854,178,100,78,31,1
227854,92,50,42,39,1
227854,1018,487,531,40,1
227854,8469,3657,4812,41,4
227854,8469,3657,4812,42,1
227854,6307,2641,3666,43,1
227854,649,349,300,44,1
227854,5658,2292,3366,45,1
227854,2162,1016,1146,51,1
227854,520,216,304,59,1
227854,5138,2076,3062,60,1
227863,3525,1140,2385,1,4
227863,1572,593,979,2,1
227863,1529,576,953,3,1
227863,237,84,153,4,1
227863,1292,492,800,5,1
227863,43,17,26,11,1
227863,1953,547,1406,12,3
227863,183,70,113,19,1
227863,1109,422,687,20,1
227863,1623,650,973,21,4
227863,1269,443,826,22,1
227863,1256,439,817,23,1
227863,233,83,150,24,1
227863,1023,356,667,25,1
227863,13,4,9,31,1
227863,354,207,147,32,3
227863,165,61,104,39,1
227863,858,295,563,40,1
227863,1902,490,1412,41,4
227863,303,150,153,42,1
227863,273,137,136,43,1
227863,4,1,3,44,1
227863,269,136,133,45,1
227863,30,13,17,51,1
227863,1599,340,1259,52,3
227863,18,9,9,59,1
227863,251,127,124,60,1
227881,19210,7667,11543,1,4
227881,16255,6682,9573,2,1
227881,16255,6682,9573,3,1
227881,2452,925,1527,4,1
227881,13803,5757,8046,5,1
227881,2955,985,1970,12,3
227881,2406,1012,1394,19,1
227881,11397,4745,6652,20,1
227881,14132,5838,8294,21,4
227881,13359,5550,7809,22,1
227881,13359,5550,7809,23,1
227881,2375,892,1483,24,1
227881,10984,4658,6326,25,1
227881,773,288,485,32,3
227881,1812,801,1011,39,1
227881,9172,3857,5315,40,1
227881,5078,1829,3249,41,4
227881,2896,1132,1764,42,1
227881,2896,1132,1764,43,1
227881,77,33,44,44,1
227881,2819,1099,1720,45,1
227881,2182,697,1485,52,3
227881,594,211,383,59,1
227881,2225,888,1337,60,1
227924,23004,9366,13638,1,4
227924,23004,9366,13638,2,1
227924,19524,7958,11566,3,1
227924,3337,1446,1891,4,1
227924,16187,6512,9675,5,1
227924,3480,1408,2072,11,1
227924,1615,670,945,19,1
227924,14572,5842,8730,20,1
227924,5672,2509,3163,21,4
227924,5672,2509,3163,22,1
227924,5226,2325,2901,23,1
227924,1415,608,807,24,1
227924,3811,1717,2094,25,1
227924,446,184,262,31,1
227924,354,157,197,39,1
227924,3457,1560,1897,40,1
227924,17332,6857,10475,41,4
227924,17332,6857,10475,42,1
227924,14298,5633,8665,43,1
227924,1922,838,1084,44,1
227924,12376,4795,7581,45,1
227924,3034,1224,1810,51,1
227924,1261,513,748,59,1
227924,11115,4282,6833,60,1
227979,28385,12368,16017,1,4
227979,28385,12368,16017,2,1
227979,24775,10767,14008,3,1
227979,5576,2631,2945,4,1
227979,19199,8136,11063,5,1
227979,3610,1601,2009,11,1
227979,1563,676,887,19,1
227979,17636,7460,10176,20,1
227979,7656,3526,4130,21,4
227979,7656,3526,4130,22,1
227979,7196,3307,3889,23,1
227979,2668,1210,1458,24,1
227979,4528,2097,2431,25,1
227979,460,219,241,31,1
227979,467,200,267,39,1
227979,4061,1897,2164,40,1
227979,20729,8842,11887,41,4
227979,20729,8842,11887,42,1
227979,17579,7460,10119,43,1
227979,2908,1421,1487,44,1
227979,14671,6039,8632,45,1
227979,3150,1382,1768,51,1
227979,1096,476,620,59,1
227979,13575,5563,8012,60,1
228042,1136,482,654,1,4
228042,1065,456,609,2,1
228042,1051,445,606,3,1
228042,299,127,172,4,1
228042,752,318,434,5,1
228042,14,11,3,11,1
228042,71,26,45,12,3
228042,76,41,35,19,1
228042,676,277,399,20,1
228042,1095,465,630,21,4
228042,1029,440,589,22,1
228042,1029,440,589,23,1
228042,299,127,172,24,1
228042,730,313,417,25,1
228042,66,25,41,32,3
228042,71,39,32,39,1
228042,659,274,385,40,1
228042,41,17,24,41,4
228042,36,16,20,42,1
228042,22,5,17,43,1
228042,22,5,17,45,1
228042,14,11,3,51,1
228042,5,1,4,52,3
228042,5,2,3,59,1
228042,17,3,14,60,1
228088,48,5,43,1,4
228088,48,5,43,2,1
228088,48,5,43,3,1
228088,23,1,22,4,1
228088,25,4,21,5,1
228088,25,4,21,20,1
228088,48,5,43,21,4
228088,48,5,43,22,1
228088,48,5,43,23,1
228088,23,1,22,24,1
228088,25,4,21,25,1
228088,25,4,21,40,1
228149,3868,1827,2041,1,4
228149,2393,1050,1343,2,1
228149,2390,1047,1343,3,1
228149,596,257,339,4,1
228149,1794,790,1004,5,1
228149,3,3,0,11,1
228149,1475,777,698,12,3
228149,124,71,53,19,1
228149,1670,719,951,20,1
228149,3279,1528,1751,21,4
228149,2286,1001,1285,22,1
228149,2283,998,1285,23,1
228149,596,257,339,24,1
228149,1687,741,946,25,1
228149,3,3,0,31,1
228149,993,527,466,32,3
228149,107,61,46,39,1
228149,1580,680,900,40,1
228149,589,299,290,41,4
228149,107,49,58,42,1
228149,107,49,58,43,1
228149,107,49,58,45,1
228149,482,250,232,52,3
228149,17,10,7,59,1
228149,90,39,51,60,1
228158,9559,4298,5261,1,4
228158,9559,4298,5261,2,1
228158,7765,3548,4217,3,1
228158,1485,730,755,4,1
228158,6280,2818,3462,5,1
228158,1794,750,1044,11,1
228158,808,424,384,19,1
228158,5472,2394,3078,20,1
228158,4678,2268,2410,21,4
228158,4678,2268,2410,22,1
228158,4655,2256,2399,23,1
228158,1192,593,599,24,1
228158,3463,1663,1800,25,1
228158,23,12,11,31,1
228158,495,275,220,39,1
228158,2968,1388,1580,40,1
228158,4881,2030,2851,41,4
228158,4881,2030,2851,42,1
228158,3110,1292,1818,43,1
228158,293,137,156,44,1
228158,2817,1155,1662,45,1
228158,1771,738,1033,51,1
228158,313,149,164,59,1
228158,2504,1006,1498,60,1
228185,42,33,9,1,4
228185,42,33,9,2,1
228185,42,33,9,3,1
228185,34,27,7,4,1
228185,8,6,2,5,1
228185,8,6,2,20,1
228185,39,30,9,21,4
228185,39,30,9,22,1
228185,39,30,9,23,1
228185,32,25,7,24,1
228185,7,5,2,25,1
228185,7,5,2,40,1
228185,3,3,0,41,4
228185,3,3,0,42,1
228185,3,3,0,43,1
228185,2,2,0,44,1
228185,1,1,0,45,1
228185,1,1,0,60,1
228194,1197,673,524,1,4
228194,1197,673,524,12,3
228194,933,516,417,21,4
228194,933,516,417,32,3
228194,264,157,107,41,4
228194,264,157,107,52,3
228200,316,121,195,1,4
228200,316,121,195,2,1
228200,316,121,195,3,1
228200,109,41,68,4,1
228200,207,80,127,5,1
228200,207,80,127,20,1
228200,316,121,195,21,4
228200,316,121,195,22,1
228200,316,121,195,23,1
228200,109,41,68,24,1
228200,207,80,127,25,1
228200,207,80,127,40,1
228219,351,80,271,1,4
228219,351,80,271,2,1
228219,351,80,271,3,1
228219,83,21,62,4,1
228219,268,59,209,5,1
228219,268,59,209,20,1
228219,351,80,271,21,4
228219,351,80,271,22,1
228219,351,80,271,23,1
228219,83,21,62,24,1
228219,268,59,209,25,1
228219,268,59,209,40,1
228246,10929,5811,5118,1,4
228246,6357,3137,3220,2,1
228246,6295,3112,3183,3,1
228246,1431,694,737,4,1
228246,4864,2418,2446,5,1
228246,62,25,37,11,1
228246,4572,2674,1898,12,3
228246,337,165,172,19,1
228246,4527,2253,2274,20,1
228246,8541,4519,4022,21,4
228246,6119,3019,3100,22,1
228246,6116,3018,3098,23,1
228246,1428,692,736,24,1
228246,4688,2326,2362,25,1
228246,3,1,2,31,1
228246,2422,1500,922,32,3
228246,328,163,165,39,1
228246,4360,2163,2197,40,1
228246,2388,1292,1096,41,4
228246,238,118,120,42,1
228246,179,94,85,43,1
228246,3,2,1,44,1
228246,176,92,84,45,1
228246,59,24,35,51,1
228246,2150,1174,976,52,3
228246,9,2,7,59,1
228246,167,90,77,60,1
228282,230,14,216,1,4
228282,230,14,216,2,1
228282,230,14,216,3,1
228282,123,6,117,4,1
228282,107,8,99,5,1
228282,107,8,99,20,1
228282,230,14,216,21,4
228282,230,14,216,22,1
228282,230,14,216,23,1
228282,123,6,117,24,1
228282,107,8,99,25,1
228282,107,8,99,40,1
228291,10,10,0,1,4
228291,10,10,0,2,1
228291,10,10,0,3,1
228291,4,4,0,4,1
228291,6,6,0,5,1
228291,6,6,0,20,1
228291,10,10,0,21,4
228291,10,10,0,22,1
228291,10,10,0,23,1
228291,4,4,0,24,1
228291,6,6,0,25,1
228291,6,6,0,40,1
228316,5410,2234,3176,1,4
228316,5410,2234,3176,2,1
228316,3872,1581,2291,3,1
228316,781,401,380,4,1
228316,3091,1180,1911,5,1
228316,1538,653,885,11,1
228316,106,56,50,19,1
228316,2985,1124,1861,20,1
228316,2039,916,1123,21,4
228316,2039,916,1123,22,1
228316,1965,866,1099,23,1
228316,514,290,224,24,1
228316,1451,576,875,25,1
228316,74,50,24,31,1
228316,43,22,21,39,1
228316,1408,554,854,40,1
228316,3371,1318,2053,41,4
228316,3371,1318,2053,42,1
228316,1907,715,1192,43,1
228316,267,111,156,44,1
228316,1640,604,1036,45,1
228316,1464,603,861,51,1
228316,63,34,29,59,1
228316,1577,570,1007,60,1
228325,2012,981,1031,1,4
228325,1700,821,879,2,1
228325,1669,809,860,3,1
228325,345,178,167,4,1
228325,1324,631,693,5,1
228325,31,12,19,11,1
228325,312,160,152,12,3
228325,220,111,109,19,1
228325,1104,520,584,20,1
228325,1488,727,761,21,4
228325,1434,695,739,22,1
228325,1434,695,739,23,1
228325,330,167,163,24,1
228325,1104,528,576,25,1
228325,54,32,22,32,3
228325,191,99,92,39,1
228325,913,429,484,40,1
228325,524,254,270,41,4
228325,266,126,140,42,1
228325,235,114,121,43,1
228325,15,11,4,44,1
228325,220,103,117,45,1
228325,31,12,19,51,1
228325,258,128,130,52,3
228325,29,12,17,59,1
228325,191,91,100,60,1
228343,1535,655,880,1,4
228343,1535,655,880,2,1
228343,1528,653,875,3,1
228343,491,226,265,4,1
228343,1037,427,610,5,1
228343,7,2,5,11,1
228343,62,31,31,19,1
228343,975,396,579,20,1
228343,1519,652,867,21,4
228343,1519,652,867,22,1
228343,1513,650,863,23,1
228343,491,226,265,24,1
228343,1022,424,598,25,1
228343,6,2,4,31,1
228343,61,31,30,39,1
228343,961,393,568,40,1
228343,16,3,13,41,4
228343,16,3,13,42,1
228343,15,3,12,43,1
228343,15,3,12,45,1
228343,1,0,1,51,1
228343,1,0,1,59,1
228343,14,3,11,60,1
228431,12772,4612,8160,1,4
228431,11006,4056,6950,2,1
228431,10715,3929,6786,3,1
228431,2253,809,1444,4,1
228431,8462,3120,5342,5,1
228431,291,127,164,11,1
228431,1766,556,1210,12,3
228431,867,349,518,19,1
228431,7595,2771,4824,20,1
228431,9895,3613,6282,21,4
228431,9333,3436,5897,22,1
228431,9325,3435,5890,23,1
228431,2227,801,1426,24,1
228431,7098,2634,4464,25,1
228431,8,1,7,31,1
228431,562,177,385,32,3
228431,746,303,443,39,1
228431,6352,2331,4021,40,1
228431,2877,999,1878,41,4
228431,1673,620,1053,42,1
228431,1390,494,896,43,1
228431,26,8,18,44,1
228431,1364,486,878,45,1
228431,283,126,157,51,1
228431,1204,379,825,52,3
228431,121,46,75,59,1
228431,1243,440,803,60,1
228459,35546,15478,20068,1,4
228459,31005,13758,17247,2,1
228459,31005,13758,17247,3,1
228459,5365,2110,3255,4,1
228459,25640,11648,13992,5,1
228459,4541,1720,2821,12,3
228459,3735,1749,1986,19,1
228459,21905,9899,12006,20,1
228459,28185,12172,16013,21,4
228459,25683,11207,14476,22,1
228459,25683,11207,14476,23,1
228459,5314,2085,3229,24,1
228459,20369,9122,11247,25,1
228459,2502,965,1537,32,3
228459,3098,1441,1657,39,1
228459,17271,7681,9590,40,1
228459,7361,3306,4055,41,4
228459,5322,2551,2771,42,1
228459,5322,2551,2771,43,1
228459,51,25,26,44,1
228459,5271,2526,2745,45,1
228459,2039,755,1284,52,3
228459,637,308,329,59,1
228459,4634,2218,2416,60,1
228468,808,343,465,1,4
228468,791,335,456,2,1
228468,715,305,410,3,1
228468,167,73,94,4,1
228468,548,232,316,5,1
228468,76,30,46,11,1
228468,17,8,9,12,3
228468,60,30,30,19,1
228468,488,202,286,20,1
228468,651,283,368,21,4
228468,642,278,364,22,1
228468,627,272,355,23,1
228468,167,73,94,24,1
228468,460,199,261,25,1
228468,15,6,9,31,1
228468,9,5,4,32,3
228468,48,26,22,39,1
228468,412,173,239,40,1
228468,157,60,97,41,4
228468,149,57,92,42,1
228468,88,33,55,43,1
228468,88,33,55,45,1
228468,61,24,37,51,1
228468,8,3,5,52,3
228468,12,4,8,59,1
228468,76,29,47,60,1
228486,172,90,82,1,4
228486,172,90,82,2,1
228486,169,88,81,3,1
228486,60,29,31,4,1
228486,109,59,50,5,1
228486,3,2,1,11,1
228486,13,9,4,19,1
228486,96,50,46,20,1
228486,157,81,76,21,4
228486,157,81,76,22,1
228486,155,79,76,23,1
228486,60,29,31,24,1
228486,95,50,45,25,1
228486,2,2,0,31,1
228486,13,9,4,39,1
228486,82,41,41,40,1
228486,15,9,6,41,4
228486,15,9,6,42,1
228486,14,9,5,43,1
228486,14,9,5,45,1
228486,1,0,1,51,1
228486,14,9,5,60,1
228501,2842,1185,1657,1,4
228501,2003,880,1123,2,1
228501,2000,877,1123,3,1
228501,305,174,131,4,1
228501,1695,703,992,5,1
228501,3,3,0,11,1
228501,839,305,534,12,3
228501,310,136,174,19,1
228501,1385,567,818,20,1
228501,1378,697,681,21,4
228501,1213,623,590,22,1
228501,1213,623,590,23,1
228501,301,172,129,24,1
228501,912,451,461,25,1
228501,165,74,91,32,3
228501,156,92,64,39,1
228501,756,359,397,40,1
228501,1464,488,976,41,4
228501,790,257,533,42,1
228501,787,254,533,43,1
228501,4,2,2,44,1
228501,783,252,531,45,1
228501,3,3,0,51,1
228501,674,231,443,52,3
228501,154,44,110,59,1
228501,629,208,421,60,1
228529,13307,5193,8114,1,4
228529,11348,4507,6841,2,1
228529,11328,4502,6826,3,1
228529,1827,726,1101,4,1
228529,9501,3776,5725,5,1
228529,20,5,15,11,1
228529,1959,686,1273,12,3
228529,1742,666,1076,19,1
228529,7759,3110,4649,20,1
228529,8278,3314,4964,21,4
228529,7842,3149,4693,22,1
228529,7840,3148,4692,23,1
228529,1698,701,997,24,1
228529,6142,2447,3695,25,1
228529,2,1,1,31,1
228529,436,165,271,32,3
228529,908,358,550,39,1
228529,5234,2089,3145,40,1
228529,5029,1879,3150,41,4
228529,3506,1358,2148,42,1
228529,3488,1354,2134,43,1
228529,129,25,104,44,1
228529,3359,1329,2030,45,1
228529,18,4,14,51,1
228529,1523,521,1002,52,3
228529,834,308,526,59,1
228529,2525,1021,1504,60,1
228547,50771,21162,29609,1,4
228547,50771,21162,29609,2,1
228547,43464,18050,25414,3,1
228547,8384,3833,4551,4,1
228547,35080,14217,20863,5,1
228547,7307,3112,4195,11,1
228547,2349,1020,1329,19,1
228547,32731,13197,19534,20,1
228547,17420,7743,9677,21,4
228547,17420,7743,9677,22,1
228547,16428,7269,9159,23,1
228547,4495,2084,2411,24,1
228547,11933,5185,6748,25,1
228547,992,474,518,31,1
228547,942,412,530,39,1
228547,10991,4773,6218,40,1
228547,33351,13419,19932,41,4
228547,33351,13419,19932,42,1
228547,27036,10781,16255,43,1
228547,3889,1749,2140,44,1
228547,23147,9032,14115,45,1
228547,6315,2638,3677,51,1
228547,1407,608,799,59,1
228547,21740,8424,13316,60,1
228608,5506,1900,3606,1,4
228608,5506,1900,3606,2,1
228608,5292,1840,3452,3,1
228608,671,287,384,4,1
228608,4621,1553,3068,5,1
228608,214,60,154,11,1
228608,344,116,228,19,1
228608,4277,1437,2840,20,1
228608,1821,723,1098,21,4
228608,1821,723,1098,22,1
228608,1769,713,1056,23,1
228608,358,166,192,24,1
228608,1411,547,864,25,1
228608,52,10,42,31,1
228608,103,48,55,39,1
228608,1308,499,809,40,1
228608,3685,1177,2508,41,4
228608,3685,1177,2508,42,1
228608,3523,1127,2396,43,1
228608,313,121,192,44,1
228608,3210,1006,2204,45,1
228608,162,50,112,51,1
228608,241,68,173,59,1
228608,2969,938,2031,60,1
228635,2374,1212,1162,1,4
228635,10,5,5,2,1
228635,10,5,5,3,1
228635,10,5,5,5,1
228635,2364,1207,1157,12,3
228635,6,2,4,19,1
228635,4,3,1,20,1
228635,1768,832,936,21,4
228635,10,5,5,22,1
228635,10,5,5,23,1
228635,10,5,5,25,1
228635,1758,827,931,32,3
228635,6,2,4,39,1
228635,4,3,1,40,1
228635,606,380,226,41,4
228635,606,380,226,52,3
228644,3148,1186,1962,1,4
228644,793,182,611,2,1
228644,793,182,611,3,1
228644,793,182,611,5,1
228644,2355,1004,1351,12,3
228644,259,72,187,19,1
228644,534,110,424,20,1
228644,2802,1084,1718,21,4
228644,739,159,580,22,1
228644,739,159,580,23,1
228644,739,159,580,25,1
228644,2063,925,1138,32,3
228644,245,65,180,39,1
228644,494,94,400,40,1
228644,346,102,244,41,4
228644,54,23,31,42,1
228644,54,23,31,43,1
228644,54,23,31,45,1
228644,292,79,213,52,3
228644,14,7,7,59,1
228644,40,16,24,60,1
228653,3112,995,2117,1,4
228653,725,158,567,2,1
228653,725,158,567,3,1
228653,725,158,567,5,1
228653,2387,837,1550,12,3
228653,273,60,213,19,1
228653,452,98,354,20,1
228653,2349,819,1530,21,4
228653,599,117,482,22,1
228653,599,117,482,23,1
228653,599,117,482,25,1
228653,1750,702,1048,32,3
228653,228,47,181,39,1
228653,371,70,301,40,1
228653,763,176,587,41,4
228653,126,41,85,42,1
228653,126,41,85,43,1
228653,126,41,85,45,1
228653,637,135,502,52,3
228653,45,13,32,59,1
228653,81,28,53,60,1
228680,3988,3132,856,1,4
228680,3988,3132,856,2,1
228680,3699,2934,765,3,1
228680,900,766,134,4,1
228680,2799,2168,631,5,1
228680,289,198,91,11,1
228680,1268,942,326,19,1
228680,1531,1226,305,20,1
228680,2846,2271,575,21,4
228680,2846,2271,575,22,1
228680,2832,2264,568,23,1
228680,787,673,114,24,1
228680,2045,1591,454,25,1
228680,14,7,7,31,1
228680,927,688,239,39,1
228680,1118,903,215,40,1
228680,1142,861,281,41,4
228680,1142,861,281,42,1
228680,867,670,197,43,1
228680,113,93,20,44,1
228680,754,577,177,45,1
228680,275,191,84,51,1
228680,341,254,87,59,1
228680,413,323,90,60,1
228699,4233,1606,2627,1,4
228699,4233,1606,2627,2,1
228699,2884,996,1888,3,1
228699,676,276,400,4,1
228699,2208,720,1488,5,1
228699,1349,610,739,11,1
228699,369,126,243,19,1
228699,1839,594,1245,20,1
228699,1661,615,1046,21,4
228699,1661,615,1046,22,1
228699,1537,568,969,23,1
228699,457,189,268,24,1
228699,1080,379,701,25,1
228699,124,47,77,31,1
228699,195,79,116,39,1
228699,885,300,585,40,1
228699,2572,991,1581,41,4
228699,2572,991,1581,42,1
228699,1347,428,919,43,1
228699,219,87,132,44,1
228699,1128,341,787,45,1
228699,1225,563,662,51,1
228699,174,47,127,59,1
228699,954,294,660,60,1
228705,12229,5565,6664,1,4
228705,9430,4296,5134,2,1
228705,9400,4273,5127,3,1
228705,1270,731,539,4,1
228705,8130,3542,4588,5,1
228705,30,23,7,11,1
228705,2799,1269,1530,12,3
228705,1510,600,910,19,1
228705,6620,2942,3678,20,1
228705,7665,3785,3880,21,4
228705,6416,3106,3310,22,1
228705,6415,3106,3309,23,1
228705,1216,699,517,24,1
228705,5199,2407,2792,25,1
228705,1,0,1,31,1
228705,1249,679,570,32,3
228705,962,384,578,39,1
228705,4237,2023,2214,40,1
228705,4564,1780,2784,41,4
228705,3014,1190,1824,42,1
228705,2985,1167,1818,43,1
228705,54,32,22,44,1
228705,2931,1135,1796,45,1
228705,29,23,6,51,1
228705,1550,590,960,52,3
228705,548,216,332,59,1
228705,2383,919,1464,60,1
228723,55697,29610,26087,1,4
228723,44072,23005,21067,2,1
228723,43931,22923,21008,3,1
228723,10241,5066,5175,4,1
228723,33690,17857,15833,5,1
228723,141,82,59,11,1
228723,11625,6605,5020,12,3
228723,2309,1230,1079,19,1
228723,31381,16627,14754,20,1
228723,48780,25966,22814,21,4
228723,39641,20619,19022,22,1
228723,39535,20552,18983,23,1
228723,9030,4444,4586,24,1
228723,30505,16108,14397,25,1
228723,106,67,39,31,1
228723,9139,5347,3792,32,3
228723,2224,1183,1041,39,1
228723,28281,14925,13356,40,1
228723,6917,3644,3273,41,4
228723,4431,2386,2045,42,1
228723,4396,2371,2025,43,1
228723,1211,622,589,44,1
228723,3185,1749,1436,45,1
228723,35,15,20,51,1
228723,2486,1258,1228,52,3
228723,85,47,38,59,1
228723,3100,1702,1398,60,1
228769,33329,14687,18642,1,4
228769,25690,11309,14381,2,1
228769,25415,11176,14239,3,1
228769,2713,1335,1378,4,1
228769,22702,9841,12861,5,1
228769,275,133,142,11,1
228769,7639,3378,4261,12,3
228769,3812,1613,2199,19,1
228769,18890,8228,10662,20,1
228769,19318,9522,9796,21,4
228769,15938,7634,8304,22,1
228769,15907,7621,8286,23,1
228769,2624,1286,1338,24,1
228769,13283,6335,6948,25,1
228769,31,13,18,31,1
228769,3380,1888,1492,32,3
228769,2111,990,1121,39,1
228769,11172,5345,5827,40,1
228769,14011,5165,8846,41,4
228769,9752,3675,6077,42,1
228769,9508,3555,5953,43,1
228769,89,49,40,44,1
228769,9419,3506,5913,45,1
228769,244,120,124,51,1
228769,4259,1490,2769,52,3
228769,1701,623,1078,59,1
228769,7718,2883,4835,60,1
228778,52059,25651,26408,1,4
228778,39979,19298,20681,2,1
228778,39323,18952,20371,3,1
228778,7249,3190,4059,4,1
228778,32074,15762,16312,5,1
228778,656,346,310,11,1
228778,12080,6353,5727,12,3
228778,2597,1368,1229,19,1
228778,29477,14394,15083,20,1
228778,47741,23355,24386,21,4
228778,36899,17645,19254,22,1
228778,36597,17478,19119,23,1
228778,7118,3125,3993,24,1
228778,29479,14353,15126,25,1
228778,302,167,135,31,1
228778,10842,5710,5132,32,3
228778,2461,1292,1169,39,1
228778,27018,13061,13957,40,1
228778,4318,2296,2022,41,4
228778,3080,1653,1427,42,1
228778,2726,1474,1252,43,1
228778,131,65,66,44,1
228778,2595,1409,1186,45,1
228778,354,179,175,51,1
228778,1238,643,595,52,3
228778,136,76,60,59,1
228778,2459,1333,1126,60,1
228787,21193,11955,9238,1,4
228787,13049,7426,5623,2,1
228787,13042,7422,5620,3,1
228787,2233,1316,917,4,1
228787,10809,6106,4703,5,1
228787,7,4,3,11,1
228787,8144,4529,3615,12,3
228787,1886,1001,885,19,1
228787,8923,5105,3818,20,1
228787,16006,8998,7008,21,4
228787,10635,6069,4566,22,1
228787,10629,6066,4563,23,1
228787,2193,1292,901,24,1
228787,8436,4774,3662,25,1
228787,6,3,3,31,1
228787,5371,2929,2442,32,3
228787,1375,727,648,39,1
228787,7061,4047,3014,40,1
228787,5187,2957,2230,41,4
228787,2414,1357,1057,42,1
228787,2413,1356,1057,43,1
228787,40,24,16,44,1
228787,2373,1332,1041,45,1
228787,1,1,0,51,1
228787,2773,1600,1173,52,3
228787,511,274,237,59,1
228787,1862,1058,804,60,1
228796,23003,10608,12395,1,4
228796,19696,9116,10580,2,1
228796,19527,9053,10474,3,1
228796,3241,1587,1654,4,1
228796,16286,7466,8820,5,1
228796,169,63,106,11,1
228796,3307,1492,1815,12,3
228796,1877,792,1085,19,1
228796,14409,6674,7735,20,1
228796,14241,6815,7426,21,4
228796,12973,6180,6793,22,1
228796,12942,6161,6781,23,1
228796,2961,1437,1524,24,1
228796,9981,4724,5257,25,1
228796,31,19,12,31,1
228796,1268,635,633,32,3
228796,1044,475,569,39,1
228796,8937,4249,4688,40,1
228796,8762,3793,4969,41,4
228796,6723,2936,3787,42,1
228796,6585,2892,3693,43,1
228796,280,150,130,44,1
228796,6305,2742,3563,45,1
228796,138,44,94,51,1
228796,2039,857,1182,52,3
228796,833,317,516,59,1
228796,5472,2425,3047,60,1
228802,7476,3043,4433,1,4
228802,5591,2387,3204,2,1
228802,5338,2265,3073,3,1
228802,707,312,395,4,1
228802,4631,1953,2678,5,1
228802,253,122,131,11,1
228802,1885,656,1229,12,3
228802,820,346,474,19,1
228802,3811,1607,2204,20,1
228802,4711,2054,2657,21,4
228802,4090,1789,2301,22,1
228802,4088,1789,2299,23,1
228802,701,310,391,24,1
228802,3387,1479,1908,25,1
228802,2,0,2,31,1
228802,621,265,356,32,3
228802,606,280,326,39,1
228802,2781,1199,1582,40,1
228802,2765,989,1776,41,4
228802,1501,598,903,42,1
228802,1250,476,774,43,1
228802,6,2,4,44,1
228802,1244,474,770,45,1
228802,251,122,129,51,1
228802,1264,391,873,52,3
228802,214,66,148,59,1
228802,1030,408,622,60,1
228866,239,130,109,1,4
228866,239,130,109,12,3
228866,227,125,102,21,4
228866,227,125,102,32,3
228866,12,5,7,41,4
228866,12,5,7,52,3
228875,9925,4077,5848,1,4
228875,8640,3495,5145,2,1
228875,8597,3470,5127,3,1
228875,1936,728,1208,4,1
228875,6661,2742,3919,5,1
228875,43,25,18,11,1
228875,1285,582,703,12,3
228875,401,158,243,19,1
228875,6260,2584,3676,20,1
228875,8936,3604,5332,21,4
228875,8326,3338,4988,22,1
228875,8309,3329,4980,23,1
228875,1935,728,1207,24,1
228875,6374,2601,3773,25,1
228875,17,9,8,31,1
228875,610,266,344,32,3
228875,391,155,236,39,1
228875,5983,2446,3537,40,1
228875,989,473,516,41,4
228875,314,157,157,42,1
228875,288,141,147,43,1
228875,1,0,1,44,1
228875,287,141,146,45,1
228875,26,16,10,51,1
228875,675,316,359,52,3
228875,10,3,7,59,1
228875,277,138,139,60,1
228884,971,591,380,1,4
228884,971,591,380,2,1
228884,945,575,370,3,1
228884,242,166,76,4,1
228884,703,409,294,5,1
228884,26,16,10,11,1
228884,172,107,65,19,1
228884,531,302,229,20,1
228884,931,567,364,21,4
228884,931,567,364,22,1
228884,931,567,364,23,1
228884,242,166,76,24,1
228884,689,401,288,25,1
228884,169,106,63,39,1
228884,520,295,225,40,1
228884,40,24,16,41,4
228884,40,24,16,42,1
228884,14,8,6,43,1
228884,14,8,6,45,1
228884,26,16,10,51,1
228884,3,1,2,59,1
228884,11,7,4,60,1
228909,2142,893,1249,1,4
228909,2142,893,1249,12,3
228909,1947,836,1111,21,4
228909,1947,836,1111,32,3
228909,195,57,138,41,4
228909,195,57,138,52,3
228981,1341,651,690,1,4
228981,1329,643,686,2,1
228981,1295,629,666,3,1
228981,346,190,156,4,1
228981,949,439,510,5,1
228981,34,14,20,11,1
228981,12,8,4,12,3
228981,60,29,31,19,1
228981,889,410,479,20,1
228981,1268,615,653,21,4
228981,1258,609,649,22,1
228981,1258,609,649,23,1
228981,346,190,156,24,1
228981,912,419,493,25,1
228981,10,6,4,32,3
228981,59,29,30,39,1
228981,853,390,463,40,1
228981,73,36,37,41,4
228981,71,34,37,42,1
228981,37,20,17,43,1
228981,37,20,17,45,1
228981,34,14,20,51,1
228981,2,2,0,52,3
228981,1,0,1,59,1
228981,36,20,16,60,1
229018,5131,2063,3068,1,4
229018,4246,1739,2507,2,1
229018,2947,1226,1721,3,1
229018,332,151,181,4,1
229018,2615,1075,1540,5,1
229018,1299,513,786,11,1
229018,885,324,561,12,3
229018,514,208,306,19,1
229018,2101,867,1234,20,1
229018,2124,932,1192,21,4
229018,1924,831,1093,22,1
229018,1907,829,1078,23,1
229018,314,140,174,24,1
229018,1593,689,904,25,1
229018,17,2,15,31,1
229018,200,101,99,32,3
229018,305,130,175,39,1
229018,1288,559,729,40,1
229018,3007,1131,1876,41,4
229018,2322,908,1414,42,1
229018,1040,397,643,43,1
229018,18,11,7,44,1
229018,1022,386,636,45,1
229018,1282,511,771,51,1
229018,685,223,462,52,3
229018,209,78,131,59,1
229018,813,308,505,60,1
229027,28623,14723,13900,1,4
229027,24342,12814,11528,2,1
229027,23840,12542,11298,3,1
229027,3593,1663,1930,4,1
229027,20247,10879,9368,5,1
229027,502,272,230,11,1
229027,4281,1909,2372,12,3
229027,2134,1110,1024,19,1
229027,18113,9769,8344,20,1
229027,21943,11387,10556,21,4
229027,20033,10455,9578,22,1
229027,19890,10371,9519,23,1
229027,3559,1644,1915,24,1
229027,16331,8727,7604,25,1
229027,143,84,59,31,1
229027,1910,932,978,32,3
229027,1718,897,821,39,1
229027,14613,7830,6783,40,1
229027,6680,3336,3344,41,4
229027,4309,2359,1950,42,1
229027,3950,2171,1779,43,1
229027,34,19,15,44,1
229027,3916,2152,1764,45,1
229027,359,188,171,51,1
229027,2371,977,1394,52,3
229027,416,213,203,59,1
229027,3500,1939,1561,60,1
229036,436,34,402,1,4
229036,436,34,402,2,1
229036,418,34,384,3,1
229036,103,4,99,4,1
229036,315,30,285,5,1
229036,18,0,18,11,1
229036,37,3,34,19,1
229036,278,27,251,20,1
229036,436,34,402,21,4
229036,436,34,402,22,1
229036,418,34,384,23,1
229036,103,4,99,24,1
229036,315,30,285,25,1
229036,18,0,18,31,1
229036,37,3,34,39,1
229036,278,27,251,40,1
229063,8703,3553,5150,1,4
229063,6288,2580,3708,2,1
229063,6288,2580,3708,3,1
229063,1109,420,689,4,1
229063,5179,2160,3019,5,1
229063,2415,973,1442,12,3
229063,703,262,441,19,1
229063,4476,1898,2578,20,1
229063,6936,2900,4036,21,4
229063,5321,2227,3094,22,1
229063,5321,2227,3094,23,1
229063,1057,398,659,24,1
229063,4264,1829,2435,25,1
229063,1615,673,942,32,3
229063,537,214,323,39,1
229063,3727,1615,2112,40,1
229063,1767,653,1114,41,4
229063,967,353,614,42,1
229063,967,353,614,43,1
229063,52,22,30,44,1
229063,915,331,584,45,1
229063,800,300,500,52,3
229063,166,48,118,59,1
229063,749,283,466,60,1
229115,33111,18057,15054,1,4
229115,27044,15054,11990,2,1
229115,26809,14937,11872,3,1
229115,4785,2508,2277,4,1
229115,22024,12429,9595,5,1
229115,235,117,118,11,1
229115,6067,3003,3064,12,3
229115,2642,1500,1142,19,1
229115,19382,10929,8453,20,1
229115,28287,15554,12733,21,4
229115,24338,13471,10867,22,1
229115,24302,13449,10853,23,1
229115,4725,2471,2254,24,1
229115,19577,10978,8599,25,1
229115,36,22,14,31,1
229115,3949,2083,1866,32,3
229115,2428,1388,1040,39,1
229115,17149,9590,7559,40,1
229115,4824,2503,2321,41,4
229115,2706,1583,1123,42,1
229115,2507,1488,1019,43,1
229115,60,37,23,44,1
229115,2447,1451,996,45,1
229115,199,95,104,51,1
229115,2118,920,1198,52,3
229115,214,112,102,59,1
229115,2233,1339,894,60,1
229151,55,48,7,1,4
229151,55,48,7,2,1
229151,55,48,7,3,1
229151,15,15,0,4,1
229151,40,33,7,5,1
229151,40,33,7,20,1
229151,55,48,7,21,4
229151,55,48,7,22,1
229151,55,48,7,23,1
229151,15,15,0,24,1
229151,40,33,7,25,1
229151,40,33,7,40,1
229160,2397,1101,1296,1,4
229160,1724,852,872,2,1
229160,1719,850,869,3,1
229160,273,149,124,4,1
229160,1446,701,745,5,1
229160,5,2,3,11,1
229160,673,249,424,12,3
229160,300,107,193,19,1
229160,1146,594,552,20,1
229160,1904,953,951,21,4
229160,1429,748,681,22,1
229160,1429,748,681,23,1
229160,266,143,123,24,1
229160,1163,605,558,25,1
229160,475,205,270,32,3
229160,221,81,140,39,1
229160,942,524,418,40,1
229160,493,148,345,41,4
229160,295,104,191,42,1
229160,290,102,188,43,1
229160,7,6,1,44,1
229160,283,96,187,45,1
229160,5,2,3,51,1
229160,198,44,154,52,3
229160,79,26,53,59,1
229160,204,70,134,60,1
229179,15058,1673,13385,1,4
229179,9515,1007,8508,2,1
229179,9220,910,8310,3,1
229179,1169,90,1079,4,1
229179,8051,820,7231,5,1
229179,295,97,198,11,1
229179,5543,666,4877,12,3
229179,1348,163,1185,19,1
229179,6703,657,6046,20,1
229179,8428,854,7574,21,4
229179,6722,657,6065,22,1
229179,6721,657,6064,23,1
229179,1155,89,1066,24,1
229179,5566,568,4998,25,1
229179,1,0,1,31,1
229179,1706,197,1509,32,3
229179,894,106,788,39,1
229179,4672,462,4210,40,1
229179,6630,819,5811,41,4
229179,2793,350,2443,42,1
229179,2499,253,2246,43,1
229179,14,1,13,44,1
229179,2485,252,2233,45,1
229179,294,97,197,51,1
229179,3837,469,3368,52,3
229179,454,57,397,59,1
229179,2031,195,1836,60,1
229267,2358,1096,1262,1,4
229267,2161,1032,1129,2,1
229267,2127,1021,1106,3,1
229267,534,259,275,4,1
229267,1593,762,831,5,1
229267,34,11,23,11,1
229267,197,64,133,12,3
229267,25,12,13,19,1
229267,1568,750,818,20,1
229267,2259,1052,1207,21,4
229267,2111,1005,1106,22,1
229267,2104,1004,1100,23,1
229267,534,259,275,24,1
229267,1570,745,825,25,1
229267,7,1,6,31,1
229267,148,47,101,32,3
229267,25,12,13,39,1
229267,1545,733,812,40,1
229267,99,44,55,41,4
229267,50,27,23,42,1
229267,23,17,6,43,1
229267,23,17,6,45,1
229267,27,10,17,51,1
229267,49,17,32,52,3
229267,23,17,6,60,1
229300,4615,1643,2972,1,4
229300,701,117,584,2,1
229300,701,117,584,3,1
229300,701,117,584,5,1
229300,3914,1526,2388,12,3
229300,112,12,100,19,1
229300,589,105,484,20,1
229300,3291,1277,2014,21,4
229300,577,92,485,22,1
229300,577,92,485,23,1
229300,577,92,485,25,1
229300,2714,1185,1529,32,3
229300,106,12,94,39,1
229300,471,80,391,40,1
229300,1324,366,958,41,4
229300,124,25,99,42,1
229300,124,25,99,43,1
229300,124,25,99,45,1
229300,1200,341,859,52,3
229300,6,0,6,59,1
229300,118,25,93,60,1
229319,5332,2590,2742,1,4
229319,5332,2590,2742,2,1
229319,3241,1609,1632,3,1
229319,766,421,345,4,1
229319,2475,1188,1287,5,1
229319,2091,981,1110,11,1
229319,304,156,148,19,1
229319,2171,1032,1139,20,1
229319,2321,1266,1055,21,4
229319,2321,1266,1055,22,1
229319,1642,911,731,23,1
229319,493,283,210,24,1
229319,1149,628,521,25,1
229319,679,355,324,31,1
229319,163,89,74,39,1
229319,986,539,447,40,1
229319,3011,1324,1687,41,4
229319,3011,1324,1687,42,1
229319,1599,698,901,43,1
229319,273,138,135,44,1
229319,1326,560,766,45,1
229319,1412,626,786,51,1
229319,141,67,74,59,1
229319,1185,493,692,60,1
229328,1281,700,581,1,4
229328,1281,700,581,2,1
229328,930,517,413,3,1
229328,350,238,112,4,1
229328,580,279,301,5,1
229328,351,183,168,11,1
229328,158,76,82,19,1
229328,422,203,219,20,1
229328,642,372,270,21,4
229328,642,372,270,22,1
229328,460,269,191,23,1
229328,159,117,42,24,1
229328,301,152,149,25,1
229328,182,103,79,31,1
229328,80,47,33,39,1
229328,221,105,116,40,1
229328,639,328,311,41,4
229328,639,328,311,42,1
229328,470,248,222,43,1
229328,191,121,70,44,1
229328,279,127,152,45,1
229328,169,80,89,51,1
229328,78,29,49,59,1
229328,201,98,103,60,1
229337,4519,1469,3050,1,4
229337,1346,211,1135,2,1
229337,1346,211,1135,3,1
229337,1346,211,1135,5,1
229337,3173,1258,1915,12,3
229337,465,71,394,19,1
229337,881,140,741,20,1
229337,3545,1188,2357,21,4
229337,1195,167,1028,22,1
229337,1195,167,1028,23,1
229337,1195,167,1028,25,1
229337,2350,1021,1329,32,3
229337,378,43,335,39,1
229337,817,124,693,40,1
229337,974,281,693,41,4
229337,151,44,107,42,1
229337,151,44,107,43,1
229337,151,44,107,45,1
229337,823,237,586,52,3
229337,87,28,59,59,1
229337,64,16,48,60,1
229355,11308,4739,6569,1,4
229355,11308,4739,6569,2,1
229355,11308,4739,6569,3,1
229355,2958,1429,1529,4,1
229355,8350,3310,5040,5,1
229355,738,316,422,19,1
229355,7612,2994,4618,20,1
229355,6200,2813,3387,21,4
229355,6200,2813,3387,22,1
229355,6200,2813,3387,23,1
229355,2452,1190,1262,24,1
229355,3748,1623,2125,25,1
229355,429,206,223,39,1
229355,3319,1417,1902,40,1
229355,5108,1926,3182,41,4
229355,5108,1926,3182,42,1
229355,5108,1926,3182,43,1
229355,506,239,267,44,1
229355,4602,1687,2915,45,1
229355,309,110,199,59,1
229355,4293,1577,2716,60,1
229416,2097,2026,71,1,4
229416,2097,2026,71,2,1
229416,2097,2026,71,3,1
229416,556,531,25,4,1
229416,1541,1495,46,5,1
229416,1541,1495,46,20,1
229416,2097,2026,71,21,4
229416,2097,2026,71,22,1
229416,2097,2026,71,23,1
229416,556,531,25,24,1
229416,1541,1495,46,25,1
229416,1541,1495,46,40,1
229425,173,11,162,1,4
229425,173,11,162,2,1
229425,173,11,162,3,1
229425,18,1,17,4,1
229425,155,10,145,5,1
229425,155,10,145,20,1
229425,66,5,61,21,4
229425,66,5,61,22,1
229425,66,5,61,23,1
229425,10,1,9,24,1
229425,56,4,52,25,1
229425,56,4,52,40,1
229425,107,6,101,41,4
229425,107,6,101,42,1
229425,107,6,101,43,1
229425,8,0,8,44,1
229425,99,6,93,45,1
229425,99,6,93,60,1
229504,3084,1115,1969,1,4
229504,3084,1115,1969,2,1
229504,2586,911,1675,3,1
229504,548,228,320,4,1
229504,2038,683,1355,5,1
229504,498,204,294,11,1
229504,230,95,135,19,1
229504,1808,588,1220,20,1
229504,1099,414,685,21,4
229504,1099,414,685,22,1
229504,1099,414,685,23,1
229504,336,132,204,24,1
229504,763,282,481,25,1
229504,106,50,56,39,1
229504,657,232,425,40,1
229504,1985,701,1284,41,4
229504,1985,701,1284,42,1
229504,1487,497,990,43,1
229504,212,96,116,44,1
229504,1275,401,874,45,1
229504,498,204,294,51,1
229504,124,45,79,59,1
229504,1151,356,795,60,1
229522,26,1,25,1,4
229522,26,1,25,2,1
229522,26,1,25,3,1
229522,16,1,15,4,1
229522,10,0,10,5,1
229522,10,0,10,20,1
229522,7,0,7,21,4
229522,7,0,7,22,1
229522,7,0,7,23,1
229522,4,0,4,24,1
229522,3,0,3,25,1
229522,3,0,3,40,1
229522,19,1,18,41,4
229522,19,1,18,42,1
229522,19,1,18,43,1
229522,12,1,11,44,1
229522,7,0,7,45,1
229522,7,0,7,60,1
229540,4419,1522,2897,1,4
229540,4419,1522,2897,2,1
229540,4176,1449,2727,3,1
229540,680,289,391,4,1
229540,3496,1160,2336,5,1
229540,243,73,170,11,1
229540,177,64,113,19,1
229540,3319,1096,2223,20,1
229540,1385,538,847,21,4
229540,1385,538,847,22,1
229540,1321,517,804,23,1
229540,390,163,227,24,1
229540,931,354,577,25,1
229540,64,21,43,31,1
229540,85,36,49,39,1
229540,846,318,528,40,1
229540,3034,984,2050,41,4
229540,3034,984,2050,42,1
229540,2855,932,1923,43,1
229540,290,126,164,44,1
229540,2565,806,1759,45,1
229540,179,52,127,51,1
229540,92,28,64,59,1
229540,2473,778,1695,60,1
229656,232,18,214,1,4
229656,232,18,214,2,1
229656,232,18,214,3,1
229656,77,10,67,4,1
229656,155,8,147,5,1
229656,155,8,147,20,1
229656,198,4,194,21,4
229656,198,4,194,22,1
229656,198,4,194,23,1
229656,50,0,50,24,1
229656,148,4,144,25,1
229656,148,4,144,40,1
229656,34,14,20,41,4
229656,34,14,20,42,1
229656,34,14,20,43,1
229656,27,10,17,44,1
229656,7,4,3,45,1
229656,7,4,3,60,1
229780,6222,3086,3136,1,4
229780,4515,2280,2235,2,1
229780,4246,2121,2125,3,1
229780,343,230,113,4,1
229780,3903,1891,2012,5,1
229780,269,159,110,11,1
229780,1707,806,901,12,3
229780,307,154,153,19,1
229780,3596,1737,1859,20,1
229780,1235,668,567,21,4
229780,1143,624,519,22,1
229780,1142,624,518,23,1
229780,315,218,97,24,1
229780,827,406,421,25,1
229780,1,0,1,31,1
229780,92,44,48,32,3
229780,81,47,34,39,1
229780,746,359,387,40,1
229780,4987,2418,2569,41,4
229780,3372,1656,1716,42,1
229780,3104,1497,1607,43,1
229780,28,12,16,44,1
229780,3076,1485,1591,45,1
229780,268,159,109,51,1
229780,1615,762,853,52,3
229780,226,107,119,59,1
229780,2850,1378,1472,60,1
229799,5694,2148,3546,1,4
229799,5694,2148,3546,2,1
229799,5549,2084,3465,3,1
229799,1169,522,647,4,1
229799,4380,1562,2818,5,1
229799,145,64,81,11,1
229799,454,162,292,19,1
229799,3926,1400,2526,20,1
229799,2443,964,1479,21,4
229799,2443,964,1479,22,1
229799,2425,954,1471,23,1
229799,859,393,466,24,1
229799,1566,561,1005,25,1
229799,18,10,8,31,1
229799,249,104,145,39,1
229799,1317,457,860,40,1
229799,3251,1184,2067,41,4
229799,3251,1184,2067,42,1
229799,3124,1130,1994,43,1
229799,310,129,181,44,1
229799,2814,1001,1813,45,1
229799,127,54,73,51,1
229799,205,58,147,59,1
229799,2609,943,1666,60,1
229814,8377,3629,4748,1,4
229814,6906,3122,3784,2,1
229814,6890,3115,3775,3,1
229814,1299,583,716,4,1
229814,5591,2532,3059,5,1
229814,16,7,9,11,1
229814,1471,507,964,12,3
229814,969,434,535,19,1
229814,4622,2098,2524,20,1
229814,6025,2671,3354,21,4
229814,5523,2487,3036,22,1
229814,5521,2486,3035,23,1
229814,1283,574,709,24,1
229814,4238,1912,2326,25,1
229814,2,1,1,31,1
229814,502,184,318,32,3
229814,670,304,366,39,1
229814,3568,1608,1960,40,1
229814,2352,958,1394,41,4
229814,1383,635,748,42,1
229814,1369,629,740,43,1
229814,16,9,7,44,1
229814,1353,620,733,45,1
229814,14,6,8,51,1
229814,969,323,646,52,3
229814,299,130,169,59,1
229814,1054,490,564,60,1
229832,2044,1040,1004,1,4
229832,2044,1040,1004,2,1
229832,675,392,283,3,1
229832,675,392,283,4,1
229832,1369,648,721,11,1
229832,608,349,259,21,4
229832,608,349,259,22,1
229832,347,197,150,23,1
229832,347,197,150,24,1
229832,261,152,109,31,1
229832,1436,691,745,41,4
229832,1436,691,745,42,1
229832,328,195,133,43,1
229832,328,195,133,44,1
229832,1108,496,612,51,1
229841,7386,3174,4212,1,4
229841,7386,3174,4212,2,1
229841,6164,2679,3485,3,1
229841,1633,779,854,4,1
229841,4531,1900,2631,5,1
229841,1222,495,727,11,1
229841,518,211,307,19,1
229841,4013,1689,2324,20,1
229841,2803,1403,1400,21,4
229841,2803,1403,1400,22,1
229841,2801,1402,1399,23,1
229841,1162,580,582,24,1
229841,1639,822,817,25,1
229841,2,1,1,31,1
229841,201,108,93,39,1
229841,1438,714,724,40,1
229841,4583,1771,2812,41,4
229841,4583,1771,2812,42,1
229841,3363,1277,2086,43,1
229841,471,199,272,44,1
229841,2892,1078,1814,45,1
229841,1220,494,726,51,1
229841,317,103,214,59,1
229841,2575,975,1600,60,1
229887,1392,611,781,1,4
229887,1388,610,778,2,1
229887,1388,610,778,3,1
229887,289,145,144,4,1
229887,1099,465,634,5,1
229887,4,1,3,12,3
229887,146,70,76,19,1
229887,953,395,558,20,1
229887,1327,588,739,21,4
229887,1326,588,738,22,1
229887,1326,588,738,23,1
229887,286,144,142,24,1
229887,1040,444,596,25,1
229887,1,0,1,32,3
229887,138,67,71,39,1
229887,902,377,525,40,1
229887,65,23,42,41,4
229887,62,22,40,42,1
229887,62,22,40,43,1
229887,3,1,2,44,1
229887,59,21,38,45,1
229887,3,1,2,52,3
229887,8,3,5,59,1
229887,51,18,33,60,1
229957,156,22,134,1,4
229957,156,22,134,2,1
229957,156,22,134,3,1
229957,32,5,27,4,1
229957,124,17,107,5,1
229957,124,17,107,20,1
229957,156,22,134,21,4
229957,156,22,134,22,1
229957,156,22,134,23,1
229957,32,5,27,24,1
229957,124,17,107,25,1
229957,124,17,107,40,1
230010,593,296,297,1,4
230010,593,296,297,2,1
230010,593,296,297,3,1
230010,126,73,53,4,1
230010,467,223,244,5,1
230010,467,223,244,20,1
230010,295,162,133,21,4
230010,295,162,133,22,1
230010,295,162,133,23,1
230010,60,39,21,24,1
230010,235,123,112,25,1
230010,235,123,112,40,1
230010,298,134,164,41,4
230010,298,134,164,42,1
230010,298,134,164,43,1
230010,66,34,32,44,1
230010,232,100,132,45,1
230010,232,100,132,60,1
230038,31123,16979,14144,1,4
230038,27765,14957,12808,2,1
230038,27765,14957,12808,3,1
230038,4423,1342,3081,4,1
230038,23342,13615,9727,5,1
230038,3358,2022,1336,12,3
230038,789,537,252,19,1
230038,22553,13078,9475,20,1
230038,27114,14797,12317,21,4
230038,25084,13535,11549,22,1
230038,25084,13535,11549,23,1
230038,4366,1310,3056,24,1
230038,20718,12225,8493,25,1
230038,2030,1262,768,32,3
230038,719,501,218,39,1
230038,19999,11724,8275,40,1
230038,4009,2182,1827,41,4
230038,2681,1422,1259,42,1
230038,2681,1422,1259,43,1
230038,57,32,25,44,1
230038,2624,1390,1234,45,1
230038,1328,760,568,52,3
230038,70,36,34,59,1
230038,2554,1354,1200,60,1
230047,2882,1271,1611,1,4
230047,2882,1271,1611,2,1
230047,2664,1176,1488,3,1
230047,515,140,375,4,1
230047,2149,1036,1113,5,1
230047,218,95,123,11,1
230047,176,93,83,19,1
230047,1973,943,1030,20,1
230047,2505,1108,1397,21,4
230047,2505,1108,1397,22,1
230047,2488,1103,1385,23,1
230047,510,140,370,24,1
230047,1978,963,1015,25,1
230047,17,5,12,31,1
230047,172,89,83,39,1
230047,1806,874,932,40,1
230047,377,163,214,41,4
230047,377,163,214,42,1
230047,176,73,103,43,1
230047,5,0,5,44,1
230047,171,73,98,45,1
230047,201,90,111,51,1
230047,4,4,0,59,1
230047,167,69,98,60,1
230056,237,61,176,1,4
230056,229,59,170,2,1
230056,221,57,164,3,1
230056,24,5,19,4,1
230056,197,52,145,5,1
230056,8,2,6,11,1
230056,8,2,6,12,3
230056,48,16,32,19,1
230056,149,36,113,20,1
230056,147,42,105,21,4
230056,142,41,101,22,1
230056,140,40,100,23,1
230056,21,5,16,24,1
230056,119,35,84,25,1
230056,2,1,1,31,1
230056,5,1,4,32,3
230056,36,12,24,39,1
230056,83,23,60,40,1
230056,90,19,71,41,4
230056,87,18,69,42,1
230056,81,17,64,43,1
230056,3,0,3,44,1
230056,78,17,61,45,1
230056,6,1,5,51,1
230056,3,1,2,52,3
230056,12,4,8,59,1
230056,66,13,53,60,1
230065,228,5,223,1,4
230065,228,5,223,2,1
230065,228,5,223,3,1
230065,214,4,210,4,1
230065,14,1,13,5,1
230065,14,1,13,20,1
230065,85,3,82,21,4
230065,85,3,82,22,1
230065,85,3,82,23,1
230065,81,3,78,24,1
230065,4,0,4,25,1
230065,4,0,4,40,1
230065,143,2,141,41,4
230065,143,2,141,42,1
230065,143,2,141,43,1
230065,133,1,132,44,1
230065,10,1,9,45,1
230065,10,1,9,60,1
230135,79,5,74,1,4
230135,79,5,74,2,1
230135,79,5,74,3,1
230135,28,2,26,4,1
230135,51,3,48,5,1
230135,51,3,48,20,1
230135,79,5,74,21,4
230135,79,5,74,22,1
230135,79,5,74,23,1
230135,28,2,26,24,1
230135,51,3,48,25,1
230135,51,3,48,40,1
230144,56,3,53,1,4
230144,56,3,53,2,1
230144,56,3,53,3,1
230144,23,2,21,4,1
230144,33,1,32,5,1
230144,33,1,32,20,1
230144,56,3,53,21,4
230144,56,3,53,22,1
230144,56,3,53,23,1
230144,23,2,21,24,1
230144,33,1,32,25,1
230144,33,1,32,40,1
230162,2769,1544,1225,1,4
230162,2769,1544,1225,2,1
230162,1557,861,696,3,1
230162,497,278,219,4,1
230162,1060,583,477,5,1
230162,1212,683,529,11,1
230162,1060,583,477,20,1
230162,464,199,265,21,4
230162,464,199,265,22,1
230162,429,187,242,23,1
230162,103,43,60,24,1
230162,326,144,182,25,1
230162,35,12,23,31,1
230162,326,144,182,40,1
230162,2305,1345,960,41,4
230162,2305,1345,960,42,1
230162,1128,674,454,43,1
230162,394,235,159,44,1
230162,734,439,295,45,1
230162,1177,671,506,51,1
230162,734,439,295,60,1
230171,8350,3960,4390,1,4
230171,8350,3960,4390,2,1
230171,7305,3509,3796,3,1
230171,1676,719,957,4,1
230171,5629,2790,2839,5,1
230171,1045,451,594,11,1
230171,556,282,274,19,1
230171,5073,2508,2565,20,1
230171,5165,2518,2647,21,4
230171,5165,2518,2647,22,1
230171,5054,2465,2589,23,1
230171,1388,564,824,24,1
230171,3666,1901,1765,25,1
230171,111,53,58,31,1
230171,384,209,175,39,1
230171,3282,1692,1590,40,1
230171,3185,1442,1743,41,4
230171,3185,1442,1743,42,1
230171,2251,1044,1207,43,1
230171,288,155,133,44,1
230171,1963,889,1074,45,1
230171,934,398,536,51,1
230171,172,73,99,59,1
230171,1791,816,975,60,1
230199,33,3,30,1,4
230199,33,3,30,2,1
230199,33,3,30,3,1
230199,24,1,23,4,1
230199,9,2,7,5,1
230199,9,2,7,20,1
230199,33,3,30,21,4
230199,33,3,30,22,1
230199,33,3,30,23,1
230199,24,1,23,24,1
230199,9,2,7,25,1
230199,9,2,7,40,1
230205,50,3,47,1,4
230205,50,3,47,2,1
230205,50,3,47,3,1
230205,17,1,16,4,1
230205,33,2,31,5,1
230205,33,2,31,20,1
230205,45,2,43,21,4
230205,45,2,43,22,1
230205,45,2,43,23,1
230205,15,1,14,24,1
230205,30,1,29,25,1
230205,30,1,29,40,1
230205,5,1,4,41,4
230205,5,1,4,42,1
230205,5,1,4,43,1
230205,2,0,2,44,1
230205,3,1,2,45,1
230205,3,1,2,60,1
230214,265,24,241,1,4
230214,265,24,241,2,1
230214,265,24,241,3,1
230214,48,3,45,4,1
230214,217,21,196,5,1
230214,217,21,196,20,1
230214,157,16,141,21,4
230214,157,16,141,22,1
230214,157,16,141,23,1
230214,33,2,31,24,1
230214,124,14,110,25,1
230214,124,14,110,40,1
230214,108,8,100,41,4
230214,108,8,100,42,1
230214,108,8,100,43,1
230214,15,1,14,44,1
230214,93,7,86,45,1
230214,93,7,86,60,1
230366,290,90,200,1,4
230366,290,90,200,2,1
230366,284,89,195,3,1
230366,94,26,68,4,1
230366,190,63,127,5,1
230366,6,1,5,11,1
230366,6,2,4,19,1
230366,184,61,123,20,1
230366,152,59,93,21,4
230366,152,59,93,22,1
230366,146,58,88,23,1
230366,60,20,40,24,1
230366,86,38,48,25,1
230366,6,1,5,31,1
230366,4,1,3,39,1
230366,82,37,45,40,1
230366,138,31,107,41,4
230366,138,31,107,42,1
230366,138,31,107,43,1
230366,34,6,28,44,1
230366,104,25,79,45,1
230366,2,1,1,59,1
230366,102,24,78,60,1
230384,471,410,61,1,4
230384,471,410,61,2,1
230384,471,410,61,3,1
230384,61,56,5,4,1
230384,410,354,56,5,1
230384,11,10,1,19,1
230384,399,344,55,20,1
230384,341,297,44,21,4
230384,341,297,44,22,1
230384,341,297,44,23,1
230384,53,48,5,24,1
230384,288,249,39,25,1
230384,6,6,0,39,1
230384,282,243,39,40,1
230384,130,113,17,41,4
230384,130,113,17,42,1
230384,130,113,17,43,1
230384,8,8,0,44,1
230384,122,105,17,45,1
230384,5,4,1,59,1
230384,117,101,16,60,1
230418,2036,1175,861,1,4
230418,2036,1175,861,2,1
230418,1992,1157,835,3,1
230418,425,222,203,4,1
230418,1567,935,632,5,1
230418,44,18,26,11,1
230418,262,165,97,19,1
230418,1305,770,535,20,1
230418,1409,823,586,21,4
230418,1409,823,586,22,1
230418,1395,818,577,23,1
230418,341,170,171,24,1
230418,1054,648,406,25,1
230418,14,5,9,31,1
230418,183,123,60,39,1
230418,871,525,346,40,1
230418,627,352,275,41,4
230418,627,352,275,42,1
230418,597,339,258,43,1
230418,84,52,32,44,1
230418,513,287,226,45,1
230418,30,13,17,51,1
230418,79,42,37,59,1
230418,434,245,189,60,1
230472,404,83,321,1,4
230472,404,83,321,2,1
230472,404,83,321,3,1
230472,37,9,28,4,1
230472,367,74,293,5,1
230472,35,5,30,19,1
230472,332,69,263,20,1
230472,319,61,258,21,4
230472,319,61,258,22,1
230472,319,61,258,23,1
230472,37,9,28,24,1
230472,282,52,230,25,1
230472,22,2,20,39,1
230472,260,50,210,40,1
230472,85,22,63,41,4
230472,85,22,63,42,1
230472,85,22,63,43,1
230472,85,22,63,45,1
230472,13,3,10,59,1
230472,72,19,53,60,1
230490,2625,1571,1054,1,4
230490,2625,1571,1054,2,1
230490,1908,1243,665,3,1
230490,160,101,59,4,1
230490,1748,1142,606,5,1
230490,717,328,389,11,1
230490,1748,1142,606,20,1
230490,569,292,277,21,4
230490,569,292,277,22,1
230490,508,271,237,23,1
230490,38,24,14,24,1
230490,470,247,223,25,1
230490,61,21,40,31,1
230490,470,247,223,40,1
230490,2056,1279,777,41,4
230490,2056,1279,777,42,1
230490,1400,972,428,43,1
230490,122,77,45,44,1
230490,1278,895,383,45,1
230490,656,307,349,51,1
230490,1278,895,383,60,1
230597,4605,2032,2573,1,4
230597,4605,2032,2573,2,1
230597,3051,1292,1759,3,1
230597,1403,493,910,4,1
230597,1648,799,849,5,1
230597,1554,740,814,11,1
230597,91,54,37,19,1
230597,1557,745,812,20,1
230597,2813,1177,1636,21,4
230597,2813,1177,1636,22,1
230597,2657,1116,1541,23,1
230597,1324,449,875,24,1
230597,1333,667,666,25,1
230597,156,61,95,31,1
230597,72,47,25,39,1
230597,1261,620,641,40,1
230597,1792,855,937,41,4
230597,1792,855,937,42,1
230597,394,176,218,43,1
230597,79,44,35,44,1
230597,315,132,183,45,1
230597,1398,679,719,51,1
230597,19,7,12,59,1
230597,296,125,171,60,1
230603,7745,3465,4280,1,4
230603,7017,3165,3852,2,1
230603,5620,2622,2998,3,1
230603,1272,449,823,4,1
230603,4348,2173,2175,5,1
230603,1397,543,854,11,1
230603,728,300,428,12,3
230603,375,199,176,19,1
230603,3973,1974,1999,20,1
230603,5421,2568,2853,21,4
230603,5254,2468,2786,22,1
230603,5035,2342,2693,23,1
230603,1211,418,793,24,1
230603,3824,1924,1900,25,1
230603,219,126,93,31,1
230603,167,100,67,32,3
230603,322,170,152,39,1
230603,3502,1754,1748,40,1
230603,2324,897,1427,41,4
230603,1763,697,1066,42,1
230603,585,280,305,43,1
230603,61,31,30,44,1
230603,524,249,275,45,1
230603,1178,417,761,51,1
230603,561,200,361,52,3
230603,53,29,24,59,1
230603,471,220,251,60,1
230621,320,128,192,1,4
230621,320,128,192,2,1
230621,320,128,192,3,1
230621,136,55,81,4,1
230621,184,73,111,5,1
230621,184,73,111,20,1
230621,320,128,192,21,4
230621,320,128,192,22,1
230621,320,128,192,23,1
230621,136,55,81,24,1
230621,184,73,111,25,1
230621,184,73,111,40,1
230630,351,161,190,1,4
230630,351,161,190,2,1
230630,351,161,190,3,1
230630,20,9,11,4,1
230630,331,152,179,5,1
230630,34,17,17,19,1
230630,297,135,162,20,1
230630,351,161,190,21,4
230630,351,161,190,22,1
230630,351,161,190,23,1
230630,20,9,11,24,1
230630,331,152,179,25,1
230630,34,17,17,39,1
230630,297,135,162,40,1
230676,1238,834,404,1,4
230676,1238,834,404,2,1
230676,492,325,167,3,1
230676,109,59,50,4,1
230676,383,266,117,5,1
230676,746,509,237,11,1
230676,383,266,117,20,1
230676,260,203,57,21,4
230676,260,203,57,22,1
230676,259,202,57,23,1
230676,53,40,13,24,1
230676,206,162,44,25,1
230676,1,1,0,31,1
230676,206,162,44,40,1
230676,978,631,347,41,4
230676,978,631,347,42,1
230676,233,123,110,43,1
230676,56,19,37,44,1
230676,177,104,73,45,1
230676,745,508,237,51,1
230676,177,104,73,60,1
230728,27812,12724,15088,1,4
230728,24385,11216,13169,2,1
230728,20775,9744,11031,3,1
230728,3970,1405,2565,4,1
230728,16805,8339,8466,5,1
230728,3610,1472,2138,11,1
230728,3427,1508,1919,12,3
230728,1769,818,951,19,1
230728,15036,7521,7515,20,1
230728,16436,7993,8443,21,4
230728,15260,7436,7824,22,1
230728,15152,7378,7774,23,1
230728,3564,1252,2312,24,1
230728,11588,6126,5462,25,1
230728,108,58,50,31,1
230728,1176,557,619,32,3
230728,1232,636,596,39,1
230728,10356,5490,4866,40,1
230728,11376,4731,6645,41,4
230728,9125,3780,5345,42,1
230728,5623,2366,3257,43,1
230728,406,153,253,44,1
230728,5217,2213,3004,45,1
230728,3502,1414,2088,51,1
230728,2251,951,1300,52,3
230728,537,182,355,59,1
230728,4680,2031,2649,60,1
230737,30564,16984,13580,1,4
230737,30370,16886,13484,2,1
230737,24243,13827,10416,3,1
230737,3352,1564,1788,4,1
230737,20891,12263,8628,5,1
230737,6127,3059,3068,11,1
230737,194,98,96,12,3
230737,1803,1007,796,19,1
230737,19088,11256,7832,20,1
230737,15755,8864,6891,21,4
230737,15751,8860,6891,22,1
230737,14989,8401,6588,23,1
230737,2454,1083,1371,24,1
230737,12535,7318,5217,25,1
230737,762,459,303,31,1
230737,4,4,0,32,3
230737,1190,685,505,39,1
230737,11345,6633,4712,40,1
230737,14809,8120,6689,41,4
230737,14619,8026,6593,42,1
230737,9254,5426,3828,43,1
230737,898,481,417,44,1
230737,8356,4945,3411,45,1
230737,5365,2600,2765,51,1
230737,190,94,96,52,3
230737,613,322,291,59,1
230737,7743,4623,3120,60,1
230746,32003,15452,16551,1,4
230746,32003,15452,16551,2,1
230746,24494,12005,12489,3,1
230746,3042,1534,1508,4,1
230746,21452,10471,10981,5,1
230746,7509,3447,4062,11,1
230746,1337,650,687,19,1
230746,20115,9821,10294,20,1
230746,8674,4472,4202,21,4
230746,8674,4472,4202,22,1
230746,8108,4156,3952,23,1
230746,1357,663,694,24,1
230746,6751,3493,3258,25,1
230746,566,316,250,31,1
230746,539,309,230,39,1
230746,6212,3184,3028,40,1
230746,23329,10980,12349,41,4
230746,23329,10980,12349,42,1
230746,16386,7849,8537,43,1
230746,1685,871,814,44,1
230746,14701,6978,7723,45,1
230746,6943,3131,3812,51,1
230746,798,341,457,59,1
230746,13903,6637,7266,60,1
230764,32077,17754,14323,1,4
230764,24492,13473,11019,2,1
230764,23273,12879,10394,3,1
230764,3124,1425,1699,4,1
230764,20149,11454,8695,5,1
230764,1219,594,625,11,1
230764,7585,4281,3304,12,3
230764,1841,1049,792,19,1
230764,18308,10405,7903,20,1
230764,23084,12682,10402,21,4
230764,17319,9474,7845,22,1
230764,17035,9338,7697,23,1
230764,2790,1286,1504,24,1
230764,14245,8052,6193,25,1
230764,284,136,148,31,1
230764,5765,3208,2557,32,3
230764,1304,718,586,39,1
230764,12941,7334,5607,40,1
230764,8993,5072,3921,41,4
230764,7173,3999,3174,42,1
230764,6238,3541,2697,43,1
230764,334,139,195,44,1
230764,5904,3402,2502,45,1
230764,935,458,477,51,1
230764,1820,1073,747,52,3
230764,537,331,206,59,1
230764,5367,3071,2296,60,1
230782,25155,11824,13331,1,4
230782,24498,11501,12997,2,1
230782,17314,8188,9126,3,1
230782,2389,1038,1351,4,1
230782,14925,7150,7775,5,1
230782,7184,3313,3871,11,1
230782,657,323,334,12,3
230782,1068,455,613,19,1
230782,13857,6695,7162,20,1
230782,11155,5447,5708,21,4
230782,10879,5301,5578,22,1
230782,10545,5136,5409,23,1
230782,1837,778,1059,24,1
230782,8708,4358,4350,25,1
230782,334,165,169,31,1
230782,276,146,130,32,3
230782,602,288,314,39,1
230782,8106,4070,4036,40,1
230782,14000,6377,7623,41,4
230782,13619,6200,7419,42,1
230782,6769,3052,3717,43,1
230782,552,260,292,44,1
230782,6217,2792,3425,45,1
230782,6850,3148,3702,51,1
230782,381,177,204,52,3
230782,466,167,299,59,1
230782,5751,2625,3126,60,1
230807,3108,1424,1684,1,4
230807,2295,1042,1253,2,1
230807,2260,1028,1232,3,1
230807,449,211,238,4,1
230807,1811,817,994,5,1
230807,35,14,21,11,1
230807,813,382,431,12,3
230807,161,64,97,19,1
230807,1650,753,897,20,1
230807,2680,1208,1472,21,4
230807,2140,953,1187,22,1
230807,2125,948,1177,23,1
230807,446,209,237,24,1
230807,1679,739,940,25,1
230807,15,5,10,31,1
230807,540,255,285,32,3
230807,141,58,83,39,1
230807,1538,681,857,40,1
230807,428,216,212,41,4
230807,155,89,66,42,1
230807,135,80,55,43,1
230807,3,2,1,44,1
230807,132,78,54,45,1
230807,20,9,11,51,1
230807,273,127,146,52,3
230807,20,6,14,59,1
230807,112,72,40,60,1
230816,738,240,498,1,4
230816,619,218,401,2,1
230816,613,216,397,3,1
230816,140,41,99,4,1
230816,473,175,298,5,1
230816,6,2,4,11,1
230816,119,22,97,12,3
230816,16,6,10,19,1
230816,457,169,288,20,1
230816,720,237,483,21,4
230816,609,215,394,22,1
230816,609,215,394,23,1
230816,140,41,99,24,1
230816,469,174,295,25,1
230816,111,22,89,32,3
230816,16,6,10,39,1
230816,453,168,285,40,1
230816,18,3,15,41,4
230816,10,3,7,42,1
230816,4,1,3,43,1
230816,4,1,3,45,1
230816,6,2,4,51,1
230816,8,0,8,52,3
230816,4,1,3,60,1
230825,243,121,122,1,4
230825,220,114,106,2,1
230825,199,106,93,3,1
230825,45,28,17,4,1
230825,154,78,76,5,1
230825,21,8,13,11,1
230825,23,7,16,12,3
230825,28,19,9,19,1
230825,126,59,67,20,1
230825,164,89,75,21,4
230825,160,88,72,22,1
230825,160,88,72,23,1
230825,44,27,17,24,1
230825,116,61,55,25,1
230825,4,1,3,32,3
230825,23,15,8,39,1
230825,93,46,47,40,1
230825,79,32,47,41,4
230825,60,26,34,42,1
230825,39,18,21,43,1
230825,1,1,0,44,1
230825,38,17,21,45,1
230825,21,8,13,51,1
230825,19,6,13,52,3
230825,5,4,1,59,1
230825,33,13,20,60,1
230834,2175,1028,1147,1,4
230834,2068,996,1072,2,1
230834,2022,973,1049,3,1
230834,480,261,219,4,1
230834,1542,712,830,5,1
230834,46,23,23,11,1
230834,107,32,75,12,3
230834,144,54,90,19,1
230834,1398,658,740,20,1
230834,1877,948,929,21,4
230834,1854,934,920,22,1
230834,1851,931,920,23,1
230834,480,261,219,24,1
230834,1371,670,701,25,1
230834,3,3,0,31,1
230834,23,14,9,32,3
230834,107,53,54,39,1
230834,1264,617,647,40,1
230834,298,80,218,41,4
230834,214,62,152,42,1
230834,171,42,129,43,1
230834,171,42,129,45,1
230834,43,20,23,51,1
230834,84,18,66,52,3
230834,37,1,36,59,1
230834,134,41,93,60,1
230852,3305,1891,1414,1,4
230852,2898,1733,1165,2,1
230852,2851,1708,1143,3,1
230852,594,361,233,4,1
230852,2257,1347,910,5,1
230852,47,25,22,11,1
230852,407,158,249,12,3
230852,202,121,81,19,1
230852,2055,1226,829,20,1
230852,2635,1544,1091,21,4
230852,2332,1432,900,22,1
230852,2329,1431,898,23,1
230852,594,361,233,24,1
230852,1735,1070,665,25,1
230852,3,1,2,31,1
230852,303,112,191,32,3
230852,115,72,43,39,1
230852,1620,998,622,40,1
230852,670,347,323,41,4
230852,566,301,265,42,1
230852,522,277,245,43,1
230852,522,277,245,45,1
230852,44,24,20,51,1
230852,104,46,58,52,3
230852,87,49,38,59,1
230852,435,228,207,60,1
230861,6200,1943,4257,1,4
230861,6200,1943,4257,2,1
230861,4401,1424,2977,3,1
230861,868,316,552,4,1
230861,3533,1108,2425,5,1
230861,1799,519,1280,11,1
230861,476,176,300,19,1
230861,3057,932,2125,20,1
230861,967,407,560,21,4
230861,967,407,560,22,1
230861,917,382,535,23,1
230861,232,100,132,24,1
230861,685,282,403,25,1
230861,50,25,25,31,1
230861,136,64,72,39,1
230861,549,218,331,40,1
230861,5233,1536,3697,41,4
230861,5233,1536,3697,42,1
230861,3484,1042,2442,43,1
230861,636,216,420,44,1
230861,2848,826,2022,45,1
230861,1749,494,1255,51,1
230861,340,112,228,59,1
230861,2508,714,1794,60,1
230889,592,181,411,1,4
230889,209,73,136,2,1
230889,201,73,128,3,1
230889,2,1,1,4,1
230889,199,72,127,5,1
230889,8,0,8,11,1
230889,383,108,275,12,3
230889,53,16,37,19,1
230889,146,56,90,20,1
230889,582,180,402,21,4
230889,206,73,133,22,1
230889,198,73,125,23,1
230889,2,1,1,24,1
230889,196,72,124,25,1
230889,8,0,8,31,1
230889,376,107,269,32,3
230889,53,16,37,39,1
230889,143,56,87,40,1
230889,10,1,9,41,4
230889,3,0,3,42,1
230889,3,0,3,43,1
230889,3,0,3,45,1
230889,7,1,6,52,3
230889,3,0,3,60,1
230898,840,349,491,1,4
230898,590,264,326,2,1
230898,578,258,320,3,1
230898,135,59,76,4,1
230898,443,199,244,5,1
230898,12,6,6,11,1
230898,250,85,165,12,3
230898,49,21,28,19,1
230898,394,178,216,20,1
230898,819,335,484,21,4
230898,569,250,319,22,1
230898,564,247,317,23,1
230898,135,59,76,24,1
230898,429,188,241,25,1
230898,5,3,2,31,1
230898,250,85,165,32,3
230898,49,21,28,39,1
230898,380,167,213,40,1
230898,21,14,7,41,4
230898,21,14,7,42,1
230898,14,11,3,43,1
230898,14,11,3,45,1
230898,7,3,4,51,1
230898,14,11,3,60,1
230913,1692,572,1120,1,4
230913,1486,529,957,2,1
230913,1433,508,925,3,1
230913,225,92,133,4,1
230913,1208,416,792,5,1
230913,53,21,32,11,1
230913,206,43,163,12,3
230913,147,42,105,19,1
230913,1061,374,687,20,1
230913,993,394,599,21,4
230913,956,383,573,22,1
230913,953,383,570,23,1
230913,224,91,133,24,1
230913,729,292,437,25,1
230913,3,0,3,31,1
230913,37,11,26,32,3
230913,74,25,49,39,1
230913,655,267,388,40,1
230913,699,178,521,41,4
230913,530,146,384,42,1
230913,480,125,355,43,1
230913,1,1,0,44,1
230913,479,124,355,45,1
230913,50,21,29,51,1
230913,169,32,137,52,3
230913,73,17,56,59,1
230913,406,107,299,60,1
230931,1519,806,713,1,4
230931,1415,793,622,2,1
230931,1363,780,583,3,1
230931,365,222,143,4,1
230931,998,558,440,5,1
230931,52,13,39,11,1
230931,104,13,91,12,3
230931,77,46,31,19,1
230931,921,512,409,20,1
230931,1259,727,532,21,4
230931,1257,727,530,22,1
230931,1257,727,530,23,1
230931,361,221,140,24,1
230931,896,506,390,25,1
230931,2,0,2,32,3
230931,69,44,25,39,1
230931,827,462,365,40,1
230931,260,79,181,41,4
230931,158,66,92,42,1
230931,106,53,53,43,1
230931,4,1,3,44,1
230931,102,52,50,45,1
230931,52,13,39,51,1
230931,102,13,89,52,3
230931,8,2,6,59,1
230931,94,50,44,60,1
230940,260,132,128,1,4
230940,260,132,128,2,1
230940,230,123,107,3,1
230940,45,27,18,4,1
230940,185,96,89,5,1
230940,30,9,21,11,1
230940,16,11,5,19,1
230940,169,85,84,20,1
230940,228,122,106,21,4
230940,228,122,106,22,1
230940,228,122,106,23,1
230940,45,27,18,24,1
230940,183,95,88,25,1
230940,16,11,5,39,1
230940,167,84,83,40,1
230940,32,10,22,41,4
230940,32,10,22,42,1
230940,2,1,1,43,1
230940,2,1,1,45,1
230940,30,9,21,51,1
230940,2,1,1,60,1
230959,2495,1219,1276,1,4
230959,2495,1219,1276,2,1
230959,2466,1212,1254,3,1
230959,625,311,314,4,1
230959,1841,901,940,5,1
230959,29,7,22,11,1
230959,1,0,1,19,1
230959,1840,901,939,20,1
230959,2477,1207,1270,21,4
230959,2477,1207,1270,22,1
230959,2456,1204,1252,23,1
230959,625,311,314,24,1
230959,1831,893,938,25,1
230959,21,3,18,31,1
230959,1,0,1,39,1
230959,1830,893,937,40,1
230959,18,12,6,41,4
230959,18,12,6,42,1
230959,10,8,2,43,1
230959,10,8,2,45,1
230959,8,4,4,51,1
230959,10,8,2,60,1
230977,462,255,207,1,4
230977,462,255,207,2,1
230977,425,235,190,3,1
230977,79,39,40,4,1
230977,346,196,150,5,1
230977,37,20,17,11,1
230977,43,26,17,19,1
230977,303,170,133,20,1
230977,347,191,156,21,4
230977,347,191,156,22,1
230977,347,191,156,23,1
230977,75,38,37,24,1
230977,272,153,119,25,1
230977,37,24,13,39,1
230977,235,129,106,40,1
230977,115,64,51,41,4
230977,115,64,51,42,1
230977,78,44,34,43,1
230977,4,1,3,44,1
230977,74,43,31,45,1
230977,37,20,17,51,1
230977,6,2,4,59,1
230977,68,41,27,60,1
230995,3417,2426,991,1,4
230995,2456,1776,680,2,1
230995,2432,1759,673,3,1
230995,590,438,152,4,1
230995,1842,1321,521,5,1
230995,24,17,7,11,1
230995,961,650,311,12,3
230995,68,40,28,19,1
230995,1774,1281,493,20,1
230995,3126,2192,934,21,4
230995,2228,1583,645,22,1
230995,2223,1581,642,23,1
230995,548,422,126,24,1
230995,1675,1159,516,25,1
230995,5,2,3,31,1
230995,898,609,289,32,3
230995,66,38,28,39,1
230995,1609,1121,488,40,1
230995,291,234,57,41,4
230995,228,193,35,42,1
230995,209,178,31,43,1
230995,42,16,26,44,1
230995,167,162,5,45,1
230995,19,15,4,51,1
230995,63,41,22,52,3
230995,2,2,0,59,1
230995,165,160,5,60,1
231004,80,5,75,1,4
231004,80,5,75,2,1
231004,80,5,75,3,1
231004,34,3,31,4,1
231004,46,2,44,5,1
231004,46,2,44,20,1
231004,80,5,75,21,4
231004,80,5,75,22,1
231004,80,5,75,23,1
231004,34,3,31,24,1
231004,46,2,44,25,1
231004,46,2,44,40,1
231059,2378,1020,1358,1,4
231059,1998,908,1090,2,1
231059,1941,873,1068,3,1
231059,506,225,281,4,1
231059,1435,648,787,5,1
231059,57,35,22,11,1
231059,380,112,268,12,3
231059,31,14,17,19,1
231059,1404,634,770,20,1
231059,2004,895,1109,21,4
231059,1959,885,1074,22,1
231059,1922,862,1060,23,1
231059,506,225,281,24,1
231059,1416,637,779,25,1
231059,37,23,14,31,1
231059,45,10,35,32,3
231059,31,14,17,39,1
231059,1385,623,762,40,1
231059,374,125,249,41,4
231059,39,23,16,42,1
231059,19,11,8,43,1
231059,19,11,8,45,1
231059,20,12,8,51,1
231059,335,102,233,52,3
231059,19,11,8,60,1
231068,443,132,311,1,4
231068,443,132,311,12,3
231068,184,64,120,21,4
231068,184,64,120,32,3
231068,259,68,191,41,4
231068,259,68,191,52,3
231077,271,110,161,1,4
231077,176,84,92,2,1
231077,158,75,83,3,1
231077,33,13,20,4,1
231077,125,62,63,5,1
231077,18,9,9,11,1
231077,95,26,69,12,3
231077,20,14,6,19,1
231077,105,48,57,20,1
231077,142,68,74,21,4
231077,120,62,58,22,1
231077,120,62,58,23,1
231077,33,13,20,24,1
231077,87,49,38,25,1
231077,22,6,16,32,3
231077,17,13,4,39,1
231077,70,36,34,40,1
231077,129,42,87,41,4
231077,56,22,34,42,1
231077,38,13,25,43,1
231077,38,13,25,45,1
231077,18,9,9,51,1
231077,73,20,53,52,3
231077,3,1,2,59,1
231077,35,12,23,60,1
231086,480,184,296,1,4
231086,480,184,296,2,1
231086,470,179,291,3,1
231086,94,34,60,4,1
231086,376,145,231,5,1
231086,10,5,5,11,1
231086,38,10,28,19,1
231086,338,135,203,20,1
231086,453,172,281,21,4
231086,453,172,281,22,1
231086,453,172,281,23,1
231086,94,34,60,24,1
231086,359,138,221,25,1
231086,36,9,27,39,1
231086,323,129,194,40,1
231086,27,12,15,41,4
231086,27,12,15,42,1
231086,17,7,10,43,1
231086,17,7,10,45,1
231086,10,5,5,51,1
231086,2,1,1,59,1
231086,15,6,9,60,1
231095,116,60,56,1,4
231095,116,60,56,2,1
231095,114,59,55,3,1
231095,18,9,9,4,1
231095,96,50,46,5,1
231095,2,1,1,11,1
231095,32,13,19,19,1
231095,64,37,27,20,1
231095,104,53,51,21,4
231095,104,53,51,22,1
231095,104,53,51,23,1
231095,17,8,9,24,1
231095,87,45,42,25,1
231095,30,12,18,39,1
231095,57,33,24,40,1
231095,12,7,5,41,4
231095,12,7,5,42,1
231095,10,6,4,43,1
231095,1,1,0,44,1
231095,9,5,4,45,1
231095,2,1,1,51,1
231095,2,1,1,59,1
231095,7,4,3,60,1
231147,675,292,383,1,4
231147,675,292,383,12,3
231147,441,212,229,21,4
231147,441,212,229,32,3
231147,234,80,154,41,4
231147,234,80,154,52,3
231165,1543,899,644,1,4
231165,1543,899,644,2,1
231165,1361,764,597,3,1
231165,194,138,56,4,1
231165,1167,626,541,5,1
231165,182,135,47,11,1
231165,244,63,181,19,1
231165,923,563,360,20,1
231165,1049,649,400,21,4
231165,1049,649,400,22,1
231165,1049,649,400,23,1
231165,191,136,55,24,1
231165,858,513,345,25,1
231165,202,53,149,39,1
231165,656,460,196,40,1
231165,494,250,244,41,4
231165,494,250,244,42,1
231165,312,115,197,43,1
231165,3,2,1,44,1
231165,309,113,196,45,1
231165,182,135,47,51,1
231165,42,10,32,59,1
231165,267,103,164,60,1
231174,12723,5550,7173,1,4
231174,10912,4771,6141,2,1
231174,9970,4388,5582,3,1
231174,2495,1087,1408,4,1
231174,7475,3301,4174,5,1
231174,942,383,559,11,1
231174,1811,779,1032,12,3
231174,407,193,214,19,1
231174,7068,3108,3960,20,1
231174,11001,4870,6131,21,4
231174,9764,4310,5454,22,1
231174,9621,4234,5387,23,1
231174,2483,1079,1404,24,1
231174,7138,3155,3983,25,1
231174,143,76,67,31,1
231174,1237,560,677,32,3
231174,375,182,193,39,1
231174,6763,2973,3790,40,1
231174,1722,680,1042,41,4
231174,1148,461,687,42,1
231174,349,154,195,43,1
231174,12,8,4,44,1
231174,337,146,191,45,1
231174,799,307,492,51,1
231174,574,219,355,52,3
231174,32,11,21,59,1
231174,305,135,170,60,1
231280,108,21,87,1,4
231280,108,21,87,2,1
231280,108,21,87,3,1
231280,89,19,70,4,1
231280,19,2,17,5,1
231280,19,2,17,20,1
231280,83,17,66,21,4
231280,83,17,66,22,1
231280,83,17,66,23,1
231280,73,16,57,24,1
231280,10,1,9,25,1
231280,10,1,9,40,1
231280,25,4,21,41,4
231280,25,4,21,42,1
231280,25,4,21,43,1
231280,16,3,13,44,1
231280,9,1,8,45,1
231280,9,1,8,60,1
231411,824,799,25,1,4
231411,824,799,25,2,1
231411,824,799,25,3,1
231411,168,166,2,4,1
231411,656,633,23,5,1
231411,22,18,4,19,1
231411,634,615,19,20,1
231411,824,799,25,21,4
231411,824,799,25,22,1
231411,824,799,25,23,1
231411,168,166,2,24,1
231411,656,633,23,25,1
231411,22,18,4,39,1
231411,634,615,19,40,1
231420,906,451,455,1,4
231420,877,439,438,2,1
231420,870,435,435,3,1
231420,237,144,93,4,1
231420,633,291,342,5,1
231420,7,4,3,11,1
231420,29,12,17,12,3
231420,91,35,56,19,1
231420,542,256,286,20,1
231420,864,436,428,21,4
231420,851,431,420,22,1
231420,851,431,420,23,1
231420,235,144,91,24,1
231420,616,287,329,25,1
231420,13,5,8,32,3
231420,91,35,56,39,1
231420,525,252,273,40,1
231420,42,15,27,41,4
231420,26,8,18,42,1
231420,19,4,15,43,1
231420,2,0,2,44,1
231420,17,4,13,45,1
231420,7,4,3,51,1
231420,16,7,9,52,3
231420,17,4,13,60,1
231536,4437,1940,2497,1,4
231536,4437,1940,2497,2,1
231536,3524,1563,1961,3,1
231536,908,460,448,4,1
231536,2616,1103,1513,5,1
231536,913,377,536,11,1
231536,319,162,157,19,1
231536,2297,941,1356,20,1
231536,1607,814,793,21,4
231536,1607,814,793,22,1
231536,1562,794,768,23,1
231536,554,290,264,24,1
231536,1008,504,504,25,1
231536,45,20,25,31,1
231536,155,76,79,39,1
231536,853,428,425,40,1
231536,2830,1126,1704,41,4
231536,2830,1126,1704,42,1
231536,1962,769,1193,43,1
231536,354,170,184,44,1
231536,1608,599,1009,45,1
231536,868,357,511,51,1
231536,164,86,78,59,1
231536,1444,513,931,60,1
231554,842,376,466,1,4
231554,837,375,462,2,1
231554,821,369,452,3,1
231554,123,73,50,4,1
231554,698,296,402,5,1
231554,16,6,10,11,1
231554,5,1,4,12,3
231554,193,84,109,19,1
231554,505,212,293,20,1
231554,726,336,390,21,4
231554,723,336,387,22,1
231554,718,335,383,23,1
231554,120,72,48,24,1
231554,598,263,335,25,1
231554,5,1,4,31,1
231554,3,0,3,32,3
231554,177,78,99,39,1
231554,421,185,236,40,1
231554,116,40,76,41,4
231554,114,39,75,42,1
231554,103,34,69,43,1
231554,3,1,2,44,1
231554,100,33,67,45,1
231554,11,5,6,51,1
231554,2,1,1,52,3
231554,16,6,10,59,1
231554,84,27,57,60,1
231581,1848,834,1014,1,4
231581,1848,834,1014,2,1
231581,1822,821,1001,3,1
231581,536,241,295,4,1
231581,1286,580,706,5,1
231581,26,13,13,11,1
231581,59,31,28,19,1
231581,1227,549,678,20,1
231581,1840,830,1010,21,4
231581,1840,830,1010,22,1
231581,1819,819,1000,23,1
231581,536,241,295,24,1
231581,1283,578,705,25,1
231581,21,11,10,31,1
231581,59,31,28,39,1
231581,1224,547,677,40,1
231581,8,4,4,41,4
231581,8,4,4,42,1
231581,3,2,1,43,1
231581,3,2,1,45,1
231581,5,2,3,51,1
231581,3,2,1,60,1
231624,8376,3789,4587,1,4
231624,6271,2814,3457,2,1
231624,6235,2799,3436,3,1
231624,1479,652,827,4,1
231624,4756,2147,2609,5,1
231624,36,15,21,11,1
231624,2105,975,1130,12,3
231624,185,79,106,19,1
231624,4571,2068,2503,20,1
231624,7850,3577,4273,21,4
231624,6195,2777,3418,22,1
231624,6189,2775,3414,23,1
231624,1479,652,827,24,1
231624,4710,2123,2587,25,1
231624,6,2,4,31,1
231624,1655,800,855,32,3
231624,179,78,101,39,1
231624,4531,2045,2486,40,1
231624,526,212,314,41,4
231624,76,37,39,42,1
231624,46,24,22,43,1
231624,46,24,22,45,1
231624,30,13,17,51,1
231624,450,175,275,52,3
231624,6,1,5,59,1
231624,40,23,17,60,1
231651,5693,2303,3390,1,4
231651,2400,940,1460,2,1
231651,2286,902,1384,3,1
231651,230,88,142,4,1
231651,2056,814,1242,5,1
231651,114,38,76,11,1
231651,3293,1363,1930,12,3
231651,339,123,216,19,1
231651,1717,691,1026,20,1
231651,2530,1019,1511,21,4
231651,1497,606,891,22,1
231651,1492,604,888,23,1
231651,218,83,135,24,1
231651,1274,521,753,25,1
231651,5,2,3,31,1
231651,1033,413,620,32,3
231651,208,73,135,39,1
231651,1066,448,618,40,1
231651,3163,1284,1879,41,4
231651,903,334,569,42,1
231651,794,298,496,43,1
231651,12,5,7,44,1
231651,782,293,489,45,1
231651,109,36,73,51,1
231651,2260,950,1310,52,3
231651,131,50,81,59,1
231651,651,243,408,60,1
231688,50,1,49,1,4
231688,50,1,49,2,1
231688,50,1,49,3,1
231688,16,1,15,4,1
231688,34,0,34,5,1
231688,34,0,34,20,1
231688,19,0,19,21,4
231688,19,0,19,22,1
231688,19,0,19,23,1
231688,5,0,5,24,1
231688,14,0,14,25,1
231688,14,0,14,40,1
231688,31,1,30,41,4
231688,31,1,30,42,1
231688,31,1,30,43,1
231688,11,1,10,44,1
231688,20,0,20,45,1
231688,20,0,20,60,1
231697,4730,2229,2501,1,4
231697,4730,2229,2501,2,1
231697,2851,1339,1512,3,1
231697,781,394,387,4,1
231697,2070,945,1125,5,1
231697,1879,890,989,11,1
231697,189,69,120,19,1
231697,1881,876,1005,20,1
231697,1465,719,746,21,4
231697,1465,719,746,22,1
231697,1180,590,590,23,1
231697,462,233,229,24,1
231697,718,357,361,25,1
231697,285,129,156,31,1
231697,95,38,57,39,1
231697,623,319,304,40,1
231697,3265,1510,1755,41,4
231697,3265,1510,1755,42,1
231697,1671,749,922,43,1
231697,319,161,158,44,1
231697,1352,588,764,45,1
231697,1594,761,833,51,1
231697,94,31,63,59,1
231697,1258,557,701,60,1
231712,5232,2248,2984,1,4
231712,5094,2203,2891,2,1
231712,5083,2198,2885,3,1
231712,1276,545,731,4,1
231712,3807,1653,2154,5,1
231712,11,5,6,11,1
231712,138,45,93,12,3
231712,191,81,110,19,1
231712,3616,1572,2044,20,1
231712,5066,2167,2899,21,4
231712,4962,2139,2823,22,1
231712,4962,2139,2823,23,1
231712,1276,545,731,24,1
231712,3686,1594,2092,25,1
231712,104,28,76,32,3
231712,179,76,103,39,1
231712,3507,1518,1989,40,1
231712,166,81,85,41,4
231712,132,64,68,42,1
231712,121,59,62,43,1
231712,121,59,62,45,1
231712,11,5,6,51,1
231712,34,17,17,52,3
231712,12,5,7,59,1
231712,109,54,55,60,1
231721,48,1,47,1,4
231721,48,1,47,2,1
231721,48,1,47,3,1
231721,3,1,2,4,1
231721,45,0,45,5,1
231721,45,0,45,20,1
231721,8,1,7,21,4
231721,8,1,7,22,1
231721,8,1,7,23,1
231721,2,1,1,24,1
231721,6,0,6,25,1
231721,6,0,6,40,1
231721,40,0,40,41,4
231721,40,0,40,42,1
231721,40,0,40,43,1
231721,1,0,1,44,1
231721,39,0,39,45,1
231721,39,0,39,60,1
231785,728,161,567,1,4
231785,728,161,567,2,1
231785,728,161,567,3,1
231785,92,34,58,4,1
231785,636,127,509,5,1
231785,128,30,98,19,1
231785,508,97,411,20,1
231785,362,101,261,21,4
231785,362,101,261,22,1
231785,362,101,261,23,1
231785,76,32,44,24,1
231785,286,69,217,25,1
231785,87,23,64,39,1
231785,199,46,153,40,1
231785,366,60,306,41,4
231785,366,60,306,42,1
231785,366,60,306,43,1
231785,16,2,14,44,1
231785,350,58,292,45,1
231785,41,7,34,59,1
231785,309,51,258,60,1
231828,906,123,783,1,4
231828,906,123,783,2,1
231828,906,123,783,3,1
231828,108,20,88,4,1
231828,798,103,695,5,1
231828,196,17,179,19,1
231828,602,86,516,20,1
231828,488,70,418,21,4
231828,488,70,418,22,1
231828,488,70,418,23,1
231828,86,16,70,24,1
231828,402,54,348,25,1
231828,121,11,110,39,1
231828,281,43,238,40,1
231828,418,53,365,41,4
231828,418,53,365,42,1
231828,418,53,365,43,1
231828,22,4,18,44,1
231828,396,49,347,45,1
231828,75,6,69,59,1
231828,321,43,278,60,1
231837,1039,203,836,1,4
231837,813,155,658,2,1
231837,810,155,655,3,1
231837,66,15,51,4,1
231837,744,140,604,5,1
231837,3,0,3,11,1
231837,226,48,178,12,3
231837,182,38,144,19,1
231837,562,102,460,20,1
231837,888,187,701,21,4
231837,692,145,547,22,1
231837,692,145,547,23,1
231837,66,15,51,24,1
231837,626,130,496,25,1
231837,196,42,154,32,3
231837,152,35,117,39,1
231837,474,95,379,40,1
231837,151,16,135,41,4
231837,121,10,111,42,1
231837,118,10,108,43,1
231837,118,10,108,45,1
231837,3,0,3,51,1
231837,30,6,24,52,3
231837,30,3,27,59,1
231837,88,7,81,60,1
231873,1312,587,725,1,4
231873,1312,587,725,2,1
231873,787,322,465,3,1
231873,231,94,137,4,1
231873,556,228,328,5,1
231873,525,265,260,11,1
231873,45,14,31,19,1
231873,511,214,297,20,1
231873,432,188,244,21,4
231873,432,188,244,22,1
231873,417,182,235,23,1
231873,162,68,94,24,1
231873,255,114,141,25,1
231873,15,6,9,31,1
231873,20,6,14,39,1
231873,235,108,127,40,1
231873,880,399,481,41,4
231873,880,399,481,42,1
231873,370,140,230,43,1
231873,69,26,43,44,1
231873,301,114,187,45,1
231873,510,259,251,51,1
231873,25,8,17,59,1
231873,276,106,170,60,1
231882,4280,1864,2416,1,4
231882,4280,1864,2416,2,1
231882,2493,1013,1480,3,1
231882,609,282,327,4,1
231882,1884,731,1153,5,1
231882,1787,851,936,11,1
231882,94,42,52,19,1
231882,1790,689,1101,20,1
231882,1540,725,815,21,4
231882,1540,725,815,22,1
231882,1410,661,749,23,1
231882,457,229,228,24,1
231882,953,432,521,25,1
231882,130,64,66,31,1
231882,50,24,26,39,1
231882,903,408,495,40,1
231882,2740,1139,1601,41,4
231882,2740,1139,1601,42,1
231882,1083,352,731,43,1
231882,152,53,99,44,1
231882,931,299,632,45,1
231882,1657,787,870,51,1
231882,44,18,26,59,1
231882,887,281,606,60,1
231970,1017,439,578,1,4
231970,1017,439,578,12,3
231970,963,426,537,21,4
231970,963,426,537,32,3
231970,54,13,41,41,4
231970,54,13,41,52,3
232016,477,84,393,1,4
232016,477,84,393,2,1
232016,477,84,393,3,1
232016,24,4,20,4,1
232016,453,80,373,5,1
232016,453,80,373,20,1
232016,270,52,218,21,4
232016,270,52,218,22,1
232016,270,52,218,23,1
232016,19,4,15,24,1
232016,251,48,203,25,1
232016,251,48,203,40,1
232016,207,32,175,41,4
232016,207,32,175,42,1
232016,207,32,175,43,1
232016,5,0,5,44,1
232016,202,32,170,45,1
232016,202,32,170,60,1
232025,959,490,469,1,4
232025,936,484,452,2,1
232025,907,472,435,3,1
232025,267,149,118,4,1
232025,640,323,317,5,1
232025,29,12,17,11,1
232025,23,6,17,12,3
232025,50,22,28,19,1
232025,590,301,289,20,1
232025,894,460,434,21,4
232025,889,458,431,22,1
232025,885,456,429,23,1
232025,264,147,117,24,1
232025,621,309,312,25,1
232025,4,2,2,31,1
232025,5,2,3,32,3
232025,49,21,28,39,1
232025,572,288,284,40,1
232025,65,30,35,41,4
232025,47,26,21,42,1
232025,22,16,6,43,1
232025,3,2,1,44,1
232025,19,14,5,45,1
232025,25,10,15,51,1
232025,18,4,14,52,3
232025,1,1,0,59,1
232025,18,13,5,60,1
232043,1640,570,1070,1,4
232043,1184,415,769,2,1
232043,1148,389,759,3,1
232043,232,106,126,4,1
232043,916,283,633,5,1
232043,36,26,10,11,1
232043,456,155,301,12,3
232043,157,35,122,19,1
232043,759,248,511,20,1
232043,1252,444,808,21,4
232043,1122,384,738,22,1
232043,1122,384,738,23,1
232043,232,106,126,24,1
232043,890,278,612,25,1
232043,130,60,70,32,3
232043,152,35,117,39,1
232043,738,243,495,40,1
232043,388,126,262,41,4
232043,62,31,31,42,1
232043,26,5,21,43,1
232043,26,5,21,45,1
232043,36,26,10,51,1
232043,326,95,231,52,3
232043,5,0,5,59,1
232043,21,5,16,60,1
232052,857,286,571,1,4
232052,857,286,571,2,1
232052,652,191,461,3,1
232052,152,62,90,4,1
232052,500,129,371,5,1
232052,205,95,110,11,1
232052,30,12,18,19,1
232052,470,117,353,20,1
232052,264,100,164,21,4
232052,264,100,164,22,1
232052,243,92,151,23,1
232052,90,42,48,24,1
232052,153,50,103,25,1
232052,21,8,13,31,1
232052,10,5,5,39,1
232052,143,45,98,40,1
232052,593,186,407,41,4
232052,593,186,407,42,1
232052,409,99,310,43,1
232052,62,20,42,44,1
232052,347,79,268,45,1
232052,184,87,97,51,1
232052,20,7,13,59,1
232052,327,72,255,60,1
232089,1512,857,655,1,4
232089,1512,857,655,2,1
232089,1506,855,651,3,1
232089,554,349,205,4,1
232089,952,506,446,5,1
232089,6,2,4,11,1
232089,67,42,25,19,1
232089,885,464,421,20,1
232089,1492,852,640,21,4
232089,1492,852,640,22,1
232089,1492,852,640,23,1
232089,554,349,205,24,1
232089,938,503,435,25,1
232089,67,42,25,39,1
232089,871,461,410,40,1
232089,20,5,15,41,4
232089,20,5,15,42,1
232089,14,3,11,43,1
232089,14,3,11,45,1
232089,6,2,4,51,1
232089,14,3,11,60,1
232186,33917,15601,18316,1,4
232186,21990,10663,11327,2,1
232186,21324,10355,10969,3,1
232186,3011,1420,1591,4,1
232186,18313,8935,9378,5,1
232186,666,308,358,11,1
232186,11927,4938,6989,12,3
232186,2659,1213,1446,19,1
232186,15654,7722,7932,20,1
232186,21421,10182,11239,21,4
232186,17261,8280,8981,22,1
232186,17200,8254,8946,23,1
232186,2992,1408,1584,24,1
232186,14208,6846,7362,25,1
232186,61,26,35,31,1
232186,4160,1902,2258,32,3
232186,2032,917,1115,39,1
232186,12176,5929,6247,40,1
232186,12496,5419,7077,41,4
232186,4729,2383,2346,42,1
232186,4124,2101,2023,43,1
232186,19,12,7,44,1
232186,4105,2089,2016,45,1
232186,605,282,323,51,1
232186,7767,3036,4731,52,3
232186,627,296,331,59,1
232186,3478,1793,1685,60,1
232195,7379,2899,4480,1,4
232195,7379,2899,4480,2,1
232195,5770,2319,3451,3,1
232195,1402,697,705,4,1
232195,4368,1622,2746,5,1
232195,1609,580,1029,11,1
232195,433,162,271,19,1
232195,3935,1460,2475,20,1
232195,2352,1098,1254,21,4
232195,2352,1098,1254,22,1
232195,2221,1036,1185,23,1
232195,787,412,375,24,1
232195,1434,624,810,25,1
232195,131,62,69,31,1
232195,170,68,102,39,1
232195,1264,556,708,40,1
232195,5027,1801,3226,41,4
232195,5027,1801,3226,42,1
232195,3549,1283,2266,43,1
232195,615,285,330,44,1
232195,2934,998,1936,45,1
232195,1478,518,960,51,1
232195,263,94,169,59,1
232195,2671,904,1767,60,1
232256,1070,1069,1,1,4
232256,1070,1069,1,2,1
232256,1070,1069,1,3,1
232256,292,292,0,4,1
232256,778,777,1,5,1
232256,16,16,0,19,1
232256,762,761,1,20,1
232256,1068,1067,1,21,4
232256,1068,1067,1,22,1
232256,1068,1067,1,23,1
232256,292,292,0,24,1
232256,776,775,1,25,1
232256,16,16,0,39,1
232256,760,759,1,40,1
232256,2,2,0,41,4
232256,2,2,0,42,1
232256,2,2,0,43,1
232256,2,2,0,45,1
232256,2,2,0,60,1
232265,4622,1652,2970,1,4
232265,3742,1362,2380,2,1
232265,3529,1270,2259,3,1
232265,1004,325,679,4,1
232265,2525,945,1580,5,1
232265,213,92,121,11,1
232265,880,290,590,12,3
232265,177,84,93,19,1
232265,2348,861,1487,20,1
232265,4116,1410,2706,21,4
232265,3491,1223,2268,22,1
232265,3342,1158,2184,23,1
232265,955,300,655,24,1
232265,2387,858,1529,25,1
232265,149,65,84,31,1
232265,625,187,438,32,3
232265,89,30,59,39,1
232265,2298,828,1470,40,1
232265,506,242,264,41,4
232265,251,139,112,42,1
232265,187,112,75,43,1
232265,49,25,24,44,1
232265,138,87,51,45,1
232265,64,27,37,51,1
232265,255,103,152,52,3
232265,88,54,34,59,1
232265,50,33,17,60,1
232308,750,38,712,1,4
232308,580,4,576,2,1
232308,568,0,568,3,1
232308,146,0,146,4,1
232308,422,0,422,5,1
232308,12,4,8,11,1
232308,170,34,136,12,3
232308,39,0,39,19,1
232308,383,0,383,20,1
232308,616,14,602,21,4
232308,561,2,559,22,1
232308,553,0,553,23,1
232308,146,0,146,24,1
232308,407,0,407,25,1
232308,8,2,6,31,1
232308,55,12,43,32,3
232308,38,0,38,39,1
232308,369,0,369,40,1
232308,134,24,110,41,4
232308,19,2,17,42,1
232308,15,0,15,43,1
232308,15,0,15,45,1
232308,4,2,2,51,1
232308,115,22,93,52,3
232308,1,0,1,59,1
232308,14,0,14,60,1
232414,12454,4929,7525,1,4
232414,12454,4929,7525,2,1
232414,10727,4198,6529,3,1
232414,1869,891,978,4,1
232414,8858,3307,5551,5,1
232414,1727,731,996,11,1
232414,939,368,571,19,1
232414,7919,2939,4980,20,1
232414,3552,1614,1938,21,4
232414,3552,1614,1938,22,1
232414,3410,1552,1858,23,1
232414,825,415,410,24,1
232414,2585,1137,1448,25,1
232414,142,62,80,31,1
232414,327,150,177,39,1
232414,2258,987,1271,40,1
232414,8902,3315,5587,41,4
232414,8902,3315,5587,42,1
232414,7317,2646,4671,43,1
232414,1044,476,568,44,1
232414,6273,2170,4103,45,1
232414,1585,669,916,51,1
232414,612,218,394,59,1
232414,5661,1952,3709,60,1
232423,20181,8063,12118,1,4
232423,18431,7526,10905,2,1
232423,18127,7380,10747,3,1
232423,4202,1588,2614,4,1
232423,13925,5792,8133,5,1
232423,304,146,158,11,1
232423,1750,537,1213,12,3
232423,621,302,319,19,1
232423,13304,5490,7814,20,1
232423,18626,7365,11261,21,4
232423,17526,7061,10465,22,1
232423,17504,7058,10446,23,1
232423,4199,1586,2613,24,1
232423,13305,5472,7833,25,1
232423,22,3,19,31,1
232423,1100,304,796,32,3
232423,568,281,287,39,1
232423,12737,5191,7546,40,1
232423,1555,698,857,41,4
232423,905,465,440,42,1
232423,623,322,301,43,1
232423,3,2,1,44,1
232423,620,320,300,45,1
232423,282,143,139,51,1
232423,650,233,417,52,3
232423,53,21,32,59,1
232423,567,299,268,60,1
232450,10103,4303,5800,1,4
232450,10103,4303,5800,2,1
232450,6402,2528,3874,3,1
232450,1429,659,770,4,1
232450,4973,1869,3104,5,1
232450,3701,1775,1926,11,1
232450,537,187,350,19,1
232450,4436,1682,2754,20,1
232450,2697,1213,1484,21,4
232450,2697,1213,1484,22,1
232450,2530,1123,1407,23,1
232450,835,396,439,24,1
232450,1695,727,968,25,1
232450,167,90,77,31,1
232450,250,94,156,39,1
232450,1445,633,812,40,1
232450,7406,3090,4316,41,4
232450,7406,3090,4316,42,1
232450,3872,1405,2467,43,1
232450,594,263,331,44,1
232450,3278,1142,2136,45,1
232450,3534,1685,1849,51,1
232450,287,93,194,59,1
232450,2991,1049,1942,60,1
232502,525,121,404,1,4
232502,525,121,404,2,1
232502,525,121,404,3,1
232502,29,6,23,4,1
232502,496,115,381,5,1
232502,94,20,74,19,1
232502,402,95,307,20,1
232502,444,88,356,21,4
232502,444,88,356,22,1
232502,444,88,356,23,1
232502,28,6,22,24,1
232502,416,82,334,25,1
232502,69,10,59,39,1
232502,347,72,275,40,1
232502,81,33,48,41,4
232502,81,33,48,42,1
232502,81,33,48,43,1
232502,1,0,1,44,1
232502,80,33,47,45,1
232502,25,10,15,59,1
232502,55,23,32,60,1
232557,77338,31395,45943,1,4
232557,47464,19572,27892,2,1
232557,47079,19379,27700,3,1
232557,4686,2018,2668,4,1
232557,42393,17361,25032,5,1
232557,385,193,192,11,1
232557,29874,11823,18051,12,3
232557,6469,2388,4081,19,1
232557,35924,14973,20951,20,1
232557,36353,15335,21018,21,4
232557,25911,11029,14882,22,1
232557,25836,10982,14854,23,1
232557,3218,1418,1800,24,1
232557,22618,9564,13054,25,1
232557,75,47,28,31,1
232557,10442,4306,6136,32,3
232557,3530,1347,2183,39,1
232557,19088,8217,10871,40,1
232557,40985,16060,24925,41,4
232557,21553,8543,13010,42,1
232557,21243,8397,12846,43,1
232557,1468,600,868,44,1
232557,19775,7797,11978,45,1
232557,310,146,164,51,1
232557,19432,7517,11915,52,3
232557,2939,1041,1898,59,1
232557,16836,6756,10080,60,1
232566,4960,1591,3369,1,4
232566,4497,1534,2963,2,1
232566,4357,1494,2863,3,1
232566,1106,368,738,4,1
232566,3251,1126,2125,5,1
232566,140,40,100,11,1
232566,463,57,406,12,3
232566,214,89,125,19,1
232566,3037,1037,2000,20,1
232566,4265,1404,2861,21,4
232566,4123,1390,2733,22,1
232566,4117,1386,2731,23,1
232566,1091,359,732,24,1
232566,3026,1027,1999,25,1
232566,6,4,2,31,1
232566,142,14,128,32,3
232566,197,84,113,39,1
232566,2829,943,1886,40,1
232566,695,187,508,41,4
232566,374,144,230,42,1
232566,240,108,132,43,1
232566,15,9,6,44,1
232566,225,99,126,45,1
232566,134,36,98,51,1
232566,321,43,278,52,3
232566,17,5,12,59,1
232566,208,94,114,60,1
232575,7238,2744,4494,1,4
232575,7238,2744,4494,2,1
232575,4666,1726,2940,3,1
232575,1103,465,638,4,1
232575,3563,1261,2302,5,1
232575,2572,1018,1554,11,1
232575,283,101,182,19,1
232575,3280,1160,2120,20,1
232575,1963,830,1133,21,4
232575,1963,830,1133,22,1
232575,1684,708,976,23,1
232575,583,258,325,24,1
232575,1101,450,651,25,1
232575,279,122,157,31,1
232575,95,35,60,39,1
232575,1006,415,591,40,1
232575,5275,1914,3361,41,4
232575,5275,1914,3361,42,1
232575,2982,1018,1964,43,1
232575,520,207,313,44,1
232575,2462,811,1651,45,1
232575,2293,896,1397,51,1
232575,188,66,122,59,1
232575,2274,745,1529,60,1
232609,2713,1065,1648,1,4
232609,2178,873,1305,2,1
232609,2140,864,1276,3,1
232609,512,211,301,4,1
232609,1628,653,975,5,1
232609,38,9,29,11,1
232609,535,192,343,12,3
232609,125,49,76,19,1
232609,1503,604,899,20,1
232609,2335,932,1403,21,4
232609,2089,842,1247,22,1
232609,2086,842,1244,23,1
232609,512,211,301,24,1
232609,1574,631,943,25,1
232609,3,0,3,31,1
232609,246,90,156,32,3
232609,119,47,72,39,1
232609,1455,584,871,40,1
232609,378,133,245,41,4
232609,89,31,58,42,1
232609,54,22,32,43,1
232609,54,22,32,45,1
232609,35,9,26,51,1
232609,289,102,187,52,3
232609,6,2,4,59,1
232609,48,20,28,60,1
232618,144,9,135,1,4
232618,144,9,135,2,1
232618,144,9,135,3,1
232618,144,9,135,5,1
232618,36,2,34,19,1
232618,108,7,101,20,1
232618,34,1,33,21,4
232618,34,1,33,22,1
232618,34,1,33,23,1
232618,34,1,33,25,1
232618,9,0,9,39,1
232618,25,1,24,40,1
232618,110,8,102,41,4
232618,110,8,102,42,1
232618,110,8,102,43,1
232618,110,8,102,45,1
232618,27,2,25,59,1
232618,83,6,77,60,1
232672,1711,129,1582,1,4
232672,1441,92,1349,2,1
232672,1307,75,1232,3,1
232672,217,0,217,4,1
232672,1090,75,1015,5,1
232672,134,17,117,11,1
232672,270,37,233,12,3
232672,124,15,109,19,1
232672,966,60,906,20,1
232672,1149,57,1092,21,4
232672,1037,46,991,22,1
232672,993,40,953,23,1
232672,217,0,217,24,1
232672,776,40,736,25,1
232672,44,6,38,31,1
232672,112,11,101,32,3
232672,90,10,80,39,1
232672,686,30,656,40,1
232672,562,72,490,41,4
232672,404,46,358,42,1
232672,314,35,279,43,1
232672,314,35,279,45,1
232672,90,11,79,51,1
232672,158,26,132,52,3
232672,34,5,29,59,1
232672,280,30,250,60,1
232681,4831,1709,3122,1,4
232681,4383,1568,2815,2,1
232681,4303,1545,2758,3,1
232681,944,314,630,4,1
232681,3359,1231,2128,5,1
232681,80,23,57,11,1
232681,448,141,307,12,3
232681,308,121,187,19,1
232681,3051,1110,1941,20,1
232681,3989,1382,2607,21,4
232681,3843,1343,2500,22,1
232681,3827,1338,2489,23,1
232681,927,306,621,24,1
232681,2900,1032,1868,25,1
232681,16,5,11,31,1
232681,146,39,107,32,3
232681,237,93,144,39,1
232681,2663,939,1724,40,1
232681,842,327,515,41,4
232681,540,225,315,42,1
232681,476,207,269,43,1
232681,17,8,9,44,1
232681,459,199,260,45,1
232681,64,18,46,51,1
232681,302,102,200,52,3
232681,71,28,43,59,1
232681,388,171,217,60,1
232706,3486,1031,2455,1,4
232706,2396,772,1624,2,1
232706,2371,762,1609,3,1
232706,400,151,249,4,1
232706,1971,611,1360,5,1
232706,25,10,15,11,1
232706,1090,259,831,12,3
232706,281,85,196,19,1
232706,1690,526,1164,20,1
232706,2682,794,1888,21,4
232706,2141,685,1456,22,1
232706,2136,683,1453,23,1
232706,397,148,249,24,1
232706,1739,535,1204,25,1
232706,5,2,3,31,1
232706,541,109,432,32,3
232706,257,82,175,39,1
232706,1482,453,1029,40,1
232706,804,237,567,41,4
232706,255,87,168,42,1
232706,235,79,156,43,1
232706,3,3,0,44,1
232706,232,76,156,45,1
232706,20,8,12,51,1
232706,549,150,399,52,3
232706,24,3,21,59,1
232706,208,73,135,60,1
232724,23,3,20,1,4
232724,23,3,20,2,1
232724,23,3,20,3,1
232724,23,3,20,5,1
232724,23,3,20,20,1
232724,23,3,20,21,4
232724,23,3,20,22,1
232724,23,3,20,23,1
232724,23,3,20,25,1
232724,23,3,20,40,1
232788,2924,1189,1735,1,4
232788,2924,1189,1735,2,1
232788,1899,739,1160,3,1
232788,508,232,276,4,1
232788,1391,507,884,5,1
232788,1025,450,575,11,1
232788,54,25,29,19,1
232788,1337,482,855,20,1
232788,1310,541,769,21,4
232788,1310,541,769,22,1
232788,1200,504,696,23,1
232788,422,194,228,24,1
232788,778,310,468,25,1
232788,110,37,73,31,1
232788,26,13,13,39,1
232788,752,297,455,40,1
232788,1614,648,966,41,4
232788,1614,648,966,42,1
232788,699,235,464,43,1
232788,86,38,48,44,1
232788,613,197,416,45,1
232788,915,413,502,51,1
232788,28,12,16,59,1
232788,585,185,400,60,1
232797,1857,434,1423,1,4
232797,1821,423,1398,2,1
232797,1804,423,1381,3,1
232797,106,25,81,4,1
232797,1698,398,1300,5,1
232797,17,0,17,11,1
232797,36,11,25,12,3
232797,232,53,179,19,1
232797,1466,345,1121,20,1
232797,1088,258,830,21,4
232797,1066,250,816,22,1
232797,1066,250,816,23,1
232797,75,18,57,24,1
232797,991,232,759,25,1
232797,22,8,14,32,3
232797,165,38,127,39,1
232797,826,194,632,40,1
232797,769,176,593,41,4
232797,755,173,582,42,1
232797,738,173,565,43,1
232797,31,7,24,44,1
232797,707,166,541,45,1
232797,17,0,17,51,1
232797,14,3,11,52,3
232797,67,15,52,59,1
232797,640,151,489,60,1
232867,4808,2386,2422,1,4
232867,4808,2386,2422,2,1
232867,2885,1390,1495,3,1
232867,688,345,343,4,1
232867,2197,1045,1152,5,1
232867,1923,996,927,11,1
232867,304,158,146,19,1
232867,1893,887,1006,20,1
232867,1887,926,961,21,4
232867,1887,926,961,22,1
232867,1596,789,807,23,1
232867,477,249,228,24,1
232867,1119,540,579,25,1
232867,291,137,154,31,1
232867,187,103,84,39,1
232867,932,437,495,40,1
232867,2921,1460,1461,41,4
232867,2921,1460,1461,42,1
232867,1289,601,688,43,1
232867,211,96,115,44,1
232867,1078,505,573,45,1
232867,1632,859,773,51,1
232867,117,55,62,59,1
232867,961,450,511,60,1
232885,360,26,334,1,4
232885,360,26,334,2,1
232885,285,18,267,3,1
232885,285,18,267,5,1
232885,75,8,67,11,1
232885,21,1,20,19,1
232885,264,17,247,20,1
232885,283,20,263,21,4
232885,283,20,263,22,1
232885,208,12,196,23,1
232885,208,12,196,25,1
232885,75,8,67,31,1
232885,10,0,10,39,1
232885,198,12,186,40,1
232885,77,6,71,41,4
232885,77,6,71,42,1
232885,77,6,71,43,1
232885,77,6,71,45,1
232885,11,1,10,59,1
232885,66,5,61,60,1
232919,310,298,12,1,4
232919,310,298,12,2,1
232919,310,298,12,3,1
232919,118,115,3,4,1
232919,192,183,9,5,1
232919,192,183,9,20,1
232919,260,250,10,21,4
232919,260,250,10,22,1
232919,260,250,10,23,1
232919,95,92,3,24,1
232919,165,158,7,25,1
232919,165,158,7,40,1
232919,50,48,2,41,4
232919,50,48,2,42,1
232919,50,48,2,43,1
232919,23,23,0,44,1
232919,27,25,2,45,1
232919,27,25,2,60,1
232937,6728,2365,4363,1,4
232937,6021,2159,3862,2,1
232937,5955,2122,3833,3,1
232937,820,318,502,4,1
232937,5135,1804,3331,5,1
232937,66,37,29,11,1
232937,707,206,501,12,3
232937,542,175,367,19,1
232937,4593,1629,2964,20,1
232937,5428,1981,3447,21,4
232937,4979,1855,3124,22,1
232937,4963,1846,3117,23,1
232937,797,309,488,24,1
232937,4166,1537,2629,25,1
232937,16,9,7,31,1
232937,449,126,323,32,3
232937,426,150,276,39,1
232937,3740,1387,2353,40,1
232937,1300,384,916,41,4
232937,1042,304,738,42,1
232937,992,276,716,43,1
232937,23,9,14,44,1
232937,969,267,702,45,1
232937,50,28,22,51,1
232937,258,80,178,52,3
232937,116,25,91,59,1
232937,853,242,611,60,1
232946,51803,25260,26543,1,4
232946,51803,25260,26543,2,1
232946,44592,21715,22877,3,1
232946,9128,4740,4388,4,1
232946,35464,16975,18489,5,1
232946,7211,3545,3666,11,1
232946,2666,1227,1439,19,1
232946,32798,15748,17050,20,1
232946,19700,10114,9586,21,4
232946,19700,10114,9586,22,1
232946,19070,9764,9306,23,1
232946,5819,3064,2755,24,1
232946,13251,6700,6551,25,1
232946,630,350,280,31,1
232946,1057,526,531,39,1
232946,12194,6174,6020,40,1
232946,32103,15146,16957,41,4
232946,32103,15146,16957,42,1
232946,25522,11951,13571,43,1
232946,3309,1676,1633,44,1
232946,22213,10275,11938,45,1
232946,6581,3195,3386,51,1
232946,1609,701,908,59,1
232946,20604,9574,11030,60,1
232982,24828,11199,13629,1,4
232982,19819,9117,10702,2,1
232982,19483,8958,10525,3,1
232982,2942,1432,1510,4,1
232982,16541,7526,9015,5,1
232982,336,159,177,11,1
232982,5009,2082,2927,12,3
232982,2105,874,1231,19,1
232982,14436,6652,7784,20,1
232982,16957,7822,9135,21,4
232982,15102,7106,7996,22,1
232982,15050,7079,7971,23,1
232982,2908,1415,1493,24,1
232982,12142,5664,6478,25,1
232982,52,27,25,31,1
232982,1855,716,1139,32,3
232982,1489,638,851,39,1
232982,10653,5026,5627,40,1
232982,7871,3377,4494,41,4
232982,4717,2011,2706,42,1
232982,4433,1879,2554,43,1
232982,34,17,17,44,1
232982,4399,1862,2537,45,1
232982,284,132,152,51,1
232982,3154,1366,1788,52,3
232982,616,236,380,59,1
232982,3783,1626,2157,60,1
233019,3163,1279,1884,1,4
233019,3163,1279,1884,2,1
233019,2325,896,1429,3,1
233019,707,310,397,4,1
233019,1618,586,1032,5,1
233019,838,383,455,11,1
233019,131,51,80,19,1
233019,1487,535,952,20,1
233019,1486,623,863,21,4
233019,1486,623,863,22,1
233019,1377,580,797,23,1
233019,542,247,295,24,1
233019,835,333,502,25,1
233019,109,43,66,31,1
233019,70,34,36,39,1
233019,765,299,466,40,1
233019,1677,656,1021,41,4
233019,1677,656,1021,42,1
233019,948,316,632,43,1
233019,165,63,102,44,1
233019,783,253,530,45,1
233019,729,340,389,51,1
233019,61,17,44,59,1
233019,722,236,486,60,1
233037,1392,450,942,1,4
233037,1392,450,942,2,1
233037,892,256,636,3,1
233037,198,67,131,4,1
233037,694,189,505,5,1
233037,500,194,306,11,1
233037,90,26,64,19,1
233037,604,163,441,20,1
233037,435,148,287,21,4
233037,435,148,287,22,1
233037,395,134,261,23,1
233037,120,41,79,24,1
233037,275,93,182,25,1
233037,40,14,26,31,1
233037,35,11,24,39,1
233037,240,82,158,40,1
233037,957,302,655,41,4
233037,957,302,655,42,1
233037,497,122,375,43,1
233037,78,26,52,44,1
233037,419,96,323,45,1
233037,460,180,280,51,1
233037,55,15,40,59,1
233037,364,81,283,60,1
233082,63,11,52,1,4
233082,63,11,52,2,1
233082,63,11,52,3,1
233082,15,4,11,4,1
233082,48,7,41,5,1
233082,48,7,41,20,1
233082,33,6,27,21,4
233082,33,6,27,22,1
233082,33,6,27,23,1
233082,9,3,6,24,1
233082,24,3,21,25,1
233082,24,3,21,40,1
233082,30,5,25,41,4
233082,30,5,25,42,1
233082,30,5,25,43,1
233082,6,1,5,44,1
233082,24,4,20,45,1
233082,24,4,20,60,1
233091,472,88,384,1,4
233091,472,88,384,2,1
233091,472,88,384,3,1
233091,112,24,88,4,1
233091,360,64,296,5,1
233091,72,10,62,19,1
233091,288,54,234,20,1
233091,305,65,240,21,4
233091,305,65,240,22,1
233091,305,65,240,23,1
233091,88,20,68,24,1
233091,217,45,172,25,1
233091,54,8,46,39,1
233091,163,37,126,40,1
233091,167,23,144,41,4
233091,167,23,144,42,1
233091,167,23,144,43,1
233091,24,4,20,44,1
233091,143,19,124,45,1
233091,18,2,16,59,1
233091,125,17,108,60,1
233116,5630,2323,3307,1,4
233116,5630,2323,3307,2,1
233116,3813,1519,2294,3,1
233116,765,371,394,4,1
233116,3048,1148,1900,5,1
233116,1817,804,1013,11,1
233116,327,143,184,19,1
233116,2721,1005,1716,20,1
233116,1208,579,629,21,4
233116,1208,579,629,22,1
233116,1093,523,570,23,1
233116,349,171,178,24,1
233116,744,352,392,25,1
233116,115,56,59,31,1
233116,116,60,56,39,1
233116,628,292,336,40,1
233116,4422,1744,2678,41,4
233116,4422,1744,2678,42,1
233116,2720,996,1724,43,1
233116,416,200,216,44,1
233116,2304,796,1508,45,1
233116,1702,748,954,51,1
233116,211,83,128,59,1
233116,2093,713,1380,60,1
233277,9928,4207,5721,1,4
233277,8913,3941,4972,2,1
233277,8866,3918,4948,3,1
233277,1986,860,1126,4,1
233277,6880,3058,3822,5,1
233277,47,23,24,11,1
233277,1015,266,749,12,3
233277,770,402,368,19,1
233277,6110,2656,3454,20,1
233277,9166,3930,5236,21,4
233277,8545,3771,4774,22,1
233277,8524,3763,4761,23,1
233277,1986,860,1126,24,1
233277,6538,2903,3635,25,1
233277,21,8,13,31,1
233277,621,159,462,32,3
233277,714,373,341,39,1
233277,5824,2530,3294,40,1
233277,762,277,485,41,4
233277,368,170,198,42,1
233277,342,155,187,43,1
233277,342,155,187,45,1
233277,26,15,11,51,1
233277,394,107,287,52,3
233277,56,29,27,59,1
233277,286,126,160,60,1
233286,80,2,78,1,4
233286,80,2,78,2,1
233286,80,2,78,3,1
233286,34,0,34,4,1
233286,46,2,44,5,1
233286,46,2,44,20,1
233286,80,2,78,21,4
233286,80,2,78,22,1
233286,80,2,78,23,1
233286,34,0,34,24,1
233286,46,2,44,25,1
233286,46,2,44,40,1
233295,1315,623,692,1,4
233295,1315,623,692,2,1
233295,1294,619,675,3,1
233295,382,196,186,4,1
233295,912,423,489,5,1
233295,21,4,17,11,1
233295,28,12,16,19,1
233295,884,411,473,20,1
233295,1295,615,680,21,4
233295,1295,615,680,22,1
233295,1286,613,673,23,1
233295,382,196,186,24,1
233295,904,417,487,25,1
233295,9,2,7,31,1
233295,28,12,16,39,1
233295,876,405,471,40,1
233295,20,8,12,41,4
233295,20,8,12,42,1
233295,8,6,2,43,1
233295,8,6,2,45,1
233295,12,2,10,51,1
233295,8,6,2,60,1
233301,682,243,439,1,4
233301,665,238,427,2,1
233301,651,232,419,3,1
233301,216,72,144,4,1
233301,435,160,275,5,1
233301,14,6,8,11,1
233301,17,5,12,12,3
233301,24,11,13,19,1
233301,411,149,262,20,1
233301,663,234,429,21,4
233301,649,229,420,22,1
233301,645,229,416,23,1
233301,216,72,144,24,1
233301,429,157,272,25,1
233301,4,0,4,31,1
233301,14,5,9,32,3
233301,24,11,13,39,1
233301,405,146,259,40,1
233301,19,9,10,41,4
233301,16,9,7,42,1
233301,6,3,3,43,1
233301,6,3,3,45,1
233301,10,6,4,51,1
233301,3,0,3,52,3
233301,6,3,3,60,1
233310,3555,1357,2198,1,4
233310,3555,1357,2198,2,1
233310,1604,521,1083,3,1
233310,413,188,225,4,1
233310,1191,333,858,5,1
233310,1951,836,1115,11,1
233310,97,27,70,19,1
233310,1094,306,788,20,1
233310,832,332,500,21,4
233310,832,332,500,22,1
233310,585,221,364,23,1
233310,222,107,115,24,1
233310,363,114,249,25,1
233310,247,111,136,31,1
233310,27,5,22,39,1
233310,336,109,227,40,1
233310,2723,1025,1698,41,4
233310,2723,1025,1698,42,1
233310,1019,300,719,43,1
233310,191,81,110,44,1
233310,828,219,609,45,1
233310,1704,725,979,51,1
233310,70,22,48,59,1
233310,758,197,561,60,1
233329,291,22,269,1,4
233329,291,22,269,2,1
233329,291,22,269,3,1
233329,87,4,83,4,1
233329,204,18,186,5,1
233329,13,1,12,19,1
233329,191,17,174,20,1
233329,291,22,269,21,4
233329,291,22,269,22,1
233329,291,22,269,23,1
233329,87,4,83,24,1
233329,204,18,186,25,1
233329,13,1,12,39,1
233329,191,17,174,40,1
233338,1428,478,950,1,4
233338,1428,478,950,2,1
233338,1078,367,711,3,1
233338,425,161,264,4,1
233338,653,206,447,5,1
233338,350,111,239,11,1
233338,57,21,36,19,1
233338,596,185,411,20,1
233338,895,317,578,21,4
233338,895,317,578,22,1
233338,881,312,569,23,1
233338,410,155,255,24,1
233338,471,157,314,25,1
233338,14,5,9,31,1
233338,36,17,19,39,1
233338,435,140,295,40,1
233338,533,161,372,41,4
233338,533,161,372,42,1
233338,197,55,142,43,1
233338,15,6,9,44,1
233338,182,49,133,45,1
233338,336,106,230,51,1
233338,21,4,17,59,1
233338,161,45,116,60,1
233356,408,26,382,1,4
233356,408,26,382,2,1
233356,408,26,382,3,1
233356,4,0,4,4,1
233356,404,26,378,5,1
233356,404,26,378,20,1
233356,207,13,194,21,4
233356,207,13,194,22,1
233356,207,13,194,23,1
233356,4,0,4,24,1
233356,203,13,190,25,1
233356,203,13,190,40,1
233356,201,13,188,41,4
233356,201,13,188,42,1
233356,201,13,188,43,1
233356,201,13,188,45,1
233356,201,13,188,60,1
233374,4140,1896,2244,1,4
233374,3215,1512,1703,2,1
233374,3107,1463,1644,3,1
233374,807,393,414,4,1
233374,2300,1070,1230,5,1
233374,108,49,59,11,1
233374,925,384,541,12,3
233374,101,42,59,19,1
233374,2199,1028,1171,20,1
233374,3554,1695,1859,21,4
233374,3010,1419,1591,22,1
233374,2930,1383,1547,23,1
233374,805,391,414,24,1
233374,2125,992,1133,25,1
233374,80,36,44,31,1
233374,544,276,268,32,3
233374,81,34,47,39,1
233374,2044,958,1086,40,1
233374,586,201,385,41,4
233374,205,93,112,42,1
233374,177,80,97,43,1
233374,2,2,0,44,1
233374,175,78,97,45,1
233374,28,13,15,51,1
233374,381,108,273,52,3
233374,20,8,12,59,1
233374,155,70,85,60,1
233408,305,28,277,1,4
233408,305,28,277,2,1
233408,305,28,277,3,1
233408,7,2,5,4,1
233408,298,26,272,5,1
233408,298,26,272,20,1
233408,291,23,268,21,4
233408,291,23,268,22,1
233408,291,23,268,23,1
233408,7,2,5,24,1
233408,284,21,263,25,1
233408,284,21,263,40,1
233408,14,5,9,41,4
233408,14,5,9,42,1
233408,14,5,9,43,1
233408,14,5,9,45,1
233408,14,5,9,60,1
233426,2029,841,1188,1,4
233426,2029,841,1188,2,1
233426,1980,819,1161,3,1
233426,542,222,320,4,1
233426,1438,597,841,5,1
233426,49,22,27,11,1
233426,74,39,35,19,1
233426,1364,558,806,20,1
233426,1964,806,1158,21,4
233426,1964,806,1158,22,1
233426,1940,797,1143,23,1
233426,542,222,320,24,1
233426,1398,575,823,25,1
233426,24,9,15,31,1
233426,73,39,34,39,1
233426,1325,536,789,40,1
233426,65,35,30,41,4
233426,65,35,30,42,1
233426,40,22,18,43,1
233426,40,22,18,45,1
233426,25,13,12,51,1
233426,1,0,1,59,1
233426,39,22,17,60,1
233480,28,4,24,1,4
233480,28,4,24,2,1
233480,28,4,24,3,1
233480,28,4,24,5,1
233480,28,4,24,20,1
233480,28,4,24,21,4
233480,28,4,24,22,1
233480,28,4,24,23,1
233480,28,4,24,25,1
233480,28,4,24,40,1
233541,4003,1381,2622,1,4
233541,2150,848,1302,2,1
233541,1859,803,1056,3,1
233541,418,189,229,4,1
233541,1441,614,827,5,1
233541,291,45,246,11,1
233541,1853,533,1320,12,3
233541,130,59,71,19,1
233541,1311,555,756,20,1
233541,2683,1042,1641,21,4
233541,1791,771,1020,22,1
233541,1790,771,1019,23,1
233541,418,189,229,24,1
233541,1372,582,790,25,1
233541,1,0,1,31,1
233541,892,271,621,32,3
233541,119,51,68,39,1
233541,1253,531,722,40,1
233541,1320,339,981,41,4
233541,359,77,282,42,1
233541,69,32,37,43,1
233541,69,32,37,45,1
233541,290,45,245,51,1
233541,961,262,699,52,3
233541,11,8,3,59,1
233541,58,24,34,60,1
233611,662,309,353,1,4
233611,662,309,353,2,1
233611,658,308,350,3,1
233611,224,90,134,4,1
233611,434,218,216,5,1
233611,4,1,3,11,1
233611,65,36,29,19,1
233611,369,182,187,20,1
233611,636,299,337,21,4
233611,636,299,337,22,1
233611,635,298,337,23,1
233611,224,90,134,24,1
233611,411,208,203,25,1
233611,1,1,0,31,1
233611,62,33,29,39,1
233611,349,175,174,40,1
233611,26,10,16,41,4
233611,26,10,16,42,1
233611,23,10,13,43,1
233611,23,10,13,45,1
233611,3,0,3,51,1
233611,3,3,0,59,1
233611,20,7,13,60,1
233639,5784,2170,3614,1,4
233639,5784,2170,3614,2,1
233639,2773,844,1929,3,1
233639,637,266,371,4,1
233639,2136,578,1558,5,1
233639,3011,1326,1685,11,1
233639,113,51,62,19,1
233639,2023,527,1496,20,1
233639,1852,693,1159,21,4
233639,1852,693,1159,22,1
233639,1204,417,787,23,1
233639,411,177,234,24,1
233639,793,240,553,25,1
233639,648,276,372,31,1
233639,58,29,29,39,1
233639,735,211,524,40,1
233639,3932,1477,2455,41,4
233639,3932,1477,2455,42,1
233639,1569,427,1142,43,1
233639,226,89,137,44,1
233639,1343,338,1005,45,1
233639,2363,1050,1313,51,1
233639,55,22,33,59,1
233639,1288,316,972,60,1
233648,2630,1092,1538,1,4
233648,2630,1092,1538,2,1
233648,1794,725,1069,3,1
233648,525,244,281,4,1
233648,1269,481,788,5,1
233648,836,367,469,11,1
233648,93,40,53,19,1
233648,1176,441,735,20,1
233648,1154,500,654,21,4
233648,1154,500,654,22,1
233648,1071,462,609,23,1
233648,437,204,233,24,1
233648,634,258,376,25,1
233648,83,38,45,31,1
233648,29,14,15,39,1
233648,605,244,361,40,1
233648,1476,592,884,41,4
233648,1476,592,884,42,1
233648,723,263,460,43,1
233648,88,40,48,44,1
233648,635,223,412,45,1
233648,753,329,424,51,1
233648,64,26,38,59,1
233648,571,197,374,60,1
233657,79,1,78,1,4
233657,79,1,78,2,1
233657,79,1,78,3,1
233657,25,0,25,4,1
233657,54,1,53,5,1
233657,54,1,53,20,1
233657,45,0,45,21,4
233657,45,0,45,22,1
233657,45,0,45,23,1
233657,18,0,18,24,1
233657,27,0,27,25,1
233657,27,0,27,40,1
233657,34,1,33,41,4
233657,34,1,33,42,1
233657,34,1,33,43,1
233657,7,0,7,44,1
233657,27,1,26,45,1
233657,27,1,26,60,1
233666,32,0,32,1,4
233666,32,0,32,2,1
233666,32,0,32,3,1
233666,30,0,30,4,1
233666,2,0,2,5,1
233666,2,0,2,20,1
233666,23,0,23,21,4
233666,23,0,23,22,1
233666,23,0,23,23,1
233666,22,0,22,24,1
233666,1,0,1,25,1
233666,1,0,1,40,1
233666,9,0,9,41,4
233666,9,0,9,42,1
233666,9,0,9,43,1
233666,8,0,8,44,1
233666,1,0,1,45,1
233666,1,0,1,60,1
233684,7649,3539,4110,1,4
233684,4943,2404,2539,2,1
233684,4837,2344,2493,3,1
233684,306,150,156,4,1
233684,4531,2194,2337,5,1
233684,106,60,46,11,1
233684,2706,1135,1571,12,3
233684,450,215,235,19,1
233684,4081,1979,2102,20,1
233684,1903,1182,721,21,4
233684,1229,828,401,22,1
233684,1224,825,399,23,1
233684,73,56,17,24,1
233684,1151,769,382,25,1
233684,5,3,2,31,1
233684,674,354,320,32,3
233684,159,100,59,39,1
233684,992,669,323,40,1
233684,5746,2357,3389,41,4
233684,3714,1576,2138,42,1
233684,3613,1519,2094,43,1
233684,233,94,139,44,1
233684,3380,1425,1955,45,1
233684,101,57,44,51,1
233684,2032,781,1251,52,3
233684,291,115,176,59,1
233684,3089,1310,1779,60,1
233718,710,16,694,1,4
233718,703,16,687,2,1
233718,599,0,599,3,1
233718,197,0,197,4,1
233718,402,0,402,5,1
233718,104,16,88,11,1
233718,7,0,7,12,3
233718,11,0,11,19,1
233718,391,0,391,20,1
233718,687,12,675,21,4
233718,680,12,668,22,1
233718,594,0,594,23,1
233718,197,0,197,24,1
233718,397,0,397,25,1
233718,86,12,74,31,1
233718,7,0,7,32,3
233718,11,0,11,39,1
233718,386,0,386,40,1
233718,23,4,19,41,4
233718,23,4,19,42,1
233718,5,0,5,43,1
233718,5,0,5,45,1
233718,18,4,14,51,1
233718,5,0,5,60,1
233754,11033,4394,6639,1,4
233754,11033,4394,6639,2,1
233754,9097,3515,5582,3,1
233754,1802,813,989,4,1
233754,7295,2702,4593,5,1
233754,1936,879,1057,11,1
233754,799,300,499,19,1
233754,6496,2402,4094,20,1
233754,3565,1525,2040,21,4
233754,3565,1525,2040,22,1
233754,3406,1423,1983,23,1
233754,935,434,501,24,1
233754,2471,989,1482,25,1
233754,159,102,57,31,1
233754,296,114,182,39,1
233754,2175,875,1300,40,1
233754,7468,2869,4599,41,4
233754,7468,2869,4599,42,1
233754,5691,2092,3599,43,1
233754,867,379,488,44,1
233754,4824,1713,3111,45,1
233754,1777,777,1000,51,1
233754,503,186,317,59,1
233754,4321,1527,2794,60,1
233772,28999,11837,17162,1,4
233772,28999,11837,17162,2,1
233772,25981,10654,15327,3,1
233772,5418,2525,2893,4,1
233772,20563,8129,12434,5,1
233772,3018,1183,1835,11,1
233772,1962,727,1235,19,1
233772,18601,7402,11199,20,1
233772,11500,4999,6501,21,4
233772,11500,4999,6501,22,1
233772,11198,4855,6343,23,1
233772,3033,1439,1594,24,1
233772,8165,3416,4749,25,1
233772,302,144,158,31,1
233772,831,345,486,39,1
233772,7334,3071,4263,40,1
233772,17499,6838,10661,41,4
233772,17499,6838,10661,42,1
233772,14783,5799,8984,43,1
233772,2385,1086,1299,44,1
233772,12398,4713,7685,45,1
233772,2716,1039,1677,51,1
233772,1131,382,749,59,1
233772,11267,4331,6936,60,1
233842,205,94,111,1,4
233842,205,94,111,12,3
233842,112,58,54,21,4
233842,112,58,54,32,3
233842,93,36,57,41,4
233842,93,36,57,52,3
233897,2291,954,1337,1,4
233897,2291,954,1337,2,1
233897,1585,799,786,3,1
233897,335,174,161,4,1
233897,1250,625,625,5,1
233897,706,155,551,11,1
233897,123,56,67,19,1
233897,1127,569,558,20,1
233897,1471,742,729,21,4
233897,1471,742,729,22,1
233897,1453,731,722,23,1
233897,332,171,161,24,1
233897,1121,560,561,25,1
233897,18,11,7,31,1
233897,106,50,56,39,1
233897,1015,510,505,40,1
233897,820,212,608,41,4
233897,820,212,608,42,1
233897,132,68,64,43,1
233897,3,3,0,44,1
233897,129,65,64,45,1
233897,688,144,544,51,1
233897,17,6,11,59,1
233897,112,59,53,60,1
233903,2484,1027,1457,1,4
233903,2484,1027,1457,2,1
233903,1689,674,1015,3,1
233903,411,174,237,4,1
233903,1278,500,778,5,1
233903,795,353,442,11,1
233903,107,45,62,19,1
233903,1171,455,716,20,1
233903,1061,470,591,21,4
233903,1061,470,591,22,1
233903,962,426,536,23,1
233903,329,143,186,24,1
233903,633,283,350,25,1
233903,99,44,55,31,1
233903,54,19,35,39,1
233903,579,264,315,40,1
233903,1423,557,866,41,4
233903,1423,557,866,42,1
233903,727,248,479,43,1
233903,82,31,51,44,1
233903,645,217,428,45,1
233903,696,309,387,51,1
233903,53,26,27,59,1
233903,592,191,401,60,1
233912,378,128,250,1,4
233912,378,128,250,2,1
233912,352,120,232,3,1
233912,46,14,32,4,1
233912,306,106,200,5,1
233912,26,8,18,11,1
233912,40,17,23,19,1
233912,266,89,177,20,1
233912,333,116,217,21,4
233912,333,116,217,22,1
233912,329,115,214,23,1
233912,45,14,31,24,1
233912,284,101,183,25,1
233912,4,1,3,31,1
233912,38,17,21,39,1
233912,246,84,162,40,1
233912,45,12,33,41,4
233912,45,12,33,42,1
233912,23,5,18,43,1
233912,1,0,1,44,1
233912,22,5,17,45,1
233912,22,7,15,51,1
233912,2,0,2,59,1
233912,20,5,15,60,1
233921,31205,18094,13111,1,4
233921,24034,14101,9933,2,1
233921,23928,14035,9893,3,1
233921,5364,3008,2356,4,1
233921,18564,11027,7537,5,1
233921,106,66,40,11,1
233921,7171,3993,3178,12,3
233921,995,677,318,19,1
233921,17569,10350,7219,20,1
233921,28425,16521,11904,21,4
233921,23512,13756,9756,22,1
233921,23441,13710,9731,23,1
233921,5360,3008,2352,24,1
233921,18081,10702,7379,25,1
233921,71,46,25,31,1
233921,4913,2765,2148,32,3
233921,971,659,312,39,1
233921,17110,10043,7067,40,1
233921,2780,1573,1207,41,4
233921,522,345,177,42,1
233921,487,325,162,43,1
233921,4,0,4,44,1
233921,483,325,158,45,1
233921,35,20,15,51,1
233921,2258,1228,1030,52,3
233921,24,18,6,59,1
233921,459,307,152,60,1
233949,8654,3906,4748,1,4
233949,8654,3906,4748,2,1
233949,5505,2428,3077,3,1
233949,1435,675,760,4,1
233949,4070,1753,2317,5,1
233949,3149,1478,1671,11,1
233949,322,126,196,19,1
233949,3748,1627,2121,20,1
233949,2688,1256,1432,21,4
233949,2688,1256,1432,22,1
233949,2628,1219,1409,23,1
233949,1056,499,557,24,1
233949,1572,720,852,25,1
233949,60,37,23,31,1
233949,148,60,88,39,1
233949,1424,660,764,40,1
233949,5966,2650,3316,41,4
233949,5966,2650,3316,42,1
233949,2877,1209,1668,43,1
233949,379,176,203,44,1
233949,2498,1033,1465,45,1
233949,3089,1441,1648,51,1
233949,174,66,108,59,1
233949,2324,967,1357,60,1
234030,30974,13091,17883,1,4
234030,23356,10155,13201,2,1
234030,22049,9534,12515,3,1
234030,3526,1447,2079,4,1
234030,18523,8087,10436,5,1
234030,1307,621,686,11,1
234030,7618,2936,4682,12,3
234030,2093,885,1208,19,1
234030,16430,7202,9228,20,1
234030,24803,10679,14124,21,4
234030,19746,8621,11125,22,1
234030,19444,8400,11044,23,1
234030,3513,1444,2069,24,1
234030,15931,6956,8975,25,1
234030,302,221,81,31,1
234030,5057,2058,2999,32,3
234030,1790,796,994,39,1
234030,14141,6160,7981,40,1
234030,6171,2412,3759,41,4
234030,3610,1534,2076,42,1
234030,2605,1134,1471,43,1
234030,13,3,10,44,1
234030,2592,1131,1461,45,1
234030,1005,400,605,51,1
234030,2561,878,1683,52,3
234030,303,89,214,59,1
234030,2289,1042,1247,60,1
234076,23464,10754,12710,1,4
234076,16087,7142,8945,2,1
234076,15020,6833,8187,3,1
234076,3534,1566,1968,4,1
234076,11486,5267,6219,5,1
234076,1067,309,758,11,1
234076,7377,3612,3765,12,3
234076,671,337,334,19,1
234076,10815,4930,5885,20,1
234076,21086,9973,11113,21,4
234076,15089,6767,8322,22,1
234076,14444,6586,7858,23,1
234076,3516,1556,1960,24,1
234076,10928,5030,5898,25,1
234076,645,181,464,31,1
234076,5997,3206,2791,32,3
234076,570,296,274,39,1
234076,10358,4734,5624,40,1
234076,2378,781,1597,41,4
234076,998,375,623,42,1
234076,576,247,329,43,1
234076,18,10,8,44,1
234076,558,237,321,45,1
234076,422,128,294,51,1
234076,1380,406,974,52,3
234076,101,41,60,59,1
234076,457,196,261,60,1
234085,1675,1499,176,1,4
234085,1675,1499,176,2,1
234085,1675,1499,176,3,1
234085,421,378,43,4,1
234085,1254,1121,133,5,1
234085,45,35,10,19,1
234085,1209,1086,123,20,1
234085,1675,1499,176,21,4
234085,1675,1499,176,22,1
234085,1675,1499,176,23,1
234085,421,378,43,24,1
234085,1254,1121,133,25,1
234085,45,35,10,39,1
234085,1209,1086,123,40,1
234119,89,25,64,1,4
234119,89,25,64,2,1
234119,89,25,64,3,1
234119,72,22,50,4,1
234119,17,3,14,5,1
234119,17,3,14,20,1
234119,40,9,31,21,4
234119,40,9,31,22,1
234119,40,9,31,23,1
234119,35,8,27,24,1
234119,5,1,4,25,1
234119,5,1,4,40,1
234119,49,16,33,41,4
234119,49,16,33,42,1
234119,49,16,33,43,1
234119,37,14,23,44,1
234119,12,2,10,45,1
234119,12,2,10,60,1
234137,582,287,295,1,4
234137,493,241,252,2,1
234137,493,241,252,3,1
234137,126,68,58,4,1
234137,367,173,194,5,1
234137,89,46,43,12,3
234137,367,173,194,20,1
234137,326,209,117,21,4
234137,259,171,88,22,1
234137,259,171,88,23,1
234137,95,63,32,24,1
234137,164,108,56,25,1
234137,67,38,29,32,3
234137,164,108,56,40,1
234137,256,78,178,41,4
234137,234,70,164,42,1
234137,234,70,164,43,1
234137,31,5,26,44,1
234137,203,65,138,45,1
234137,22,8,14,52,3
234137,203,65,138,60,1
234155,5763,2317,3446,1,4
234155,5073,2033,3040,2,1
234155,5023,2007,3016,3,1
234155,1137,445,692,4,1
234155,3886,1562,2324,5,1
234155,50,26,24,11,1
234155,690,284,406,12,3
234155,372,153,219,19,1
234155,3514,1409,2105,20,1
234155,5164,2066,3098,21,4
234155,4817,1927,2890,22,1
234155,4812,1923,2889,23,1
234155,1136,444,692,24,1
234155,3676,1479,2197,25,1
234155,5,4,1,31,1
234155,347,139,208,32,3
234155,336,142,194,39,1
234155,3340,1337,2003,40,1
234155,599,251,348,41,4
234155,256,106,150,42,1
234155,211,84,127,43,1
234155,1,1,0,44,1
234155,210,83,127,45,1
234155,45,22,23,51,1
234155,343,145,198,52,3
234155,36,11,25,59,1
234155,174,72,102,60,1
234164,1749,806,943,1,4
234164,1359,611,748,2,1
234164,1359,611,748,3,1
234164,404,179,225,4,1
234164,955,432,523,5,1
234164,390,195,195,12,3
234164,83,48,35,19,1
234164,872,384,488,20,1
234164,1700,783,917,21,4
234164,1329,595,734,22,1
234164,1329,595,734,23,1
234164,402,177,225,24,1
234164,927,418,509,25,1
234164,371,188,183,32,3
234164,80,48,32,39,1
234164,847,370,477,40,1
234164,49,23,26,41,4
234164,30,16,14,42,1
234164,30,16,14,43,1
234164,2,2,0,44,1
234164,28,14,14,45,1
234164,19,7,12,52,3
234164,3,0,3,59,1
234164,25,14,11,60,1
234173,1459,562,897,1,4
234173,1459,562,897,2,1
234173,1436,554,882,3,1
234173,453,183,270,4,1
234173,983,371,612,5,1
234173,23,8,15,11,1
234173,63,28,35,19,1
234173,920,343,577,20,1
234173,1349,532,817,21,4
234173,1349,532,817,22,1
234173,1346,530,816,23,1
234173,453,183,270,24,1
234173,893,347,546,25,1
234173,3,2,1,31,1
234173,59,26,33,39,1
234173,834,321,513,40,1
234173,110,30,80,41,4
234173,110,30,80,42,1
234173,90,24,66,43,1
234173,90,24,66,45,1
234173,20,6,14,51,1
234173,4,2,2,59,1
234173,86,22,64,60,1
234191,152,54,98,1,4
234191,152,54,98,2,1
234191,152,54,98,3,1
234191,18,5,13,4,1
234191,134,49,85,5,1
234191,134,49,85,20,1
234191,152,54,98,21,4
234191,152,54,98,22,1
234191,152,54,98,23,1
234191,18,5,13,24,1
234191,134,49,85,25,1
234191,134,49,85,40,1
234207,2277,1155,1122,1,4
234207,1855,936,919,2,1
234207,1846,934,912,3,1
234207,480,245,235,4,1
234207,1366,689,677,5,1
234207,9,2,7,11,1
234207,422,219,203,12,3
234207,1366,689,677,20,1
234207,2273,1153,1120,21,4
234207,1851,934,917,22,1
234207,1844,933,911,23,1
234207,480,245,235,24,1
234207,1364,688,676,25,1
234207,7,1,6,31,1
234207,422,219,203,32,3
234207,1364,688,676,40,1
234207,4,2,2,41,4
234207,4,2,2,42,1
234207,2,1,1,43,1
234207,2,1,1,45,1
234207,2,1,1,51,1
234207,2,1,1,60,1
234216,231,49,182,1,4
234216,231,49,182,2,1
234216,231,49,182,3,1
234216,231,49,182,5,1
234216,231,49,182,20,1
234216,194,44,150,21,4
234216,194,44,150,22,1
234216,194,44,150,23,1
234216,194,44,150,25,1
234216,194,44,150,40,1
234216,37,5,32,41,4
234216,37,5,32,42,1
234216,37,5,32,43,1
234216,37,5,32,45,1
234216,37,5,32,60,1
234225,81,43,38,1,4
234225,81,43,38,2,1
234225,81,43,38,3,1
234225,56,37,19,4,1
234225,25,6,19,5,1
234225,25,6,19,20,1
234225,81,43,38,21,4
234225,81,43,38,22,1
234225,81,43,38,23,1
234225,56,37,19,24,1
234225,25,6,19,25,1
234225,25,6,19,40,1
234359,164,115,49,1,4
234359,164,115,49,2,1
234359,164,115,49,3,1
234359,51,34,17,4,1
234359,113,81,32,5,1
234359,113,81,32,20,1
234359,164,115,49,21,4
234359,164,115,49,22,1
234359,164,115,49,23,1
234359,51,34,17,24,1
234359,113,81,32,25,1
234359,113,81,32,40,1
234377,3468,1265,2203,1,4
234377,3468,1265,2203,2,1
234377,2076,663,1413,3,1
234377,588,268,320,4,1
234377,1488,395,1093,5,1
234377,1392,602,790,11,1
234377,127,34,93,19,1
234377,1361,361,1000,20,1
234377,1209,466,743,21,4
234377,1209,466,743,22,1
234377,1109,438,671,23,1
234377,442,214,228,24,1
234377,667,224,443,25,1
234377,100,28,72,31,1
234377,61,18,43,39,1
234377,606,206,400,40,1
234377,2259,799,1460,41,4
234377,2259,799,1460,42,1
234377,967,225,742,43,1
234377,146,54,92,44,1
234377,821,171,650,45,1
234377,1292,574,718,51,1
234377,66,16,50,59,1
234377,755,155,600,60,1
234401,77,2,75,1,4
234401,77,2,75,2,1
234401,77,2,75,3,1
234401,32,2,30,4,1
234401,45,0,45,5,1
234401,45,0,45,20,1
234401,77,2,75,21,4
234401,77,2,75,22,1
234401,77,2,75,23,1
234401,32,2,30,24,1
234401,45,0,45,25,1
234401,45,0,45,40,1
234492,1573,842,731,1,4
234492,1573,842,731,2,1
234492,1573,842,731,3,1
234492,276,163,113,4,1
234492,1297,679,618,5,1
234492,277,127,150,19,1
234492,1020,552,468,20,1
234492,1009,562,447,21,4
234492,1009,562,447,22,1
234492,1009,562,447,23,1
234492,200,119,81,24,1
234492,809,443,366,25,1
234492,184,95,89,39,1
234492,625,348,277,40,1
234492,564,280,284,41,4
234492,564,280,284,42,1
234492,564,280,284,43,1
234492,76,44,32,44,1
234492,488,236,252,45,1
234492,93,32,61,59,1
234492,395,204,191,60,1
234650,100,9,91,1,4
234650,100,9,91,2,1
234650,100,9,91,3,1
234650,7,0,7,4,1
234650,93,9,84,5,1
234650,93,9,84,20,1
234650,100,9,91,21,4
234650,100,9,91,22,1
234650,100,9,91,23,1
234650,7,0,7,24,1
234650,93,9,84,25,1
234650,93,9,84,40,1
234669,13820,6316,7504,1,4
234669,13820,6316,7504,2,1
234669,5684,2592,3092,3,1
234669,949,512,437,4,1
234669,4735,2080,2655,5,1
234669,8136,3724,4412,11,1
234669,2233,859,1374,19,1
234669,2502,1221,1281,20,1
234669,6704,3312,3392,21,4
234669,6704,3312,3392,22,1
234669,3001,1422,1579,23,1
234669,679,377,302,24,1
234669,2322,1045,1277,25,1
234669,3703,1890,1813,31,1
234669,1042,422,620,39,1
234669,1280,623,657,40,1
234669,7116,3004,4112,41,4
234669,7116,3004,4112,42,1
234669,2683,1170,1513,43,1
234669,270,135,135,44,1
234669,2413,1035,1378,45,1
234669,4433,1834,2599,51,1
234669,1191,437,754,59,1
234669,1222,598,624,60,1
234696,2258,1190,1068,1,4
234696,2258,1190,1068,2,1
234696,720,385,335,3,1
234696,80,55,25,4,1
234696,640,330,310,5,1
234696,1538,805,733,11,1
234696,332,161,171,19,1
234696,308,169,139,20,1
234696,1256,810,446,21,4
234696,1256,810,446,22,1
234696,493,313,180,23,1
234696,59,43,16,24,1
234696,434,270,164,25,1
234696,763,497,266,31,1
234696,226,128,98,39,1
234696,208,142,66,40,1
234696,1002,380,622,41,4
234696,1002,380,622,42,1
234696,227,72,155,43,1
234696,21,12,9,44,1
234696,206,60,146,45,1
234696,775,308,467,51,1
234696,106,33,73,59,1
234696,100,27,73,60,1
234711,1991,847,1144,1,4
234711,1991,847,1144,2,1
234711,1530,662,868,3,1
234711,310,138,172,4,1
234711,1220,524,696,5,1
234711,461,185,276,11,1
234711,288,140,148,19,1
234711,932,384,548,20,1
234711,1440,644,796,21,4
234711,1440,644,796,22,1
234711,1162,529,633,23,1
234711,267,121,146,24,1
234711,895,408,487,25,1
234711,278,115,163,31,1
234711,211,107,104,39,1
234711,684,301,383,40,1
234711,551,203,348,41,4
234711,551,203,348,42,1
234711,368,133,235,43,1
234711,43,17,26,44,1
234711,325,116,209,45,1
234711,183,70,113,51,1
234711,77,33,44,59,1
234711,248,83,165,60,1
234739,273,40,233,1,4
234739,273,40,233,2,1
234739,273,40,233,3,1
234739,49,8,41,4,1
234739,224,32,192,5,1
234739,23,3,20,19,1
234739,201,29,172,20,1
234739,269,37,232,21,4
234739,269,37,232,22,1
234739,269,37,232,23,1
234739,49,8,41,24,1
234739,220,29,191,25,1
234739,23,3,20,39,1
234739,197,26,171,40,1
234739,4,3,1,41,4
234739,4,3,1,42,1
234739,4,3,1,43,1
234739,4,3,1,45,1
234739,4,3,1,60,1
234784,444,59,385,1,4
234784,444,59,385,2,1
234784,444,59,385,3,1
234784,102,15,87,4,1
234784,342,44,298,5,1
234784,342,44,298,20,1
234784,444,59,385,21,4
234784,444,59,385,22,1
234784,444,59,385,23,1
234784,102,15,87,24,1
234784,342,44,298,25,1
234784,342,44,298,40,1
234827,11287,5552,5735,1,4
234827,10423,5167,5256,2,1
234827,9958,4962,4996,3,1
234827,1502,716,786,4,1
234827,8456,4246,4210,5,1
234827,465,205,260,11,1
234827,864,385,479,12,3
234827,1374,667,707,19,1
234827,7082,3579,3503,20,1
234827,9458,4693,4765,21,4
234827,8996,4476,4520,22,1
234827,8908,4439,4469,23,1
234827,1486,708,778,24,1
234827,7422,3731,3691,25,1
234827,88,37,51,31,1
234827,462,217,245,32,3
234827,1191,579,612,39,1
234827,6231,3152,3079,40,1
234827,1829,859,970,41,4
234827,1427,691,736,42,1
234827,1050,523,527,43,1
234827,16,8,8,44,1
234827,1034,515,519,45,1
234827,377,168,209,51,1
234827,402,168,234,52,3
234827,183,88,95,59,1
234827,851,427,424,60,1
234845,3453,1567,1886,1,4
234845,3453,1567,1886,2,1
234845,1632,716,916,3,1
234845,398,188,210,4,1
234845,1234,528,706,5,1
234845,1821,851,970,11,1
234845,364,154,210,19,1
234845,870,374,496,20,1
234845,1806,855,951,21,4
234845,1806,855,951,22,1
234845,1281,594,687,23,1
234845,355,174,181,24,1
234845,926,420,506,25,1
234845,525,261,264,31,1
234845,265,123,142,39,1
234845,661,297,364,40,1
234845,1647,712,935,41,4
234845,1647,712,935,42,1
234845,351,122,229,43,1
234845,43,14,29,44,1
234845,308,108,200,45,1
234845,1296,590,706,51,1
234845,99,31,68,59,1
234845,209,77,132,60,1
234915,2368,1035,1333,1,4
234915,1272,598,674,2,1
234915,1162,552,610,3,1
234915,50,26,24,4,1
234915,1112,526,586,5,1
234915,110,46,64,11,1
234915,1096,437,659,12,3
234915,314,137,177,19,1
234915,798,389,409,20,1
234915,1367,567,800,21,4
234915,638,302,336,22,1
234915,631,299,332,23,1
234915,6,6,0,24,1
234915,625,293,332,25,1
234915,7,3,4,31,1
234915,729,265,464,32,3
234915,217,91,126,39,1
234915,408,202,206,40,1
234915,1001,468,533,41,4
234915,634,296,338,42,1
234915,531,253,278,43,1
234915,44,20,24,44,1
234915,487,233,254,45,1
234915,103,43,60,51,1
234915,367,172,195,52,3
234915,97,46,51,59,1
234915,390,187,203,60,1
234924,128,5,123,1,4
234924,128,5,123,2,1
234924,128,5,123,3,1
234924,30,2,28,4,1
234924,98,3,95,5,1
234924,98,3,95,20,1
234924,128,5,123,21,4
234924,128,5,123,22,1
234924,128,5,123,23,1
234924,30,2,28,24,1
234924,98,3,95,25,1
234924,98,3,95,40,1
234933,11462,4906,6556,1,4
234933,11462,4906,6556,2,1
234933,9907,4253,5654,3,1
234933,1284,608,676,4,1
234933,8623,3645,4978,5,1
234933,1555,653,902,11,1
234933,2131,832,1299,19,1
234933,6492,2813,3679,20,1
234933,5636,2554,3082,21,4
234933,5636,2554,3082,22,1
234933,5237,2359,2878,23,1
234933,819,390,429,24,1
234933,4418,1969,2449,25,1
234933,399,195,204,31,1
234933,1068,437,631,39,1
234933,3350,1532,1818,40,1
234933,5826,2352,3474,41,4
234933,5826,2352,3474,42,1
234933,4670,1894,2776,43,1
234933,465,218,247,44,1
234933,4205,1676,2529,45,1
234933,1156,458,698,51,1
234933,1063,395,668,59,1
234933,3142,1281,1861,60,1
234951,3720,1320,2400,1,4
234951,3720,1320,2400,2,1
234951,1633,743,890,3,1
234951,278,141,137,4,1
234951,1355,602,753,5,1
234951,2087,577,1510,11,1
234951,725,295,430,19,1
234951,630,307,323,20,1
234951,2358,1132,1226,21,4
234951,2358,1132,1226,22,1
234951,1375,657,718,23,1
234951,251,131,120,24,1
234951,1124,526,598,25,1
234951,983,475,508,31,1
234951,602,262,340,39,1
234951,522,264,258,40,1
234951,1362,188,1174,41,4
234951,1362,188,1174,42,1
234951,258,86,172,43,1
234951,27,10,17,44,1
234951,231,76,155,45,1
234951,1104,102,1002,51,1
234951,123,33,90,59,1
234951,108,43,65,60,1
234979,6480,3081,3399,1,4
234979,6480,3081,3399,2,1
234979,5146,2281,2865,3,1
234979,959,473,486,4,1
234979,4187,1808,2379,5,1
234979,1334,800,534,11,1
234979,1814,781,1033,19,1
234979,2373,1027,1346,20,1
234979,3693,1662,2031,21,4
234979,3693,1662,2031,22,1
234979,3240,1472,1768,23,1
234979,723,359,364,24,1
234979,2517,1113,1404,25,1
234979,453,190,263,31,1
234979,919,417,502,39,1
234979,1598,696,902,40,1
234979,2787,1419,1368,41,4
234979,2787,1419,1368,42,1
234979,1906,809,1097,43,1
234979,236,114,122,44,1
234979,1670,695,975,45,1
234979,881,610,271,51,1
234979,895,364,531,59,1
234979,775,331,444,60,1
235024,778,277,501,1,4
235024,775,274,501,2,1
235024,775,274,501,3,1
235024,167,52,115,4,1
235024,608,222,386,5,1
235024,3,3,0,12,3
235024,83,28,55,19,1
235024,525,194,331,20,1
235024,752,266,486,21,4
235024,749,263,486,22,1
235024,749,263,486,23,1
235024,166,52,114,24,1
235024,583,211,372,25,1
235024,3,3,0,32,3
235024,83,28,55,39,1
235024,500,183,317,40,1
235024,26,11,15,41,4
235024,26,11,15,42,1
235024,26,11,15,43,1
235024,1,0,1,44,1
235024,25,11,14,45,1
235024,25,11,14,60,1
235088,234,223,11,1,4
235088,234,223,11,2,1
235088,234,223,11,3,1
235088,157,153,4,4,1
235088,77,70,7,5,1
235088,77,70,7,20,1
235088,234,223,11,21,4
235088,234,223,11,22,1
235088,234,223,11,23,1
235088,157,153,4,24,1
235088,77,70,7,25,1
235088,77,70,7,40,1
235097,12791,5736,7055,1,4
235097,11678,5372,6306,2,1
235097,11672,5367,6305,3,1
235097,1486,608,878,4,1
235097,10186,4759,5427,5,1
235097,6,5,1,11,1
235097,1113,364,749,12,3
235097,1386,645,741,19,1
235097,8800,4114,4686,20,1
235097,10544,4764,5780,21,4
235097,9715,4490,5225,22,1
235097,9713,4489,5224,23,1
235097,1469,601,868,24,1
235097,8244,3888,4356,25,1
235097,2,1,1,31,1
235097,829,274,555,32,3
235097,1235,586,649,39,1
235097,7009,3302,3707,40,1
235097,2247,972,1275,41,4
235097,1963,882,1081,42,1
235097,1959,878,1081,43,1
235097,17,7,10,44,1
235097,1942,871,1071,45,1
235097,4,4,0,51,1
235097,284,90,194,52,3
235097,151,59,92,59,1
235097,1791,812,979,60,1
235103,9070,4308,4762,1,4
235103,9070,4308,4762,2,1
235103,4589,2202,2387,3,1
235103,532,276,256,4,1
235103,4057,1926,2131,5,1
235103,4481,2106,2375,11,1
235103,1489,663,826,19,1
235103,2568,1263,1305,20,1
235103,4184,2160,2024,21,4
235103,4184,2160,2024,22,1
235103,2669,1335,1334,23,1
235103,397,210,187,24,1
235103,2272,1125,1147,25,1
235103,1515,825,690,31,1
235103,805,373,432,39,1
235103,1467,752,715,40,1
235103,4886,2148,2738,41,4
235103,4886,2148,2738,42,1
235103,1920,867,1053,43,1
235103,135,66,69,44,1
235103,1785,801,984,45,1
235103,2966,1281,1685,51,1
235103,684,290,394,59,1
235103,1101,511,590,60,1
235149,7154,3140,4014,1,4
235149,7154,3140,4014,2,1
235149,4612,1905,2707,3,1
235149,711,342,369,4,1
235149,3901,1563,2338,5,1
235149,2542,1235,1307,11,1
235149,1088,445,643,19,1
235149,2813,1118,1695,20,1
235149,3925,1825,2100,21,4
235149,3925,1825,2100,22,1
235149,2619,1163,1456,23,1
235149,512,258,254,24,1
235149,2107,905,1202,25,1
235149,1306,662,644,31,1
235149,576,259,317,39,1
235149,1531,646,885,40,1
235149,3229,1315,1914,41,4
235149,3229,1315,1914,42,1
235149,1993,742,1251,43,1
235149,199,84,115,44,1
235149,1794,658,1136,45,1
235149,1236,573,663,51,1
235149,512,186,326,59,1
235149,1282,472,810,60,1
235158,109,24,85,1,4
235158,109,24,85,2,1
235158,109,24,85,3,1
235158,13,1,12,4,1
235158,96,23,73,5,1
235158,96,23,73,20,1
235158,109,24,85,21,4
235158,109,24,85,22,1
235158,109,24,85,23,1
235158,13,1,12,24,1
235158,96,23,73,25,1
235158,96,23,73,40,1
235167,4398,2003,2395,1,4
235167,4087,1901,2186,2,1
235167,4017,1866,2151,3,1
235167,509,225,284,4,1
235167,3508,1641,1867,5,1
235167,70,35,35,11,1
235167,311,102,209,12,3
235167,740,328,412,19,1
235167,2768,1313,1455,20,1
235167,3955,1816,2139,21,4
235167,3766,1748,2018,22,1
235167,3758,1742,2016,23,1
235167,497,221,276,24,1
235167,3261,1521,1740,25,1
235167,8,6,2,31,1
235167,189,68,121,32,3
235167,706,314,392,39,1
235167,2555,1207,1348,40,1
235167,443,187,256,41,4
235167,321,153,168,42,1
235167,259,124,135,43,1
235167,12,4,8,44,1
235167,247,120,127,45,1
235167,62,29,33,51,1
235167,122,34,88,52,3
235167,34,14,20,59,1
235167,213,106,107,60,1
235237,6203,2566,3637,1,4
235237,6203,2566,3637,2,1
235237,4407,1776,2631,3,1
235237,488,229,259,4,1
235237,3919,1547,2372,5,1
235237,1796,790,1006,11,1
235237,1535,539,996,19,1
235237,2384,1008,1376,20,1
235237,2800,1182,1618,21,4
235237,2800,1182,1618,22,1
235237,2151,863,1288,23,1
235237,325,155,170,24,1
235237,1826,708,1118,25,1
235237,649,319,330,31,1
235237,728,262,466,39,1
235237,1098,446,652,40,1
235237,3403,1384,2019,41,4
235237,3403,1384,2019,42,1
235237,2256,913,1343,43,1
235237,163,74,89,44,1
235237,2093,839,1254,45,1
235237,1147,471,676,51,1
235237,807,277,530,59,1
235237,1286,562,724,60,1
235307,153,4,149,1,4
235307,153,4,149,2,1
235307,153,4,149,3,1
235307,48,3,45,4,1
235307,105,1,104,5,1
235307,105,1,104,20,1
235307,151,4,147,21,4
235307,151,4,147,22,1
235307,151,4,147,23,1
235307,47,3,44,24,1
235307,104,1,103,25,1
235307,104,1,103,40,1
235307,2,0,2,41,4
235307,2,0,2,42,1
235307,2,0,2,43,1
235307,1,0,1,44,1
235307,1,0,1,45,1
235307,1,0,1,60,1
235316,7605,3301,4304,1,4
235316,4896,2240,2656,2,1
235316,4830,2206,2624,3,1
235316,1238,560,678,4,1
235316,3592,1646,1946,5,1
235316,66,34,32,11,1
235316,2709,1061,1648,12,3
235316,155,87,68,19,1
235316,3437,1559,1878,20,1
235316,5490,2528,2962,21,4
235316,4826,2206,2620,22,1
235316,4780,2183,2597,23,1
235316,1238,560,678,24,1
235316,3542,1623,1919,25,1
235316,46,23,23,31,1
235316,664,322,342,32,3
235316,151,85,66,39,1
235316,3391,1538,1853,40,1
235316,2115,773,1342,41,4
235316,70,34,36,42,1
235316,50,23,27,43,1
235316,50,23,27,45,1
235316,20,11,9,51,1
235316,2045,739,1306,52,3
235316,4,2,2,59,1
235316,46,21,25,60,1
235334,1958,975,983,1,4
235334,1958,975,983,2,1
235334,1061,462,599,3,1
235334,259,125,134,4,1
235334,802,337,465,5,1
235334,897,513,384,11,1
235334,240,101,139,19,1
235334,562,236,326,20,1
235334,1345,647,698,21,4
235334,1345,647,698,22,1
235334,873,376,497,23,1
235334,246,119,127,24,1
235334,627,257,370,25,1
235334,472,271,201,31,1
235334,184,74,110,39,1
235334,443,183,260,40,1
235334,613,328,285,41,4
235334,613,328,285,42,1
235334,188,86,102,43,1
235334,13,6,7,44,1
235334,175,80,95,45,1
235334,425,242,183,51,1
235334,56,27,29,59,1
235334,119,53,66,60,1
235343,7801,3871,3930,1,4
235343,7801,3871,3930,2,1
235343,5191,2633,2558,3,1
235343,814,428,386,4,1
235343,4377,2205,2172,5,1
235343,2610,1238,1372,11,1
235343,1241,601,640,19,1
235343,3136,1604,1532,20,1
235343,5021,2627,2394,21,4
235343,5021,2627,2394,22,1
235343,3461,1823,1638,23,1
235343,602,326,276,24,1
235343,2859,1497,1362,25,1
235343,1560,804,756,31,1
235343,807,413,394,39,1
235343,2052,1084,968,40,1
235343,2780,1244,1536,41,4
235343,2780,1244,1536,42,1
235343,1730,810,920,43,1
235343,212,102,110,44,1
235343,1518,708,810,45,1
235343,1050,434,616,51,1
235343,434,188,246,59,1
235343,1084,520,564,60,1
235352,65,11,54,1,4
235352,65,11,54,2,1
235352,65,11,54,3,1
235352,9,2,7,4,1
235352,56,9,47,5,1
235352,56,9,47,20,1
235352,65,11,54,21,4
235352,65,11,54,22,1
235352,65,11,54,23,1
235352,9,2,7,24,1
235352,56,9,47,25,1
235352,56,9,47,40,1
235422,1128,281,847,1,4
235422,876,201,675,2,1
235422,842,190,652,3,1
235422,84,24,60,4,1
235422,758,166,592,5,1
235422,34,11,23,11,1
235422,252,80,172,12,3
235422,122,21,101,19,1
235422,636,145,491,20,1
235422,719,184,535,21,4
235422,651,150,501,22,1
235422,651,150,501,23,1
235422,74,19,55,24,1
235422,577,131,446,25,1
235422,68,34,34,32,3
235422,104,19,85,39,1
235422,473,112,361,40,1
235422,409,97,312,41,4
235422,225,51,174,42,1
235422,191,40,151,43,1
235422,10,5,5,44,1
235422,181,35,146,45,1
235422,34,11,23,51,1
235422,184,46,138,52,3
235422,18,2,16,59,1
235422,163,33,130,60,1
235431,6612,2752,3860,1,4
235431,6612,2752,3860,2,1
235431,3107,1251,1856,3,1
235431,467,205,262,4,1
235431,2640,1046,1594,5,1
235431,3505,1501,2004,11,1
235431,861,322,539,19,1
235431,1779,724,1055,20,1
235431,3937,1668,2269,21,4
235431,3937,1668,2269,22,1
235431,1866,756,1110,23,1
235431,330,144,186,24,1
235431,1536,612,924,25,1
235431,2071,912,1159,31,1
235431,442,168,274,39,1
235431,1094,444,650,40,1
235431,2675,1084,1591,41,4
235431,2675,1084,1591,42,1
235431,1241,495,746,43,1
235431,137,61,76,44,1
235431,1104,434,670,45,1
235431,1434,589,845,51,1
235431,419,154,265,59,1
235431,685,280,405,60,1
235495,49,19,30,1,4
235495,49,19,30,2,1
235495,49,19,30,3,1
235495,3,0,3,4,1
235495,46,19,27,5,1
235495,34,13,21,19,1
235495,12,6,6,20,1
235495,49,19,30,21,4
235495,49,19,30,22,1
235495,49,19,30,23,1
235495,3,0,3,24,1
235495,46,19,27,25,1
235495,34,13,21,39,1
235495,12,6,6,40,1
235501,266,134,132,1,4
235501,266,134,132,2,1
235501,266,134,132,3,1
235501,186,102,84,4,1
235501,80,32,48,5,1
235501,80,32,48,20,1
235501,266,134,132,21,4
235501,266,134,132,22,1
235501,266,134,132,23,1
235501,186,102,84,24,1
235501,80,32,48,25,1
235501,80,32,48,40,1
235510,444,383,61,1,4
235510,444,383,61,2,1
235510,444,383,61,3,1
235510,63,50,13,4,1
235510,381,333,48,5,1
235510,11,11,0,19,1
235510,370,322,48,20,1
235510,352,302,50,21,4
235510,352,302,50,22,1
235510,352,302,50,23,1
235510,55,44,11,24,1
235510,297,258,39,25,1
235510,10,10,0,39,1
235510,287,248,39,40,1
235510,92,81,11,41,4
235510,92,81,11,42,1
235510,92,81,11,43,1
235510,8,6,2,44,1
235510,84,75,9,45,1
235510,1,1,0,59,1
235510,83,74,9,60,1
235529,297,261,36,1,4
235529,297,261,36,2,1
235529,297,261,36,3,1
235529,52,44,8,4,1
235529,245,217,28,5,1
235529,8,6,2,19,1
235529,237,211,26,20,1
235529,239,211,28,21,4
235529,239,211,28,22,1
235529,239,211,28,23,1
235529,49,41,8,24,1
235529,190,170,20,25,1
235529,7,5,2,39,1
235529,183,165,18,40,1
235529,58,50,8,41,4
235529,58,50,8,42,1
235529,58,50,8,43,1
235529,3,3,0,44,1
235529,55,47,8,45,1
235529,1,1,0,59,1
235529,54,46,8,60,1
235547,1115,193,922,1,4
235547,259,46,213,2,1
235547,216,38,178,3,1
235547,216,38,178,5,1
235547,43,8,35,11,1
235547,856,147,709,12,3
235547,109,21,88,19,1
235547,107,17,90,20,1
235547,1015,180,835,21,4
235547,207,38,169,22,1
235547,198,37,161,23,1
235547,198,37,161,25,1
235547,9,1,8,31,1
235547,808,142,666,32,3
235547,105,21,84,39,1
235547,93,16,77,40,1
235547,100,13,87,41,4
235547,52,8,44,42,1
235547,18,1,17,43,1
235547,18,1,17,45,1
235547,34,7,27,51,1
235547,48,5,43,52,3
235547,4,0,4,59,1
235547,14,1,13,60,1
235583,230,10,220,1,4
235583,230,10,220,2,1
235583,230,10,220,3,1
235583,28,2,26,4,1
235583,202,8,194,5,1
235583,202,8,194,20,1
235583,230,10,220,21,4
235583,230,10,220,22,1
235583,230,10,220,23,1
235583,28,2,26,24,1
235583,202,8,194,25,1
235583,202,8,194,40,1
235671,3704,1655,2049,1,4
235671,3704,1655,2049,2,1
235671,1091,741,350,3,1
235671,163,124,39,4,1
235671,928,617,311,5,1
235671,2613,914,1699,11,1
235671,529,315,214,19,1
235671,399,302,97,20,1
235671,1987,1029,958,21,4
235671,1987,1029,958,22,1
235671,1006,681,325,23,1
235671,158,119,39,24,1
235671,848,562,286,25,1
235671,981,348,633,31,1
235671,484,286,198,39,1
235671,364,276,88,40,1
235671,1717,626,1091,41,4
235671,1717,626,1091,42,1
235671,85,60,25,43,1
235671,5,5,0,44,1
235671,80,55,25,45,1
235671,1632,566,1066,51,1
235671,45,29,16,59,1
235671,35,26,9,60,1
235699,3819,1525,2294,1,4
235699,3819,1525,2294,2,1
235699,2227,969,1258,3,1
235699,208,101,107,4,1
235699,2019,868,1151,5,1
235699,1592,556,1036,11,1
235699,1140,402,738,19,1
235699,879,466,413,20,1
235699,1918,963,955,21,4
235699,1918,963,955,22,1
235699,1459,713,746,23,1
235699,164,86,78,24,1
235699,1295,627,668,25,1
235699,459,250,209,31,1
235699,704,278,426,39,1
235699,591,349,242,40,1
235699,1901,562,1339,41,4
235699,1901,562,1339,42,1
235699,768,256,512,43,1
235699,44,15,29,44,1
235699,724,241,483,45,1
235699,1133,306,827,51,1
235699,436,124,312,59,1
235699,288,117,171,60,1
235750,3152,1129,2023,1,4
235750,3152,1129,2023,2,1
235750,1405,526,879,3,1
235750,304,137,167,4,1
235750,1101,389,712,5,1
235750,1747,603,1144,11,1
235750,353,109,244,19,1
235750,748,280,468,20,1
235750,1633,653,980,21,4
235750,1633,653,980,22,1
235750,821,356,465,23,1
235750,239,116,123,24,1
235750,582,240,342,25,1
235750,812,297,515,31,1
235750,181,68,113,39,1
235750,401,172,229,40,1
235750,1519,476,1043,41,4
235750,1519,476,1043,42,1
235750,584,170,414,43,1
235750,65,21,44,44,1
235750,519,149,370,45,1
235750,935,306,629,51,1
235750,172,41,131,59,1
235750,347,108,239,60,1
235769,194,91,103,1,4
235769,194,91,103,2,1
235769,192,91,101,3,1
235769,48,25,23,4,1
235769,144,66,78,5,1
235769,2,0,2,11,1
235769,27,14,13,19,1
235769,117,52,65,20,1
235769,182,87,95,21,4
235769,182,87,95,22,1
235769,182,87,95,23,1
235769,48,25,23,24,1
235769,134,62,72,25,1
235769,26,14,12,39,1
235769,108,48,60,40,1
235769,12,4,8,41,4
235769,12,4,8,42,1
235769,10,4,6,43,1
235769,10,4,6,45,1
235769,2,0,2,51,1
235769,1,0,1,59,1
235769,9,4,5,60,1
235954,24,0,24,1,4
235954,24,0,24,2,1
235954,24,0,24,3,1
235954,3,0,3,4,1
235954,21,0,21,5,1
235954,21,0,21,20,1
235954,24,0,24,21,4
235954,24,0,24,22,1
235954,24,0,24,23,1
235954,3,0,3,24,1
235954,21,0,21,25,1
235954,21,0,21,40,1
236018,121,28,93,1,4
236018,121,28,93,2,1
236018,121,28,93,3,1
236018,24,13,11,4,1
236018,97,15,82,5,1
236018,97,15,82,20,1
236018,121,28,93,21,4
236018,121,28,93,22,1
236018,121,28,93,23,1
236018,24,13,11,24,1
236018,97,15,82,25,1
236018,97,15,82,40,1
236027,160,4,156,1,4
236027,160,4,156,2,1
236027,160,4,156,3,1
236027,27,1,26,4,1
236027,133,3,130,5,1
236027,133,3,130,20,1
236027,160,4,156,21,4
236027,160,4,156,22,1
236027,160,4,156,23,1
236027,27,1,26,24,1
236027,133,3,130,25,1
236027,133,3,130,40,1
236072,6118,2532,3586,1,4
236072,6118,2532,3586,2,1
236072,2752,1346,1406,3,1
236072,159,88,71,4,1
236072,2593,1258,1335,5,1
236072,3366,1186,2180,11,1
236072,1448,676,772,19,1
236072,1145,582,563,20,1
236072,2240,1178,1062,21,4
236072,2240,1178,1062,22,1
236072,1360,724,636,23,1
236072,99,59,40,24,1
236072,1261,665,596,25,1
236072,880,454,426,31,1
236072,613,326,287,39,1
236072,648,339,309,40,1
236072,3878,1354,2524,41,4
236072,3878,1354,2524,42,1
236072,1392,622,770,43,1
236072,60,29,31,44,1
236072,1332,593,739,45,1
236072,2486,732,1754,51,1
236072,835,350,485,59,1
236072,497,243,254,60,1
236133,1733,703,1030,1,4
236133,1438,595,843,2,1
236133,1354,547,807,3,1
236133,215,68,147,4,1
236133,1139,479,660,5,1
236133,84,48,36,11,1
236133,295,108,187,12,3
236133,325,158,167,19,1
236133,814,321,493,20,1
236133,1436,543,893,21,4
236133,1221,473,748,22,1
236133,1206,469,737,23,1
236133,202,61,141,24,1
236133,1004,408,596,25,1
236133,15,4,11,31,1
236133,215,70,145,32,3
236133,254,118,136,39,1
236133,750,290,460,40,1
236133,297,160,137,41,4
236133,217,122,95,42,1
236133,148,78,70,43,1
236133,13,7,6,44,1
236133,135,71,64,45,1
236133,69,44,25,51,1
236133,80,38,42,52,3
236133,71,40,31,59,1
236133,64,31,33,60,1
236188,7329,3334,3995,1,4
236188,7329,3334,3995,2,1
236188,4900,2162,2738,3,1
236188,561,294,267,4,1
236188,4339,1868,2471,5,1
236188,2429,1172,1257,11,1
236188,1238,527,711,19,1
236188,3101,1341,1760,20,1
236188,4287,1970,2317,21,4
236188,4287,1970,2317,22,1
236188,3152,1388,1764,23,1
236188,382,191,191,24,1
236188,2770,1197,1573,25,1
236188,1135,582,553,31,1
236188,715,296,419,39,1
236188,2055,901,1154,40,1
236188,3042,1364,1678,41,4
236188,3042,1364,1678,42,1
236188,1748,774,974,43,1
236188,179,103,76,44,1
236188,1569,671,898,45,1
236188,1294,590,704,51,1
236188,523,231,292,59,1
236188,1046,440,606,60,1
236212,774,643,131,1,4
236212,774,643,131,2,1
236212,774,643,131,3,1
236212,179,148,31,4,1
236212,595,495,100,5,1
236212,595,495,100,20,1
236212,774,643,131,21,4
236212,774,643,131,22,1
236212,774,643,131,23,1
236212,179,148,31,24,1
236212,595,495,100,25,1
236212,595,495,100,40,1
236230,3462,1306,2156,1,4
236230,3142,1203,1939,2,1
236230,3062,1163,1899,3,1
236230,648,238,410,4,1
236230,2414,925,1489,5,1
236230,80,40,40,11,1
236230,320,103,217,12,3
236230,240,92,148,19,1
236230,2174,833,1341,20,1
236230,3201,1198,2003,21,4
236230,3010,1135,1875,22,1
236230,2964,1118,1846,23,1
236230,648,238,410,24,1
236230,2316,880,1436,25,1
236230,46,17,29,31,1
236230,191,63,128,32,3
236230,236,91,145,39,1
236230,2080,789,1291,40,1
236230,261,108,153,41,4
236230,132,68,64,42,1
236230,98,45,53,43,1
236230,98,45,53,45,1
236230,34,23,11,51,1
236230,129,40,89,52,3
236230,4,1,3,59,1
236230,94,44,50,60,1
236258,2405,1128,1277,1,4
236258,2405,1128,1277,2,1
236258,1378,591,787,3,1
236258,204,110,94,4,1
236258,1174,481,693,5,1
236258,1027,537,490,11,1
236258,357,138,219,19,1
236258,817,343,474,20,1
236258,1427,686,741,21,4
236258,1427,686,741,22,1
236258,993,446,547,23,1
236258,178,94,84,24,1
236258,815,352,463,25,1
236258,434,240,194,31,1
236258,241,97,144,39,1
236258,574,255,319,40,1
236258,978,442,536,41,4
236258,978,442,536,42,1
236258,385,145,240,43,1
236258,26,16,10,44,1
236258,359,129,230,45,1
236258,593,297,296,51,1
236258,116,41,75,59,1
236258,243,88,155,60,1
236328,2812,1164,1648,1,4
236328,2544,1100,1444,2,1
236328,2542,1098,1444,3,1
236328,670,291,379,4,1
236328,1872,807,1065,5,1
236328,2,2,0,11,1
236328,268,64,204,12,3
236328,59,25,34,19,1
236328,1813,782,1031,20,1
236328,2756,1141,1615,21,4
236328,2522,1082,1440,22,1
236328,2522,1082,1440,23,1
236328,670,291,379,24,1
236328,1852,791,1061,25,1
236328,234,59,175,32,3
236328,59,25,34,39,1
236328,1793,766,1027,40,1
236328,56,23,33,41,4
236328,22,18,4,42,1
236328,20,16,4,43,1
236328,20,16,4,45,1
236328,2,2,0,51,1
236328,34,5,29,52,3
236328,20,16,4,60,1
236382,3338,2196,1142,1,4
236382,3338,2196,1142,2,1
236382,1281,569,712,3,1
236382,178,94,84,4,1
236382,1103,475,628,5,1
236382,2057,1627,430,11,1
236382,598,238,360,19,1
236382,505,237,268,20,1
236382,1241,608,633,21,4
236382,1241,608,633,22,1
236382,906,435,471,23,1
236382,134,76,58,24,1
236382,772,359,413,25,1
236382,335,173,162,31,1
236382,419,178,241,39,1
236382,353,181,172,40,1
236382,2097,1588,509,41,4
236382,2097,1588,509,42,1
236382,375,134,241,43,1
236382,44,18,26,44,1
236382,331,116,215,45,1
236382,1722,1454,268,51,1
236382,179,60,119,59,1
236382,152,56,96,60,1
236452,1787,841,946,1,4
236452,1428,706,722,2,1
236452,1299,621,678,3,1
236452,158,68,90,4,1
236452,1141,553,588,5,1
236452,129,85,44,11,1
236452,359,135,224,12,3
236452,157,74,83,19,1
236452,984,479,505,20,1
236452,1193,575,618,21,4
236452,1111,531,580,22,1
236452,1103,530,573,23,1
236452,158,68,90,24,1
236452,945,462,483,25,1
236452,8,1,7,31,1
236452,82,44,38,32,3
236452,134,66,68,39,1
236452,811,396,415,40,1
236452,594,266,328,41,4
236452,317,175,142,42,1
236452,196,91,105,43,1
236452,196,91,105,45,1
236452,121,84,37,51,1
236452,277,91,186,52,3
236452,23,8,15,59,1
236452,173,83,90,60,1
236504,4951,2857,2094,1,4
236504,4951,2857,2094,2,1
236504,2002,1085,917,3,1
236504,228,130,98,4,1
236504,1774,955,819,5,1
236504,2949,1772,1177,11,1
236504,895,452,443,19,1
236504,879,503,376,20,1
236504,1992,1180,812,21,4
236504,1992,1180,812,22,1
236504,1201,722,479,23,1
236504,193,112,81,24,1
236504,1008,610,398,25,1
236504,791,458,333,31,1
236504,456,260,196,39,1
236504,552,350,202,40,1
236504,2959,1677,1282,41,4
236504,2959,1677,1282,42,1
236504,801,363,438,43,1
236504,35,18,17,44,1
236504,766,345,421,45,1
236504,2158,1314,844,51,1
236504,439,192,247,59,1
236504,327,153,174,60,1
236513,7110,3230,3880,1,4
236513,7110,3230,3880,2,1
236513,3116,1493,1623,3,1
236513,169,87,82,4,1
236513,2947,1406,1541,5,1
236513,3994,1737,2257,11,1
236513,1381,635,746,19,1
236513,1566,771,795,20,1
236513,4184,2011,2173,21,4
236513,4184,2011,2173,22,1
236513,2120,1040,1080,23,1
236513,132,65,67,24,1
236513,1988,975,1013,25,1
236513,2064,971,1093,31,1
236513,852,404,448,39,1
236513,1136,571,565,40,1
236513,2926,1219,1707,41,4
236513,2926,1219,1707,42,1
236513,996,453,543,43,1
236513,37,22,15,44,1
236513,959,431,528,45,1
236513,1930,766,1164,51,1
236513,529,231,298,59,1
236513,430,200,230,60,1
236531,174,45,129,1,4
236531,174,45,129,2,1
236531,174,45,129,3,1
236531,22,4,18,4,1
236531,152,41,111,5,1
236531,152,41,111,20,1
236531,174,45,129,21,4
236531,174,45,129,22,1
236531,174,45,129,23,1
236531,22,4,18,24,1
236531,152,41,111,25,1
236531,152,41,111,40,1
236577,4270,1416,2854,1,4
236577,3366,1139,2227,2,1
236577,3354,1131,2223,3,1
236577,767,245,522,4,1
236577,2587,886,1701,5,1
236577,12,8,4,11,1
236577,904,277,627,12,3
236577,216,80,136,19,1
236577,2371,806,1565,20,1
236577,3609,1211,2398,21,4
236577,3230,1097,2133,22,1
236577,3228,1095,2133,23,1
236577,765,244,521,24,1
236577,2463,851,1612,25,1
236577,2,2,0,31,1
236577,379,114,265,32,3
236577,216,80,136,39,1
236577,2247,771,1476,40,1
236577,661,205,456,41,4
236577,136,42,94,42,1
236577,126,36,90,43,1
236577,2,1,1,44,1
236577,124,35,89,45,1
236577,10,6,4,51,1
236577,525,163,362,52,3
236577,124,35,89,60,1
236595,7422,3060,4362,1,4
236595,4608,1918,2690,2,1
236595,4595,1915,2680,3,1
236595,964,380,584,4,1
236595,3631,1535,2096,5,1
236595,13,3,10,11,1
236595,2814,1142,1672,12,3
236595,388,174,214,19,1
236595,3243,1361,1882,20,1
236595,5780,2332,3448,21,4
236595,4377,1798,2579,22,1
236595,4376,1798,2578,23,1
236595,958,378,580,24,1
236595,3418,1420,1998,25,1
236595,1,0,1,31,1
236595,1403,534,869,32,3
236595,374,168,206,39,1
236595,3044,1252,1792,40,1
236595,1642,728,914,41,4
236595,231,120,111,42,1
236595,219,117,102,43,1
236595,6,2,4,44,1
236595,213,115,98,45,1
236595,12,3,9,51,1
236595,1411,608,803,52,3
236595,14,6,8,59,1
236595,199,109,90,60,1
236610,5937,2725,3212,1,4
236610,5937,2725,3212,2,1
236610,2927,1368,1559,3,1
236610,419,244,175,4,1
236610,2508,1124,1384,5,1
236610,3010,1357,1653,11,1
236610,1223,494,729,19,1
236610,1285,630,655,20,1
236610,3227,1693,1534,21,4
236610,3227,1693,1534,22,1
236610,1839,923,916,23,1
236610,341,204,137,24,1
236610,1498,719,779,25,1
236610,1388,770,618,31,1
236610,728,317,411,39,1
236610,770,402,368,40,1
236610,2710,1032,1678,41,4
236610,2710,1032,1678,42,1
236610,1088,445,643,43,1
236610,78,40,38,44,1
236610,1010,405,605,45,1
236610,1622,587,1035,51,1
236610,495,177,318,59,1
236610,515,228,287,60,1
236638,4790,2001,2789,1,4
236638,4790,2001,2789,2,1
236638,2768,1173,1595,3,1
236638,546,278,268,4,1
236638,2222,895,1327,5,1
236638,2022,828,1194,11,1
236638,809,324,485,19,1
236638,1413,571,842,20,1
236638,2571,1232,1339,21,4
236638,2571,1232,1339,22,1
236638,1746,841,905,23,1
236638,432,231,201,24,1
236638,1314,610,704,25,1
236638,825,391,434,31,1
236638,479,224,255,39,1
236638,835,386,449,40,1
236638,2219,769,1450,41,4
236638,2219,769,1450,42,1
236638,1022,332,690,43,1
236638,114,47,67,44,1
236638,908,285,623,45,1
236638,1197,437,760,51,1
236638,330,100,230,59,1
236638,578,185,393,60,1
236656,4938,2108,2830,1,4
236656,4938,2108,2830,2,1
236656,3284,1453,1831,3,1
236656,556,291,265,4,1
236656,2728,1162,1566,5,1
236656,1654,655,999,11,1
236656,1104,444,660,19,1
236656,1624,718,906,20,1
236656,2765,1299,1466,21,4
236656,2765,1299,1466,22,1
236656,1967,950,1017,23,1
236656,401,219,182,24,1
236656,1566,731,835,25,1
236656,798,349,449,31,1
236656,606,279,327,39,1
236656,960,452,508,40,1
236656,2173,809,1364,41,4
236656,2173,809,1364,42,1
236656,1317,503,814,43,1
236656,155,72,83,44,1
236656,1162,431,731,45,1
236656,856,306,550,51,1
236656,498,165,333,59,1
236656,664,266,398,60,1
236692,6731,3237,3494,1,4
236692,6731,3237,3494,2,1
236692,4858,2011,2847,3,1
236692,678,352,326,4,1
236692,4180,1659,2521,5,1
236692,1873,1226,647,11,1
236692,1653,651,1002,19,1
236692,2527,1008,1519,20,1
236692,4381,2025,2356,21,4
236692,4381,2025,2356,22,1
236692,3620,1637,1983,23,1
236692,597,315,282,24,1
236692,3023,1322,1701,25,1
236692,761,388,373,31,1
236692,1152,522,630,39,1
236692,1871,800,1071,40,1
236692,2350,1212,1138,41,4
236692,2350,1212,1138,42,1
236692,1238,374,864,43,1
236692,81,37,44,44,1
236692,1157,337,820,45,1
236692,1112,838,274,51,1
236692,501,129,372,59,1
236692,656,208,448,60,1
236708,8855,3408,5447,1,4
236708,8855,3408,5447,2,1
236708,4565,1983,2582,3,1
236708,938,445,493,4,1
236708,3627,1538,2089,5,1
236708,4290,1425,2865,11,1
236708,1141,512,629,19,1
236708,2486,1026,1460,20,1
236708,4503,2054,2449,21,4
236708,4503,2054,2449,22,1
236708,3401,1530,1871,23,1
236708,808,390,418,24,1
236708,2593,1140,1453,25,1
236708,1102,524,578,31,1
236708,781,369,412,39,1
236708,1812,771,1041,40,1
236708,4352,1354,2998,41,4
236708,4352,1354,2998,42,1
236708,1164,453,711,43,1
236708,130,55,75,44,1
236708,1034,398,636,45,1
236708,3188,901,2287,51,1
236708,360,143,217,59,1
236708,674,255,419,60,1
236744,102,4,98,1,4
236744,102,4,98,2,1
236744,102,4,98,3,1
236744,34,3,31,4,1
236744,68,1,67,5,1
236744,68,1,67,20,1
236744,102,4,98,21,4
236744,102,4,98,22,1
236744,102,4,98,23,1
236744,34,3,31,24,1
236744,68,1,67,25,1
236744,68,1,67,40,1
236753,7146,2700,4446,1,4
236753,7146,2700,4446,2,1
236753,5262,2021,3241,3,1
236753,667,313,354,4,1
236753,4595,1708,2887,5,1
236753,1884,679,1205,11,1
236753,1773,557,1216,19,1
236753,2822,1151,1671,20,1
236753,4373,1716,2657,21,4
236753,4373,1716,2657,22,1
236753,3372,1346,2026,23,1
236753,529,246,283,24,1
236753,2843,1100,1743,25,1
236753,1001,370,631,31,1
236753,1070,362,708,39,1
236753,1773,738,1035,40,1
236753,2773,984,1789,41,4
236753,2773,984,1789,42,1
236753,1890,675,1215,43,1
236753,138,67,71,44,1
236753,1752,608,1144,45,1
236753,883,309,574,51,1
236753,703,195,508,59,1
236753,1049,413,636,60,1
236887,5109,2908,2201,1,4
236887,5109,2908,2201,2,1
236887,2715,1475,1240,3,1
236887,491,256,235,4,1
236887,2224,1219,1005,5,1
236887,2394,1433,961,11,1
236887,767,362,405,19,1
236887,1457,857,600,20,1
236887,2969,1654,1315,21,4
236887,2969,1654,1315,22,1
236887,2069,1097,972,23,1
236887,454,239,215,24,1
236887,1615,858,757,25,1
236887,900,557,343,31,1
236887,554,252,302,39,1
236887,1061,606,455,40,1
236887,2140,1254,886,41,4
236887,2140,1254,886,42,1
236887,646,378,268,43,1
236887,37,17,20,44,1
236887,609,361,248,45,1
236887,1494,876,618,51,1
236887,213,110,103,59,1
236887,396,251,145,60,1
236896,1917,890,1027,1,4
236896,1686,836,850,2,1
236896,1646,817,829,3,1
236896,389,181,208,4,1
236896,1257,636,621,5,1
236896,40,19,21,11,1
236896,231,54,177,12,3
236896,98,44,54,19,1
236896,1159,592,567,20,1
236896,1802,832,970,21,4
236896,1592,789,803,22,1
236896,1589,787,802,23,1
236896,387,179,208,24,1
236896,1202,608,594,25,1
236896,3,2,1,31,1
236896,210,43,167,32,3
236896,90,43,47,39,1
236896,1112,565,547,40,1
236896,115,58,57,41,4
236896,94,47,47,42,1
236896,57,30,27,43,1
236896,2,2,0,44,1
236896,55,28,27,45,1
236896,37,17,20,51,1
236896,21,11,10,52,3
236896,8,1,7,59,1
236896,47,27,20,60,1
236939,27642,13607,14035,1,4
236939,23070,11379,11691,2,1
236939,22825,11273,11552,3,1
236939,4163,1954,2209,4,1
236939,18662,9319,9343,5,1
236939,245,106,139,11,1
236939,4572,2228,2344,12,3
236939,2346,1164,1182,19,1
236939,16316,8155,8161,20,1
236939,23604,11741,11863,21,4
236939,20312,10195,10117,22,1
236939,20254,10168,10086,23,1
236939,4057,1902,2155,24,1
236939,16197,8266,7931,25,1
236939,58,27,31,31,1
236939,3292,1546,1746,32,3
236939,1923,1001,922,39,1
236939,14274,7265,7009,40,1
236939,4038,1866,2172,41,4
236939,2758,1184,1574,42,1
236939,2571,1105,1466,43,1
236939,106,52,54,44,1
236939,2465,1053,1412,45,1
236939,187,79,108,51,1
236939,1280,682,598,52,3
236939,423,163,260,59,1
236939,2042,890,1152,60,1
236948,43762,20941,22821,1,4
236948,29756,14235,15521,2,1
236948,28754,13751,15003,3,1
236948,6203,2939,3264,4,1
236948,22551,10812,11739,5,1
236948,1002,484,518,11,1
236948,14006,6706,7300,12,3
236948,1503,707,796,19,1
236948,21048,10105,10943,20,1
236948,38327,18179,20148,21,4
236948,27050,12831,14219,22,1
236948,27015,12817,14198,23,1
236948,6144,2908,3236,24,1
236948,20871,9909,10962,25,1
236948,35,14,21,31,1
236948,11277,5348,5929,32,3
236948,1338,627,711,39,1
236948,19533,9282,10251,40,1
236948,5435,2762,2673,41,4
236948,2706,1404,1302,42,1
236948,1739,934,805,43,1
236948,59,31,28,44,1
236948,1680,903,777,45,1
236948,967,470,497,51,1
236948,2729,1358,1371,52,3
236948,165,80,85,59,1
236948,1515,823,692,60,1
236975,3619,1541,2078,1,4
236975,3619,1541,2078,2,1
236975,2700,1126,1574,3,1
236975,553,265,288,4,1
236975,2147,861,1286,5,1
236975,919,415,504,11,1
236975,507,196,311,19,1
236975,1640,665,975,20,1
236975,2624,1171,1453,21,4
236975,2624,1171,1453,22,1
236975,2042,880,1162,23,1
236975,461,225,236,24,1
236975,1581,655,926,25,1
236975,582,291,291,31,1
236975,395,166,229,39,1
236975,1186,489,697,40,1
236975,995,370,625,41,4
236975,995,370,625,42,1
236975,658,246,412,43,1
236975,92,40,52,44,1
236975,566,206,360,45,1
236975,337,124,213,51,1
236975,112,30,82,59,1
236975,454,176,278,60,1
236993,324,52,272,1,4
236993,324,52,272,2,1
236993,324,52,272,3,1
236993,59,5,54,4,1
236993,265,47,218,5,1
236993,33,6,27,19,1
236993,232,41,191,20,1
236993,274,45,229,21,4
236993,274,45,229,22,1
236993,274,45,229,23,1
236993,59,5,54,24,1
236993,215,40,175,25,1
236993,33,6,27,39,1
236993,182,34,148,40,1
236993,50,7,43,41,4
236993,50,7,43,42,1
236993,50,7,43,43,1
236993,50,7,43,45,1
236993,50,7,43,60,1
237011,14950,6632,8318,1,4
237011,14026,6290,7736,2,1
237011,13925,6241,7684,3,1
237011,2795,1181,1614,4,1
237011,11130,5060,6070,5,1
237011,101,49,52,11,1
237011,924,342,582,12,3
237011,1045,473,572,19,1
237011,10085,4587,5498,20,1
237011,13457,5882,7575,21,4
237011,12942,5701,7241,22,1
237011,12915,5689,7226,23,1
237011,2764,1169,1595,24,1
237011,10151,4520,5631,25,1
237011,27,12,15,31,1
237011,515,181,334,32,3
237011,942,425,517,39,1
237011,9209,4095,5114,40,1
237011,1493,750,743,41,4
237011,1084,589,495,42,1
237011,1010,552,458,43,1
237011,31,12,19,44,1
237011,979,540,439,45,1
237011,74,37,37,51,1
237011,409,161,248,52,3
237011,103,48,55,59,1
237011,876,492,384,60,1
237039,4427,1971,2456,1,4
237039,4427,1971,2456,2,1
237039,2971,1325,1646,3,1
237039,377,177,200,4,1
237039,2594,1148,1446,5,1
237039,1456,646,810,11,1
237039,947,399,548,19,1
237039,1647,749,898,20,1
237039,2466,1143,1323,21,4
237039,2466,1143,1323,22,1
237039,1780,812,968,23,1
237039,289,126,163,24,1
237039,1491,686,805,25,1
237039,686,331,355,31,1
237039,521,238,283,39,1
237039,970,448,522,40,1
237039,1961,828,1133,41,4
237039,1961,828,1133,42,1
237039,1191,513,678,43,1
237039,88,51,37,44,1
237039,1103,462,641,45,1
237039,770,315,455,51,1
237039,426,161,265,59,1
237039,677,301,376,60,1
237057,1541,666,875,1,4
237057,1541,666,875,2,1
237057,1525,659,866,3,1
237057,392,172,220,4,1
237057,1133,487,646,5,1
237057,16,7,9,11,1
237057,20,6,14,19,1
237057,1113,481,632,20,1
237057,1505,646,859,21,4
237057,1505,646,859,22,1
237057,1502,646,856,23,1
237057,392,172,220,24,1
237057,1110,474,636,25,1
237057,3,0,3,31,1
237057,20,6,14,39,1
237057,1090,468,622,40,1
237057,36,20,16,41,4
237057,36,20,16,42,1
237057,23,13,10,43,1
237057,23,13,10,45,1
237057,13,7,6,51,1
237057,23,13,10,60,1
237066,2569,1012,1557,1,4
237066,2358,934,1424,2,1
237066,2337,929,1408,3,1
237066,593,233,360,4,1
237066,1744,696,1048,5,1
237066,21,5,16,11,1
237066,211,78,133,12,3
237066,84,28,56,19,1
237066,1660,668,992,20,1
237066,2373,935,1438,21,4
237066,2317,917,1400,22,1
237066,2307,916,1391,23,1
237066,593,233,360,24,1
237066,1714,683,1031,25,1
237066,10,1,9,31,1
237066,56,18,38,32,3
237066,83,28,55,39,1
237066,1631,655,976,40,1
237066,196,77,119,41,4
237066,41,17,24,42,1
237066,30,13,17,43,1
237066,30,13,17,45,1
237066,11,4,7,51,1
237066,155,60,95,52,3
237066,1,0,1,59,1
237066,29,13,16,60,1
237109,4105,1423,2682,1,4
237109,4105,1423,2682,2,1
237109,2587,930,1657,3,1
237109,402,173,229,4,1
237109,2185,757,1428,5,1
237109,1518,493,1025,11,1
237109,543,173,370,19,1
237109,1642,584,1058,20,1
237109,2873,1030,1843,21,4
237109,2873,1030,1843,22,1
237109,1882,698,1184,23,1
237109,317,139,178,24,1
237109,1565,559,1006,25,1
237109,991,332,659,31,1
237109,390,122,268,39,1
237109,1175,437,738,40,1
237109,1232,393,839,41,4
237109,1232,393,839,42,1
237109,705,232,473,43,1
237109,85,34,51,44,1
237109,620,198,422,45,1
237109,527,161,366,51,1
237109,153,51,102,59,1
237109,467,147,320,60,1
237118,1117,565,552,1,4
237118,1052,543,509,2,1
237118,1032,537,495,3,1
237118,438,255,183,4,1
237118,594,282,312,5,1
237118,20,6,14,11,1
237118,65,22,43,12,3
237118,74,34,40,19,1
237118,520,248,272,20,1
237118,1060,553,507,21,4
237118,995,531,464,22,1
237118,992,530,462,23,1
237118,438,255,183,24,1
237118,554,275,279,25,1
237118,3,1,2,31,1
237118,65,22,43,32,3
237118,66,34,32,39,1
237118,488,241,247,40,1
237118,57,12,45,41,4
237118,57,12,45,42,1
237118,40,7,33,43,1
237118,40,7,33,45,1
237118,17,5,12,51,1
237118,8,0,8,59,1
237118,32,7,25,60,1
237127,19,1,18,1,4
237127,19,1,18,2,1
237127,19,1,18,3,1
237127,7,1,6,4,1
237127,12,0,12,5,1
237127,12,0,12,20,1
237127,19,1,18,21,4
237127,19,1,18,22,1
237127,19,1,18,23,1
237127,7,1,6,24,1
237127,12,0,12,25,1
237127,12,0,12,40,1
237136,285,136,149,1,4
237136,278,129,149,2,1
237136,204,99,105,3,1
237136,61,31,30,4,1
237136,143,68,75,5,1
237136,74,30,44,11,1
237136,7,7,0,12,3
237136,24,13,11,19,1
237136,119,55,64,20,1
237136,197,97,100,21,4
237136,197,97,100,22,1
237136,197,97,100,23,1
237136,60,30,30,24,1
237136,137,67,70,25,1
237136,23,12,11,39,1
237136,114,55,59,40,1
237136,88,39,49,41,4
237136,81,32,49,42,1
237136,7,2,5,43,1
237136,1,1,0,44,1
237136,6,1,5,45,1
237136,74,30,44,51,1
237136,7,7,0,52,3
237136,1,1,0,59,1
237136,5,0,5,60,1
237145,36,3,33,1,4
237145,36,3,33,2,1
237145,36,3,33,3,1
237145,16,2,14,4,1
237145,20,1,19,5,1
237145,20,1,19,20,1
237145,36,3,33,21,4
237145,36,3,33,22,1
237145,36,3,33,23,1
237145,16,2,14,24,1
237145,20,1,19,25,1
237145,20,1,19,40,1
237172,477,362,115,1,4
237172,477,362,115,2,1
237172,477,362,115,3,1
237172,455,340,115,4,1
237172,22,22,0,5,1
237172,22,22,0,20,1
237172,120,102,18,21,4
237172,120,102,18,22,1
237172,120,102,18,23,1
237172,109,91,18,24,1
237172,11,11,0,25,1
237172,11,11,0,40,1
237172,357,260,97,41,4
237172,357,260,97,42,1
237172,357,260,97,43,1
237172,346,249,97,44,1
237172,11,11,0,45,1
237172,11,11,0,60,1
237181,726,406,320,1,4
237181,693,390,303,2,1
237181,690,389,301,3,1
237181,183,104,79,4,1
237181,507,285,222,5,1
237181,3,1,2,11,1
237181,33,16,17,12,3
237181,29,18,11,19,1
237181,478,267,211,20,1
237181,718,401,317,21,4
237181,690,388,302,22,1
237181,688,387,301,23,1
237181,183,104,79,24,1
237181,505,283,222,25,1
237181,2,1,1,31,1
237181,28,13,15,32,3
237181,29,18,11,39,1
237181,476,265,211,40,1
237181,8,5,3,41,4
237181,3,2,1,42,1
237181,2,2,0,43,1
237181,2,2,0,45,1
237181,1,0,1,51,1
237181,5,3,2,52,3
237181,2,2,0,60,1
237215,1747,663,1084,1,4
237215,1747,663,1084,2,1
237215,1708,651,1057,3,1
237215,303,134,169,4,1
237215,1405,517,888,5,1
237215,39,12,27,11,1
237215,161,55,106,19,1
237215,1244,462,782,20,1
237215,1440,578,862,21,4
237215,1440,578,862,22,1
237215,1437,576,861,23,1
237215,295,130,165,24,1
237215,1142,446,696,25,1
237215,3,2,1,31,1
237215,134,48,86,39,1
237215,1008,398,610,40,1
237215,307,85,222,41,4
237215,307,85,222,42,1
237215,271,75,196,43,1
237215,8,4,4,44,1
237215,263,71,192,45,1
237215,36,10,26,51,1
237215,27,7,20,59,1
237215,236,64,172,60,1
237242,130,95,35,1,4
237242,130,95,35,2,1
237242,130,95,35,3,1
237242,43,29,14,4,1
237242,87,66,21,5,1
237242,87,66,21,20,1
237242,70,37,33,21,4
237242,70,37,33,22,1
237242,70,37,33,23,1
237242,37,24,13,24,1
237242,33,13,20,25,1
237242,33,13,20,40,1
237242,60,58,2,41,4
237242,60,58,2,42,1
237242,60,58,2,43,1
237242,6,5,1,44,1
237242,54,53,1,45,1
237242,54,53,1,60,1
237303,121,42,79,1,4
237303,121,42,79,2,1
237303,121,42,79,3,1
237303,41,20,21,4,1
237303,80,22,58,5,1
237303,80,22,58,20,1
237303,121,42,79,21,4
237303,121,42,79,22,1
237303,121,42,79,23,1
237303,41,20,21,24,1
237303,80,22,58,25,1
237303,80,22,58,40,1
237312,1935,858,1077,1,4
237312,1386,577,809,2,1
237312,1373,572,801,3,1
237312,272,114,158,4,1
237312,1101,458,643,5,1
237312,13,5,8,11,1
237312,549,281,268,12,3
237312,345,160,185,19,1
237312,756,298,458,20,1
237312,1788,789,999,21,4
237312,1250,513,737,22,1
237312,1250,513,737,23,1
237312,271,114,157,24,1
237312,979,399,580,25,1
237312,538,276,262,32,3
237312,287,129,158,39,1
237312,692,270,422,40,1
237312,147,69,78,41,4
237312,136,64,72,42,1
237312,123,59,64,43,1
237312,1,0,1,44,1
237312,122,59,63,45,1
237312,13,5,8,51,1
237312,11,5,6,52,3
237312,58,31,27,59,1
237312,64,28,36,60,1
237321,70,12,58,1,4
237321,70,12,58,2,1
237321,70,12,58,3,1
237321,41,6,35,4,1
237321,29,6,23,5,1
237321,29,6,23,20,1
237321,70,12,58,21,4
237321,70,12,58,22,1
237321,70,12,58,23,1
237321,41,6,35,24,1
237321,29,6,23,25,1
237321,29,6,23,40,1
237330,2767,1132,1635,1,4
237330,2505,1085,1420,2,1
237330,2474,1076,1398,3,1
237330,517,235,282,4,1
237330,1957,841,1116,5,1
237330,31,9,22,11,1
237330,262,47,215,12,3
237330,181,65,116,19,1
237330,1776,776,1000,20,1
237330,2339,1003,1336,21,4
237330,2275,991,1284,22,1
237330,2272,991,1281,23,1
237330,507,233,274,24,1
237330,1765,758,1007,25,1
237330,3,0,3,31,1
237330,64,12,52,32,3
237330,169,59,110,39,1
237330,1596,699,897,40,1
237330,428,129,299,41,4
237330,230,94,136,42,1
237330,202,85,117,43,1
237330,10,2,8,44,1
237330,192,83,109,45,1
237330,28,9,19,51,1
237330,198,35,163,52,3
237330,12,6,6,59,1
237330,180,77,103,60,1
237358,874,401,473,1,4
237358,874,401,473,2,1
237358,866,399,467,3,1
237358,269,125,144,4,1
237358,597,274,323,5,1
237358,8,2,6,11,1
237358,48,21,27,19,1
237358,549,253,296,20,1
237358,847,397,450,21,4
237358,847,397,450,22,1
237358,847,397,450,23,1
237358,269,125,144,24,1
237358,578,272,306,25,1
237358,42,21,21,39,1
237358,536,251,285,40,1
237358,27,4,23,41,4
237358,27,4,23,42,1
237358,19,2,17,43,1
237358,19,2,17,45,1
237358,8,2,6,51,1
237358,6,0,6,59,1
237358,13,2,11,60,1
237367,4232,1862,2370,1,4
237367,3966,1782,2184,2,1
237367,3856,1753,2103,3,1
237367,750,354,396,4,1
237367,3106,1399,1707,5,1
237367,110,29,81,11,1
237367,266,80,186,12,3
237367,406,165,241,19,1
237367,2700,1234,1466,20,1
237367,3541,1636,1905,21,4
237367,3435,1595,1840,22,1
237367,3411,1587,1824,23,1
237367,741,351,390,24,1
237367,2670,1236,1434,25,1
237367,24,8,16,31,1
237367,106,41,65,32,3
237367,353,155,198,39,1
237367,2317,1081,1236,40,1
237367,691,226,465,41,4
237367,531,187,344,42,1
237367,445,166,279,43,1
237367,9,3,6,44,1
237367,436,163,273,45,1
237367,86,21,65,51,1
237367,160,39,121,52,3
237367,53,10,43,59,1
237367,383,153,230,60,1
237385,1850,1055,795,1,4
237385,1850,1055,795,2,1
237385,1413,826,587,3,1
237385,315,182,133,4,1
237385,1098,644,454,5,1
237385,437,229,208,11,1
237385,154,90,64,19,1
237385,944,554,390,20,1
237385,1114,625,489,21,4
237385,1114,625,489,22,1
237385,1092,620,472,23,1
237385,280,163,117,24,1
237385,812,457,355,25,1
237385,22,5,17,31,1
237385,58,36,22,39,1
237385,754,421,333,40,1
237385,736,430,306,41,4
237385,736,430,306,42,1
237385,321,206,115,43,1
237385,35,19,16,44,1
237385,286,187,99,45,1
237385,415,224,191,51,1
237385,96,54,42,59,1
237385,190,133,57,60,1
237437,685,222,463,1,4
237437,685,222,463,2,1
237437,682,220,462,3,1
237437,125,76,49,4,1
237437,557,144,413,5,1
237437,3,2,1,11,1
237437,98,28,70,19,1
237437,459,116,343,20,1
237437,583,203,380,21,4
237437,583,203,380,22,1
237437,583,203,380,23,1
237437,120,75,45,24,1
237437,463,128,335,25,1
237437,88,26,62,39,1
237437,375,102,273,40,1
237437,102,19,83,41,4
237437,102,19,83,42,1
237437,99,17,82,43,1
237437,5,1,4,44,1
237437,94,16,78,45,1
237437,3,2,1,51,1
237437,10,2,8,59,1
237437,84,14,70,60,1
237473,129,84,45,1,4
237473,129,84,45,2,1
237473,129,84,45,3,1
237473,93,58,35,4,1
237473,36,26,10,5,1
237473,36,26,10,20,1
237473,129,84,45,21,4
237473,129,84,45,22,1
237473,129,84,45,23,1
237473,93,58,35,24,1
237473,36,26,10,25,1
237473,36,26,10,40,1
237491,27,2,25,1,4
237491,27,2,25,2,1
237491,27,2,25,3,1
237491,6,2,4,4,1
237491,21,0,21,5,1
237491,21,0,21,20,1
237491,27,2,25,21,4
237491,27,2,25,22,1
237491,27,2,25,23,1
237491,6,2,4,24,1
237491,21,0,21,25,1
237491,21,0,21,40,1
237525,13407,5557,7850,1,4
237525,9756,4245,5511,2,1
237525,9098,3988,5110,3,1
237525,1857,781,1076,4,1
237525,7241,3207,4034,5,1
237525,658,257,401,11,1
237525,3651,1312,2339,12,3
237525,613,273,340,19,1
237525,6628,2934,3694,20,1
237525,9949,4387,5562,21,4
237525,8268,3644,4624,22,1
237525,8211,3618,4593,23,1
237525,1843,775,1068,24,1
237525,6368,2843,3525,25,1
237525,57,26,31,31,1
237525,1681,743,938,32,3
237525,506,243,263,39,1
237525,5862,2600,3262,40,1
237525,3458,1170,2288,41,4
237525,1488,601,887,42,1
237525,887,370,517,43,1
237525,14,6,8,44,1
237525,873,364,509,45,1
237525,601,231,370,51,1
237525,1970,569,1401,52,3
237525,107,30,77,59,1
237525,766,334,432,60,1
237543,219,66,153,1,4
237543,219,66,153,2,1
237543,219,66,153,3,1
237543,156,50,106,4,1
237543,63,16,47,5,1
237543,63,16,47,20,1
237543,70,14,56,21,4
237543,70,14,56,22,1
237543,70,14,56,23,1
237543,67,14,53,24,1
237543,3,0,3,25,1
237543,3,0,3,40,1
237543,149,52,97,41,4
237543,149,52,97,42,1
237543,149,52,97,43,1
237543,89,36,53,44,1
237543,60,16,44,45,1
237543,60,16,44,60,1
237552,121,13,108,1,4
237552,121,13,108,2,1
237552,121,13,108,3,1
237552,25,2,23,4,1
237552,96,11,85,5,1
237552,96,11,85,20,1
237552,121,13,108,21,4
237552,121,13,108,22,1
237552,121,13,108,23,1
237552,25,2,23,24,1
237552,96,11,85,25,1
237552,96,11,85,40,1
237561,84,24,60,1,4
237561,84,24,60,2,1
237561,84,24,60,3,1
237561,30,12,18,4,1
237561,54,12,42,5,1
237561,54,12,42,20,1
237561,81,23,58,21,4
237561,81,23,58,22,1
237561,81,23,58,23,1
237561,27,11,16,24,1
237561,54,12,42,25,1
237561,54,12,42,40,1
237561,3,1,2,41,4
237561,3,1,2,42,1
237561,3,1,2,43,1
237561,3,1,2,44,1
237570,68,5,63,1,4
237570,68,5,63,2,1
237570,68,5,63,3,1
237570,14,0,14,4,1
237570,54,5,49,5,1
237570,54,5,49,20,1
237570,68,5,63,21,4
237570,68,5,63,22,1
237570,68,5,63,23,1
237570,14,0,14,24,1
237570,54,5,49,25,1
237570,54,5,49,40,1
237598,153,33,120,1,4
237598,153,33,120,2,1
237598,153,33,120,3,1
237598,11,7,4,4,1
237598,142,26,116,5,1
237598,142,26,116,20,1
237598,141,32,109,21,4
237598,141,32,109,22,1
237598,141,32,109,23,1
237598,10,7,3,24,1
237598,131,25,106,25,1
237598,131,25,106,40,1
237598,12,1,11,41,4
237598,12,1,11,42,1
237598,12,1,11,43,1
237598,1,0,1,44,1
237598,11,1,10,45,1
237598,11,1,10,60,1
237604,232,58,174,1,4
237604,232,58,174,2,1
237604,232,58,174,3,1
237604,37,10,27,4,1
237604,195,48,147,5,1
237604,19,3,16,19,1
237604,176,45,131,20,1
237604,232,58,174,21,4
237604,232,58,174,22,1
237604,232,58,174,23,1
237604,37,10,27,24,1
237604,195,48,147,25,1
237604,19,3,16,39,1
237604,176,45,131,40,1
237613,96,6,90,1,4
237613,96,6,90,2,1
237613,96,6,90,3,1
237613,43,0,43,4,1
237613,53,6,47,5,1
237613,53,6,47,20,1
237613,96,6,90,21,4
237613,96,6,90,22,1
237613,96,6,90,23,1
237613,43,0,43,24,1
237613,53,6,47,25,1
237613,53,6,47,40,1
237640,451,239,212,1,4
237640,410,220,190,2,1
237640,394,218,176,3,1
237640,89,55,34,4,1
237640,305,163,142,5,1
237640,16,2,14,11,1
237640,41,19,22,12,3
237640,34,17,17,19,1
237640,271,146,125,20,1
237640,383,211,172,21,4
237640,372,205,167,22,1
237640,370,205,165,23,1
237640,89,55,34,24,1
237640,281,150,131,25,1
237640,2,0,2,31,1
237640,11,6,5,32,3
237640,34,17,17,39,1
237640,247,133,114,40,1
237640,68,28,40,41,4
237640,38,15,23,42,1
237640,24,13,11,43,1
237640,24,13,11,45,1
237640,14,2,12,51,1
237640,30,13,17,52,3
237640,24,13,11,60,1
237686,3461,1345,2116,1,4
237686,3461,1345,2116,2,1
237686,3043,1138,1905,3,1
237686,540,246,294,4,1
237686,2503,892,1611,5,1
237686,418,207,211,11,1
237686,216,88,128,19,1
237686,2287,804,1483,20,1
237686,2128,818,1310,21,4
237686,2128,818,1310,22,1
237686,2124,817,1307,23,1
237686,456,202,254,24,1
237686,1668,615,1053,25,1
237686,4,1,3,31,1
237686,138,60,78,39,1
237686,1530,555,975,40,1
237686,1333,527,806,41,4
237686,1333,527,806,42,1
237686,919,321,598,43,1
237686,84,44,40,44,1
237686,835,277,558,45,1
237686,414,206,208,51,1
237686,78,28,50,59,1
237686,757,249,508,60,1
237701,1660,767,893,1,4
237701,1660,767,893,2,1
237701,1378,669,709,3,1
237701,631,328,303,4,1
237701,747,341,406,5,1
237701,282,98,184,11,1
237701,49,23,26,19,1
237701,698,318,380,20,1
237701,1289,633,656,21,4
237701,1289,633,656,22,1
237701,1289,633,656,23,1
237701,624,324,300,24,1
237701,665,309,356,25,1
237701,41,20,21,39,1
237701,624,289,335,40,1
237701,371,134,237,41,4
237701,371,134,237,42,1
237701,89,36,53,43,1
237701,7,4,3,44,1
237701,82,32,50,45,1
237701,282,98,184,51,1
237701,8,3,5,59,1
237701,74,29,45,60,1
237729,124,38,86,1,4
237729,124,38,86,2,1
237729,124,38,86,3,1
237729,49,24,25,4,1
237729,75,14,61,5,1
237729,75,14,61,20,1
237729,55,5,50,21,4
237729,55,5,50,22,1
237729,55,5,50,23,1
237729,11,1,10,24,1
237729,44,4,40,25,1
237729,44,4,40,40,1
237729,69,33,36,41,4
237729,69,33,36,42,1
237729,69,33,36,43,1
237729,38,23,15,44,1
237729,31,10,21,45,1
237729,31,10,21,60,1
237783,618,279,339,1,4
237783,441,205,236,2,1
237783,441,205,236,3,1
237783,129,70,59,4,1
237783,312,135,177,5,1
237783,177,74,103,12,3
237783,69,31,38,19,1
237783,243,104,139,20,1
237783,615,277,338,21,4
237783,441,205,236,22,1
237783,441,205,236,23,1
237783,129,70,59,24,1
237783,312,135,177,25,1
237783,174,72,102,32,3
237783,69,31,38,39,1
237783,243,104,139,40,1
237783,3,2,1,41,4
237783,3,2,1,52,3
237792,4221,1780,2441,1,4
237792,3990,1703,2287,2,1
237792,3695,1523,2172,3,1
237792,684,300,384,4,1
237792,3011,1223,1788,5,1
237792,295,180,115,11,1
237792,231,77,154,12,3
237792,355,140,215,19,1
237792,2656,1083,1573,20,1
237792,3371,1385,1986,21,4
237792,3289,1351,1938,22,1
237792,3288,1350,1938,23,1
237792,676,297,379,24,1
237792,2612,1053,1559,25,1
237792,1,1,0,31,1
237792,82,34,48,32,3
237792,299,122,177,39,1
237792,2313,931,1382,40,1
237792,850,395,455,41,4
237792,701,352,349,42,1
237792,407,173,234,43,1
237792,8,3,5,44,1
237792,399,170,229,45,1
237792,294,179,115,51,1
237792,149,43,106,52,3
237792,56,18,38,59,1
237792,343,152,191,60,1
237817,2002,668,1334,1,4
237817,2002,668,1334,2,1
237817,1829,593,1236,3,1
237817,536,185,351,4,1
237817,1293,408,885,5,1
237817,173,75,98,11,1
237817,94,39,55,19,1
237817,1199,369,830,20,1
237817,1276,406,870,21,4
237817,1276,406,870,22,1
237817,1266,399,867,23,1
237817,468,156,312,24,1
237817,798,243,555,25,1
237817,10,7,3,31,1
237817,58,21,37,39,1
237817,740,222,518,40,1
237817,726,262,464,41,4
237817,726,262,464,42,1
237817,563,194,369,43,1
237817,68,29,39,44,1
237817,495,165,330,45,1
237817,163,68,95,51,1
237817,36,18,18,59,1
237817,459,147,312,60,1
237844,120,90,30,1,4
237844,120,90,30,2,1
237844,120,90,30,3,1
237844,118,88,30,4,1
237844,2,2,0,5,1
237844,2,2,0,20,1
237844,91,64,27,21,4
237844,91,64,27,22,1
237844,91,64,27,23,1
237844,90,63,27,24,1
237844,1,1,0,25,1
237844,1,1,0,40,1
237844,29,26,3,41,4
237844,29,26,3,42,1
237844,29,26,3,43,1
237844,28,25,3,44,1
237844,1,1,0,45,1
237844,1,1,0,60,1
237880,817,436,381,1,4
237880,817,436,381,12,3
237880,817,436,381,21,4
237880,817,436,381,32,3
237899,2677,1208,1469,1,4
237899,2622,1184,1438,2,1
237899,2195,999,1196,3,1
237899,418,218,200,4,1
237899,1777,781,996,5,1
237899,427,185,242,11,1
237899,55,24,31,12,3
237899,230,103,127,19,1
237899,1547,678,869,20,1
237899,1922,900,1022,21,4
237899,1889,884,1005,22,1
237899,1858,868,990,23,1
237899,403,210,193,24,1
237899,1455,658,797,25,1
237899,31,16,15,31,1
237899,33,16,17,32,3
237899,196,86,110,39,1
237899,1259,572,687,40,1
237899,755,308,447,41,4
237899,733,300,433,42,1
237899,337,131,206,43,1
237899,15,8,7,44,1
237899,322,123,199,45,1
237899,396,169,227,51,1
237899,22,8,14,52,3
237899,34,17,17,59,1
237899,288,106,182,60,1
237905,49,8,41,1,4
237905,42,8,34,2,1
237905,42,8,34,3,1
237905,15,4,11,4,1
237905,27,4,23,5,1
237905,7,0,7,12,3
237905,27,4,23,20,1
237905,49,8,41,21,4
237905,42,8,34,22,1
237905,42,8,34,23,1
237905,15,4,11,24,1
237905,27,4,23,25,1
237905,7,0,7,32,3
237905,27,4,23,40,1
237932,2776,1110,1666,1,4
237932,2660,1071,1589,2,1
237932,2412,998,1414,3,1
237932,501,206,295,4,1
237932,1911,792,1119,5,1
237932,248,73,175,11,1
237932,116,39,77,12,3
237932,203,79,124,19,1
237932,1708,713,995,20,1
237932,2269,942,1327,21,4
237932,2200,919,1281,22,1
237932,2184,916,1268,23,1
237932,498,206,292,24,1
237932,1686,710,976,25,1
237932,16,3,13,31,1
237932,69,23,46,32,3
237932,159,67,92,39,1
237932,1527,643,884,40,1
237932,507,168,339,41,4
237932,460,152,308,42,1
237932,228,82,146,43,1
237932,3,0,3,44,1
237932,225,82,143,45,1
237932,232,70,162,51,1
237932,47,16,31,52,3
237932,44,12,32,59,1
237932,181,70,111,60,1
237950,1222,760,462,1,4
237950,1222,760,462,2,1
237950,1133,736,397,3,1
237950,305,217,88,4,1
237950,828,519,309,5,1
237950,89,24,65,11,1
237950,122,82,40,19,1
237950,706,437,269,20,1
237950,967,620,347,21,4
237950,967,620,347,22,1
237950,967,620,347,23,1
237950,298,212,86,24,1
237950,669,408,261,25,1
237950,107,71,36,39,1
237950,562,337,225,40,1
237950,255,140,115,41,4
237950,255,140,115,42,1
237950,166,116,50,43,1
237950,7,5,2,44,1
237950,159,111,48,45,1
237950,89,24,65,51,1
237950,15,11,4,59,1
237950,144,100,44,60,1
237969,1469,677,792,1,4
237969,1367,642,725,2,1
237969,1356,641,715,3,1
237969,471,243,228,4,1
237969,885,398,487,5,1
237969,11,1,10,11,1
237969,102,35,67,12,3
237969,40,24,16,19,1
237969,845,374,471,20,1
237969,1433,659,774,21,4
237969,1345,628,717,22,1
237969,1338,628,710,23,1
237969,471,243,228,24,1
237969,867,385,482,25,1
237969,7,0,7,31,1
237969,88,31,57,32,3
237969,39,23,16,39,1
237969,828,362,466,40,1
237969,36,18,18,41,4
237969,22,14,8,42,1
237969,18,13,5,43,1
237969,18,13,5,45,1
237969,4,1,3,51,1
237969,14,4,10,52,3
237969,1,1,0,59,1
237969,17,12,5,60,1
237978,147,18,129,1,4
237978,147,18,129,2,1
237978,147,18,129,3,1
237978,54,7,47,4,1
237978,93,11,82,5,1
237978,93,11,82,20,1
237978,147,18,129,21,4
237978,147,18,129,22,1
237978,147,18,129,23,1
237978,54,7,47,24,1
237978,93,11,82,25,1
237978,93,11,82,40,1
237987,213,50,163,1,4
237987,213,50,163,2,1
237987,213,50,163,3,1
237987,67,16,51,4,1
237987,146,34,112,5,1
237987,40,4,36,19,1
237987,106,30,76,20,1
237987,203,49,154,21,4
237987,203,49,154,22,1
237987,203,49,154,23,1
237987,66,16,50,24,1
237987,137,33,104,25,1
237987,38,4,34,39,1
237987,99,29,70,40,1
237987,10,1,9,41,4
237987,10,1,9,42,1
237987,10,1,9,43,1
237987,1,0,1,44,1
237987,9,1,8,45,1
237987,2,0,2,59,1
237987,7,1,6,60,1
237996,291,62,229,1,4
237996,291,62,229,2,1
237996,291,62,229,3,1
237996,83,18,65,4,1
237996,208,44,164,5,1
237996,93,16,77,19,1
237996,115,28,87,20,1
237996,291,62,229,21,4
237996,291,62,229,22,1
237996,291,62,229,23,1
237996,83,18,65,24,1
237996,208,44,164,25,1
237996,93,16,77,39,1
237996,115,28,87,40,1
238005,70,7,63,1,4
238005,70,7,63,2,1
238005,70,7,63,3,1
238005,31,4,27,4,1
238005,39,3,36,5,1
238005,39,3,36,20,1
238005,70,7,63,21,4
238005,70,7,63,22,1
238005,70,7,63,23,1
238005,31,4,27,24,1
238005,39,3,36,25,1
238005,39,3,36,40,1
238014,2086,687,1399,1,4
238014,2086,687,1399,2,1
238014,1776,564,1212,3,1
238014,337,133,204,4,1
238014,1439,431,1008,5,1
238014,310,123,187,11,1
238014,254,85,169,19,1
238014,1185,346,839,20,1
238014,952,346,606,21,4
238014,952,346,606,22,1
238014,947,343,604,23,1
238014,249,94,155,24,1
238014,698,249,449,25,1
238014,5,3,2,31,1
238014,160,58,102,39,1
238014,538,191,347,40,1
238014,1134,341,793,41,4
238014,1134,341,793,42,1
238014,829,221,608,43,1
238014,88,39,49,44,1
238014,741,182,559,45,1
238014,305,120,185,51,1
238014,94,27,67,59,1
238014,647,155,492,60,1
238032,29466,15321,14145,1,4
238032,22757,12326,10431,2,1
238032,22130,12093,10037,3,1
238032,4913,2566,2347,4,1
238032,17217,9527,7690,5,1
238032,627,233,394,11,1
238032,6709,2995,3714,12,3
238032,1101,626,475,19,1
238032,16116,8901,7215,20,1
238032,25796,13906,11890,21,4
238032,21027,11587,9440,22,1
238032,21027,11587,9440,23,1
238032,4901,2559,2342,24,1
238032,16126,9028,7098,25,1
238032,4769,2319,2450,32,3
238032,1030,601,429,39,1
238032,15096,8427,6669,40,1
238032,3670,1415,2255,41,4
238032,1730,739,991,42,1
238032,1103,506,597,43,1
238032,12,7,5,44,1
238032,1091,499,592,45,1
238032,627,233,394,51,1
238032,1940,676,1264,52,3
238032,71,25,46,59,1
238032,1020,474,546,60,1
238078,1619,654,965,1,4
238078,1180,528,652,2,1
238078,1139,514,625,3,1
238078,250,157,93,4,1
238078,889,357,532,5,1
238078,41,14,27,11,1
238078,439,126,313,12,3
238078,106,55,51,19,1
238078,783,302,481,20,1
238078,1087,529,558,21,4
238078,938,467,471,22,1
238078,938,467,471,23,1
238078,250,157,93,24,1
238078,688,310,378,25,1
238078,149,62,87,32,3
238078,104,53,51,39,1
238078,584,257,327,40,1
238078,532,125,407,41,4
238078,242,61,181,42,1
238078,201,47,154,43,1
238078,201,47,154,45,1
238078,41,14,27,51,1
238078,290,64,226,52,3
238078,2,2,0,59,1
238078,199,45,154,60,1
238096,35,1,34,1,4
238096,35,1,34,2,1
238096,35,1,34,3,1
238096,9,0,9,4,1
238096,26,1,25,5,1
238096,26,1,25,20,1
238096,35,1,34,21,4
238096,35,1,34,22,1
238096,35,1,34,23,1
238096,9,0,9,24,1
238096,26,1,25,25,1
238096,26,1,25,40,1
238166,121,7,114,1,4
238166,121,7,114,2,1
238166,121,7,114,3,1
238166,16,2,14,4,1
238166,105,5,100,5,1
238166,105,5,100,20,1
238166,121,7,114,21,4
238166,121,7,114,22,1
238166,121,7,114,23,1
238166,16,2,14,24,1
238166,105,5,100,25,1
238166,105,5,100,40,1
238175,136,6,130,1,4
238175,136,6,130,2,1
238175,136,6,130,3,1
238175,31,0,31,4,1
238175,105,6,99,5,1
238175,105,6,99,20,1
238175,136,6,130,21,4
238175,136,6,130,22,1
238175,136,6,130,23,1
238175,31,0,31,24,1
238175,105,6,99,25,1
238175,105,6,99,40,1
238193,2536,73,2463,1,4
238193,1862,3,1859,2,1
238193,1833,2,1831,3,1
238193,208,0,208,4,1
238193,1625,2,1623,5,1
238193,29,1,28,11,1
238193,674,70,604,12,3
238193,165,0,165,19,1
238193,1460,2,1458,20,1
238193,1750,47,1703,21,4
238193,1360,0,1360,22,1
238193,1342,0,1342,23,1
238193,202,0,202,24,1
238193,1140,0,1140,25,1
238193,18,0,18,31,1
238193,390,47,343,32,3
238193,140,0,140,39,1
238193,1000,0,1000,40,1
238193,786,26,760,41,4
238193,502,3,499,42,1
238193,491,2,489,43,1
238193,6,0,6,44,1
238193,485,2,483,45,1
238193,11,1,10,51,1
238193,284,23,261,52,3
238193,25,0,25,59,1
238193,460,2,458,60,1
238263,15402,6925,8477,1,4
238263,15340,6912,8428,2,1
238263,12863,5683,7180,3,1
238263,2631,1373,1258,4,1
238263,10232,4310,5922,5,1
238263,2477,1229,1248,11,1
238263,62,13,49,12,3
238263,1094,504,590,19,1
238263,9138,3806,5332,20,1
238263,5160,2762,2398,21,4
238263,5138,2755,2383,22,1
238263,4967,2651,2316,23,1
238263,1264,755,509,24,1
238263,3703,1896,1807,25,1
238263,171,104,67,31,1
238263,22,7,15,32,3
238263,529,285,244,39,1
238263,3174,1611,1563,40,1
238263,10242,4163,6079,41,4
238263,10202,4157,6045,42,1
238263,7896,3032,4864,43,1
238263,1367,618,749,44,1
238263,6529,2414,4115,45,1
238263,2306,1125,1181,51,1
238263,40,6,34,52,3
238263,565,219,346,59,1
238263,5964,2195,3769,60,1
238324,325,23,302,1,4
238324,286,23,263,2,1
238324,285,23,262,3,1
238324,41,1,40,4,1
238324,244,22,222,5,1
238324,1,0,1,11,1
238324,39,0,39,12,3
238324,10,0,10,19,1
238324,234,22,212,20,1
238324,237,20,217,21,4
238324,237,20,217,22,1
238324,237,20,217,23,1
238324,41,1,40,24,1
238324,196,19,177,25,1
238324,10,0,10,39,1
238324,186,19,167,40,1
238324,88,3,85,41,4
238324,49,3,46,42,1
238324,48,3,45,43,1
238324,48,3,45,45,1
238324,1,0,1,51,1
238324,39,0,39,52,3
238324,48,3,45,60,1
238333,1306,533,773,1,4
238333,1306,533,773,2,1
238333,1244,512,732,3,1
238333,299,126,173,4,1
238333,945,386,559,5,1
238333,62,21,41,11,1
238333,24,13,11,19,1
238333,921,373,548,20,1
238333,1254,515,739,21,4
238333,1254,515,739,22,1
238333,1237,511,726,23,1
238333,299,126,173,24,1
238333,938,385,553,25,1
238333,17,4,13,31,1
238333,24,13,11,39,1
238333,914,372,542,40,1
238333,52,18,34,41,4
238333,52,18,34,42,1
238333,7,1,6,43,1
238333,7,1,6,45,1
238333,45,17,28,51,1
238333,7,1,6,60,1
238397,2637,1035,1602,1,4
238397,2637,1035,1602,2,1
238397,2637,1035,1602,3,1
238397,447,225,222,4,1
238397,2190,810,1380,5,1
238397,2190,810,1380,20,1
238397,1056,509,547,21,4
238397,1056,509,547,22,1
238397,1056,509,547,23,1
238397,230,136,94,24,1
238397,826,373,453,25,1
238397,826,373,453,40,1
238397,1581,526,1055,41,4
238397,1581,526,1055,42,1
238397,1581,526,1055,43,1
238397,217,89,128,44,1
238397,1364,437,927,45,1
238397,1364,437,927,60,1
238430,4407,1577,2830,1,4
238430,2693,949,1744,2,1
238430,2680,945,1735,3,1
238430,195,86,109,4,1
238430,2485,859,1626,5,1
238430,13,4,9,11,1
238430,1714,628,1086,12,3
238430,255,89,166,19,1
238430,2230,770,1460,20,1
238430,3988,1468,2520,21,4
238430,2520,917,1603,22,1
238430,2514,915,1599,23,1
238430,195,86,109,24,1
238430,2319,829,1490,25,1
238430,6,2,4,31,1
238430,1468,551,917,32,3
238430,228,83,145,39,1
238430,2091,746,1345,40,1
238430,419,109,310,41,4
238430,173,32,141,42,1
238430,166,30,136,43,1
238430,166,30,136,45,1
238430,7,2,5,51,1
238430,246,77,169,52,3
238430,27,6,21,59,1
238430,139,24,115,60,1
238458,3534,1212,2322,1,4
238458,3119,1094,2025,2,1
238458,3024,1065,1959,3,1
238458,686,226,460,4,1
238458,2338,839,1499,5,1
238458,95,29,66,11,1
238458,415,118,297,12,3
238458,105,44,61,19,1
238458,2233,795,1438,20,1
238458,2901,1010,1891,21,4
238458,2729,953,1776,22,1
238458,2703,946,1757,23,1
238458,678,225,453,24,1
238458,2025,721,1304,25,1
238458,26,7,19,31,1
238458,172,57,115,32,3
238458,84,37,47,39,1
238458,1941,684,1257,40,1
238458,633,202,431,41,4
238458,390,141,249,42,1
238458,321,119,202,43,1
238458,8,1,7,44,1
238458,313,118,195,45,1
238458,69,22,47,51,1
238458,243,61,182,52,3
238458,21,7,14,59,1
238458,292,111,181,60,1
238476,2988,1372,1616,1,4
238476,2902,1341,1561,2,1
238476,2874,1328,1546,3,1
238476,717,364,353,4,1
238476,2157,964,1193,5,1
238476,28,13,15,11,1
238476,86,31,55,12,3
238476,116,58,58,19,1
238476,2041,906,1135,20,1
238476,2583,1236,1347,21,4
238476,2581,1234,1347,22,1
238476,2578,1233,1345,23,1
238476,714,364,350,24,1
238476,1864,869,995,25,1
238476,3,1,2,31,1
238476,2,2,0,32,3
238476,105,51,54,39,1
238476,1759,818,941,40,1
238476,405,136,269,41,4
238476,321,107,214,42,1
238476,296,95,201,43,1
238476,3,0,3,44,1
238476,293,95,198,45,1
238476,25,12,13,51,1
238476,84,29,55,52,3
238476,11,7,4,59,1
238476,282,88,194,60,1
238573,157,15,142,1,4
238573,157,15,142,2,1
238573,157,15,142,3,1
238573,157,15,142,5,1
238573,50,3,47,19,1
238573,107,12,95,20,1
238573,142,14,128,21,4
238573,142,14,128,22,1
238573,142,14,128,23,1
238573,142,14,128,25,1
238573,49,3,46,39,1
238573,93,11,82,40,1
238573,15,1,14,41,4
238573,15,1,14,42,1
238573,15,1,14,43,1
238573,15,1,14,45,1
238573,1,0,1,59,1
238573,14,1,13,60,1
238616,7943,2556,5387,1,4
238616,4363,1485,2878,2,1
238616,4322,1472,2850,3,1
238616,581,255,326,4,1
238616,3741,1217,2524,5,1
238616,41,13,28,11,1
238616,3580,1071,2509,12,3
238616,627,176,451,19,1
238616,3114,1041,2073,20,1
238616,4676,1644,3032,21,4
238616,3059,1153,1906,22,1
238616,3059,1153,1906,23,1
238616,581,255,326,24,1
238616,2478,898,1580,25,1
238616,1617,491,1126,32,3
238616,259,91,168,39,1
238616,2219,807,1412,40,1
238616,3267,912,2355,41,4
238616,1304,332,972,42,1
238616,1263,319,944,43,1
238616,1263,319,944,45,1
238616,41,13,28,51,1
238616,1963,580,1383,52,3
238616,368,85,283,59,1
238616,895,234,661,60,1
238661,2894,861,2033,1,4
238661,1998,623,1375,2,1
238661,1914,594,1320,3,1
238661,298,86,212,4,1
238661,1616,508,1108,5,1
238661,84,29,55,11,1
238661,896,238,658,12,3
238661,207,69,138,19,1
238661,1409,439,970,20,1
238661,1796,560,1236,21,4
238661,1681,526,1155,22,1
238661,1665,521,1144,23,1
238661,298,86,212,24,1
238661,1367,435,932,25,1
238661,16,5,11,31,1
238661,115,34,81,32,3
238661,186,59,127,39,1
238661,1181,376,805,40,1
238661,1098,301,797,41,4
238661,317,97,220,42,1
238661,249,73,176,43,1
238661,249,73,176,45,1
238661,68,24,44,51,1
238661,781,204,577,52,3
238661,21,10,11,59,1
238661,228,63,165,60,1
238722,10511,5367,5144,1,4
238722,10511,5367,5144,2,1
238722,7027,3432,3595,3,1
238722,937,580,357,4,1
238722,6090,2852,3238,5,1
238722,3484,1935,1549,11,1
238722,1903,828,1075,19,1
238722,4187,2024,2163,20,1
238722,2911,1788,1123,21,4
238722,2911,1788,1123,22,1
238722,2621,1585,1036,23,1
238722,399,305,94,24,1
238722,2222,1280,942,25,1
238722,290,203,87,31,1
238722,747,413,334,39,1
238722,1475,867,608,40,1
238722,7600,3579,4021,41,4
238722,7600,3579,4021,42,1
238722,4406,1847,2559,43,1
238722,538,275,263,44,1
238722,3868,1572,2296,45,1
238722,3194,1732,1462,51,1
238722,1156,415,741,59,1
238722,2712,1157,1555,60,1
238759,8268,3283,4985,1,4
238759,8268,3283,4985,2,1
238759,7295,2748,4547,3,1
238759,1518,707,811,4,1
238759,5777,2041,3736,5,1
238759,973,535,438,11,1
238759,703,257,446,19,1
238759,5074,1784,3290,20,1
238759,1582,864,718,21,4
238759,1582,864,718,22,1
238759,1531,827,704,23,1
238759,407,266,141,24,1
238759,1124,561,563,25,1
238759,51,37,14,31,1
238759,166,91,75,39,1
238759,958,470,488,40,1
238759,6686,2419,4267,41,4
238759,6686,2419,4267,42,1
238759,5764,1921,3843,43,1
238759,1111,441,670,44,1
238759,4653,1480,3173,45,1
238759,922,498,424,51,1
238759,537,166,371,59,1
238759,4116,1314,2802,60,1
238786,113,9,104,1,4
238786,113,9,104,2,1
238786,113,9,104,3,1
238786,23,0,23,4,1
238786,90,9,81,5,1
238786,90,9,81,20,1
238786,93,9,84,21,4
238786,93,9,84,22,1
238786,93,9,84,23,1
238786,15,0,15,24,1
238786,78,9,69,25,1
238786,78,9,69,40,1
238786,20,0,20,41,4
238786,20,0,20,42,1
238786,20,0,20,43,1
238786,8,0,8,44,1
238786,12,0,12,45,1
238786,12,0,12,60,1
238810,77,6,71,1,4
238810,77,6,71,2,1
238810,77,6,71,3,1
238810,41,4,37,4,1
238810,36,2,34,5,1
238810,36,2,34,20,1
238810,63,3,60,21,4
238810,63,3,60,22,1
238810,63,3,60,23,1
238810,36,3,33,24,1
238810,27,0,27,25,1
238810,27,0,27,40,1
238810,14,3,11,41,4
238810,14,3,11,42,1
238810,14,3,11,43,1
238810,5,1,4,44,1
238810,9,2,7,45,1
238810,9,2,7,60,1
238892,448,340,108,1,4
238892,448,340,108,2,1
238892,448,340,108,3,1
238892,92,56,36,4,1
238892,356,284,72,5,1
238892,2,1,1,19,1
238892,354,283,71,20,1
238892,341,265,76,21,4
238892,341,265,76,22,1
238892,341,265,76,23,1
238892,79,49,30,24,1
238892,262,216,46,25,1
238892,2,1,1,39,1
238892,260,215,45,40,1
238892,107,75,32,41,4
238892,107,75,32,42,1
238892,107,75,32,43,1
238892,13,7,6,44,1
238892,94,68,26,45,1
238892,94,68,26,60,1
238980,3806,1564,2242,1,4
238980,2972,1298,1674,2,1
238980,2449,1061,1388,3,1
238980,216,123,93,4,1
238980,2233,938,1295,5,1
238980,523,237,286,11,1
238980,834,266,568,12,3
238980,283,111,172,19,1
238980,1950,827,1123,20,1
238980,1148,574,574,21,4
238980,1024,535,489,22,1
238980,1022,534,488,23,1
238980,214,121,93,24,1
238980,808,413,395,25,1
238980,2,1,1,31,1
238980,124,39,85,32,3
238980,80,40,40,39,1
238980,728,373,355,40,1
238980,2658,990,1668,41,4
238980,1948,763,1185,42,1
238980,1427,527,900,43,1
238980,2,2,0,44,1
238980,1425,525,900,45,1
238980,521,236,285,51,1
238980,710,227,483,52,3
238980,203,71,132,59,1
238980,1222,454,768,60,1
239008,2930,1304,1626,1,4
239008,2930,1304,1626,2,1
239008,2255,981,1274,3,1
239008,393,222,171,4,1
239008,1862,759,1103,5,1
239008,675,323,352,11,1
239008,42,17,25,19,1
239008,1820,742,1078,20,1
239008,910,472,438,21,4
239008,910,472,438,22,1
239008,899,466,433,23,1
239008,226,147,79,24,1
239008,673,319,354,25,1
239008,11,6,5,31,1
239008,18,8,10,39,1
239008,655,311,344,40,1
239008,2020,832,1188,41,4
239008,2020,832,1188,42,1
239008,1356,515,841,43,1
239008,167,75,92,44,1
239008,1189,440,749,45,1
239008,664,317,347,51,1
239008,24,9,15,59,1
239008,1165,431,734,60,1
239017,1553,686,867,1,4
239017,1553,686,867,2,1
239017,1517,678,839,3,1
239017,395,180,215,4,1
239017,1122,498,624,5,1
239017,36,8,28,11,1
239017,18,10,8,19,1
239017,1104,488,616,20,1
239017,1518,668,850,21,4
239017,1518,668,850,22,1
239017,1491,662,829,23,1
239017,392,179,213,24,1
239017,1099,483,616,25,1
239017,27,6,21,31,1
239017,17,9,8,39,1
239017,1082,474,608,40,1
239017,35,18,17,41,4
239017,35,18,17,42,1
239017,26,16,10,43,1
239017,3,1,2,44,1
239017,23,15,8,45,1
239017,9,2,7,51,1
239017,1,1,0,59,1
239017,22,14,8,60,1
239071,1035,518,517,1,4
239071,946,439,507,2,1
239071,780,351,429,3,1
239071,210,94,116,4,1
239071,570,257,313,5,1
239071,166,88,78,11,1
239071,89,79,10,12,3
239071,33,11,22,19,1
239071,537,246,291,20,1
239071,717,340,377,21,4
239071,689,316,373,22,1
239071,689,316,373,23,1
239071,206,93,113,24,1
239071,483,223,260,25,1
239071,28,24,4,32,3
239071,32,11,21,39,1
239071,451,212,239,40,1
239071,318,178,140,41,4
239071,257,123,134,42,1
239071,91,35,56,43,1
239071,4,1,3,44,1
239071,87,34,53,45,1
239071,166,88,78,51,1
239071,61,55,6,52,3
239071,1,0,1,59,1
239071,86,34,52,60,1
239080,2188,613,1575,1,4
239080,1688,482,1206,2,1
239080,1676,479,1197,3,1
239080,248,72,176,4,1
239080,1428,407,1021,5,1
239080,12,3,9,11,1
239080,500,131,369,12,3
239080,262,63,199,19,1
239080,1166,344,822,20,1
239080,1384,388,996,21,4
239080,1339,376,963,22,1
239080,1339,376,963,23,1
239080,248,72,176,24,1
239080,1091,304,787,25,1
239080,45,12,33,32,3
239080,164,34,130,39,1
239080,927,270,657,40,1
239080,804,225,579,41,4
239080,349,106,243,42,1
239080,337,103,234,43,1
239080,337,103,234,45,1
239080,12,3,9,51,1
239080,455,119,336,52,3
239080,98,29,69,59,1
239080,239,74,165,60,1
239105,11782,5649,6133,1,4
239105,8365,4005,4360,2,1
239105,8190,3912,4278,3,1
239105,1990,941,1049,4,1
239105,6200,2971,3229,5,1
239105,175,93,82,11,1
239105,3417,1644,1773,12,3
239105,142,72,70,19,1
239105,6058,2899,3159,20,1
239105,10164,4879,5285,21,4
239105,8046,3841,4205,22,1
239105,7996,3818,4178,23,1
239105,1989,941,1048,24,1
239105,6007,2877,3130,25,1
239105,50,23,27,31,1
239105,2118,1038,1080,32,3
239105,130,67,63,39,1
239105,5877,2810,3067,40,1
239105,1618,770,848,41,4
239105,319,164,155,42,1
239105,194,94,100,43,1
239105,1,0,1,44,1
239105,193,94,99,45,1
239105,125,70,55,51,1
239105,1299,606,693,52,3
239105,12,5,7,59,1
239105,181,89,92,60,1
239132,89,7,82,1,4
239132,89,7,82,2,1
239132,89,7,82,3,1
239132,27,2,25,4,1
239132,62,5,57,5,1
239132,62,5,57,20,1
239132,70,5,65,21,4
239132,70,5,65,22,1
239132,70,5,65,23,1
239132,22,1,21,24,1
239132,48,4,44,25,1
239132,48,4,44,40,1
239132,19,2,17,41,4
239132,19,2,17,42,1
239132,19,2,17,43,1
239132,5,1,4,44,1
239132,14,1,13,45,1
239132,14,1,13,60,1
239169,1212,622,590,1,4
239169,1212,622,590,12,3
239169,1010,536,474,21,4
239169,1010,536,474,32,3
239169,202,86,116,41,4
239169,202,86,116,52,3
239220,2905,1228,1677,1,4
239220,2905,1228,1677,2,1
239220,2619,1106,1513,3,1
239220,492,275,217,4,1
239220,2127,831,1296,5,1
239220,286,122,164,11,1
239220,45,13,32,19,1
239220,2082,818,1264,20,1
239220,1021,560,461,21,4
239220,1021,560,461,22,1
239220,1002,549,453,23,1
239220,265,173,92,24,1
239220,737,376,361,25,1
239220,19,11,8,31,1
239220,12,4,8,39,1
239220,725,372,353,40,1
239220,1884,668,1216,41,4
239220,1884,668,1216,42,1
239220,1617,557,1060,43,1
239220,227,102,125,44,1
239220,1390,455,935,45,1
239220,267,111,156,51,1
239220,33,9,24,59,1
239220,1357,446,911,60,1
239248,17961,7813,10148,1,4
239248,17961,7813,10148,2,1
239248,16172,7012,9160,3,1
239248,1724,890,834,4,1
239248,14448,6122,8326,5,1
239248,1789,801,988,11,1
239248,258,125,133,19,1
239248,14190,5997,8193,20,1
239248,5731,2903,2828,21,4
239248,5731,2903,2828,22,1
239248,5495,2792,2703,23,1
239248,897,488,409,24,1
239248,4598,2304,2294,25,1
239248,236,111,125,31,1
239248,121,62,59,39,1
239248,4477,2242,2235,40,1
239248,12230,4910,7320,41,4
239248,12230,4910,7320,42,1
239248,10677,4220,6457,43,1
239248,827,402,425,44,1
239248,9850,3818,6032,45,1
239248,1553,690,863,51,1
239248,137,63,74,59,1
239248,9713,3755,5958,60,1
239309,667,226,441,1,4
239309,667,226,441,2,1
239309,666,225,441,3,1
239309,157,49,108,4,1
239309,509,176,333,5,1
239309,1,1,0,11,1
239309,40,15,25,19,1
239309,469,161,308,20,1
239309,652,219,433,21,4
239309,652,219,433,22,1
239309,652,219,433,23,1
239309,157,49,108,24,1
239309,495,170,325,25,1
239309,39,15,24,39,1
239309,456,155,301,40,1
239309,15,7,8,41,4
239309,15,7,8,42,1
239309,14,6,8,43,1
239309,14,6,8,45,1
239309,1,1,0,51,1
239309,1,0,1,59,1
239309,13,6,7,60,1
239318,2658,2040,618,1,4
239318,2459,1886,573,2,1
239318,2452,1879,573,3,1
239318,539,417,122,4,1
239318,1913,1462,451,5,1
239318,7,7,0,11,1
239318,199,154,45,12,3
239318,201,134,67,19,1
239318,1712,1328,384,20,1
239318,2341,1776,565,21,4
239318,2284,1733,551,22,1
239318,2284,1733,551,23,1
239318,538,416,122,24,1
239318,1746,1317,429,25,1
239318,57,43,14,32,3
239318,182,117,65,39,1
239318,1564,1200,364,40,1
239318,317,264,53,41,4
239318,175,153,22,42,1
239318,168,146,22,43,1
239318,1,1,0,44,1
239318,167,145,22,45,1
239318,7,7,0,51,1
239318,142,111,31,52,3
239318,19,17,2,59,1
239318,148,128,20,60,1
239372,6613,2717,3896,1,4
239372,6613,2717,3896,2,1
239372,3320,1198,2122,3,1
239372,341,154,187,4,1
239372,2979,1044,1935,5,1
239372,3293,1519,1774,11,1
239372,2979,1044,1935,20,1
239372,1112,522,590,21,4
239372,1112,522,590,22,1
239372,1074,500,574,23,1
239372,163,89,74,24,1
239372,911,411,500,25,1
239372,38,22,16,31,1
239372,911,411,500,40,1
239372,5501,2195,3306,41,4
239372,5501,2195,3306,42,1
239372,2246,698,1548,43,1
239372,178,65,113,44,1
239372,2068,633,1435,45,1
239372,3255,1497,1758,51,1
239372,2068,633,1435,60,1
239390,1481,72,1409,1,4
239390,926,21,905,2,1
239390,811,5,806,3,1
239390,114,0,114,4,1
239390,697,5,692,5,1
239390,115,16,99,11,1
239390,555,51,504,12,3
239390,62,0,62,19,1
239390,635,5,630,20,1
239390,1070,37,1033,21,4
239390,685,3,682,22,1
239390,681,2,679,23,1
239390,113,0,113,24,1
239390,568,2,566,25,1
239390,4,1,3,31,1
239390,385,34,351,32,3
239390,58,0,58,39,1
239390,510,2,508,40,1
239390,411,35,376,41,4
239390,241,18,223,42,1
239390,130,3,127,43,1
239390,1,0,1,44,1
239390,129,3,126,45,1
239390,111,15,96,51,1
239390,170,17,153,52,3
239390,4,0,4,59,1
239390,125,3,122,60,1
239424,124,100,24,1,4
239424,124,100,24,12,3
239424,101,81,20,21,4
239424,101,81,20,32,3
239424,23,19,4,41,4
239424,23,19,4,52,3
239442,1271,448,823,1,4
239442,1271,448,823,2,1
239442,1123,406,717,3,1
239442,229,106,123,4,1
239442,894,300,594,5,1
239442,148,42,106,11,1
239442,34,8,26,19,1
239442,860,292,568,20,1
239442,623,300,323,21,4
239442,623,300,323,22,1
239442,620,297,323,23,1
239442,149,82,67,24,1
239442,471,215,256,25,1
239442,3,3,0,31,1
239442,19,8,11,39,1
239442,452,207,245,40,1
239442,648,148,500,41,4
239442,648,148,500,42,1
239442,503,109,394,43,1
239442,80,24,56,44,1
239442,423,85,338,45,1
239442,145,39,106,51,1
239442,15,0,15,59,1
239442,408,85,323,60,1
239460,4384,1747,2637,1,4
239460,4384,1747,2637,2,1
239460,3632,1468,2164,3,1
239460,900,412,488,4,1
239460,2732,1056,1676,5,1
239460,752,279,473,11,1
239460,2732,1056,1676,20,1
239460,1859,923,936,21,4
239460,1859,923,936,22,1
239460,1745,859,886,23,1
239460,486,261,225,24,1
239460,1259,598,661,25,1
239460,114,64,50,31,1
239460,1259,598,661,40,1
239460,2525,824,1701,41,4
239460,2525,824,1701,42,1
239460,1887,609,1278,43,1
239460,414,151,263,44,1
239460,1473,458,1015,45,1
239460,638,215,423,51,1
239460,1473,458,1015,60,1
239488,10441,4215,6226,1,4
239488,10441,4215,6226,2,1
239488,6675,2774,3901,3,1
239488,1171,622,549,4,1
239488,5504,2152,3352,5,1
239488,3766,1441,2325,11,1
239488,345,127,218,19,1
239488,5159,2025,3134,20,1
239488,3551,1905,1646,21,4
239488,3551,1905,1646,22,1
239488,3060,1675,1385,23,1
239488,705,440,265,24,1
239488,2355,1235,1120,25,1
239488,491,230,261,31,1
239488,192,95,97,39,1
239488,2163,1140,1023,40,1
239488,6890,2310,4580,41,4
239488,6890,2310,4580,42,1
239488,3615,1099,2516,43,1
239488,466,182,284,44,1
239488,3149,917,2232,45,1
239488,3275,1211,2064,51,1
239488,153,32,121,59,1
239488,2996,885,2111,60,1
239503,327,179,148,1,4
239503,261,134,127,2,1
239503,254,130,124,3,1
239503,41,23,18,4,1
239503,213,107,106,5,1
239503,7,4,3,11,1
239503,66,45,21,12,3
239503,15,6,9,19,1
239503,198,101,97,20,1
239503,255,135,120,21,4
239503,242,126,116,22,1
239503,237,122,115,23,1
239503,40,22,18,24,1
239503,197,100,97,25,1
239503,5,4,1,31,1
239503,13,9,4,32,3
239503,15,6,9,39,1
239503,182,94,88,40,1
239503,72,44,28,41,4
239503,19,8,11,42,1
239503,17,8,9,43,1
239503,1,1,0,44,1
239503,16,7,9,45,1
239503,2,0,2,51,1
239503,53,36,17,52,3
239503,16,7,9,60,1
239512,552,267,285,1,4
239512,552,267,285,2,1
239512,546,263,283,3,1
239512,140,73,67,4,1
239512,406,190,216,5,1
239512,6,4,2,11,1
239512,37,17,20,19,1
239512,369,173,196,20,1
239512,538,263,275,21,4
239512,538,263,275,22,1
239512,538,263,275,23,1
239512,140,73,67,24,1
239512,398,190,208,25,1
239512,37,17,20,39,1
239512,361,173,188,40,1
239512,14,4,10,41,4
239512,14,4,10,42,1
239512,8,0,8,43,1
239512,8,0,8,45,1
239512,6,4,2,51,1
239512,8,0,8,60,1
239628,904,423,481,1,4
239628,904,423,481,2,1
239628,883,416,467,3,1
239628,238,116,122,4,1
239628,645,300,345,5,1
239628,21,7,14,11,1
239628,10,7,3,19,1
239628,635,293,342,20,1
239628,888,417,471,21,4
239628,888,417,471,22,1
239628,880,415,465,23,1
239628,238,116,122,24,1
239628,642,299,343,25,1
239628,8,2,6,31,1
239628,10,7,3,39,1
239628,632,292,340,40,1
239628,16,6,10,41,4
239628,16,6,10,42,1
239628,3,1,2,43,1
239628,3,1,2,45,1
239628,13,5,8,51,1
239628,3,1,2,60,1
239637,113,105,8,1,4
239637,113,105,8,12,3
239637,96,93,3,21,4
239637,96,93,3,32,3
239637,17,12,5,41,4
239637,17,12,5,52,3
239716,2222,916,1306,1,4
239716,2160,893,1267,2,1
239716,2128,878,1250,3,1
239716,539,223,316,4,1
239716,1589,655,934,5,1
239716,32,15,17,11,1
239716,62,23,39,12,3
239716,44,22,22,19,1
239716,1545,633,912,20,1
239716,2118,876,1242,21,4
239716,2118,876,1242,22,1
239716,2104,869,1235,23,1
239716,539,223,316,24,1
239716,1565,646,919,25,1
239716,14,7,7,31,1
239716,43,21,22,39,1
239716,1522,625,897,40,1
239716,104,40,64,41,4
239716,42,17,25,42,1
239716,24,9,15,43,1
239716,24,9,15,45,1
239716,18,8,10,51,1
239716,62,23,39,52,3
239716,1,1,0,59,1
239716,23,8,15,60,1
239743,679,215,464,1,4
239743,501,165,336,2,1
239743,299,87,212,3,1
239743,40,11,29,4,1
239743,259,76,183,5,1
239743,202,78,124,11,1
239743,178,50,128,12,3
239743,31,16,15,19,1
239743,228,60,168,20,1
239743,223,65,158,21,4
239743,213,63,150,22,1
239743,201,60,141,23,1
239743,40,11,29,24,1
239743,161,49,112,25,1
239743,12,3,9,31,1
239743,10,2,8,32,3
239743,19,11,8,39,1
239743,142,38,104,40,1
239743,456,150,306,41,4
239743,288,102,186,42,1
239743,98,27,71,43,1
239743,98,27,71,45,1
239743,190,75,115,51,1
239743,168,48,120,52,3
239743,12,5,7,59,1
239743,86,22,64,60,1
239877,55,1,54,1,4
239877,55,1,54,2,1
239877,55,1,54,3,1
239877,27,0,27,4,1
239877,28,1,27,5,1
239877,28,1,27,20,1
239877,49,1,48,21,4
239877,49,1,48,22,1
239877,49,1,48,23,1
239877,27,0,27,24,1
239877,22,1,21,25,1
239877,22,1,21,40,1
239877,6,0,6,41,4
239877,6,0,6,42,1
239877,6,0,6,43,1
239877,6,0,6,45,1
239877,6,0,6,60,1
239910,4144,2180,1964,1,4
239910,4144,2180,1964,2,1
239910,1347,592,755,3,1
239910,366,203,163,4,1
239910,981,389,592,5,1
239910,2797,1588,1209,11,1
239910,386,125,261,19,1
239910,595,264,331,20,1
239910,736,416,320,21,4
239910,736,416,320,22,1
239910,730,412,318,23,1
239910,229,153,76,24,1
239910,501,259,242,25,1
239910,6,4,2,31,1
239910,177,85,92,39,1
239910,324,174,150,40,1
239910,3408,1764,1644,41,4
239910,3408,1764,1644,42,1
239910,617,180,437,43,1
239910,137,50,87,44,1
239910,480,130,350,45,1
239910,2791,1584,1207,51,1
239910,209,40,169,59,1
239910,271,90,181,60,1
239929,1051,301,750,1,4
239929,1051,301,750,2,1
239929,1051,301,750,3,1
239929,242,94,148,4,1
239929,809,207,602,5,1
239929,143,46,97,19,1
239929,666,161,505,20,1
239929,418,141,277,21,4
239929,418,141,277,22,1
239929,418,141,277,23,1
239929,155,64,91,24,1
239929,263,77,186,25,1
239929,77,28,49,39,1
239929,186,49,137,40,1
239929,633,160,473,41,4
239929,633,160,473,42,1
239929,633,160,473,43,1
239929,87,30,57,44,1
239929,546,130,416,45,1
239929,66,18,48,59,1
239929,480,112,368,60,1
240055,13947,6429,7518,1,4
240055,13947,6429,7518,2,1
240055,11827,5598,6229,3,1
240055,4189,2047,2142,4,1
240055,7638,3551,4087,5,1
240055,2120,831,1289,11,1
240055,755,366,389,19,1
240055,6883,3185,3698,20,1
240055,8015,3996,4019,21,4
240055,8015,3996,4019,22,1
240055,7938,3952,3986,23,1
240055,3642,1806,1836,24,1
240055,4296,2146,2150,25,1
240055,77,44,33,31,1
240055,449,237,212,39,1
240055,3847,1909,1938,40,1
240055,5932,2433,3499,41,4
240055,5932,2433,3499,42,1
240055,3889,1646,2243,43,1
240055,547,241,306,44,1
240055,3342,1405,1937,45,1
240055,2043,787,1256,51,1
240055,306,129,177,59,1
240055,3036,1276,1760,60,1
240107,2762,759,2003,1,4
240107,2079,564,1515,2,1
240107,2052,551,1501,3,1
240107,304,85,219,4,1
240107,1748,466,1282,5,1
240107,27,13,14,11,1
240107,683,195,488,12,3
240107,266,85,181,19,1
240107,1482,381,1101,20,1
240107,1926,558,1368,21,4
240107,1581,451,1130,22,1
240107,1580,450,1130,23,1
240107,303,84,219,24,1
240107,1277,366,911,25,1
240107,1,1,0,31,1
240107,345,107,238,32,3
240107,148,61,87,39,1
240107,1129,305,824,40,1
240107,836,201,635,41,4
240107,498,113,385,42,1
240107,472,101,371,43,1
240107,1,1,0,44,1
240107,471,100,371,45,1
240107,26,12,14,51,1
240107,338,88,250,52,3
240107,118,24,94,59,1
240107,353,76,277,60,1
240116,5617,2437,3180,1,4
240116,5617,2437,3180,2,1
240116,4687,1932,2755,3,1
240116,1366,698,668,4,1
240116,3321,1234,2087,5,1
240116,930,505,425,11,1
240116,390,162,228,19,1
240116,2931,1072,1859,20,1
240116,2445,1336,1109,21,4
240116,2445,1336,1109,22,1
240116,2343,1279,1064,23,1
240116,891,531,360,24,1
240116,1452,748,704,25,1
240116,102,57,45,31,1
240116,185,99,86,39,1
240116,1267,649,618,40,1
240116,3172,1101,2071,41,4
240116,3172,1101,2071,42,1
240116,2344,653,1691,43,1
240116,475,167,308,44,1
240116,1869,486,1383,45,1
240116,828,448,380,51,1
240116,205,63,142,59,1
240116,1664,423,1241,60,1
240125,8799,4548,4251,1,4
240125,8799,4548,4251,2,1
240125,5718,2837,2881,3,1
240125,518,285,233,4,1
240125,5200,2552,2648,5,1
240125,3081,1711,1370,11,1
240125,393,176,217,19,1
240125,4807,2376,2431,20,1
240125,1905,1141,764,21,4
240125,1905,1141,764,22,1
240125,1905,1141,764,23,1
240125,256,154,102,24,1
240125,1649,987,662,25,1
240125,171,90,81,39,1
240125,1478,897,581,40,1
240125,6894,3407,3487,41,4
240125,6894,3407,3487,42,1
240125,3813,1696,2117,43,1
240125,262,131,131,44,1
240125,3551,1565,1986,45,1
240125,3081,1711,1370,51,1
240125,222,86,136,59,1
240125,3329,1479,1850,60,1
240170,4572,2038,2534,1,4
240170,4572,2038,2534,2,1
240170,4327,1929,2398,3,1
240170,687,356,331,4,1
240170,3640,1573,2067,5,1
240170,245,109,136,11,1
240170,444,203,241,19,1
240170,3196,1370,1826,20,1
240170,1920,1050,870,21,4
240170,1920,1050,870,22,1
240170,1909,1043,866,23,1
240170,440,266,174,24,1
240170,1469,777,692,25,1
240170,11,7,4,31,1
240170,219,122,97,39,1
240170,1250,655,595,40,1
240170,2652,988,1664,41,4
240170,2652,988,1664,42,1
240170,2418,886,1532,43,1
240170,247,90,157,44,1
240170,2171,796,1375,45,1
240170,234,102,132,51,1
240170,225,81,144,59,1
240170,1946,715,1231,60,1
240189,12027,5881,6146,1,4
240189,10864,5335,5529,2,1
240189,10438,5161,5277,3,1
240189,2108,1054,1054,4,1
240189,8330,4107,4223,5,1
240189,426,174,252,11,1
240189,1163,546,617,12,3
240189,689,335,354,19,1
240189,7641,3772,3869,20,1
240189,10308,5063,5245,21,4
240189,9889,4880,5009,22,1
240189,9795,4839,4956,23,1
240189,2096,1046,1050,24,1
240189,7699,3793,3906,25,1
240189,94,41,53,31,1
240189,419,183,236,32,3
240189,637,320,317,39,1
240189,7062,3473,3589,40,1
240189,1719,818,901,41,4
240189,975,455,520,42,1
240189,643,322,321,43,1
240189,12,8,4,44,1
240189,631,314,317,45,1
240189,332,133,199,51,1
240189,744,363,381,52,3
240189,52,15,37,59,1
240189,579,299,280,60,1
240198,3418,1374,2044,1,4
240198,3418,1374,2044,2,1
240198,2956,1199,1757,3,1
240198,549,309,240,4,1
240198,2407,890,1517,5,1
240198,462,175,287,11,1
240198,2407,890,1517,20,1
240198,1469,766,703,21,4
240198,1469,766,703,22,1
240198,1456,759,697,23,1
240198,320,211,109,24,1
240198,1136,548,588,25,1
240198,13,7,6,31,1
240198,1136,548,588,40,1
240198,1949,608,1341,41,4
240198,1949,608,1341,42,1
240198,1500,440,1060,43,1
240198,229,98,131,44,1
240198,1271,342,929,45,1
240198,449,168,281,51,1
240198,1271,342,929,60,1
240213,92,24,68,1,4
240213,92,24,68,12,3
240213,40,12,28,21,4
240213,40,12,28,32,3
240213,52,12,40,41,4
240213,52,12,40,52,3
240240,156,6,150,1,4
240240,156,6,150,2,1
240240,156,6,150,3,1
240240,16,1,15,4,1
240240,140,5,135,5,1
240240,140,5,135,20,1
240240,156,6,150,21,4
240240,156,6,150,22,1
240240,156,6,150,23,1
240240,16,1,15,24,1
240240,140,5,135,25,1
240240,140,5,135,40,1
240268,10923,4452,6471,1,4
240268,10404,4246,6158,2,1
240268,10218,4192,6026,3,1
240268,2017,699,1318,4,1
240268,8201,3493,4708,5,1
240268,186,54,132,11,1
240268,519,206,313,12,3
240268,568,273,295,19,1
240268,7633,3220,4413,20,1
240268,9616,3946,5670,21,4
240268,9508,3920,5588,22,1
240268,9508,3920,5588,23,1
240268,2014,697,1317,24,1
240268,7494,3223,4271,25,1
240268,108,26,82,32,3
240268,502,253,249,39,1
240268,6992,2970,4022,40,1
240268,1307,506,801,41,4
240268,896,326,570,42,1
240268,710,272,438,43,1
240268,3,2,1,44,1
240268,707,270,437,45,1
240268,186,54,132,51,1
240268,411,180,231,52,3
240268,66,20,46,59,1
240268,641,250,391,60,1
240277,6668,2306,4362,1,4
240277,6445,2225,4220,2,1
240277,5765,1980,3785,3,1
240277,809,253,556,4,1
240277,4956,1727,3229,5,1
240277,680,245,435,11,1
240277,223,81,142,12,3
240277,587,194,393,19,1
240277,4369,1533,2836,20,1
240277,4388,1627,2761,21,4
240277,4330,1606,2724,22,1
240277,4305,1591,2714,23,1
240277,782,251,531,24,1
240277,3523,1340,2183,25,1
240277,25,15,10,31,1
240277,58,21,37,32,3
240277,401,148,253,39,1
240277,3122,1192,1930,40,1
240277,2280,679,1601,41,4
240277,2115,619,1496,42,1
240277,1460,389,1071,43,1
240277,27,2,25,44,1
240277,1433,387,1046,45,1
240277,655,230,425,51,1
240277,165,60,105,52,3
240277,186,46,140,59,1
240277,1247,341,906,60,1
240329,10520,4500,6020,1,4
240329,9702,4232,5470,2,1
240329,9335,4064,5271,3,1
240329,2005,849,1156,4,1
240329,7330,3215,4115,5,1
240329,367,168,199,11,1
240329,818,268,550,12,3
240329,540,285,255,19,1
240329,6790,2930,3860,20,1
240329,9577,4116,5461,21,4
240329,9188,3982,5206,22,1
240329,9042,3918,5124,23,1
240329,1995,846,1149,24,1
240329,7047,3072,3975,25,1
240329,146,64,82,31,1
240329,389,134,255,32,3
240329,516,276,240,39,1
240329,6531,2796,3735,40,1
240329,943,384,559,41,4
240329,514,250,264,42,1
240329,293,146,147,43,1
240329,10,3,7,44,1
240329,283,143,140,45,1
240329,221,104,117,51,1
240329,429,134,295,52,3
240329,24,9,15,59,1
240329,259,134,125,60,1
240338,1178,547,631,1,4
240338,1070,500,570,2,1
240338,1058,492,566,3,1
240338,229,106,123,4,1
240338,829,386,443,5,1
240338,12,8,4,11,1
240338,108,47,61,12,3
240338,75,31,44,19,1
240338,754,355,399,20,1
240338,1011,475,536,21,4
240338,1002,472,530,22,1
240338,1001,471,530,23,1
240338,229,106,123,24,1
240338,772,365,407,25,1
240338,1,1,0,31,1
240338,9,3,6,32,3
240338,67,29,38,39,1
240338,705,336,369,40,1
240338,167,72,95,41,4
240338,68,28,40,42,1
240338,57,21,36,43,1
240338,57,21,36,45,1
240338,11,7,4,51,1
240338,99,44,55,52,3
240338,8,2,6,59,1
240338,49,19,30,60,1
240365,13900,5489,8411,1,4
240365,12622,5094,7528,2,1
240365,10633,4533,6100,3,1
240365,1747,693,1054,4,1
240365,8886,3840,5046,5,1
240365,1989,561,1428,11,1
240365,1278,395,883,12,3
240365,924,377,547,19,1
240365,7962,3463,4499,20,1
240365,9375,3988,5387,21,4
240365,9193,3945,5248,22,1
240365,9142,3926,5216,23,1
240365,1730,685,1045,24,1
240365,7412,3241,4171,25,1
240365,51,19,32,31,1
240365,182,43,139,32,3
240365,689,295,394,39,1
240365,6723,2946,3777,40,1
240365,4525,1501,3024,41,4
240365,3429,1149,2280,42,1
240365,1491,607,884,43,1
240365,17,8,9,44,1
240365,1474,599,875,45,1
240365,1938,542,1396,51,1
240365,1096,352,744,52,3
240365,235,82,153,59,1
240365,1239,517,722,60,1
240374,4578,2211,2367,1,4
240374,4450,2137,2313,2,1
240374,4354,2103,2251,3,1
240374,762,345,417,4,1
240374,3592,1758,1834,5,1
240374,96,34,62,11,1
240374,128,74,54,12,3
240374,396,192,204,19,1
240374,3196,1566,1630,20,1
240374,3365,1668,1697,21,4
240374,3332,1647,1685,22,1
240374,3330,1645,1685,23,1
240374,686,321,365,24,1
240374,2644,1324,1320,25,1
240374,2,2,0,31,1
240374,33,21,12,32,3
240374,294,158,136,39,1
240374,2350,1166,1184,40,1
240374,1213,543,670,41,4
240374,1118,490,628,42,1
240374,1024,458,566,43,1
240374,76,24,52,44,1
240374,948,434,514,45,1
240374,94,32,62,51,1
240374,95,53,42,52,3
240374,102,34,68,59,1
240374,846,400,446,60,1
240392,2680,637,2043,1,4
240392,2452,587,1865,2,1
240392,2435,585,1850,3,1
240392,227,51,176,4,1
240392,2208,534,1674,5,1
240392,17,2,15,11,1
240392,228,50,178,12,3
240392,69,17,52,19,1
240392,2139,517,1622,20,1
240392,1265,339,926,21,4
240392,1166,317,849,22,1
240392,1166,317,849,23,1
240392,125,35,90,24,1
240392,1041,282,759,25,1
240392,99,22,77,32,3
240392,43,14,29,39,1
240392,998,268,730,40,1
240392,1415,298,1117,41,4
240392,1286,270,1016,42,1
240392,1269,268,1001,43,1
240392,102,16,86,44,1
240392,1167,252,915,45,1
240392,17,2,15,51,1
240392,129,28,101,52,3
240392,26,3,23,59,1
240392,1141,249,892,60,1
240417,9313,4690,4623,1,4
240417,8208,4363,3845,2,1
240417,8094,4311,3783,3,1
240417,1573,809,764,4,1
240417,6521,3502,3019,5,1
240417,114,52,62,11,1
240417,1105,327,778,12,3
240417,683,389,294,19,1
240417,5838,3113,2725,20,1
240417,7088,3650,3438,21,4
240417,6820,3573,3247,22,1
240417,6782,3553,3229,23,1
240417,1561,803,758,24,1
240417,5221,2750,2471,25,1
240417,38,20,18,31,1
240417,268,77,191,32,3
240417,489,270,219,39,1
240417,4732,2480,2252,40,1
240417,2225,1040,1185,41,4
240417,1388,790,598,42,1
240417,1312,758,554,43,1
240417,12,6,6,44,1
240417,1300,752,548,45,1
240417,76,32,44,51,1
240417,837,250,587,52,3
240417,194,119,75,59,1
240417,1106,633,473,60,1
240426,2661,1052,1609,1,4
240426,2527,1017,1510,2,1
240426,2415,989,1426,3,1
240426,325,130,195,4,1
240426,2090,859,1231,5,1
240426,112,28,84,11,1
240426,134,35,99,12,3
240426,317,124,193,19,1
240426,1773,735,1038,20,1
240426,2071,877,1194,21,4
240426,2020,869,1151,22,1
240426,2010,867,1143,23,1
240426,318,128,190,24,1
240426,1692,739,953,25,1
240426,10,2,8,31,1
240426,51,8,43,32,3
240426,256,108,148,39,1
240426,1436,631,805,40,1
240426,590,175,415,41,4
240426,507,148,359,42,1
240426,405,122,283,43,1
240426,7,2,5,44,1
240426,398,120,278,45,1
240426,102,26,76,51,1
240426,83,27,56,52,3
240426,61,16,45,59,1
240426,337,104,233,60,1
240444,42677,20958,21719,1,4
240444,30728,14963,15765,2,1
240444,29504,14391,15113,3,1
240444,6339,3060,3279,4,1
240444,23165,11331,11834,5,1
240444,1224,572,652,11,1
240444,11949,5995,5954,12,3
240444,1092,538,554,19,1
240444,22073,10793,11280,20,1
240444,38428,18872,19556,21,4
240444,28568,13872,14696,22,1
240444,28183,13670,14513,23,1
240444,6323,3051,3272,24,1
240444,21860,10619,11241,25,1
240444,385,202,183,31,1
240444,9860,5000,4860,32,3
240444,1042,517,525,39,1
240444,20818,10102,10716,40,1
240444,4249,2086,2163,41,4
240444,2160,1091,1069,42,1
240444,1321,721,600,43,1
240444,16,9,7,44,1
240444,1305,712,593,45,1
240444,839,370,469,51,1
240444,2089,995,1094,52,3
240444,50,21,29,59,1
240444,1255,691,564,60,1
240453,27416,13062,14354,1,4
240453,22648,11126,11522,2,1
240453,21747,10806,10941,3,1
240453,3303,1595,1708,4,1
240453,18444,9211,9233,5,1
240453,901,320,581,11,1
240453,4768,1936,2832,12,3
240453,1721,872,849,19,1
240453,16723,8339,8384,20,1
240453,21548,10476,11072,21,4
240453,18942,9391,9551,22,1
240453,18705,9303,9402,23,1
240453,3201,1535,1666,24,1
240453,15504,7768,7736,25,1
240453,237,88,149,31,1
240453,2606,1085,1521,32,3
240453,1469,749,720,39,1
240453,14035,7019,7016,40,1
240453,5868,2586,3282,41,4
240453,3706,1735,1971,42,1
240453,3042,1503,1539,43,1
240453,102,60,42,44,1
240453,2940,1443,1497,45,1
240453,664,232,432,51,1
240453,2162,851,1311,52,3
240453,252,123,129,59,1
240453,2688,1320,1368,60,1
240462,8712,5585,3127,1,4
240462,7862,5128,2734,2,1
240462,7740,5055,2685,3,1
240462,1646,1088,558,4,1
240462,6094,3967,2127,5,1
240462,122,73,49,11,1
240462,850,457,393,12,3
240462,446,268,178,19,1
240462,5648,3699,1949,20,1
240462,7136,4638,2498,21,4
240462,7033,4599,2434,22,1
240462,7011,4585,2426,23,1
240462,1625,1075,550,24,1
240462,5386,3510,1876,25,1
240462,22,14,8,31,1
240462,103,39,64,32,3
240462,385,224,161,39,1
240462,5001,3286,1715,40,1
240462,1576,947,629,41,4
240462,829,529,300,42,1
240462,729,470,259,43,1
240462,21,13,8,44,1
240462,708,457,251,45,1
240462,100,59,41,51,1
240462,747,418,329,52,3
240462,61,44,17,59,1
240462,647,413,234,60,1
240471,6160,2405,3755,1,4
240471,5782,2286,3496,2,1
240471,5506,2185,3321,3,1
240471,1071,408,663,4,1
240471,4435,1777,2658,5,1
240471,276,101,175,11,1
240471,378,119,259,12,3
240471,371,163,208,19,1
240471,4064,1614,2450,20,1
240471,5375,2110,3265,21,4
240471,5249,2075,3174,22,1
240471,5115,2020,3095,23,1
240471,1059,405,654,24,1
240471,4056,1615,2441,25,1
240471,134,55,79,31,1
240471,126,35,91,32,3
240471,342,148,194,39,1
240471,3714,1467,2247,40,1
240471,785,295,490,41,4
240471,533,211,322,42,1
240471,391,165,226,43,1
240471,12,3,9,44,1
240471,379,162,217,45,1
240471,142,46,96,51,1
240471,252,84,168,52,3
240471,29,15,14,59,1
240471,350,147,203,60,1
240480,9661,4544,5117,1,4
240480,9313,4463,4850,2,1
240480,9150,4396,4754,3,1
240480,1636,788,848,4,1
240480,7514,3608,3906,5,1
240480,163,67,96,11,1
240480,348,81,267,12,3
240480,754,366,388,19,1
240480,6760,3242,3518,20,1
240480,8770,4192,4578,21,4
240480,8650,4166,4484,22,1
240480,8631,4156,4475,23,1
240480,1624,782,842,24,1
240480,7007,3374,3633,25,1
240480,19,10,9,31,1
240480,120,26,94,32,3
240480,672,330,342,39,1
240480,6335,3044,3291,40,1
240480,891,352,539,41,4
240480,663,297,366,42,1
240480,519,240,279,43,1
240480,12,6,6,44,1
240480,507,234,273,45,1
240480,144,57,87,51,1
240480,228,55,173,52,3
240480,82,36,46,59,1
240480,425,198,227,60,1
240505,4082,1764,2318,1,4
240505,4082,1764,2318,2,1
240505,2771,1108,1663,3,1
240505,685,329,356,4,1
240505,2086,779,1307,5,1
240505,1311,656,655,11,1
240505,129,53,76,19,1
240505,1957,726,1231,20,1
240505,1957,845,1112,21,4
240505,1957,845,1112,22,1
240505,1906,827,1079,23,1
240505,616,300,316,24,1
240505,1290,527,763,25,1
240505,51,18,33,31,1
240505,96,44,52,39,1
240505,1194,483,711,40,1
240505,2125,919,1206,41,4
240505,2125,919,1206,42,1
240505,865,281,584,43,1
240505,69,29,40,44,1
240505,796,252,544,45,1
240505,1260,638,622,51,1
240505,33,9,24,59,1
240505,763,243,520,60,1
240514,2182,1005,1177,1,4
240514,2182,1005,1177,2,1
240514,1127,455,672,3,1
240514,309,147,162,4,1
240514,818,308,510,5,1
240514,1055,550,505,11,1
240514,399,136,263,19,1
240514,419,172,247,20,1
240514,831,356,475,21,4
240514,831,356,475,22,1
240514,674,292,382,23,1
240514,235,106,129,24,1
240514,439,186,253,25,1
240514,157,64,93,31,1
240514,189,77,112,39,1
240514,250,109,141,40,1
240514,1351,649,702,41,4
240514,1351,649,702,42,1
240514,453,163,290,43,1
240514,74,41,33,44,1
240514,379,122,257,45,1
240514,898,486,412,51,1
240514,210,59,151,59,1
240514,169,63,106,60,1
240596,1788,761,1027,1,4
240596,1788,761,1027,2,1
240596,771,315,456,3,1
240596,265,120,145,4,1
240596,506,195,311,5,1
240596,1017,446,571,11,1
240596,176,60,116,19,1
240596,330,135,195,20,1
240596,686,319,367,21,4
240596,686,319,367,22,1
240596,531,237,294,23,1
240596,229,108,121,24,1
240596,302,129,173,25,1
240596,155,82,73,31,1
240596,97,36,61,39,1
240596,205,93,112,40,1
240596,1102,442,660,41,4
240596,1102,442,660,42,1
240596,240,78,162,43,1
240596,36,12,24,44,1
240596,204,66,138,45,1
240596,862,364,498,51,1
240596,79,24,55,59,1
240596,125,42,83,60,1
240620,4780,1924,2856,1,4
240620,4780,1924,2856,2,1
240620,3517,1374,2143,3,1
240620,438,194,244,4,1
240620,3079,1180,1899,5,1
240620,1263,550,713,11,1
240620,259,104,155,19,1
240620,2820,1076,1744,20,1
240620,1961,831,1130,21,4
240620,1961,831,1130,22,1
240620,1905,800,1105,23,1
240620,318,144,174,24,1
240620,1587,656,931,25,1
240620,56,31,25,31,1
240620,142,67,75,39,1
240620,1445,589,856,40,1
240620,2819,1093,1726,41,4
240620,2819,1093,1726,42,1
240620,1612,574,1038,43,1
240620,120,50,70,44,1
240620,1492,524,968,45,1
240620,1207,519,688,51,1
240620,117,37,80,59,1
240620,1375,487,888,60,1
240657,1880,772,1108,1,4
240657,1880,772,1108,2,1
240657,1624,659,965,3,1
240657,400,203,197,4,1
240657,1224,456,768,5,1
240657,256,113,143,11,1
240657,40,28,12,19,1
240657,1184,428,756,20,1
240657,1080,492,588,21,4
240657,1080,492,588,22,1
240657,1056,477,579,23,1
240657,372,192,180,24,1
240657,684,285,399,25,1
240657,24,15,9,31,1
240657,40,28,12,39,1
240657,644,257,387,40,1
240657,800,280,520,41,4
240657,800,280,520,42,1
240657,568,182,386,43,1
240657,28,11,17,44,1
240657,540,171,369,45,1
240657,232,98,134,51,1
240657,540,171,369,60,1
240666,4437,2257,2180,1,4
240666,4437,2257,2180,2,1
240666,2108,857,1251,3,1
240666,531,249,282,4,1
240666,1577,608,969,5,1
240666,2329,1400,929,11,1
240666,71,26,45,19,1
240666,1506,582,924,20,1
240666,1441,641,800,21,4
240666,1441,641,800,22,1
240666,1342,590,752,23,1
240666,448,203,245,24,1
240666,894,387,507,25,1
240666,99,51,48,31,1
240666,34,13,21,39,1
240666,860,374,486,40,1
240666,2996,1616,1380,41,4
240666,2996,1616,1380,42,1
240666,766,267,499,43,1
240666,83,46,37,44,1
240666,683,221,462,45,1
240666,2230,1349,881,51,1
240666,37,13,24,59,1
240666,646,208,438,60,1
240693,3620,1694,1926,1,4
240693,3620,1694,1926,2,1
240693,2792,1165,1627,3,1
240693,428,211,217,4,1
240693,2364,954,1410,5,1
240693,828,529,299,11,1
240693,324,146,178,19,1
240693,2040,808,1232,20,1
240693,1222,562,660,21,4
240693,1222,562,660,22,1
240693,1182,541,641,23,1
240693,356,184,172,24,1
240693,826,357,469,25,1
240693,40,21,19,31,1
240693,132,55,77,39,1
240693,694,302,392,40,1
240693,2398,1132,1266,41,4
240693,2398,1132,1266,42,1
240693,1610,624,986,43,1
240693,72,27,45,44,1
240693,1538,597,941,45,1
240693,788,508,280,51,1
240693,192,91,101,59,1
240693,1346,506,840,60,1
240709,46,2,44,1,4
240709,46,2,44,2,1
240709,46,2,44,3,1
240709,35,2,33,4,1
240709,11,0,11,5,1
240709,11,0,11,20,1
240709,34,1,33,21,4
240709,34,1,33,22,1
240709,34,1,33,23,1
240709,25,1,24,24,1
240709,9,0,9,25,1
240709,9,0,9,40,1
240709,12,1,11,41,4
240709,12,1,11,42,1
240709,12,1,11,43,1
240709,10,1,9,44,1
240709,2,0,2,45,1
240709,2,0,2,60,1
240718,1462,1401,61,1,4
240718,1462,1401,61,2,1
240718,1462,1401,61,3,1
240718,424,414,10,4,1
240718,1038,987,51,5,1
240718,67,63,4,19,1
240718,971,924,47,20,1
240718,1462,1401,61,21,4
240718,1462,1401,61,22,1
240718,1462,1401,61,23,1
240718,424,414,10,24,1
240718,1038,987,51,25,1
240718,67,63,4,39,1
240718,971,924,47,40,1
240727,12778,6065,6713,1,4
240727,10117,4804,5313,2,1
240727,9969,4742,5227,3,1
240727,1582,739,843,4,1
240727,8387,4003,4384,5,1
240727,148,62,86,11,1
240727,2661,1261,1400,12,3
240727,1082,463,619,19,1
240727,7305,3540,3765,20,1
240727,9743,4902,4841,21,4
240727,8255,4155,4100,22,1
240727,8254,4155,4099,23,1
240727,1568,727,841,24,1
240727,6686,3428,3258,25,1
240727,1,0,1,31,1
240727,1488,747,741,32,3
240727,758,376,382,39,1
240727,5928,3052,2876,40,1
240727,3035,1163,1872,41,4
240727,1862,649,1213,42,1
240727,1715,587,1128,43,1
240727,14,12,2,44,1
240727,1701,575,1126,45,1
240727,147,62,85,51,1
240727,1173,514,659,52,3
240727,324,87,237,59,1
240727,1377,488,889,60,1
240736,1488,576,912,1,4
240736,1488,576,912,2,1
240736,1487,576,911,3,1
240736,438,194,244,4,1
240736,1049,382,667,5,1
240736,1,0,1,11,1
240736,1,0,1,19,1
240736,1048,382,666,20,1
240736,735,285,450,21,4
240736,735,285,450,22,1
240736,735,285,450,23,1
240736,264,126,138,24,1
240736,471,159,312,25,1
240736,471,159,312,40,1
240736,753,291,462,41,4
240736,753,291,462,42,1
240736,752,291,461,43,1
240736,174,68,106,44,1
240736,578,223,355,45,1
240736,1,0,1,51,1
240736,1,0,1,59,1
240736,577,223,354,60,1
240745,2603,1154,1449,1,4
240745,2603,1154,1449,2,1
240745,2162,906,1256,3,1
240745,200,79,121,4,1
240745,1962,827,1135,5,1
240745,441,248,193,11,1
240745,51,19,32,19,1
240745,1911,808,1103,20,1
240745,1021,428,593,21,4
240745,1021,428,593,22,1
240745,941,380,561,23,1
240745,97,35,62,24,1
240745,844,345,499,25,1
240745,80,48,32,31,1
240745,25,13,12,39,1
240745,819,332,487,40,1
240745,1582,726,856,41,4
240745,1582,726,856,42,1
240745,1221,526,695,43,1
240745,103,44,59,44,1
240745,1118,482,636,45,1
240745,361,200,161,51,1
240745,26,6,20,59,1
240745,1092,476,616,60,1
240754,3836,1584,2252,1,4
240754,3532,1473,2059,2,1
240754,3488,1455,2033,3,1
240754,575,228,347,4,1
240754,2913,1227,1686,5,1
240754,44,18,26,11,1
240754,304,111,193,12,3
240754,168,69,99,19,1
240754,2745,1158,1587,20,1
240754,2793,1123,1670,21,4
240754,2690,1083,1607,22,1
240754,2684,1082,1602,23,1
240754,488,186,302,24,1
240754,2196,896,1300,25,1
240754,6,1,5,31,1
240754,103,40,63,32,3
240754,129,54,75,39,1
240754,2067,842,1225,40,1
240754,1043,461,582,41,4
240754,842,390,452,42,1
240754,804,373,431,43,1
240754,87,42,45,44,1
240754,717,331,386,45,1
240754,38,17,21,51,1
240754,201,71,130,52,3
240754,39,15,24,59,1
240754,678,316,362,60,1
240790,1109,429,680,1,4
240790,1109,429,680,2,1
240790,1063,415,648,3,1
240790,284,122,162,4,1
240790,779,293,486,5,1
240790,46,14,32,11,1
240790,6,1,5,19,1
240790,773,292,481,20,1
240790,914,352,562,21,4
240790,914,352,562,22,1
240790,896,345,551,23,1
240790,256,110,146,24,1
240790,640,235,405,25,1
240790,18,7,11,31,1
240790,4,1,3,39,1
240790,636,234,402,40,1
240790,195,77,118,41,4
240790,195,77,118,42,1
240790,167,70,97,43,1
240790,28,12,16,44,1
240790,139,58,81,45,1
240790,28,7,21,51,1
240790,2,0,2,59,1
240790,137,58,79,60,1
240879,156,39,117,1,4
240879,156,39,117,2,1
240879,156,39,117,3,1
240879,153,38,115,4,1
240879,3,1,2,5,1
240879,3,1,2,20,1
240879,156,39,117,21,4
240879,156,39,117,22,1
240879,156,39,117,23,1
240879,153,38,115,24,1
240879,3,1,2,25,1
240879,3,1,2,40,1
240985,225,71,154,1,4
240985,225,71,154,2,1
240985,225,71,154,3,1
240985,117,42,75,4,1
240985,108,29,79,5,1
240985,108,29,79,20,1
240985,225,71,154,21,4
240985,225,71,154,22,1
240985,225,71,154,23,1
240985,117,42,75,24,1
240985,108,29,79,25,1
240985,108,29,79,40,1
241100,968,471,497,1,4
241100,858,453,405,2,1
241100,850,450,400,3,1
241100,129,83,46,4,1
241100,721,367,354,5,1
241100,8,3,5,11,1
241100,110,18,92,12,3
241100,9,4,5,19,1
241100,712,363,349,20,1
241100,836,436,400,21,4
241100,794,425,369,22,1
241100,792,424,368,23,1
241100,127,82,45,24,1
241100,665,342,323,25,1
241100,2,1,1,31,1
241100,42,11,31,32,3
241100,8,3,5,39,1
241100,657,339,318,40,1
241100,132,35,97,41,4
241100,64,28,36,42,1
241100,58,26,32,43,1
241100,2,1,1,44,1
241100,56,25,31,45,1
241100,6,2,4,51,1
241100,68,7,61,52,3
241100,1,1,0,59,1
241100,55,24,31,60,1
241128,1082,496,586,1,4
241128,1008,485,523,2,1
241128,998,484,514,3,1
241128,211,119,92,4,1
241128,787,365,422,5,1
241128,10,1,9,11,1
241128,74,11,63,12,3
241128,46,20,26,19,1
241128,741,345,396,20,1
241128,953,448,505,21,4
241128,918,441,477,22,1
241128,914,441,473,23,1
241128,210,118,92,24,1
241128,704,323,381,25,1
241128,4,0,4,31,1
241128,35,7,28,32,3
241128,44,18,26,39,1
241128,660,305,355,40,1
241128,129,48,81,41,4
241128,90,44,46,42,1
241128,84,43,41,43,1
241128,1,1,0,44,1
241128,83,42,41,45,1
241128,6,1,5,51,1
241128,39,4,35,52,3
241128,2,2,0,59,1
241128,81,40,41,60,1
241146,560,180,380,1,4
241146,560,180,380,2,1
241146,560,180,380,3,1
241146,328,103,225,4,1
241146,232,77,155,5,1
241146,232,77,155,20,1
241146,557,179,378,21,4
241146,557,179,378,22,1
241146,557,179,378,23,1
241146,328,103,225,24,1
241146,229,76,153,25,1
241146,229,76,153,40,1
241146,3,1,2,41,4
241146,3,1,2,42,1
241146,3,1,2,43,1
241146,3,1,2,45,1
241146,3,1,2,60,1
241182,548,149,399,1,4
241182,548,149,399,2,1
241182,548,149,399,3,1
241182,195,55,140,4,1
241182,353,94,259,5,1
241182,353,94,259,20,1
241182,548,149,399,21,4
241182,548,149,399,22,1
241182,548,149,399,23,1
241182,195,55,140,24,1
241182,353,94,259,25,1
241182,353,94,259,40,1
241191,1403,536,867,1,4
241191,1287,519,768,2,1
241191,1261,513,748,3,1
241191,196,74,122,4,1
241191,1065,439,626,5,1
241191,26,6,20,11,1
241191,116,17,99,12,3
241191,113,52,61,19,1
241191,952,387,565,20,1
241191,1282,502,780,21,4
241191,1190,489,701,22,1
241191,1189,488,701,23,1
241191,195,74,121,24,1
241191,994,414,580,25,1
241191,1,1,0,31,1
241191,92,13,79,32,3
241191,111,52,59,39,1
241191,883,362,521,40,1
241191,121,34,87,41,4
241191,97,30,67,42,1
241191,72,25,47,43,1
241191,1,0,1,44,1
241191,71,25,46,45,1
241191,25,5,20,51,1
241191,24,4,20,52,3
241191,2,0,2,59,1
241191,69,25,44,60,1
241216,1429,1043,386,1,4
241216,1365,1011,354,2,1
241216,1365,1011,354,3,1
241216,270,192,78,4,1
241216,1095,819,276,5,1
241216,64,32,32,12,3
241216,84,62,22,19,1
241216,1011,757,254,20,1
241216,1038,764,274,21,4
241216,1015,753,262,22,1
241216,1015,753,262,23,1
241216,266,190,76,24,1
241216,749,563,186,25,1
241216,23,11,12,32,3
241216,78,58,20,39,1
241216,671,505,166,40,1
241216,391,279,112,41,4
241216,350,258,92,42,1
241216,350,258,92,43,1
241216,4,2,2,44,1
241216,346,256,90,45,1
241216,41,21,20,52,3
241216,6,4,2,59,1
241216,340,252,88,60,1
241225,2065,654,1411,1,4
241225,1657,535,1122,2,1
241225,1654,535,1119,3,1
241225,242,96,146,4,1
241225,1412,439,973,5,1
241225,3,0,3,11,1
241225,408,119,289,12,3
241225,143,43,100,19,1
241225,1269,396,873,20,1
241225,1476,466,1010,21,4
241225,1291,418,873,22,1
241225,1288,418,870,23,1
241225,229,91,138,24,1
241225,1059,327,732,25,1
241225,3,0,3,31,1
241225,185,48,137,32,3
241225,112,33,79,39,1
241225,947,294,653,40,1
241225,589,188,401,41,4
241225,366,117,249,42,1
241225,366,117,249,43,1
241225,13,5,8,44,1
241225,353,112,241,45,1
241225,223,71,152,52,3
241225,31,10,21,59,1
241225,322,102,220,60,1
241304,1823,574,1249,1,4
241304,1680,535,1145,2,1
241304,1680,535,1145,3,1
241304,295,112,183,4,1
241304,1385,423,962,5,1
241304,143,39,104,12,3
241304,1385,423,962,20,1
241304,817,290,527,21,4
241304,743,266,477,22,1
241304,743,266,477,23,1
241304,250,97,153,24,1
241304,493,169,324,25,1
241304,74,24,50,32,3
241304,493,169,324,40,1
241304,1006,284,722,41,4
241304,937,269,668,42,1
241304,937,269,668,43,1
241304,45,15,30,44,1
241304,892,254,638,45,1
241304,69,15,54,52,3
241304,892,254,638,60,1
241331,919,148,771,1,4
241331,142,16,126,2,1
241331,88,5,83,3,1
241331,88,5,83,5,1
241331,54,11,43,11,1
241331,777,132,645,12,3
241331,77,3,74,19,1
241331,11,2,9,20,1
241331,773,126,647,21,4
241331,78,5,73,22,1
241331,69,3,66,23,1
241331,69,3,66,25,1
241331,9,2,7,31,1
241331,695,121,574,32,3
241331,60,1,59,39,1
241331,9,2,7,40,1
241331,146,22,124,41,4
241331,64,11,53,42,1
241331,19,2,17,43,1
241331,19,2,17,45,1
241331,45,9,36,51,1
241331,82,11,71,52,3
241331,17,2,15,59,1
241331,2,0,2,60,1
241377,1876,764,1112,1,4
241377,1578,708,870,2,1
241377,1572,708,864,3,1
241377,265,140,125,4,1
241377,1307,568,739,5,1
241377,6,0,6,11,1
241377,298,56,242,12,3
241377,53,27,26,19,1
241377,1254,541,713,20,1
241377,1395,576,819,21,4
241377,1251,546,705,22,1
241377,1250,546,704,23,1
241377,237,124,113,24,1
241377,1013,422,591,25,1
241377,1,0,1,31,1
241377,144,30,114,32,3
241377,42,22,20,39,1
241377,971,400,571,40,1
241377,481,188,293,41,4
241377,327,162,165,42,1
241377,322,162,160,43,1
241377,28,16,12,44,1
241377,294,146,148,45,1
241377,5,0,5,51,1
241377,154,26,128,52,3
241377,11,5,6,59,1
241377,283,141,142,60,1
241386,827,198,629,1,4
241386,704,172,532,2,1
241386,703,172,531,3,1
241386,55,13,42,4,1
241386,648,159,489,5,1
241386,1,0,1,11,1
241386,123,26,97,12,3
241386,32,7,25,19,1
241386,616,152,464,20,1
241386,606,142,464,21,4
241386,559,131,428,22,1
241386,559,131,428,23,1
241386,46,11,35,24,1
241386,513,120,393,25,1
241386,47,11,36,32,3
241386,22,4,18,39,1
241386,491,116,375,40,1
241386,221,56,165,41,4
241386,145,41,104,42,1
241386,144,41,103,43,1
241386,9,2,7,44,1
241386,135,39,96,45,1
241386,1,0,1,51,1
241386,76,15,61,52,3
241386,10,3,7,59,1
241386,125,36,89,60,1
241395,986,318,668,1,4
241395,655,244,411,2,1
241395,594,228,366,3,1
241395,97,38,59,4,1
241395,497,190,307,5,1
241395,61,16,45,11,1
241395,331,74,257,12,3
241395,53,20,33,19,1
241395,444,170,274,20,1
241395,805,264,541,21,4
241395,556,212,344,22,1
241395,549,211,338,23,1
241395,97,38,59,24,1
241395,452,173,279,25,1
241395,7,1,6,31,1
241395,249,52,197,32,3
241395,51,20,31,39,1
241395,401,153,248,40,1
241395,181,54,127,41,4
241395,99,32,67,42,1
241395,45,17,28,43,1
241395,45,17,28,45,1
241395,54,15,39,51,1
241395,82,22,60,52,3
241395,2,0,2,59,1
241395,43,17,26,60,1
241410,8341,3290,5051,1,4
241410,6032,2492,3540,2,1
241410,5926,2461,3465,3,1
241410,1102,433,669,4,1
241410,4824,2028,2796,5,1
241410,106,31,75,11,1
241410,2309,798,1511,12,3
241410,223,122,101,19,1
241410,4601,1906,2695,20,1
241410,7150,2882,4268,21,4
241410,5479,2260,3219,22,1
241410,5453,2255,3198,23,1
241410,1099,433,666,24,1
241410,4354,1822,2532,25,1
241410,26,5,21,31,1
241410,1671,622,1049,32,3
241410,219,118,101,39,1
241410,4135,1704,2431,40,1
241410,1191,408,783,41,4
241410,553,232,321,42,1
241410,473,206,267,43,1
241410,3,0,3,44,1
241410,470,206,264,45,1
241410,80,26,54,51,1
241410,638,176,462,52,3
241410,4,4,0,59,1
241410,466,202,264,60,1
241517,987,256,731,1,4
241517,987,256,731,2,1
241517,987,256,731,3,1
241517,328,92,236,4,1
241517,659,164,495,5,1
241517,160,38,122,19,1
241517,499,126,373,20,1
241517,959,251,708,21,4
241517,959,251,708,22,1
241517,959,251,708,23,1
241517,328,92,236,24,1
241517,631,159,472,25,1
241517,150,36,114,39,1
241517,481,123,358,40,1
241517,28,5,23,41,4
241517,28,5,23,42,1
241517,28,5,23,43,1
241517,28,5,23,45,1
241517,10,2,8,59,1
241517,18,3,15,60,1
241614,202,122,80,1,4
241614,202,122,80,2,1
241614,199,120,79,3,1
241614,21,12,9,4,1
241614,178,108,70,5,1
241614,3,2,1,11,1
241614,37,22,15,19,1
241614,141,86,55,20,1
241614,110,65,45,21,4
241614,110,65,45,22,1
241614,110,65,45,23,1
241614,13,7,6,24,1
241614,97,58,39,25,1
241614,19,14,5,39,1
241614,78,44,34,40,1
241614,92,57,35,41,4
241614,92,57,35,42,1
241614,89,55,34,43,1
241614,8,5,3,44,1
241614,81,50,31,45,1
241614,3,2,1,51,1
241614,18,8,10,59,1
241614,63,42,21,60,1
241720,1387,637,750,1,4
241720,1387,637,750,2,1
241720,1387,637,750,3,1
241720,176,92,84,4,1
241720,1211,545,666,5,1
241720,209,112,97,19,1
241720,1002,433,569,20,1
241720,1171,550,621,21,4
241720,1171,550,621,22,1
241720,1171,550,621,23,1
241720,167,86,81,24,1
241720,1004,464,540,25,1
241720,184,103,81,39,1
241720,820,361,459,40,1
241720,216,87,129,41,4
241720,216,87,129,42,1
241720,216,87,129,43,1
241720,9,6,3,44,1
241720,207,81,126,45,1
241720,25,9,16,59,1
241720,182,72,110,60,1
241739,13631,4833,8798,1,4
241739,11503,4160,7343,2,1
241739,11503,4160,7343,3,1
241739,2142,827,1315,4,1
241739,9361,3333,6028,5,1
241739,2128,673,1455,12,3
241739,1322,504,818,19,1
241739,8039,2829,5210,20,1
241739,10202,3666,6536,21,4
241739,9192,3339,5853,22,1
241739,9192,3339,5853,23,1
241739,1984,765,1219,24,1
241739,7208,2574,4634,25,1
241739,1010,327,683,32,3
241739,1021,400,621,39,1
241739,6187,2174,4013,40,1
241739,3429,1167,2262,41,4
241739,2311,821,1490,42,1
241739,2311,821,1490,43,1
241739,158,62,96,44,1
241739,2153,759,1394,45,1
241739,1118,346,772,52,3
241739,301,104,197,59,1
241739,1852,655,1197,60,1
241766,492,330,162,1,4
241766,441,303,138,2,1
241766,424,288,136,3,1
241766,78,52,26,4,1
241766,346,236,110,5,1
241766,17,15,2,11,1
241766,51,27,24,12,3
241766,55,41,14,19,1
241766,291,195,96,20,1
241766,324,212,112,21,4
241766,289,194,95,22,1
241766,285,190,95,23,1
241766,24,11,13,24,1
241766,261,179,82,25,1
241766,4,4,0,31,1
241766,35,18,17,32,3
241766,3,2,1,39,1
241766,258,177,81,40,1
241766,168,118,50,41,4
241766,152,109,43,42,1
241766,139,98,41,43,1
241766,54,41,13,44,1
241766,85,57,28,45,1
241766,13,11,2,51,1
241766,16,9,7,52,3
241766,52,39,13,59,1
241766,33,18,15,60,1
241793,503,200,303,1,4
241793,503,200,303,12,3
241793,299,122,177,21,4
241793,299,122,177,32,3
241793,204,78,126,41,4
241793,204,78,126,52,3
241836,1195,423,772,1,4
241836,1195,423,772,2,1
241836,1195,423,772,3,1
241836,186,82,104,4,1
241836,1009,341,668,5,1
241836,45,20,25,19,1
241836,964,321,643,20,1
241836,850,314,536,21,4
241836,850,314,536,22,1
241836,850,314,536,23,1
241836,183,80,103,24,1
241836,667,234,433,25,1
241836,41,19,22,39,1
241836,626,215,411,40,1
241836,345,109,236,41,4
241836,345,109,236,42,1
241836,345,109,236,43,1
241836,3,2,1,44,1
241836,342,107,235,45,1
241836,4,1,3,59,1
241836,338,106,232,60,1
241906,397,96,301,1,4
241906,397,96,301,2,1
241906,397,96,301,3,1
241906,109,25,84,4,1
241906,288,71,217,5,1
241906,288,71,217,20,1
241906,397,96,301,21,4
241906,397,96,301,22,1
241906,397,96,301,23,1
241906,109,25,84,24,1
241906,288,71,217,25,1
241906,288,71,217,40,1
241951,529,201,328,1,4
241951,529,201,328,2,1
241951,529,201,328,3,1
241951,87,24,63,4,1
241951,442,177,265,5,1
241951,37,12,25,19,1
241951,405,165,240,20,1
241951,370,130,240,21,4
241951,370,130,240,22,1
241951,370,130,240,23,1
241951,86,24,62,24,1
241951,284,106,178,25,1
241951,30,11,19,39,1
241951,254,95,159,40,1
241951,159,71,88,41,4
241951,159,71,88,42,1
241951,159,71,88,43,1
241951,1,0,1,44,1
241951,158,71,87,45,1
241951,7,1,6,59,1
241951,151,70,81,60,1
242042,755,445,310,1,4
242042,755,445,310,2,1
242042,755,445,310,3,1
242042,319,184,135,4,1
242042,436,261,175,5,1
242042,436,261,175,20,1
242042,636,361,275,21,4
242042,636,361,275,22,1
242042,636,361,275,23,1
242042,308,179,129,24,1
242042,328,182,146,25,1
242042,328,182,146,40,1
242042,119,84,35,41,4
242042,119,84,35,42,1
242042,119,84,35,43,1
242042,11,5,6,44,1
242042,108,79,29,45,1
242042,108,79,29,60,1
242112,1255,585,670,1,4
242112,1255,585,670,2,1
242112,1255,585,670,3,1
242112,248,139,109,4,1
242112,1007,446,561,5,1
242112,260,142,118,19,1
242112,747,304,443,20,1
242112,1062,500,562,21,4
242112,1062,500,562,22,1
242112,1062,500,562,23,1
242112,245,138,107,24,1
242112,817,362,455,25,1
242112,244,135,109,39,1
242112,573,227,346,40,1
242112,193,85,108,41,4
242112,193,85,108,42,1
242112,193,85,108,43,1
242112,3,1,2,44,1
242112,190,84,106,45,1
242112,16,7,9,59,1
242112,174,77,97,60,1
242121,705,264,441,1,4
242121,705,264,441,2,1
242121,705,264,441,3,1
242121,160,68,92,4,1
242121,545,196,349,5,1
242121,17,10,7,19,1
242121,528,186,342,20,1
242121,458,181,277,21,4
242121,458,181,277,22,1
242121,458,181,277,23,1
242121,136,56,80,24,1
242121,322,125,197,25,1
242121,12,6,6,39,1
242121,310,119,191,40,1
242121,247,83,164,41,4
242121,247,83,164,42,1
242121,247,83,164,43,1
242121,24,12,12,44,1
242121,223,71,152,45,1
242121,5,4,1,59,1
242121,218,67,151,60,1
242130,542,183,359,1,4
242130,542,183,359,2,1
242130,542,183,359,3,1
242130,156,54,102,4,1
242130,386,129,257,5,1
242130,21,7,14,19,1
242130,365,122,243,20,1
242130,499,171,328,21,4
242130,499,171,328,22,1
242130,499,171,328,23,1
242130,151,51,100,24,1
242130,348,120,228,25,1
242130,20,6,14,39,1
242130,328,114,214,40,1
242130,43,12,31,41,4
242130,43,12,31,42,1
242130,43,12,31,43,1
242130,5,3,2,44,1
242130,38,9,29,45,1
242130,1,1,0,59,1
242130,37,8,29,60,1
242149,596,211,385,1,4
242149,596,211,385,2,1
242149,596,211,385,3,1
242149,225,72,153,4,1
242149,371,139,232,5,1
242149,18,9,9,19,1
242149,353,130,223,20,1
242149,503,178,325,21,4
242149,503,178,325,22,1
242149,503,178,325,23,1
242149,219,70,149,24,1
242149,284,108,176,25,1
242149,13,6,7,39,1
242149,271,102,169,40,1
242149,93,33,60,41,4
242149,93,33,60,42,1
242149,93,33,60,43,1
242149,6,2,4,44,1
242149,87,31,56,45,1
242149,5,3,2,59,1
242149,82,28,54,60,1
242316,335,124,211,1,4
242316,335,124,211,2,1
242316,335,124,211,3,1
242316,298,112,186,4,1
242316,37,12,25,5,1
242316,37,12,25,20,1
242316,335,124,211,21,4
242316,335,124,211,22,1
242316,335,124,211,23,1
242316,298,112,186,24,1
242316,37,12,25,25,1
242316,37,12,25,40,1
242413,266,194,72,1,4
242413,266,194,72,2,1
242413,266,194,72,3,1
242413,118,87,31,4,1
242413,148,107,41,5,1
242413,148,107,41,20,1
242413,266,194,72,21,4
242413,266,194,72,22,1
242413,266,194,72,23,1
242413,118,87,31,24,1
242413,148,107,41,25,1
242413,148,107,41,40,1
242422,16339,7119,9220,1,4
242422,16339,7119,9220,2,1
242422,16339,7119,9220,3,1
242422,8287,3900,4387,4,1
242422,8052,3219,4833,5,1
242422,8052,3219,4833,20,1
242422,16339,7119,9220,21,4
242422,16339,7119,9220,22,1
242422,16339,7119,9220,23,1
242422,8287,3900,4387,24,1
242422,8052,3219,4833,25,1
242422,8052,3219,4833,40,1
242556,861,522,339,1,4
242556,861,522,339,2,1
242556,861,522,339,3,1
242556,436,288,148,4,1
242556,425,234,191,5,1
242556,3,1,2,19,1
242556,422,233,189,20,1
242556,773,467,306,21,4
242556,773,467,306,22,1
242556,773,467,306,23,1
242556,436,288,148,24,1
242556,337,179,158,25,1
242556,3,1,2,39,1
242556,334,178,156,40,1
242556,88,55,33,41,4
242556,88,55,33,42,1
242556,88,55,33,43,1
242556,88,55,33,45,1
242556,88,55,33,60,1
242565,644,439,205,1,4
242565,644,439,205,2,1
242565,644,439,205,3,1
242565,272,185,87,4,1
242565,372,254,118,5,1
242565,372,254,118,20,1
242565,593,406,187,21,4
242565,593,406,187,22,1
242565,593,406,187,23,1
242565,254,170,84,24,1
242565,339,236,103,25,1
242565,339,236,103,40,1
242565,51,33,18,41,4
242565,51,33,18,42,1
242565,51,33,18,43,1
242565,18,15,3,44,1
242565,33,18,15,45,1
242565,33,18,15,60,1
242583,650,417,233,1,4
242583,650,417,233,2,1
242583,650,417,233,3,1
242583,279,195,84,4,1
242583,371,222,149,5,1
242583,24,12,12,19,1
242583,347,210,137,20,1
242583,542,343,199,21,4
242583,542,343,199,22,1
242583,542,343,199,23,1
242583,259,182,77,24,1
242583,283,161,122,25,1
242583,19,9,10,39,1
242583,264,152,112,40,1
242583,108,74,34,41,4
242583,108,74,34,42,1
242583,108,74,34,43,1
242583,20,13,7,44,1
242583,88,61,27,45,1
242583,5,3,2,59,1
242583,83,58,25,60,1
242617,5177,2313,2864,1,4
242617,4395,2088,2307,2,1
242617,4308,2053,2255,3,1
242617,892,438,454,4,1
242617,3416,1615,1801,5,1
242617,87,35,52,11,1
242617,782,225,557,12,3
242617,93,52,41,19,1
242617,3323,1563,1760,20,1
242617,4443,2034,2409,21,4
242617,3940,1881,2059,22,1
242617,3928,1878,2050,23,1
242617,882,432,450,24,1
242617,3046,1446,1600,25,1
242617,12,3,9,31,1
242617,503,153,350,32,3
242617,82,47,35,39,1
242617,2964,1399,1565,40,1
242617,734,279,455,41,4
242617,455,207,248,42,1
242617,380,175,205,43,1
242617,10,6,4,44,1
242617,370,169,201,45,1
242617,75,32,43,51,1
242617,279,72,207,52,3
242617,11,5,6,59,1
242617,359,164,195,60,1
242626,4595,2038,2557,1,4
242626,4280,1942,2338,2,1
242626,4203,1909,2294,3,1
242626,870,392,478,4,1
242626,3333,1517,1816,5,1
242626,77,33,44,11,1
242626,315,96,219,12,3
242626,102,43,59,19,1
242626,3231,1474,1757,20,1
242626,3938,1752,2186,21,4
242626,3666,1667,1999,22,1
242626,3662,1664,1998,23,1
242626,860,388,472,24,1
242626,2802,1276,1526,25,1
242626,4,3,1,31,1
242626,272,85,187,32,3
242626,90,36,54,39,1
242626,2712,1240,1472,40,1
242626,657,286,371,41,4
242626,614,275,339,42,1
242626,541,245,296,43,1
242626,10,4,6,44,1
242626,531,241,290,45,1
242626,73,30,43,51,1
242626,43,11,32,52,3
242626,12,7,5,59,1
242626,519,234,285,60,1
242635,4799,1888,2911,1,4
242635,4308,1755,2553,2,1
242635,4275,1747,2528,3,1
242635,833,389,444,4,1
242635,3442,1358,2084,5,1
242635,33,8,25,11,1
242635,491,133,358,12,3
242635,151,62,89,19,1
242635,3291,1296,1995,20,1
242635,4022,1611,2411,21,4
242635,3637,1515,2122,22,1
242635,3633,1514,2119,23,1
242635,817,380,437,24,1
242635,2816,1134,1682,25,1
242635,4,1,3,31,1
242635,385,96,289,32,3
242635,138,56,82,39,1
242635,2678,1078,1600,40,1
242635,777,277,500,41,4
242635,671,240,431,42,1
242635,642,233,409,43,1
242635,16,9,7,44,1
242635,626,224,402,45,1
242635,29,7,22,51,1
242635,106,37,69,52,3
242635,13,6,7,59,1
242635,613,218,395,60,1
242644,2073,773,1300,1,4
242644,2016,753,1263,2,1
242644,2005,753,1252,3,1
242644,513,194,319,4,1
242644,1492,559,933,5,1
242644,11,0,11,11,1
242644,57,20,37,12,3
242644,48,23,25,19,1
242644,1444,536,908,20,1
242644,1854,705,1149,21,4
242644,1811,692,1119,22,1
242644,1810,692,1118,23,1
242644,507,193,314,24,1
242644,1303,499,804,25,1
242644,1,0,1,31,1
242644,43,13,30,32,3
242644,44,22,22,39,1
242644,1259,477,782,40,1
242644,219,68,151,41,4
242644,205,61,144,42,1
242644,195,61,134,43,1
242644,6,1,5,44,1
242644,189,60,129,45,1
242644,10,0,10,51,1
242644,14,7,7,52,3
242644,4,1,3,59,1
242644,185,59,126,60,1
242653,9853,4066,5787,1,4
242653,7140,3196,3944,2,1
242653,6844,3089,3755,3,1
242653,856,390,466,4,1
242653,5988,2699,3289,5,1
242653,296,107,189,11,1
242653,2713,870,1843,12,3
242653,480,213,267,19,1
242653,5508,2486,3022,20,1
242653,7725,3210,4515,21,4
242653,5739,2561,3178,22,1
242653,5704,2545,3159,23,1
242653,819,374,445,24,1
242653,4885,2171,2714,25,1
242653,35,16,19,31,1
242653,1986,649,1337,32,3
242653,412,181,231,39,1
242653,4473,1990,2483,40,1
242653,2128,856,1272,41,4
242653,1401,635,766,42,1
242653,1140,544,596,43,1
242653,37,16,21,44,1
242653,1103,528,575,45,1
242653,261,91,170,51,1
242653,727,221,506,52,3
242653,68,32,36,59,1
242653,1035,496,539,60,1
242662,5821,2311,3510,1,4
242662,5416,2187,3229,2,1
242662,5353,2170,3183,3,1
242662,1064,441,623,4,1
242662,4289,1729,2560,5,1
242662,63,17,46,11,1
242662,405,124,281,12,3
242662,139,66,73,19,1
242662,4150,1663,2487,20,1
242662,4974,2022,2952,21,4
242662,4618,1914,2704,22,1
242662,4617,1913,2704,23,1
242662,1058,438,620,24,1
242662,3559,1475,2084,25,1
242662,1,1,0,31,1
242662,356,108,248,32,3
242662,131,64,67,39,1
242662,3428,1411,2017,40,1
242662,847,289,558,41,4
242662,798,273,525,42,1
242662,736,257,479,43,1
242662,6,3,3,44,1
242662,730,254,476,45,1
242662,62,16,46,51,1
242662,49,16,33,52,3
242662,8,2,6,59,1
242662,722,252,470,60,1
242680,2259,903,1356,1,4
242680,2179,868,1311,2,1
242680,2159,867,1292,3,1
242680,431,165,266,4,1
242680,1728,702,1026,5,1
242680,20,1,19,11,1
242680,80,35,45,12,3
242680,45,21,24,19,1
242680,1683,681,1002,20,1
242680,1902,757,1145,21,4
242680,1828,725,1103,22,1
242680,1826,725,1101,23,1
242680,413,156,257,24,1
242680,1413,569,844,25,1
242680,2,0,2,31,1
242680,74,32,42,32,3
242680,40,17,23,39,1
242680,1373,552,821,40,1
242680,357,146,211,41,4
242680,351,143,208,42,1
242680,333,142,191,43,1
242680,18,9,9,44,1
242680,315,133,182,45,1
242680,18,1,17,51,1
242680,6,3,3,52,3
242680,5,4,1,59,1
242680,310,129,181,60,1
242699,2169,766,1403,1,4
242699,2093,718,1375,2,1
242699,2054,707,1347,3,1
242699,324,118,206,4,1
242699,1730,589,1141,5,1
242699,39,11,28,11,1
242699,76,48,28,12,3
242699,77,30,47,19,1
242699,1653,559,1094,20,1
242699,1844,643,1201,21,4
242699,1784,607,1177,22,1
242699,1774,605,1169,23,1
242699,317,114,203,24,1
242699,1457,491,966,25,1
242699,10,2,8,31,1
242699,60,36,24,32,3
242699,70,28,42,39,1
242699,1387,463,924,40,1
242699,325,123,202,41,4
242699,309,111,198,42,1
242699,280,102,178,43,1
242699,7,4,3,44,1
242699,273,98,175,45,1
242699,29,9,20,51,1
242699,16,12,4,52,3
242699,7,2,5,59,1
242699,266,96,170,60,1
242705,4857,2685,2172,1,4
242705,4712,2644,2068,2,1
242705,4681,2635,2046,3,1
242705,926,533,393,4,1
242705,3755,2102,1653,5,1
242705,31,9,22,11,1
242705,145,41,104,12,3
242705,155,80,75,19,1
242705,3600,2022,1578,20,1
242705,4169,2291,1878,21,4
242705,4057,2261,1796,22,1
242705,4057,2261,1796,23,1
242705,917,526,391,24,1
242705,3140,1735,1405,25,1
242705,112,30,82,32,3
242705,140,77,63,39,1
242705,3000,1658,1342,40,1
242705,688,394,294,41,4
242705,655,383,272,42,1
242705,624,374,250,43,1
242705,9,7,2,44,1
242705,615,367,248,45,1
242705,31,9,22,51,1
242705,33,11,22,52,3
242705,15,3,12,59,1
242705,600,364,236,60,1
242723,803,354,449,1,4
242723,803,354,449,12,3
242723,457,201,256,21,4
242723,457,201,256,32,3
242723,346,153,193,41,4
242723,346,153,193,52,3
242750,102,51,51,1,4
242750,102,51,51,2,1
242750,102,51,51,3,1
242750,57,25,32,4,1
242750,45,26,19,5,1
242750,45,26,19,20,1
242750,102,51,51,21,4
242750,102,51,51,22,1
242750,102,51,51,23,1
242750,57,25,32,24,1
242750,45,26,19,25,1
242750,45,26,19,40,1
242820,1316,1107,209,1,4
242820,1316,1107,209,2,1
242820,1316,1107,209,3,1
242820,369,317,52,4,1
242820,947,790,157,5,1
242820,947,790,157,20,1
242820,1316,1107,209,21,4
242820,1316,1107,209,22,1
242820,1316,1107,209,23,1
242820,369,317,52,24,1
242820,947,790,157,25,1
242820,947,790,157,40,1
242884,4431,1217,3214,1,4
242884,4431,1217,3214,2,1
242884,4431,1217,3214,3,1
242884,2157,602,1555,4,1
242884,2274,615,1659,5,1
242884,2274,615,1659,20,1
242884,4425,1215,3210,21,4
242884,4425,1215,3210,22,1
242884,4425,1215,3210,23,1
242884,2157,602,1555,24,1
242884,2268,613,1655,25,1
242884,2268,613,1655,40,1
242884,6,2,4,41,4
242884,6,2,4,42,1
242884,6,2,4,43,1
242884,6,2,4,45,1
242884,6,2,4,60,1
242945,253,82,171,1,4
242945,253,82,171,2,1
242945,253,82,171,3,1
242945,224,74,150,4,1
242945,29,8,21,5,1
242945,29,8,21,20,1
242945,199,67,132,21,4
242945,199,67,132,22,1
242945,199,67,132,23,1
242945,180,60,120,24,1
242945,19,7,12,25,1
242945,19,7,12,40,1
242945,54,15,39,41,4
242945,54,15,39,42,1
242945,54,15,39,43,1
242945,44,14,30,44,1
242945,10,1,9,45,1
242945,10,1,9,60,1
242954,76,12,64,1,4
242954,76,12,64,2,1
242954,76,12,64,3,1
242954,73,12,61,4,1
242954,3,0,3,5,1
242954,3,0,3,20,1
242954,65,12,53,21,4
242954,65,12,53,22,1
242954,65,12,53,23,1
242954,63,12,51,24,1
242954,2,0,2,25,1
242954,2,0,2,40,1
242954,11,0,11,41,4
242954,11,0,11,42,1
242954,11,0,11,43,1
242954,10,0,10,44,1
242954,1,0,1,45,1
242954,1,0,1,60,1
242972,5213,1641,3572,1,4
242972,4998,1591,3407,2,1
242972,4993,1589,3404,3,1
242972,1291,462,829,4,1
242972,3702,1127,2575,5,1
242972,5,2,3,11,1
242972,215,50,165,12,3
242972,704,231,473,19,1
242972,2998,896,2102,20,1
242972,3525,1133,2392,21,4
242972,3354,1091,2263,22,1
242972,3354,1091,2263,23,1
242972,1029,379,650,24,1
242972,2325,712,1613,25,1
242972,171,42,129,32,3
242972,509,164,345,39,1
242972,1816,548,1268,40,1
242972,1688,508,1180,41,4
242972,1644,500,1144,42,1
242972,1639,498,1141,43,1
242972,262,83,179,44,1
242972,1377,415,962,45,1
242972,5,2,3,51,1
242972,44,8,36,52,3
242972,195,67,128,59,1
242972,1182,348,834,60,1
242981,1650,619,1031,1,4
242981,1650,619,1031,2,1
242981,1646,618,1028,3,1
242981,283,111,172,4,1
242981,1363,507,856,5,1
242981,4,1,3,11,1
242981,162,60,102,19,1
242981,1201,447,754,20,1
242981,1124,436,688,21,4
242981,1124,436,688,22,1
242981,1124,436,688,23,1
242981,274,110,164,24,1
242981,850,326,524,25,1
242981,129,48,81,39,1
242981,721,278,443,40,1
242981,526,183,343,41,4
242981,526,183,343,42,1
242981,522,182,340,43,1
242981,9,1,8,44,1
242981,513,181,332,45,1
242981,4,1,3,51,1
242981,33,12,21,59,1
242981,480,169,311,60,1
243072,2882,1104,1778,1,4
243072,2882,1104,1778,2,1
243072,2882,1104,1778,3,1
243072,546,230,316,4,1
243072,2336,874,1462,5,1
243072,506,199,307,19,1
243072,1830,675,1155,20,1
243072,2714,1024,1690,21,4
243072,2714,1024,1690,22,1
243072,2714,1024,1690,23,1
243072,525,222,303,24,1
243072,2189,802,1387,25,1
243072,472,183,289,39,1
243072,1717,619,1098,40,1
243072,168,80,88,41,4
243072,168,80,88,42,1
243072,168,80,88,43,1
243072,21,8,13,44,1
243072,147,72,75,45,1
243072,34,16,18,59,1
243072,113,56,57,60,1
243081,669,206,463,1,4
243081,669,206,463,12,3
243081,669,206,463,21,4
243081,669,206,463,32,3
243106,2973,1204,1769,1,4
243106,2973,1204,1769,2,1
243106,2886,1165,1721,3,1
243106,718,300,418,4,1
243106,2168,865,1303,5,1
243106,87,39,48,11,1
243106,72,32,40,19,1
243106,2096,833,1263,20,1
243106,2708,1089,1619,21,4
243106,2708,1089,1619,22,1
243106,2697,1085,1612,23,1
243106,718,300,418,24,1
243106,1979,785,1194,25,1
243106,11,4,7,31,1
243106,69,29,40,39,1
243106,1910,756,1154,40,1
243106,265,115,150,41,4
243106,265,115,150,42,1
243106,189,80,109,43,1
243106,189,80,109,45,1
243106,76,35,41,51,1
243106,3,3,0,59,1
243106,186,77,109,60,1
243115,3759,1518,2241,1,4
243115,3759,1518,2241,2,1
243115,3654,1487,2167,3,1
243115,863,377,486,4,1
243115,2791,1110,1681,5,1
243115,105,31,74,11,1
243115,21,12,9,19,1
243115,2770,1098,1672,20,1
243115,3456,1400,2056,21,4
243115,3456,1400,2056,22,1
243115,3430,1392,2038,23,1
243115,863,377,486,24,1
243115,2567,1015,1552,25,1
243115,26,8,18,31,1
243115,21,12,9,39,1
243115,2546,1003,1543,40,1
243115,303,118,185,41,4
243115,303,118,185,42,1
243115,224,95,129,43,1
243115,224,95,129,45,1
243115,79,23,56,51,1
243115,224,95,129,60,1
243133,5075,2422,2653,1,4
243133,5075,2422,2653,2,1
243133,4847,2350,2497,3,1
243133,1134,556,578,4,1
243133,3713,1794,1919,5,1
243133,228,72,156,11,1
243133,124,57,67,19,1
243133,3589,1737,1852,20,1
243133,4305,2073,2232,21,4
243133,4305,2073,2232,22,1
243133,4269,2059,2210,23,1
243133,1131,555,576,24,1
243133,3138,1504,1634,25,1
243133,36,14,22,31,1
243133,92,41,51,39,1
243133,3046,1463,1583,40,1
243133,770,349,421,41,4
243133,770,349,421,42,1
243133,578,291,287,43,1
243133,3,1,2,44,1
243133,575,290,285,45,1
243133,192,58,134,51,1
243133,32,16,16,59,1
243133,543,274,269,60,1
243142,3994,1526,2468,1,4
243142,3994,1526,2468,2,1
243142,3880,1469,2411,3,1
243142,973,362,611,4,1
243142,2907,1107,1800,5,1
243142,114,57,57,11,1
243142,55,22,33,19,1
243142,2852,1085,1767,20,1
243142,3155,1196,1959,21,4
243142,3155,1196,1959,22,1
243142,3123,1187,1936,23,1
243142,971,360,611,24,1
243142,2152,827,1325,25,1
243142,32,9,23,31,1
243142,55,22,33,39,1
243142,2097,805,1292,40,1
243142,839,330,509,41,4
243142,839,330,509,42,1
243142,757,282,475,43,1
243142,2,2,0,44,1
243142,755,280,475,45,1
243142,82,48,34,51,1
243142,755,280,475,60,1
243151,3816,1270,2546,1,4
243151,3816,1270,2546,2,1
243151,3779,1259,2520,3,1
243151,872,334,538,4,1
243151,2907,925,1982,5,1
243151,37,11,26,11,1
243151,148,51,97,19,1
243151,2759,874,1885,20,1
243151,3530,1186,2344,21,4
243151,3530,1186,2344,22,1
243151,3507,1178,2329,23,1
243151,871,334,537,24,1
243151,2636,844,1792,25,1
243151,23,8,15,31,1
243151,110,45,65,39,1
243151,2526,799,1727,40,1
243151,286,84,202,41,4
243151,286,84,202,42,1
243151,272,81,191,43,1
243151,1,0,1,44,1
243151,271,81,190,45,1
243151,14,3,11,51,1
243151,38,6,32,59,1
243151,233,75,158,60,1
243179,3495,1233,2262,1,4
243179,3495,1233,2262,2,1
243179,3383,1194,2189,3,1
243179,780,272,508,4,1
243179,2603,922,1681,5,1
243179,112,39,73,11,1
243179,59,23,36,19,1
243179,2544,899,1645,20,1
243179,3099,1097,2002,21,4
243179,3099,1097,2002,22,1
243179,3074,1087,1987,23,1
243179,777,271,506,24,1
243179,2297,816,1481,25,1
243179,25,10,15,31,1
243179,58,23,35,39,1
243179,2239,793,1446,40,1
243179,396,136,260,41,4
243179,396,136,260,42,1
243179,309,107,202,43,1
243179,3,1,2,44,1
243179,306,106,200,45,1
243179,87,29,58,51,1
243179,1,0,1,59,1
243179,305,106,199,60,1
243188,1559,762,797,1,4
243188,1559,762,797,2,1
243188,1504,738,766,3,1
243188,645,336,309,4,1
243188,859,402,457,5,1
243188,55,24,31,11,1
243188,24,16,8,19,1
243188,835,386,449,20,1
243188,1460,714,746,21,4
243188,1460,714,746,22,1
243188,1449,711,738,23,1
243188,645,336,309,24,1
243188,804,375,429,25,1
243188,11,3,8,31,1
243188,24,16,8,39,1
243188,780,359,421,40,1
243188,99,48,51,41,4
243188,99,48,51,42,1
243188,55,27,28,43,1
243188,55,27,28,45,1
243188,44,21,23,51,1
243188,55,27,28,60,1
243197,11838,6343,5495,1,4
243197,10944,5859,5085,2,1
243197,10697,5752,4945,3,1
243197,1851,991,860,4,1
243197,8846,4761,4085,5,1
243197,247,107,140,11,1
243197,894,484,410,12,3
243197,224,146,78,19,1
243197,8622,4615,4007,20,1
243197,11057,5924,5133,21,4
243197,10219,5468,4751,22,1
243197,10134,5433,4701,23,1
243197,1850,990,860,24,1
243197,8284,4443,3841,25,1
243197,85,35,50,31,1
243197,838,456,382,32,3
243197,221,143,78,39,1
243197,8063,4300,3763,40,1
243197,781,419,362,41,4
243197,725,391,334,42,1
243197,563,319,244,43,1
243197,1,1,0,44,1
243197,562,318,244,45,1
243197,162,72,90,51,1
243197,56,28,28,52,3
243197,3,3,0,59,1
243197,559,315,244,60,1
243203,2253,644,1609,1,4
243203,489,102,387,2,1
243203,489,102,387,3,1
243203,489,102,387,5,1
243203,1764,542,1222,12,3
243203,192,38,154,19,1
243203,297,64,233,20,1
243203,2123,601,1522,21,4
243203,453,91,362,22,1
243203,453,91,362,23,1
243203,453,91,362,25,1
243203,1670,510,1160,32,3
243203,185,36,149,39,1
243203,268,55,213,40,1
243203,130,43,87,41,4
243203,36,11,25,42,1
243203,36,11,25,43,1
243203,36,11,25,45,1
243203,94,32,62,52,3
243203,7,2,5,59,1
243203,29,9,20,60,1
243212,3120,1305,1815,1,4
243212,3120,1305,1815,2,1
243212,3120,1305,1815,3,1
243212,768,352,416,4,1
243212,2352,953,1399,5,1
243212,99,47,52,19,1
243212,2253,906,1347,20,1
243212,2881,1226,1655,21,4
243212,2881,1226,1655,22,1
243212,2881,1226,1655,23,1
243212,766,352,414,24,1
243212,2115,874,1241,25,1
243212,94,45,49,39,1
243212,2021,829,1192,40,1
243212,239,79,160,41,4
243212,239,79,160,42,1
243212,239,79,160,43,1
243212,2,0,2,44,1
243212,237,79,158,45,1
243212,5,2,3,59,1
243212,232,77,155,60,1
243221,15487,5911,9576,1,4
243221,12126,4627,7499,2,1
243221,11834,4479,7355,3,1
243221,2211,836,1375,4,1
243221,9623,3643,5980,5,1
243221,292,148,144,11,1
243221,3361,1284,2077,12,3
243221,359,128,231,19,1
243221,9264,3515,5749,20,1
243221,13538,5160,8378,21,4
243221,10780,4083,6697,22,1
243221,10613,3993,6620,23,1
243221,2180,821,1359,24,1
243221,8433,3172,5261,25,1
243221,167,90,77,31,1
243221,2758,1077,1681,32,3
243221,336,118,218,39,1
243221,8097,3054,5043,40,1
243221,1949,751,1198,41,4
243221,1346,544,802,42,1
243221,1221,486,735,43,1
243221,31,15,16,44,1
243221,1190,471,719,45,1
243221,125,58,67,51,1
243221,603,207,396,52,3
243221,23,10,13,59,1
243221,1167,461,706,60,1
243346,13420,5075,8345,1,4
243346,12287,4763,7524,2,1
243346,12287,4763,7524,3,1
243346,2340,1026,1314,4,1
243346,9947,3737,6210,5,1
243346,1133,312,821,12,3
243346,451,167,284,19,1
243346,9496,3570,5926,20,1
243346,9681,3800,5881,21,4
243346,9217,3658,5559,22,1
243346,9217,3658,5559,23,1
243346,2050,871,1179,24,1
243346,7167,2787,4380,25,1
243346,464,142,322,32,3
243346,295,108,187,39,1
243346,6872,2679,4193,40,1
243346,3739,1275,2464,41,4
243346,3070,1105,1965,42,1
243346,3070,1105,1965,43,1
243346,290,155,135,44,1
243346,2780,950,1830,45,1
243346,669,170,499,52,3
243346,156,59,97,59,1
243346,2624,891,1733,60,1
243407,14,6,8,1,4
243407,14,6,8,2,1
243407,14,6,8,3,1
243407,7,5,2,4,1
243407,7,1,6,5,1
243407,7,1,6,20,1
243407,14,6,8,21,4
243407,14,6,8,22,1
243407,14,6,8,23,1
243407,7,5,2,24,1
243407,7,1,6,25,1
243407,7,1,6,40,1
243416,33,6,27,1,4
243416,33,6,27,2,1
243416,33,6,27,3,1
243416,25,5,20,4,1
243416,8,1,7,5,1
243416,8,1,7,20,1
243416,33,6,27,21,4
243416,33,6,27,22,1
243416,33,6,27,23,1
243416,25,5,20,24,1
243416,8,1,7,25,1
243416,8,1,7,40,1
243443,5892,2242,3650,1,4
243443,5159,2030,3129,2,1
243443,5097,2003,3094,3,1
243443,728,278,450,4,1
243443,4369,1725,2644,5,1
243443,62,27,35,11,1
243443,733,212,521,12,3
243443,393,181,212,19,1
243443,3976,1544,2432,20,1
243443,4435,1754,2681,21,4
243443,4424,1752,2672,22,1
243443,4394,1739,2655,23,1
243443,669,262,407,24,1
243443,3725,1477,2248,25,1
243443,30,13,17,31,1
243443,11,2,9,32,3
243443,367,167,200,39,1
243443,3358,1310,2048,40,1
243443,1457,488,969,41,4
243443,735,278,457,42,1
243443,703,264,439,43,1
243443,59,16,43,44,1
243443,644,248,396,45,1
243443,32,14,18,51,1
243443,722,210,512,52,3
243443,26,14,12,59,1
243443,618,234,384,60,1
243498,224,134,90,1,4
243498,224,134,90,12,3
243498,49,33,16,21,4
243498,49,33,16,32,3
243498,175,101,74,41,4
243498,175,101,74,52,3
243568,467,184,283,1,4
243568,144,27,117,2,1
243568,144,27,117,3,1
243568,12,1,11,4,1
243568,132,26,106,5,1
243568,323,157,166,12,3
243568,132,26,106,20,1
243568,422,172,250,21,4
243568,101,16,85,22,1
243568,101,16,85,23,1
243568,12,1,11,24,1
243568,89,15,74,25,1
243568,321,156,165,32,3
243568,89,15,74,40,1
243568,45,12,33,41,4
243568,43,11,32,42,1
243568,43,11,32,43,1
243568,43,11,32,45,1
243568,2,1,1,52,3
243568,43,11,32,60,1
243577,4646,3633,1013,1,4
243577,3861,3077,784,2,1
243577,3840,3065,775,3,1
243577,364,302,62,4,1
243577,3476,2763,713,5,1
243577,21,12,9,11,1
243577,785,556,229,12,3
243577,247,204,43,19,1
243577,3229,2559,670,20,1
243577,2394,1849,545,21,4
243577,1873,1492,381,22,1
243577,1873,1492,381,23,1
243577,348,289,59,24,1
243577,1525,1203,322,25,1
243577,521,357,164,32,3
243577,141,113,28,39,1
243577,1384,1090,294,40,1
243577,2252,1784,468,41,4
243577,1988,1585,403,42,1
243577,1967,1573,394,43,1
243577,16,13,3,44,1
243577,1951,1560,391,45,1
243577,21,12,9,51,1
243577,264,199,65,52,3
243577,106,91,15,59,1
243577,1845,1469,376,60,1
243586,1501,595,906,1,4
243586,1386,547,839,2,1
243586,1369,539,830,3,1
243586,184,76,108,4,1
243586,1185,463,722,5,1
243586,17,8,9,11,1
243586,115,48,67,12,3
243586,108,51,57,19,1
243586,1077,412,665,20,1
243586,1263,501,762,21,4
243586,1205,479,726,22,1
243586,1201,478,723,23,1
243586,184,76,108,24,1
243586,1017,402,615,25,1
243586,4,1,3,31,1
243586,58,22,36,32,3
243586,105,51,54,39,1
243586,912,351,561,40,1
243586,238,94,144,41,4
243586,181,68,113,42,1
243586,168,61,107,43,1
243586,168,61,107,45,1
243586,13,7,6,51,1
243586,57,26,31,52,3
243586,3,0,3,59,1
243586,165,61,104,60,1
243601,17287,6958,10329,1,4
243601,14556,6051,8505,2,1
243601,14556,6051,8505,3,1
243601,2542,1162,1380,4,1
243601,12014,4889,7125,5,1
243601,2731,907,1824,12,3
243601,538,221,317,19,1
243601,11476,4668,6808,20,1
243601,12133,5077,7056,21,4
243601,10832,4618,6214,22,1
243601,10832,4618,6214,23,1
243601,2365,1087,1278,24,1
243601,8467,3531,4936,25,1
243601,1301,459,842,32,3
243601,367,150,217,39,1
243601,8100,3381,4719,40,1
243601,5154,1881,3273,41,4
243601,3724,1433,2291,42,1
243601,3724,1433,2291,43,1
243601,177,75,102,44,1
243601,3547,1358,2189,45,1
243601,1430,448,982,52,3
243601,171,71,100,59,1
243601,3376,1287,2089,60,1
243638,2446,1183,1263,1,4
243638,2446,1183,1263,2,1
243638,2446,1183,1263,3,1
243638,481,249,232,4,1
243638,1965,934,1031,5,1
243638,1965,934,1031,20,1
243638,1630,778,852,21,4
243638,1630,778,852,22,1
243638,1630,778,852,23,1
243638,338,172,166,24,1
243638,1292,606,686,25,1
243638,1292,606,686,40,1
243638,816,405,411,41,4
243638,816,405,411,42,1
243638,816,405,411,43,1
243638,143,77,66,44,1
243638,673,328,345,45,1
243638,673,328,345,60,1
243647,646,302,344,1,4
243647,646,302,344,2,1
243647,637,295,342,3,1
243647,216,115,101,4,1
243647,421,180,241,5,1
243647,9,7,2,11,1
243647,5,4,1,19,1
243647,416,176,240,20,1
243647,417,200,217,21,4
243647,417,200,217,22,1
243647,415,198,217,23,1
243647,182,93,89,24,1
243647,233,105,128,25,1
243647,2,2,0,31,1
243647,2,1,1,39,1
243647,231,104,127,40,1
243647,229,102,127,41,4
243647,229,102,127,42,1
243647,222,97,125,43,1
243647,34,22,12,44,1
243647,188,75,113,45,1
243647,7,5,2,51,1
243647,3,3,0,59,1
243647,185,72,113,60,1
243665,2321,703,1618,1,4
243665,2143,669,1474,2,1
243665,2023,626,1397,3,1
243665,345,123,222,4,1
243665,1678,503,1175,5,1
243665,120,43,77,11,1
243665,178,34,144,12,3
243665,123,42,81,19,1
243665,1555,461,1094,20,1
243665,1396,449,947,21,4
243665,1334,440,894,22,1
243665,1330,439,891,23,1
243665,301,104,197,24,1
243665,1029,335,694,25,1
243665,4,1,3,31,1
243665,62,9,53,32,3
243665,88,29,59,39,1
243665,941,306,635,40,1
243665,925,254,671,41,4
243665,809,229,580,42,1
243665,693,187,506,43,1
243665,44,19,25,44,1
243665,649,168,481,45,1
243665,116,42,74,51,1
243665,116,25,91,52,3
243665,35,13,22,59,1
243665,614,155,459,60,1
243744,18346,10382,7964,1,4
243744,7274,3743,3531,2,1
243744,6980,3706,3274,3,1
243744,1674,902,772,4,1
243744,5306,2804,2502,5,1
243744,294,37,257,11,1
243744,11072,6639,4433,12,3
243744,28,17,11,19,1
243744,5278,2787,2491,20,1
243744,15585,9045,6540,21,4
243744,6981,3706,3275,22,1
243744,6980,3706,3274,23,1
243744,1674,902,772,24,1
243744,5306,2804,2502,25,1
243744,1,0,1,31,1
243744,8604,5339,3265,32,3
243744,28,17,11,39,1
243744,5278,2787,2491,40,1
243744,2761,1337,1424,41,4
243744,293,37,256,42,1
243744,293,37,256,51,1
243744,2468,1300,1168,52,3
243780,39794,23234,16560,1,4
243780,30446,17672,12774,2,1
243780,30167,17517,12650,3,1
243780,6422,3659,2763,4,1
243780,23745,13858,9887,5,1
243780,279,155,124,11,1
243780,9348,5562,3786,12,3
243780,971,510,461,19,1
243780,22774,13348,9426,20,1
243780,34871,20132,14739,21,4
243780,28659,16593,12066,22,1
243780,28615,16562,12053,23,1
243780,6388,3639,2749,24,1
243780,22227,12923,9304,25,1
243780,44,31,13,31,1
243780,6212,3539,2673,32,3
243780,873,473,400,39,1
243780,21354,12450,8904,40,1
243780,4923,3102,1821,41,4
243780,1787,1079,708,42,1
243780,1552,955,597,43,1
243780,34,20,14,44,1
243780,1518,935,583,45,1
243780,235,124,111,51,1
243780,3136,2023,1113,52,3
243780,98,37,61,59,1
243780,1420,898,522,60,1
243799,56,9,47,1,4
243799,56,9,47,2,1
243799,56,9,47,3,1
243799,5,0,5,4,1
243799,51,9,42,5,1
243799,51,9,42,20,1
243799,56,9,47,21,4
243799,56,9,47,22,1
243799,56,9,47,23,1
243799,5,0,5,24,1
243799,51,9,42,25,1
243799,51,9,42,40,1
243823,922,492,430,1,4
243823,157,63,94,2,1
243823,157,63,94,3,1
243823,26,9,17,4,1
243823,131,54,77,5,1
243823,765,429,336,12,3
243823,107,40,67,19,1
243823,24,14,10,20,1
243823,819,451,368,21,4
243823,76,36,40,22,1
243823,76,36,40,23,1
243823,8,3,5,24,1
243823,68,33,35,25,1
243823,743,415,328,32,3
243823,52,25,27,39,1
243823,16,8,8,40,1
243823,103,41,62,41,4
243823,81,27,54,42,1
243823,81,27,54,43,1
243823,18,6,12,44,1
243823,63,21,42,45,1
243823,22,14,8,52,3
243823,55,15,40,59,1
243823,8,6,2,60,1
243832,1348,483,865,1,4
243832,1275,440,835,2,1
243832,1272,439,833,3,1
243832,112,32,80,4,1
243832,1160,407,753,5,1
243832,3,1,2,11,1
243832,73,43,30,12,3
243832,346,114,232,19,1
243832,814,293,521,20,1
243832,843,295,548,21,4
243832,778,256,522,22,1
243832,778,256,522,23,1
243832,94,26,68,24,1
243832,684,230,454,25,1
243832,65,39,26,32,3
243832,222,66,156,39,1
243832,462,164,298,40,1
243832,505,188,317,41,4
243832,497,184,313,42,1
243832,494,183,311,43,1
243832,18,6,12,44,1
243832,476,177,299,45,1
243832,3,1,2,51,1
243832,8,4,4,52,3
243832,124,48,76,59,1
243832,352,129,223,60,1
243841,789,234,555,1,4
243841,789,234,555,2,1
243841,789,234,555,3,1
243841,376,108,268,4,1
243841,413,126,287,5,1
243841,14,3,11,19,1
243841,399,123,276,20,1
243841,678,211,467,21,4
243841,678,211,467,22,1
243841,678,211,467,23,1
243841,361,106,255,24,1
243841,317,105,212,25,1
243841,13,2,11,39,1
243841,304,103,201,40,1
243841,111,23,88,41,4
243841,111,23,88,42,1
243841,111,23,88,43,1
243841,15,2,13,44,1
243841,96,21,75,45,1
243841,1,1,0,59,1
243841,95,20,75,60,1
244011,557,449,108,1,4
244011,557,449,108,2,1
244011,557,449,108,3,1
244011,91,75,16,4,1
244011,466,374,92,5,1
244011,4,4,0,19,1
244011,462,370,92,20,1
244011,435,360,75,21,4
244011,435,360,75,22,1
244011,435,360,75,23,1
244011,81,68,13,24,1
244011,354,292,62,25,1
244011,3,3,0,39,1
244011,351,289,62,40,1
244011,122,89,33,41,4
244011,122,89,33,42,1
244011,122,89,33,43,1
244011,10,7,3,44,1
244011,112,82,30,45,1
244011,1,1,0,59,1
244011,111,81,30,60,1
244154,218,194,24,1,4
244154,218,194,24,2,1
244154,218,194,24,3,1
244154,37,33,4,4,1
244154,181,161,20,5,1
244154,3,1,2,19,1
244154,178,160,18,20,1
244154,170,151,19,21,4
244154,170,151,19,22,1
244154,170,151,19,23,1
244154,34,31,3,24,1
244154,136,120,16,25,1
244154,3,1,2,39,1
244154,133,119,14,40,1
244154,48,43,5,41,4
244154,48,43,5,42,1
244154,48,43,5,43,1
244154,3,2,1,44,1
244154,45,41,4,45,1
244154,45,41,4,60,1
244190,905,424,481,1,4
244190,110,14,96,2,1
244190,105,13,92,3,1
244190,28,4,24,4,1
244190,77,9,68,5,1
244190,5,1,4,11,1
244190,795,410,385,12,3
244190,5,0,5,19,1
244190,72,9,63,20,1
244190,720,383,337,21,4
244190,28,4,24,22,1
244190,28,4,24,23,1
244190,6,2,4,24,1
244190,22,2,20,25,1
244190,692,379,313,32,3
244190,3,0,3,39,1
244190,19,2,17,40,1
244190,185,41,144,41,4
244190,82,10,72,42,1
244190,77,9,68,43,1
244190,22,2,20,44,1
244190,55,7,48,45,1
244190,5,1,4,51,1
244190,103,31,72,52,3
244190,2,0,2,59,1
244190,53,7,46,60,1
244233,633,177,456,1,4
244233,633,177,456,2,1
244233,633,177,456,3,1
244233,47,15,32,4,1
244233,586,162,424,5,1
244233,61,14,47,19,1
244233,525,148,377,20,1
244233,386,118,268,21,4
244233,386,118,268,22,1
244233,386,118,268,23,1
244233,33,9,24,24,1
244233,353,109,244,25,1
244233,33,8,25,39,1
244233,320,101,219,40,1
244233,247,59,188,41,4
244233,247,59,188,42,1
244233,247,59,188,43,1
244233,14,6,8,44,1
244233,233,53,180,45,1
244233,28,6,22,59,1
244233,205,47,158,60,1
244279,163,10,153,1,4
244279,163,10,153,2,1
244279,163,10,153,3,1
244279,40,5,35,4,1
244279,123,5,118,5,1
244279,123,5,118,20,1
244279,163,10,153,21,4
244279,163,10,153,22,1
244279,163,10,153,23,1
244279,40,5,35,24,1
244279,123,5,118,25,1
244279,123,5,118,40,1
244437,21123,8647,12476,1,4
244437,21123,8647,12476,2,1
244437,18982,7843,11139,3,1
244437,3410,1651,1759,4,1
244437,15572,6192,9380,5,1
244437,2141,804,1337,11,1
244437,2121,850,1271,19,1
244437,13451,5342,8109,20,1
244437,8140,3801,4339,21,4
244437,8140,3801,4339,22,1
244437,7836,3700,4136,23,1
244437,2133,1060,1073,24,1
244437,5703,2640,3063,25,1
244437,304,101,203,31,1
244437,974,450,524,39,1
244437,4729,2190,2539,40,1
244437,12983,4846,8137,41,4
244437,12983,4846,8137,42,1
244437,11146,4143,7003,43,1
244437,1277,591,686,44,1
244437,9869,3552,6317,45,1
244437,1837,703,1134,51,1
244437,1147,400,747,59,1
244437,8722,3152,5570,60,1
244446,4431,1814,2617,1,4
244446,4431,1814,2617,2,1
244446,4047,1685,2362,3,1
244446,696,365,331,4,1
244446,3351,1320,2031,5,1
244446,384,129,255,11,1
244446,1848,689,1159,19,1
244446,1503,631,872,20,1
244446,1470,704,766,21,4
244446,1470,704,766,22,1
244446,1403,692,711,23,1
244446,281,179,102,24,1
244446,1122,513,609,25,1
244446,67,12,55,31,1
244446,654,291,363,39,1
244446,468,222,246,40,1
244446,2961,1110,1851,41,4
244446,2961,1110,1851,42,1
244446,2644,993,1651,43,1
244446,415,186,229,44,1
244446,2229,807,1422,45,1
244446,317,117,200,51,1
244446,1194,398,796,59,1
244446,1035,409,626,60,1
244491,112,5,107,1,4
244491,112,5,107,2,1
244491,112,5,107,3,1
244491,24,1,23,4,1
244491,88,4,84,5,1
244491,88,4,84,20,1
244491,112,5,107,21,4
244491,112,5,107,22,1
244491,112,5,107,23,1
244491,24,1,23,24,1
244491,88,4,84,25,1
244491,88,4,84,40,1
244561,472,116,356,1,4
244561,472,116,356,2,1
244561,472,116,356,3,1
244561,243,57,186,4,1
244561,229,59,170,5,1
244561,229,59,170,20,1
244561,89,24,65,21,4
244561,89,24,65,22,1
244561,89,24,65,23,1
244561,30,8,22,24,1
244561,59,16,43,25,1
244561,59,16,43,40,1
244561,383,92,291,41,4
244561,383,92,291,42,1
244561,383,92,291,43,1
244561,213,49,164,44,1
244561,170,43,127,45,1
244561,170,43,127,60,1
244613,309,304,5,1,4
244613,309,304,5,2,1
244613,309,304,5,3,1
244613,181,177,4,4,1
244613,128,127,1,5,1
244613,128,127,1,20,1
244613,155,151,4,21,4
244613,155,151,4,22,1
244613,155,151,4,23,1
244613,91,87,4,24,1
244613,64,64,0,25,1
244613,64,64,0,40,1
244613,154,153,1,41,4
244613,154,153,1,42,1
244613,154,153,1,43,1
244613,90,90,0,44,1
244613,64,63,1,45,1
244613,64,63,1,60,1
245032,97,14,83,1,4
245032,97,14,83,2,1
245032,97,14,83,3,1
245032,97,14,83,5,1
245032,1,0,1,19,1
245032,96,14,82,20,1
245032,97,14,83,21,4
245032,97,14,83,22,1
245032,97,14,83,23,1
245032,97,14,83,25,1
245032,1,0,1,39,1
245032,96,14,82,40,1
245069,48,4,44,1,4
245069,48,4,44,2,1
245069,48,4,44,3,1
245069,26,3,23,4,1
245069,22,1,21,5,1
245069,22,1,21,20,1
245069,34,3,31,21,4
245069,34,3,31,22,1
245069,34,3,31,23,1
245069,17,2,15,24,1
245069,17,1,16,25,1
245069,17,1,16,40,1
245069,14,1,13,41,4
245069,14,1,13,42,1
245069,14,1,13,43,1
245069,9,1,8,44,1
245069,5,0,5,45,1
245069,5,0,5,60,1
245281,31,22,9,1,4
245281,31,22,9,2,1
245281,31,22,9,3,1
245281,6,3,3,4,1
245281,25,19,6,5,1
245281,25,19,6,20,1
245281,31,22,9,21,4
245281,31,22,9,22,1
245281,31,22,9,23,1
245281,6,3,3,24,1
245281,25,19,6,25,1
245281,25,19,6,40,1
245290,112,52,60,1,4
245290,112,52,60,2,1
245290,112,52,60,3,1
245290,46,24,22,4,1
245290,66,28,38,5,1
245290,66,28,38,20,1
245290,75,36,39,21,4
245290,75,36,39,22,1
245290,75,36,39,23,1
245290,31,16,15,24,1
245290,44,20,24,25,1
245290,44,20,24,40,1
245290,37,16,21,41,4
245290,37,16,21,42,1
245290,37,16,21,43,1
245290,15,8,7,44,1
245290,22,8,14,45,1
245290,22,8,14,60,1
245342,1344,664,680,1,4
245342,1344,664,680,2,1
245342,1344,664,680,3,1
245342,157,88,69,4,1
245342,1187,576,611,5,1
245342,150,50,100,19,1
245342,1037,526,511,20,1
245342,1344,664,680,21,4
245342,1344,664,680,22,1
245342,1344,664,680,23,1
245342,157,88,69,24,1
245342,1187,576,611,25,1
245342,150,50,100,39,1
245342,1037,526,511,40,1
245421,71,11,60,1,4
245421,71,11,60,2,1
245421,71,11,60,3,1
245421,15,5,10,4,1
245421,56,6,50,5,1
245421,49,5,44,19,1
245421,7,1,6,20,1
245421,65,11,54,21,4
245421,65,11,54,22,1
245421,65,11,54,23,1
245421,15,5,10,24,1
245421,50,6,44,25,1
245421,44,5,39,39,1
245421,6,1,5,40,1
245421,6,0,6,41,4
245421,6,0,6,42,1
245421,6,0,6,43,1
245421,6,0,6,45,1
245421,5,0,5,59,1
245421,1,0,1,60,1
245430,142,21,121,1,4
245430,142,21,121,2,1
245430,142,21,121,3,1
245430,14,2,12,4,1
245430,128,19,109,5,1
245430,41,6,35,19,1
245430,87,13,74,20,1
245430,113,18,95,21,4
245430,113,18,95,22,1
245430,113,18,95,23,1
245430,14,2,12,24,1
245430,99,16,83,25,1
245430,35,5,30,39,1
245430,64,11,53,40,1
245430,29,3,26,41,4
245430,29,3,26,42,1
245430,29,3,26,43,1
245430,29,3,26,45,1
245430,6,1,5,59,1
245430,23,2,21,60,1
245625,2358,941,1417,1,4
245625,2358,941,1417,2,1
245625,1444,555,889,3,1
245625,576,198,378,4,1
245625,868,357,511,5,1
245625,914,386,528,11,1
245625,152,54,98,19,1
245625,716,303,413,20,1
245625,922,408,514,21,4
245625,922,408,514,22,1
245625,743,335,408,23,1
245625,328,143,185,24,1
245625,415,192,223,25,1
245625,179,73,106,31,1
245625,55,24,31,39,1
245625,360,168,192,40,1
245625,1436,533,903,41,4
245625,1436,533,903,42,1
245625,701,220,481,43,1
245625,248,55,193,44,1
245625,453,165,288,45,1
245625,735,313,422,51,1
245625,97,30,67,59,1
245625,356,135,221,60,1
245652,419,230,189,1,4
245652,339,184,155,2,1
245652,339,184,155,3,1
245652,83,38,45,4,1
245652,256,146,110,5,1
245652,80,46,34,12,3
245652,256,146,110,20,1
245652,404,226,178,21,4
245652,336,183,153,22,1
245652,336,183,153,23,1
245652,83,38,45,24,1
245652,253,145,108,25,1
245652,68,43,25,32,3
245652,253,145,108,40,1
245652,15,4,11,41,4
245652,3,1,2,42,1
245652,3,1,2,43,1
245652,3,1,2,45,1
245652,12,3,9,52,3
245652,3,1,2,60,1
245731,46,46,0,1,4
245731,25,25,0,2,1
245731,25,25,0,3,1
245731,25,25,0,5,1
245731,21,21,0,12,3
245731,10,10,0,19,1
245731,15,15,0,20,1
245731,46,46,0,21,4
245731,25,25,0,22,1
245731,25,25,0,23,1
245731,25,25,0,25,1
245731,21,21,0,32,3
245731,10,10,0,39,1
245731,15,15,0,40,1
245777,54,54,0,1,4
245777,27,27,0,2,1
245777,27,27,0,3,1
245777,27,27,0,5,1
245777,27,27,0,12,3
245777,22,22,0,19,1
245777,5,5,0,20,1
245777,54,54,0,21,4
245777,27,27,0,22,1
245777,27,27,0,23,1
245777,27,27,0,25,1
245777,27,27,0,32,3
245777,22,22,0,39,1
245777,5,5,0,40,1
245838,986,270,716,1,4
245838,319,94,225,2,1
245838,137,31,106,3,1
245838,137,31,106,5,1
245838,182,63,119,11,1
245838,667,176,491,12,3
245838,34,6,28,19,1
245838,103,25,78,20,1
245838,666,172,494,21,4
245838,67,15,52,22,1
245838,67,15,52,23,1
245838,67,15,52,25,1
245838,599,157,442,32,3
245838,21,4,17,39,1
245838,46,11,35,40,1
245838,320,98,222,41,4
245838,252,79,173,42,1
245838,70,16,54,43,1
245838,70,16,54,45,1
245838,182,63,119,51,1
245838,68,19,49,52,3
245838,13,2,11,59,1
245838,57,14,43,60,1
245847,375,105,270,1,4
245847,168,62,106,2,1
245847,144,51,93,3,1
245847,144,51,93,5,1
245847,24,11,13,11,1
245847,207,43,164,12,3
245847,48,15,33,19,1
245847,96,36,60,20,1
245847,265,67,198,21,4
245847,85,30,55,22,1
245847,85,30,55,23,1
245847,85,30,55,25,1
245847,180,37,143,32,3
245847,36,11,25,39,1
245847,49,19,30,40,1
245847,110,38,72,41,4
245847,83,32,51,42,1
245847,59,21,38,43,1
245847,59,21,38,45,1
245847,24,11,13,51,1
245847,27,6,21,52,3
245847,12,4,8,59,1
245847,47,17,30,60,1
245865,725,157,568,1,4
245865,725,157,568,12,3
245865,587,126,461,21,4
245865,587,126,461,32,3
245865,138,31,107,41,4
245865,138,31,107,52,3
245883,884,179,705,1,4
245883,230,62,168,2,1
245883,230,62,168,3,1
245883,20,5,15,4,1
245883,210,57,153,5,1
245883,654,117,537,12,3
245883,47,18,29,19,1
245883,163,39,124,20,1
245883,495,101,394,21,4
245883,80,26,54,22,1
245883,80,26,54,23,1
245883,20,5,15,24,1
245883,60,21,39,25,1
245883,415,75,340,32,3
245883,22,11,11,39,1
245883,38,10,28,40,1
245883,389,78,311,41,4
245883,150,36,114,42,1
245883,150,36,114,43,1
245883,150,36,114,45,1
245883,239,42,197,52,3
245883,25,7,18,59,1
245883,125,29,96,60,1
245892,310,92,218,1,4
245892,116,34,82,2,1
245892,116,34,82,3,1
245892,116,34,82,5,1
245892,194,58,136,12,3
245892,42,12,30,19,1
245892,74,22,52,20,1
245892,131,42,89,21,4
245892,39,11,28,22,1
245892,39,11,28,23,1
245892,39,11,28,25,1
245892,92,31,61,32,3
245892,18,5,13,39,1
245892,21,6,15,40,1
245892,179,50,129,41,4
245892,77,23,54,42,1
245892,77,23,54,43,1
245892,77,23,54,45,1
245892,102,27,75,52,3
245892,24,7,17,59,1
245892,53,16,37,60,1
245953,2942,1086,1856,1,4
245953,2407,909,1498,2,1
245953,2347,887,1460,3,1
245953,302,110,192,4,1
245953,2045,777,1268,5,1
245953,60,22,38,11,1
245953,535,177,358,12,3
245953,478,173,305,19,1
245953,1567,604,963,20,1
245953,2235,838,1397,21,4
245953,1923,725,1198,22,1
245953,1918,724,1194,23,1
245953,286,104,182,24,1
245953,1632,620,1012,25,1
245953,5,1,4,31,1
245953,312,113,199,32,3
245953,465,169,296,39,1
245953,1167,451,716,40,1
245953,707,248,459,41,4
245953,484,184,300,42,1
245953,429,163,266,43,1
245953,16,6,10,44,1
245953,413,157,256,45,1
245953,55,21,34,51,1
245953,223,64,159,52,3
245953,13,4,9,59,1
245953,400,153,247,60,1
245962,360,87,273,1,4
245962,360,87,273,2,1
245962,360,87,273,3,1
245962,32,3,29,4,1
245962,328,84,244,5,1
245962,57,12,45,19,1
245962,271,72,199,20,1
245962,360,87,273,21,4
245962,360,87,273,22,1
245962,360,87,273,23,1
245962,32,3,29,24,1
245962,328,84,244,25,1
245962,57,12,45,39,1
245962,271,72,199,40,1
245980,31,2,29,1,4
245980,31,2,29,2,1
245980,31,2,29,3,1
245980,14,0,14,4,1
245980,17,2,15,5,1
245980,17,2,15,20,1
245980,31,2,29,21,4
245980,31,2,29,22,1
245980,31,2,29,23,1
245980,14,0,14,24,1
245980,17,2,15,25,1
245980,17,2,15,40,1
245999,2014,991,1023,1,4
245999,2014,991,1023,2,1
245999,921,459,462,3,1
245999,345,183,162,4,1
245999,576,276,300,5,1
245999,1093,532,561,11,1
245999,576,276,300,20,1
245999,573,281,292,21,4
245999,573,281,292,22,1
245999,573,281,292,23,1
245999,189,95,94,24,1
245999,384,186,198,25,1
245999,384,186,198,40,1
245999,1441,710,731,41,4
245999,1441,710,731,42,1
245999,348,178,170,43,1
245999,156,88,68,44,1
245999,192,90,102,45,1
245999,1093,532,561,51,1
245999,192,90,102,60,1
246008,236,50,186,1,4
246008,236,50,186,2,1
246008,236,50,186,3,1
246008,141,31,110,4,1
246008,95,19,76,5,1
246008,95,19,76,20,1
246008,236,50,186,21,4
246008,236,50,186,22,1
246008,236,50,186,23,1
246008,141,31,110,24,1
246008,95,19,76,25,1
246008,95,19,76,40,1
246017,279,140,139,1,4
246017,279,140,139,2,1
246017,279,140,139,3,1
246017,144,79,65,4,1
246017,135,61,74,5,1
246017,135,61,74,20,1
246017,186,94,92,21,4
246017,186,94,92,22,1
246017,186,94,92,23,1
246017,80,45,35,24,1
246017,106,49,57,25,1
246017,106,49,57,40,1
246017,93,46,47,41,4
246017,93,46,47,42,1
246017,93,46,47,43,1
246017,64,34,30,44,1
246017,29,12,17,45,1
246017,29,12,17,60,1
246035,242,34,208,1,4
246035,242,34,208,2,1
246035,242,34,208,3,1
246035,242,34,208,5,1
246035,242,34,208,20,1
246035,237,33,204,21,4
246035,237,33,204,22,1
246035,237,33,204,23,1
246035,237,33,204,25,1
246035,237,33,204,40,1
246035,5,1,4,41,4
246035,5,1,4,42,1
246035,5,1,4,43,1
246035,5,1,4,45,1
246035,5,1,4,60,1
246071,76,10,66,1,4
246071,76,10,66,2,1
246071,76,10,66,3,1
246071,12,1,11,4,1
246071,64,9,55,5,1
246071,64,9,55,20,1
246071,76,10,66,21,4
246071,76,10,66,22,1
246071,76,10,66,23,1
246071,12,1,11,24,1
246071,64,9,55,25,1
246071,64,9,55,40,1
246202,323,31,292,1,4
246202,323,31,292,2,1
246202,315,30,285,3,1
246202,40,4,36,4,1
246202,275,26,249,5,1
246202,8,1,7,11,1
246202,44,3,41,19,1
246202,231,23,208,20,1
246202,323,31,292,21,4
246202,323,31,292,22,1
246202,315,30,285,23,1
246202,40,4,36,24,1
246202,275,26,249,25,1
246202,8,1,7,31,1
246202,44,3,41,39,1
246202,231,23,208,40,1
246266,681,227,454,1,4
246266,681,227,454,2,1
246266,671,225,446,3,1
246266,169,61,108,4,1
246266,502,164,338,5,1
246266,10,2,8,11,1
246266,13,3,10,19,1
246266,489,161,328,20,1
246266,681,227,454,21,4
246266,681,227,454,22,1
246266,671,225,446,23,1
246266,169,61,108,24,1
246266,502,164,338,25,1
246266,10,2,8,31,1
246266,13,3,10,39,1
246266,489,161,328,40,1
246345,174,83,91,1,4
246345,174,83,91,12,3
246345,88,43,45,21,4
246345,88,43,45,32,3
246345,86,40,46,41,4
246345,86,40,46,52,3
246354,8427,3329,5098,1,4
246354,8427,3329,5098,2,1
246354,6637,2588,4049,3,1
246354,1350,546,804,4,1
246354,5287,2042,3245,5,1
246354,1790,741,1049,11,1
246354,444,189,255,19,1
246354,4843,1853,2990,20,1
246354,1399,538,861,21,4
246354,1399,538,861,22,1
246354,1368,521,847,23,1
246354,419,158,261,24,1
246354,949,363,586,25,1
246354,31,17,14,31,1
246354,68,32,36,39,1
246354,881,331,550,40,1
246354,7028,2791,4237,41,4
246354,7028,2791,4237,42,1
246354,5269,2067,3202,43,1
246354,931,388,543,44,1
246354,4338,1679,2659,45,1
246354,1759,724,1035,51,1
246354,376,157,219,59,1
246354,3962,1522,2440,60,1
246406,31,5,26,1,4
246406,31,5,26,2,1
246406,31,5,26,3,1
246406,9,0,9,4,1
246406,22,5,17,5,1
246406,22,5,17,20,1
246406,31,5,26,21,4
246406,31,5,26,22,1
246406,31,5,26,23,1
246406,9,0,9,24,1
246406,22,5,17,25,1
246406,22,5,17,40,1
246415,56,4,52,1,4
246415,56,4,52,2,1
246415,56,4,52,3,1
246415,56,4,52,5,1
246415,56,4,52,20,1
246415,13,1,12,21,4
246415,13,1,12,22,1
246415,13,1,12,23,1
246415,13,1,12,25,1
246415,13,1,12,40,1
246415,43,3,40,41,4
246415,43,3,40,42,1
246415,43,3,40,43,1
246415,43,3,40,45,1
246415,43,3,40,60,1
246460,80,15,65,1,4
246460,80,15,65,2,1
246460,80,15,65,3,1
246460,65,10,55,4,1
246460,15,5,10,5,1
246460,15,5,10,20,1
246460,80,15,65,21,4
246460,80,15,65,22,1
246460,80,15,65,23,1
246460,65,10,55,24,1
246460,15,5,10,25,1
246460,15,5,10,40,1
246594,72,3,69,1,4
246594,72,3,69,2,1
246594,72,3,69,3,1
246594,44,1,43,4,1
246594,28,2,26,5,1
246594,28,2,26,20,1
246594,72,3,69,21,4
246594,72,3,69,22,1
246594,72,3,69,23,1
246594,44,1,43,24,1
246594,28,2,26,25,1
246594,28,2,26,40,1
246789,114,75,39,1,4
246789,19,10,9,2,1
246789,18,9,9,3,1
246789,5,2,3,4,1
246789,13,7,6,5,1
246789,1,1,0,11,1
246789,95,65,30,12,3
246789,13,7,6,19,1
246789,88,62,26,21,4
246789,16,8,8,22,1
246789,16,8,8,23,1
246789,5,2,3,24,1
246789,11,6,5,25,1
246789,72,54,18,32,3
246789,11,6,5,39,1
246789,26,13,13,41,4
246789,3,2,1,42,1
246789,2,1,1,43,1
246789,2,1,1,45,1
246789,1,1,0,51,1
246789,23,11,12,52,3
246789,2,1,1,59,1
246813,4563,1592,2971,1,4
246813,4563,1592,2971,2,1
246813,4279,1484,2795,3,1
246813,898,350,548,4,1
246813,3381,1134,2247,5,1
246813,284,108,176,11,1
246813,517,185,332,19,1
246813,2864,949,1915,20,1
246813,1281,574,707,21,4
246813,1281,574,707,22,1
246813,1260,564,696,23,1
246813,337,156,181,24,1
246813,923,408,515,25,1
246813,21,10,11,31,1
246813,176,87,89,39,1
246813,747,321,426,40,1
246813,3282,1018,2264,41,4
246813,3282,1018,2264,42,1
246813,3019,920,2099,43,1
246813,561,194,367,44,1
246813,2458,726,1732,45,1
246813,263,98,165,51,1
246813,341,98,243,59,1
246813,2117,628,1489,60,1
246895,798,271,527,1,4
246895,798,271,527,2,1
246895,795,270,525,3,1
246895,352,74,278,4,1
246895,443,196,247,5,1
246895,3,1,2,11,1
246895,443,196,247,20,1
246895,389,257,132,21,4
246895,389,257,132,22,1
246895,386,256,130,23,1
246895,121,70,51,24,1
246895,265,186,79,25,1
246895,3,1,2,31,1
246895,265,186,79,40,1
246895,409,14,395,41,4
246895,409,14,395,42,1
246895,409,14,395,43,1
246895,231,4,227,44,1
246895,178,10,168,45,1
246895,178,10,168,60,1
246974,521,58,463,1,4
246974,521,58,463,2,1
246974,521,58,463,3,1
246974,70,13,57,4,1
246974,451,45,406,5,1
246974,86,5,81,19,1
246974,365,40,325,20,1
246974,505,56,449,21,4
246974,505,56,449,22,1
246974,505,56,449,23,1
246974,70,13,57,24,1
246974,435,43,392,25,1
246974,82,4,78,39,1
246974,353,39,314,40,1
246974,16,2,14,41,4
246974,16,2,14,42,1
246974,16,2,14,43,1
246974,16,2,14,45,1
246974,4,1,3,59,1
246974,12,1,11,60,1
247010,41,0,41,1,4
247010,41,0,41,2,1
247010,41,0,41,3,1
247010,38,0,38,4,1
247010,3,0,3,5,1
247010,3,0,3,20,1
247010,41,0,41,21,4
247010,41,0,41,22,1
247010,41,0,41,23,1
247010,38,0,38,24,1
247010,3,0,3,25,1
247010,3,0,3,40,1
247047,117,7,110,1,4
247047,117,7,110,2,1
247047,117,7,110,3,1
247047,56,3,53,4,1
247047,61,4,57,5,1
247047,61,4,57,20,1
247047,117,7,110,21,4
247047,117,7,110,22,1
247047,117,7,110,23,1
247047,56,3,53,24,1
247047,61,4,57,25,1
247047,61,4,57,40,1
247065,807,156,651,1,4
247065,807,156,651,2,1
247065,807,156,651,3,1
247065,90,25,65,4,1
247065,717,131,586,5,1
247065,189,26,163,19,1
247065,528,105,423,20,1
247065,492,78,414,21,4
247065,492,78,414,22,1
247065,492,78,414,23,1
247065,59,13,46,24,1
247065,433,65,368,25,1
247065,141,16,125,39,1
247065,292,49,243,40,1
247065,315,78,237,41,4
247065,315,78,237,42,1
247065,315,78,237,43,1
247065,31,12,19,44,1
247065,284,66,218,45,1
247065,48,10,38,59,1
247065,236,56,180,60,1
247153,191,57,134,1,4
247153,191,57,134,2,1
247153,191,57,134,3,1
247153,77,31,46,4,1
247153,114,26,88,5,1
247153,114,26,88,20,1
247153,191,57,134,21,4
247153,191,57,134,22,1
247153,191,57,134,23,1
247153,77,31,46,24,1
247153,114,26,88,25,1
247153,114,26,88,40,1
247162,81,29,52,1,4
247162,16,5,11,2,1
247162,16,5,11,3,1
247162,8,3,5,4,1
247162,8,2,6,5,1
247162,65,24,41,12,3
247162,8,2,6,20,1
247162,39,14,25,21,4
247162,39,14,25,32,3
247162,42,15,27,41,4
247162,16,5,11,42,1
247162,16,5,11,43,1
247162,8,3,5,44,1
247162,8,2,6,45,1
247162,26,10,16,52,3
247162,8,2,6,60,1
247409,208,16,192,1,4
247409,208,16,192,2,1
247409,208,16,192,3,1
247409,59,5,54,4,1
247409,149,11,138,5,1
247409,149,11,138,20,1
247409,208,16,192,21,4
247409,208,16,192,22,1
247409,208,16,192,23,1
247409,59,5,54,24,1
247409,149,11,138,25,1
247409,149,11,138,40,1
247603,3235,1527,1708,1,4
247603,3235,1527,1708,2,1
247603,2838,1353,1485,3,1
247603,690,392,298,4,1
247603,2148,961,1187,5,1
247603,397,174,223,11,1
247603,171,67,104,19,1
247603,1977,894,1083,20,1
247603,1746,897,849,21,4
247603,1746,897,849,22,1
247603,1693,868,825,23,1
247603,533,310,223,24,1
247603,1160,558,602,25,1
247603,53,29,24,31,1
247603,91,44,47,39,1
247603,1069,514,555,40,1
247603,1489,630,859,41,4
247603,1489,630,859,42,1
247603,1145,485,660,43,1
247603,157,82,75,44,1
247603,988,403,585,45,1
247603,344,145,199,51,1
247603,80,23,57,59,1
247603,908,380,528,60,1
247649,494,360,134,1,4
247649,494,360,134,2,1
247649,491,357,134,3,1
247649,138,115,23,4,1
247649,353,242,111,5,1
247649,3,3,0,11,1
247649,98,76,22,19,1
247649,255,166,89,20,1
247649,491,357,134,21,4
247649,491,357,134,22,1
247649,491,357,134,23,1
247649,138,115,23,24,1
247649,353,242,111,25,1
247649,98,76,22,39,1
247649,255,166,89,40,1
247649,3,3,0,41,4
247649,3,3,0,42,1
247649,3,3,0,51,1
247700,633,141,492,1,4
247700,633,141,492,2,1
247700,562,90,472,3,1
247700,62,15,47,4,1
247700,500,75,425,5,1
247700,71,51,20,11,1
247700,54,9,45,19,1
247700,446,66,380,20,1
247700,28,7,21,21,4
247700,28,7,21,22,1
247700,28,7,21,23,1
247700,2,0,2,24,1
247700,26,7,19,25,1
247700,3,2,1,39,1
247700,23,5,18,40,1
247700,605,134,471,41,4
247700,605,134,471,42,1
247700,534,83,451,43,1
247700,60,15,45,44,1
247700,474,68,406,45,1
247700,71,51,20,51,1
247700,51,7,44,59,1
247700,423,61,362,60,1
247773,74,74,0,1,4
247773,58,58,0,2,1
247773,58,58,0,3,1
247773,15,15,0,4,1
247773,43,43,0,5,1
247773,16,16,0,12,3
247773,3,3,0,19,1
247773,40,40,0,20,1
247773,69,69,0,21,4
247773,58,58,0,22,1
247773,58,58,0,23,1
247773,15,15,0,24,1
247773,43,43,0,25,1
247773,11,11,0,32,3
247773,3,3,0,39,1
247773,40,40,0,40,1
247773,5,5,0,41,4
247773,5,5,0,52,3
247825,60,40,20,1,4
247825,28,21,7,2,1
247825,28,21,7,3,1
247825,28,21,7,5,1
247825,32,19,13,12,3
247825,28,21,7,20,1
247825,16,10,6,21,4
247825,2,1,1,22,1
247825,2,1,1,23,1
247825,2,1,1,25,1
247825,14,9,5,32,3
247825,2,1,1,40,1
247825,44,30,14,41,4
247825,26,20,6,42,1
247825,26,20,6,43,1
247825,26,20,6,45,1
247825,18,10,8,52,3
247825,26,20,6,60,1
247834,27972,12393,15579,1,4
247834,27972,12393,15579,2,1
247834,24687,11019,13668,3,1
247834,5334,2597,2737,4,1
247834,19353,8422,10931,5,1
247834,3285,1374,1911,11,1
247834,2565,1036,1529,19,1
247834,16788,7386,9402,20,1
247834,9529,4613,4916,21,4
247834,9529,4613,4916,22,1
247834,9488,4594,4894,23,1
247834,3167,1547,1620,24,1
247834,6321,3047,3274,25,1
247834,41,19,22,31,1
247834,939,433,506,39,1
247834,5382,2614,2768,40,1
247834,18443,7780,10663,41,4
247834,18443,7780,10663,42,1
247834,15199,6425,8774,43,1
247834,2167,1050,1117,44,1
247834,13032,5375,7657,45,1
247834,3244,1355,1889,51,1
247834,1626,603,1023,59,1
247834,11406,4772,6634,60,1
247940,4286,1787,2499,1,4
247940,4286,1787,2499,2,1
247940,3296,1233,2063,3,1
247940,774,342,432,4,1
247940,2522,891,1631,5,1
247940,990,554,436,11,1
247940,163,77,86,19,1
247940,2359,814,1545,20,1
247940,1845,781,1064,21,4
247940,1845,781,1064,22,1
247940,1821,772,1049,23,1
247940,595,273,322,24,1
247940,1226,499,727,25,1
247940,24,9,15,31,1
247940,93,48,45,39,1
247940,1133,451,682,40,1
247940,2441,1006,1435,41,4
247940,2441,1006,1435,42,1
247940,1475,461,1014,43,1
247940,179,69,110,44,1
247940,1296,392,904,45,1
247940,966,545,421,51,1
247940,70,29,41,59,1
247940,1226,363,863,60,1
248165,62,3,59,1,4
248165,62,3,59,2,1
248165,62,3,59,3,1
248165,28,3,25,4,1
248165,34,0,34,5,1
248165,34,0,34,20,1
248165,40,3,37,21,4
248165,40,3,37,22,1
248165,40,3,37,23,1
248165,20,3,17,24,1
248165,20,0,20,25,1
248165,20,0,20,40,1
248165,22,0,22,41,4
248165,22,0,22,42,1
248165,22,0,22,43,1
248165,8,0,8,44,1
248165,14,0,14,45,1
248165,14,0,14,60,1
248192,28,0,28,1,4
248192,28,0,28,2,1
248192,28,0,28,3,1
248192,20,0,20,4,1
248192,8,0,8,5,1
248192,8,0,8,20,1
248192,15,0,15,21,4
248192,15,0,15,22,1
248192,15,0,15,23,1
248192,12,0,12,24,1
248192,3,0,3,25,1
248192,3,0,3,40,1
248192,13,0,13,41,4
248192,13,0,13,42,1
248192,13,0,13,43,1
248192,8,0,8,44,1
248192,5,0,5,45,1
248192,5,0,5,60,1
248305,118,5,113,1,4
248305,118,5,113,2,1
248305,118,5,113,3,1
248305,35,1,34,4,1
248305,83,4,79,5,1
248305,83,4,79,20,1
248305,97,5,92,21,4
248305,97,5,92,22,1
248305,97,5,92,23,1
248305,29,1,28,24,1
248305,68,4,64,25,1
248305,68,4,64,40,1
248305,21,0,21,41,4
248305,21,0,21,42,1
248305,21,0,21,43,1
248305,6,0,6,44,1
248305,15,0,15,45,1
248305,15,0,15,60,1
248314,6,0,6,1,4
248314,6,0,6,2,1
248314,6,0,6,3,1
248314,4,0,4,4,1
248314,2,0,2,5,1
248314,2,0,2,20,1
248314,5,0,5,21,4
248314,5,0,5,22,1
248314,5,0,5,23,1
248314,4,0,4,24,1
248314,1,0,1,25,1
248314,1,0,1,40,1
248314,1,0,1,41,4
248314,1,0,1,42,1
248314,1,0,1,43,1
248314,1,0,1,45,1
248314,1,0,1,60,1
248527,44,3,41,1,4
248527,44,3,41,2,1
248527,44,3,41,3,1
248527,39,3,36,4,1
248527,5,0,5,5,1
248527,5,0,5,20,1
248527,44,3,41,21,4
248527,44,3,41,22,1
248527,44,3,41,23,1
248527,39,3,36,24,1
248527,5,0,5,25,1
248527,5,0,5,40,1
248606,1165,698,467,1,4
248606,1165,698,467,2,1
248606,750,474,276,3,1
248606,339,242,97,4,1
248606,411,232,179,5,1
248606,415,224,191,11,1
248606,411,232,179,20,1
248606,238,89,149,21,4
248606,238,89,149,22,1
248606,229,89,140,23,1
248606,68,42,26,24,1
248606,161,47,114,25,1
248606,9,0,9,31,1
248606,161,47,114,40,1
248606,927,609,318,41,4
248606,927,609,318,42,1
248606,521,385,136,43,1
248606,271,200,71,44,1
248606,250,185,65,45,1
248606,406,224,182,51,1
248606,250,185,65,60,1
248624,109,9,100,1,4
248624,109,9,100,2,1
248624,108,9,99,3,1
248624,12,0,12,4,1
248624,96,9,87,5,1
248624,1,0,1,11,1
248624,96,9,87,20,1
248624,109,9,100,21,4
248624,109,9,100,22,1
248624,108,9,99,23,1
248624,12,0,12,24,1
248624,96,9,87,25,1
248624,1,0,1,31,1
248624,96,9,87,40,1
248633,60,1,59,1,4
248633,60,1,59,2,1
248633,60,1,59,3,1
248633,30,0,30,4,1
248633,30,1,29,5,1
248633,30,1,29,20,1
248633,60,1,59,21,4
248633,60,1,59,22,1
248633,60,1,59,23,1
248633,30,0,30,24,1
248633,30,1,29,25,1
248633,30,1,29,40,1
248660,207,16,191,1,4
248660,207,16,191,2,1
248660,207,16,191,3,1
248660,2,0,2,4,1
248660,205,16,189,5,1
248660,205,16,189,20,1
248660,160,14,146,21,4
248660,160,14,146,22,1
248660,160,14,146,23,1
248660,1,0,1,24,1
248660,159,14,145,25,1
248660,159,14,145,40,1
248660,47,2,45,41,4
248660,47,2,45,42,1
248660,47,2,45,43,1
248660,1,0,1,44,1
248660,46,2,44,45,1
248660,46,2,44,60,1
248703,161,5,156,1,4
248703,161,5,156,2,1
248703,161,5,156,3,1
248703,55,3,52,4,1
248703,106,2,104,5,1
248703,106,2,104,20,1
248703,92,3,89,21,4
248703,92,3,89,22,1
248703,92,3,89,23,1
248703,34,2,32,24,1
248703,58,1,57,25,1
248703,58,1,57,40,1
248703,69,2,67,41,4
248703,69,2,67,42,1
248703,69,2,67,43,1
248703,21,1,20,44,1
248703,48,1,47,45,1
248703,48,1,47,60,1
248776,1180,413,767,1,4
248776,1180,413,767,2,1
248776,1000,365,635,3,1
248776,272,115,157,4,1
248776,728,250,478,5,1
248776,180,48,132,11,1
248776,185,63,122,19,1
248776,543,187,356,20,1
248776,382,117,265,21,4
248776,382,117,265,22,1
248776,380,115,265,23,1
248776,76,36,40,24,1
248776,304,79,225,25,1
248776,2,2,0,31,1
248776,98,36,62,39,1
248776,206,43,163,40,1
248776,798,296,502,41,4
248776,798,296,502,42,1
248776,620,250,370,43,1
248776,196,79,117,44,1
248776,424,171,253,45,1
248776,178,46,132,51,1
248776,87,27,60,59,1
248776,337,144,193,60,1
248846,169,9,160,1,4
248846,169,9,160,2,1
248846,169,9,160,3,1
248846,67,6,61,4,1
248846,102,3,99,5,1
248846,43,2,41,19,1
248846,59,1,58,20,1
248846,151,8,143,21,4
248846,151,8,143,22,1
248846,151,8,143,23,1
248846,66,6,60,24,1
248846,85,2,83,25,1
248846,38,2,36,39,1
248846,47,0,47,40,1
248846,18,1,17,41,4
248846,18,1,17,42,1
248846,18,1,17,43,1
248846,1,0,1,44,1
248846,17,1,16,45,1
248846,5,0,5,59,1
248846,12,1,11,60,1
248882,397,101,296,1,4
248882,397,101,296,2,1
248882,396,100,296,3,1
248882,17,5,12,4,1
248882,379,95,284,5,1
248882,1,1,0,11,1
248882,74,22,52,19,1
248882,305,73,232,20,1
248882,51,20,31,21,4
248882,51,20,31,22,1
248882,51,20,31,23,1
248882,51,20,31,25,1
248882,13,4,9,39,1
248882,38,16,22,40,1
248882,346,81,265,41,4
248882,346,81,265,42,1
248882,345,80,265,43,1
248882,17,5,12,44,1
248882,328,75,253,45,1
248882,1,1,0,51,1
248882,61,18,43,59,1
248882,267,57,210,60,1
248925,1014,568,446,1,4
248925,1014,568,446,2,1
248925,749,422,327,3,1
248925,279,149,130,4,1
248925,470,273,197,5,1
248925,265,146,119,11,1
248925,470,273,197,20,1
248925,594,336,258,21,4
248925,594,336,258,22,1
248925,594,336,258,23,1
248925,226,117,109,24,1
248925,368,219,149,25,1
248925,368,219,149,40,1
248925,420,232,188,41,4
248925,420,232,188,42,1
248925,155,86,69,43,1
248925,53,32,21,44,1
248925,102,54,48,45,1
248925,265,146,119,51,1
248925,102,54,48,60,1
248934,10845,4796,6049,1,4
248934,10803,4760,6043,2,1
248934,10241,4533,5708,3,1
248934,948,395,553,4,1
248934,9293,4138,5155,5,1
248934,562,227,335,11,1
248934,42,36,6,12,3
248934,975,340,635,19,1
248934,8318,3798,4520,20,1
248934,10283,4569,5714,21,4
248934,10241,4533,5708,22,1
248934,10241,4533,5708,23,1
248934,948,395,553,24,1
248934,9293,4138,5155,25,1
248934,42,36,6,32,3
248934,975,340,635,39,1
248934,8318,3798,4520,40,1
248934,562,227,335,41,4
248934,562,227,335,42,1
248934,562,227,335,51,1
249061,93,2,91,1,4
249061,93,2,91,2,1
249061,93,2,91,3,1
249061,60,2,58,4,1
249061,33,0,33,5,1
249061,33,0,33,20,1
249061,55,0,55,21,4
249061,55,0,55,22,1
249061,55,0,55,23,1
249061,30,0,30,24,1
249061,25,0,25,25,1
249061,25,0,25,40,1
249061,38,2,36,41,4
249061,38,2,36,42,1
249061,38,2,36,43,1
249061,30,2,28,44,1
249061,8,0,8,45,1
249061,8,0,8,60,1
249140,435,146,289,1,4
249140,435,146,289,2,1
249140,435,146,289,3,1
249140,150,42,108,4,1
249140,285,104,181,5,1
249140,285,104,181,20,1
249140,435,146,289,21,4
249140,435,146,289,22,1
249140,435,146,289,23,1
249140,150,42,108,24,1
249140,285,104,181,25,1
249140,285,104,181,40,1
249238,272,31,241,1,4
249238,272,31,241,2,1
249238,272,31,241,3,1
249238,45,7,38,4,1
249238,227,24,203,5,1
249238,227,24,203,20,1
249238,181,19,162,21,4
249238,181,19,162,22,1
249238,181,19,162,23,1
249238,30,4,26,24,1
249238,151,15,136,25,1
249238,151,15,136,40,1
249238,91,12,79,41,4
249238,91,12,79,42,1
249238,91,12,79,43,1
249238,15,3,12,44,1
249238,76,9,67,45,1
249238,76,9,67,60,1
249566,374,350,24,1,4
249566,374,350,24,2,1
249566,374,350,24,3,1
249566,360,337,23,4,1
249566,14,13,1,5,1
249566,14,13,1,20,1
249566,374,350,24,21,4
249566,374,350,24,22,1
249566,374,350,24,23,1
249566,360,337,23,24,1
249566,14,13,1,25,1
249566,14,13,1,40,1
249609,224,114,110,1,4
249609,224,114,110,2,1
249609,224,114,110,3,1
249609,66,35,31,4,1
249609,158,79,79,5,1
249609,20,10,10,19,1
249609,138,69,69,20,1
249609,224,114,110,21,4
249609,224,114,110,22,1
249609,224,114,110,23,1
249609,66,35,31,24,1
249609,158,79,79,25,1
249609,20,10,10,39,1
249609,138,69,69,40,1
250027,212,44,168,1,4
250027,212,44,168,2,1
250027,211,44,167,3,1
250027,95,21,74,4,1
250027,116,23,93,5,1
250027,1,0,1,11,1
250027,72,15,57,19,1
250027,44,8,36,20,1
250027,211,44,167,21,4
250027,211,44,167,22,1
250027,211,44,167,23,1
250027,95,21,74,24,1
250027,116,23,93,25,1
250027,72,15,57,39,1
250027,44,8,36,40,1
250027,1,0,1,41,4
250027,1,0,1,42,1
250027,1,0,1,51,1
250072,119,3,116,1,4
250072,119,3,116,2,1
250072,119,3,116,3,1
250072,62,0,62,4,1
250072,57,3,54,5,1
250072,57,3,54,20,1
250072,96,3,93,21,4
250072,96,3,93,22,1
250072,96,3,93,23,1
250072,50,0,50,24,1
250072,46,3,43,25,1
250072,46,3,43,40,1
250072,23,0,23,41,4
250072,23,0,23,42,1
250072,23,0,23,43,1
250072,12,0,12,44,1
250072,11,0,11,45,1
250072,11,0,11,60,1
250285,385,370,15,1,4
250285,385,370,15,2,1
250285,385,370,15,3,1
250285,72,69,3,4,1
250285,313,301,12,5,1
250285,313,301,12,20,1
250285,347,334,13,21,4
250285,347,334,13,22,1
250285,347,334,13,23,1
250285,63,62,1,24,1
250285,284,272,12,25,1
250285,284,272,12,40,1
250285,38,36,2,41,4
250285,38,36,2,42,1
250285,38,36,2,43,1
250285,9,7,2,44,1
250285,29,29,0,45,1
250285,29,29,0,60,1
250407,161,25,136,1,4
250407,161,25,136,2,1
250407,161,25,136,3,1
250407,161,25,136,5,1
250407,161,25,136,20,1
250407,156,23,133,21,4
250407,156,23,133,22,1
250407,156,23,133,23,1
250407,156,23,133,25,1
250407,156,23,133,40,1
250407,5,2,3,41,4
250407,5,2,3,42,1
250407,5,2,3,43,1
250407,5,2,3,45,1
250407,5,2,3,60,1
250498,109,47,62,1,4
250498,109,47,62,2,1
250498,109,47,62,3,1
250498,34,16,18,4,1
250498,75,31,44,5,1
250498,75,31,44,20,1
250498,109,47,62,21,4
250498,109,47,62,22,1
250498,109,47,62,23,1
250498,34,16,18,24,1
250498,75,31,44,25,1
250498,75,31,44,40,1
250601,513,187,326,1,4
250601,513,187,326,2,1
250601,513,187,326,3,1
250601,12,2,10,4,1
250601,501,185,316,5,1
250601,8,0,8,19,1
250601,493,185,308,20,1
250601,358,144,214,21,4
250601,358,144,214,22,1
250601,358,144,214,23,1
250601,12,2,10,24,1
250601,346,142,204,25,1
250601,8,0,8,39,1
250601,338,142,196,40,1
250601,155,43,112,41,4
250601,155,43,112,42,1
250601,155,43,112,43,1
250601,155,43,112,45,1
250601,155,43,112,60,1
250744,515,32,483,1,4
250744,515,32,483,2,1
250744,515,32,483,3,1
250744,146,13,133,4,1
250744,369,19,350,5,1
250744,369,19,350,20,1
250744,515,32,483,21,4
250744,515,32,483,22,1
250744,515,32,483,23,1
250744,146,13,133,24,1
250744,369,19,350,25,1
250744,369,19,350,40,1
250832,64,0,64,1,4
250832,64,0,64,2,1
250832,64,0,64,3,1
250832,12,0,12,4,1
250832,52,0,52,5,1
250832,52,0,52,20,1
250832,64,0,64,21,4
250832,64,0,64,22,1
250832,64,0,64,23,1
250832,12,0,12,24,1
250832,52,0,52,25,1
250832,52,0,52,40,1
250902,74,4,70,1,4
250902,74,4,70,2,1
250902,74,4,70,3,1
250902,66,4,62,4,1
250902,8,0,8,5,1
250902,8,0,8,20,1
250902,38,3,35,21,4
250902,38,3,35,22,1
250902,38,3,35,23,1
250902,33,3,30,24,1
250902,5,0,5,25,1
250902,5,0,5,40,1
250902,36,1,35,41,4
250902,36,1,35,42,1
250902,36,1,35,43,1
250902,33,1,32,44,1
250902,3,0,3,45,1
250902,3,0,3,60,1
250993,448,241,207,1,4
250993,448,241,207,2,1
250993,106,55,51,3,1
250993,74,42,32,4,1
250993,32,13,19,5,1
250993,342,186,156,11,1
250993,32,13,19,20,1
250993,59,28,31,21,4
250993,59,28,31,22,1
250993,59,28,31,23,1
250993,38,21,17,24,1
250993,21,7,14,25,1
250993,21,7,14,40,1
250993,389,213,176,41,4
250993,389,213,176,42,1
250993,47,27,20,43,1
250993,36,21,15,44,1
250993,11,6,5,45,1
250993,342,186,156,51,1
250993,11,6,5,60,1
251075,335,58,277,1,4
251075,335,58,277,2,1
251075,335,58,277,3,1
251075,68,9,59,4,1
251075,267,49,218,5,1
251075,11,2,9,19,1
251075,256,47,209,20,1
251075,335,58,277,21,4
251075,335,58,277,22,1
251075,335,58,277,23,1
251075,68,9,59,24,1
251075,267,49,218,25,1
251075,11,2,9,39,1
251075,256,47,209,40,1
251251,295,166,129,1,4
251251,295,166,129,2,1
251251,295,166,129,3,1
251251,24,19,5,4,1
251251,271,147,124,5,1
251251,271,147,124,20,1
251251,197,125,72,21,4
251251,197,125,72,22,1
251251,197,125,72,23,1
251251,21,16,5,24,1
251251,176,109,67,25,1
251251,176,109,67,40,1
251251,98,41,57,41,4
251251,98,41,57,42,1
251251,98,41,57,43,1
251251,3,3,0,44,1
251251,95,38,57,45,1
251251,95,38,57,60,1
251260,4805,2023,2782,1,4
251260,4805,2023,2782,2,1
251260,4613,1938,2675,3,1
251260,1202,523,679,4,1
251260,3411,1415,1996,5,1
251260,192,85,107,11,1
251260,600,287,313,19,1
251260,2811,1128,1683,20,1
251260,2811,1292,1519,21,4
251260,2811,1292,1519,22,1
251260,2804,1285,1519,23,1
251260,1060,461,599,24,1
251260,1744,824,920,25,1
251260,7,7,0,31,1
251260,373,206,167,39,1
251260,1371,618,753,40,1
251260,1994,731,1263,41,4
251260,1994,731,1263,42,1
251260,1809,653,1156,43,1
251260,142,62,80,44,1
251260,1667,591,1076,45,1
251260,185,78,107,51,1
251260,227,81,146,59,1
251260,1440,510,930,60,1
251312,1627,330,1297,1,4
251312,1167,236,931,2,1
251312,1167,236,931,3,1
251312,35,6,29,4,1
251312,1132,230,902,5,1
251312,460,94,366,12,3
251312,277,57,220,19,1
251312,855,173,682,20,1
251312,888,205,683,21,4
251312,673,147,526,22,1
251312,673,147,526,23,1
251312,23,5,18,24,1
251312,650,142,508,25,1
251312,215,58,157,32,3
251312,134,28,106,39,1
251312,516,114,402,40,1
251312,739,125,614,41,4
251312,494,89,405,42,1
251312,494,89,405,43,1
251312,12,1,11,44,1
251312,482,88,394,45,1
251312,245,36,209,52,3
251312,143,29,114,59,1
251312,339,59,280,60,1
260293,4318,1074,3244,1,4
260293,4140,1049,3091,2,1
260293,4140,1049,3091,3,1
260293,80,19,61,4,1
260293,4060,1030,3030,5,1
260293,178,25,153,12,3
260293,224,69,155,19,1
260293,3836,961,2875,20,1
260293,2224,551,1673,21,4
260293,2157,541,1616,22,1
260293,2157,541,1616,23,1
260293,72,13,59,24,1
260293,2085,528,1557,25,1
260293,67,10,57,32,3
260293,139,39,100,39,1
260293,1946,489,1457,40,1
260293,2094,523,1571,41,4
260293,1983,508,1475,42,1
260293,1983,508,1475,43,1
260293,8,6,2,44,1
260293,1975,502,1473,45,1
260293,111,15,96,52,3
260293,85,30,55,59,1
260293,1890,472,1418,60,1
260336,23,3,20,1,4
260336,23,3,20,2,1
260336,23,3,20,3,1
260336,3,0,3,4,1
260336,20,3,17,5,1
260336,20,3,17,20,1
260336,23,3,20,21,4
260336,23,3,20,22,1
260336,23,3,20,23,1
260336,3,0,3,24,1
260336,20,3,17,25,1
260336,20,3,17,40,1
260354,112,17,95,1,4
260354,112,17,95,2,1
260354,112,17,95,3,1
260354,9,2,7,4,1
260354,103,15,88,5,1
260354,16,4,12,19,1
260354,87,11,76,20,1
260354,107,16,91,21,4
260354,107,16,91,22,1
260354,107,16,91,23,1
260354,9,2,7,24,1
260354,98,14,84,25,1
260354,15,4,11,39,1
260354,83,10,73,40,1
260354,5,1,4,41,4
260354,5,1,4,42,1
260354,5,1,4,43,1
260354,5,1,4,45,1
260354,1,0,1,59,1
260354,4,1,3,60,1
260363,35,2,33,1,4
260363,35,2,33,2,1
260363,35,2,33,3,1
260363,35,2,33,5,1
260363,35,2,33,20,1
260363,35,2,33,21,4
260363,35,2,33,22,1
260363,35,2,33,23,1
260363,35,2,33,25,1
260363,35,2,33,40,1
260372,303,98,205,1,4
260372,303,98,205,2,1
260372,254,75,179,3,1
260372,52,14,38,4,1
260372,202,61,141,5,1
260372,49,23,26,11,1
260372,15,4,11,19,1
260372,187,57,130,20,1
260372,194,64,130,21,4
260372,194,64,130,22,1
260372,184,59,125,23,1
260372,37,10,27,24,1
260372,147,49,98,25,1
260372,10,5,5,31,1
260372,10,4,6,39,1
260372,137,45,92,40,1
260372,109,34,75,41,4
260372,109,34,75,42,1
260372,70,16,54,43,1
260372,15,4,11,44,1
260372,55,12,43,45,1
260372,39,18,21,51,1
260372,5,0,5,59,1
260372,50,12,38,60,1
260664,149,124,25,1,4
260664,149,124,25,2,1
260664,149,124,25,3,1
260664,54,42,12,4,1
260664,95,82,13,5,1
260664,95,82,13,20,1
260664,149,124,25,21,4
260664,149,124,25,22,1
260664,149,124,25,23,1
260664,54,42,12,24,1
260664,95,82,13,25,1
260664,95,82,13,40,1
260691,1146,279,867,1,4
260691,1146,279,867,2,1
260691,1146,279,867,3,1
260691,325,76,249,4,1
260691,821,203,618,5,1
260691,821,203,618,20,1
260691,1146,279,867,21,4
260691,1146,279,867,22,1
260691,1146,279,867,23,1
260691,325,76,249,24,1
260691,821,203,618,25,1
260691,821,203,618,40,1
260789,608,170,438,1,4
260789,608,170,438,2,1
260789,608,170,438,3,1
260789,83,27,56,4,1
260789,525,143,382,5,1
260789,38,10,28,19,1
260789,487,133,354,20,1
260789,608,170,438,21,4
260789,608,170,438,22,1
260789,608,170,438,23,1
260789,83,27,56,24,1
260789,525,143,382,25,1
260789,38,10,28,39,1
260789,487,133,354,40,1
260813,209,27,182,1,4
260813,209,27,182,2,1
260813,209,27,182,3,1
260813,2,0,2,4,1
260813,207,27,180,5,1
260813,21,2,19,19,1
260813,186,25,161,20,1
260813,209,27,182,21,4
260813,209,27,182,22,1
260813,209,27,182,23,1
260813,2,0,2,24,1
260813,207,27,180,25,1
260813,21,2,19,39,1
260813,186,25,161,40,1
260901,52407,12838,39569,1,4
260901,40349,9830,30519,2,1
260901,40209,9745,30464,3,1
260901,4984,1175,3809,4,1
260901,35225,8570,26655,5,1
260901,140,85,55,11,1
260901,12058,3008,9050,12,3
260901,8818,2264,6554,19,1
260901,26407,6306,20101,20,1
260901,12935,3636,9299,21,4
260901,6413,1575,4838,22,1
260901,6412,1575,4837,23,1
260901,50,18,32,24,1
260901,6362,1557,4805,25,1
260901,1,0,1,31,1
260901,6522,2061,4461,32,3
260901,952,270,682,39,1
260901,5410,1287,4123,40,1
260901,39472,9202,30270,41,4
260901,33936,8255,25681,42,1
260901,33797,8170,25627,43,1
260901,4934,1157,3777,44,1
260901,28863,7013,21850,45,1
260901,139,85,54,51,1
260901,5536,947,4589,52,3
260901,7866,1994,5872,59,1
260901,20997,5019,15978,60,1
260910,449,92,357,1,4
260910,386,77,309,2,1
260910,386,77,309,3,1
260910,28,5,23,4,1
260910,358,72,286,5,1
260910,63,15,48,12,3
260910,108,20,88,19,1
260910,250,52,198,20,1
260910,302,70,232,21,4
260910,251,57,194,22,1
260910,251,57,194,23,1
260910,17,4,13,24,1
260910,234,53,181,25,1
260910,51,13,38,32,3
260910,58,11,47,39,1
260910,176,42,134,40,1
260910,147,22,125,41,4
260910,135,20,115,42,1
260910,135,20,115,43,1
260910,11,1,10,44,1
260910,124,19,105,45,1
260910,12,2,10,52,3
260910,50,9,41,59,1
260910,74,10,64,60,1
260929,150,5,145,1,4
260929,150,5,145,2,1
260929,150,5,145,3,1
260929,24,1,23,4,1
260929,126,4,122,5,1
260929,126,4,122,20,1
260929,114,5,109,21,4
260929,114,5,109,22,1
260929,114,5,109,23,1
260929,19,1,18,24,1
260929,95,4,91,25,1
260929,95,4,91,40,1
260929,36,0,36,41,4
260929,36,0,36,42,1
260929,36,0,36,43,1
260929,5,0,5,44,1
260929,31,0,31,45,1
260929,31,0,31,60,1
260947,41,21,20,1,4
260947,41,21,20,2,1
260947,41,21,20,3,1
260947,5,3,2,4,1
260947,36,18,18,5,1
260947,6,6,0,19,1
260947,30,12,18,20,1
260947,22,12,10,21,4
260947,22,12,10,22,1
260947,22,12,10,23,1
260947,2,1,1,24,1
260947,20,11,9,25,1
260947,1,1,0,39,1
260947,19,10,9,40,1
260947,19,9,10,41,4
260947,19,9,10,42,1
260947,19,9,10,43,1
260947,3,2,1,44,1
260947,16,7,9,45,1
260947,5,5,0,59,1
260947,11,2,9,60,1
260956,186,132,54,1,4
260956,186,132,54,12,3
260956,182,130,52,21,4
260956,182,130,52,32,3
260956,4,2,2,41,4
260956,4,2,2,52,3
260965,61,1,60,1,4
260965,61,1,60,2,1
260965,61,1,60,3,1
260965,7,0,7,4,1
260965,54,1,53,5,1
260965,54,1,53,20,1
260965,61,1,60,21,4
260965,61,1,60,22,1
260965,61,1,60,23,1
260965,7,0,7,24,1
260965,54,1,53,25,1
260965,54,1,53,40,1
260974,248,222,26,1,4
260974,248,222,26,2,1
260974,248,222,26,3,1
260974,30,26,4,4,1
260974,218,196,22,5,1
260974,7,7,0,19,1
260974,211,189,22,20,1
260974,193,174,19,21,4
260974,193,174,19,22,1
260974,193,174,19,23,1
260974,27,23,4,24,1
260974,166,151,15,25,1
260974,5,5,0,39,1
260974,161,146,15,40,1
260974,55,48,7,41,4
260974,55,48,7,42,1
260974,55,48,7,43,1
260974,3,3,0,44,1
260974,52,45,7,45,1
260974,2,2,0,59,1
260974,50,43,7,60,1
260992,756,121,635,1,4
260992,756,121,635,2,1
260992,756,121,635,3,1
260992,199,42,157,4,1
260992,557,79,478,5,1
260992,79,15,64,19,1
260992,478,64,414,20,1
260992,342,70,272,21,4
260992,342,70,272,22,1
260992,342,70,272,23,1
260992,123,33,90,24,1
260992,219,37,182,25,1
260992,219,37,182,40,1
260992,414,51,363,41,4
260992,414,51,363,42,1
260992,414,51,363,43,1
260992,76,9,67,44,1
260992,338,42,296,45,1
260992,79,15,64,59,1
260992,259,27,232,60,1
261375,1762,943,819,1,4
261375,1762,943,819,2,1
261375,1762,943,819,3,1
261375,89,54,35,4,1
261375,1673,889,784,5,1
261375,1673,889,784,20,1
261375,362,114,248,21,4
261375,362,114,248,22,1
261375,362,114,248,23,1
261375,63,30,33,24,1
261375,299,84,215,25,1
261375,299,84,215,40,1
261375,1400,829,571,41,4
261375,1400,829,571,42,1
261375,1400,829,571,43,1
261375,26,24,2,44,1
261375,1374,805,569,45,1
261375,1374,805,569,60,1
261384,694,489,205,1,4
261384,694,489,205,2,1
261384,694,489,205,3,1
261384,64,54,10,4,1
261384,630,435,195,5,1
261384,630,435,195,20,1
261384,142,126,16,21,4
261384,142,126,16,22,1
261384,142,126,16,23,1
261384,27,26,1,24,1
261384,115,100,15,25,1
261384,115,100,15,40,1
261384,552,363,189,41,4
261384,552,363,189,42,1
261384,552,363,189,43,1
261384,37,28,9,44,1
261384,515,335,180,45,1
261384,515,335,180,60,1
261393,736,550,186,1,4
261393,736,550,186,2,1
261393,736,550,186,3,1
261393,87,79,8,4,1
261393,649,471,178,5,1
261393,649,471,178,20,1
261393,156,120,36,21,4
261393,156,120,36,22,1
261393,156,120,36,23,1
261393,39,32,7,24,1
261393,117,88,29,25,1
261393,117,88,29,40,1
261393,580,430,150,41,4
261393,580,430,150,42,1
261393,580,430,150,43,1
261393,48,47,1,44,1
261393,532,383,149,45,1
261393,532,383,149,60,1
261436,977,51,926,1,4
261436,977,51,926,2,1
261436,977,51,926,3,1
261436,486,34,452,4,1
261436,491,17,474,5,1
261436,491,17,474,20,1
261436,977,51,926,21,4
261436,977,51,926,22,1
261436,977,51,926,23,1
261436,486,34,452,24,1
261436,491,17,474,25,1
261436,491,17,474,40,1
261472,581,462,119,1,4
261472,581,462,119,2,1
261472,581,462,119,3,1
261472,66,51,15,4,1
261472,515,411,104,5,1
261472,8,5,3,19,1
261472,507,406,101,20,1
261472,392,312,80,21,4
261472,392,312,80,22,1
261472,392,312,80,23,1
261472,56,42,14,24,1
261472,336,270,66,25,1
261472,7,4,3,39,1
261472,329,266,63,40,1
261472,189,150,39,41,4
261472,189,150,39,42,1
261472,189,150,39,43,1
261472,10,9,1,44,1
261472,179,141,38,45,1
261472,1,1,0,59,1
261472,178,140,38,60,1
261676,127,6,121,1,4
261676,127,6,121,2,1
261676,127,6,121,3,1
261676,62,2,60,4,1
261676,65,4,61,5,1
261676,65,4,61,20,1
261676,127,6,121,21,4
261676,127,6,121,22,1
261676,127,6,121,23,1
261676,62,2,60,24,1
261676,65,4,61,25,1
261676,65,4,61,40,1
261685,128,20,108,1,4
261685,128,20,108,2,1
261685,128,20,108,3,1
261685,35,3,32,4,1
261685,93,17,76,5,1
261685,93,17,76,20,1
261685,128,20,108,21,4
261685,128,20,108,22,1
261685,128,20,108,23,1
261685,35,3,32,24,1
261685,93,17,76,25,1
261685,93,17,76,40,1
261719,204,5,199,1,4
261719,204,5,199,2,1
261719,204,5,199,3,1
261719,115,1,114,4,1
261719,89,4,85,5,1
261719,89,4,85,20,1
261719,204,5,199,21,4
261719,204,5,199,22,1
261719,204,5,199,23,1
261719,115,1,114,24,1
261719,89,4,85,25,1
261719,89,4,85,40,1
261773,27,10,17,1,4
261773,27,10,17,2,1
261773,27,10,17,3,1
261773,25,8,17,4,1
261773,2,2,0,5,1
261773,2,2,0,20,1
261773,25,8,17,21,4
261773,25,8,17,22,1
261773,25,8,17,23,1
261773,24,7,17,24,1
261773,1,1,0,25,1
261773,1,1,0,40,1
261773,2,2,0,41,4
261773,2,2,0,42,1
261773,2,2,0,43,1
261773,1,1,0,44,1
261773,1,1,0,45,1
261773,1,1,0,60,1
261861,118,8,110,1,4
261861,118,8,110,2,1
261861,118,8,110,3,1
261861,30,0,30,4,1
261861,88,8,80,5,1
261861,25,2,23,19,1
261861,63,6,57,20,1
261861,118,8,110,21,4
261861,118,8,110,22,1
261861,118,8,110,23,1
261861,30,0,30,24,1
261861,88,8,80,25,1
261861,25,2,23,39,1
261861,63,6,57,40,1
261931,195,55,140,1,4
261931,195,55,140,2,1
261931,193,53,140,3,1
261931,14,4,10,4,1
261931,179,49,130,5,1
261931,2,2,0,11,1
261931,28,2,26,19,1
261931,151,47,104,20,1
261931,195,55,140,21,4
261931,195,55,140,22,1
261931,193,53,140,23,1
261931,14,4,10,24,1
261931,179,49,130,25,1
261931,2,2,0,31,1
261931,28,2,26,39,1
261931,151,47,104,40,1
262022,178,101,77,1,4
262022,178,101,77,12,3
262022,41,23,18,21,4
262022,41,23,18,32,3
262022,137,78,59,41,4
262022,137,78,59,52,3
262031,7396,3184,4212,1,4
262031,7396,3184,4212,2,1
262031,6744,2892,3852,3,1
262031,1561,768,793,4,1
262031,5183,2124,3059,5,1
262031,652,292,360,11,1
262031,586,253,333,19,1
262031,4597,1871,2726,20,1
262031,3549,1675,1874,21,4
262031,3549,1675,1874,22,1
262031,3451,1615,1836,23,1
262031,1155,574,581,24,1
262031,2296,1041,1255,25,1
262031,98,60,38,31,1
262031,376,165,211,39,1
262031,1920,876,1044,40,1
262031,3847,1509,2338,41,4
262031,3847,1509,2338,42,1
262031,3293,1277,2016,43,1
262031,406,194,212,44,1
262031,2887,1083,1804,45,1
262031,554,232,322,51,1
262031,210,88,122,59,1
262031,2677,995,1682,60,1
262086,7746,2795,4951,1,4
262086,3885,1473,2412,2,1
262086,3642,1327,2315,3,1
262086,46,20,26,4,1
262086,3596,1307,2289,5,1
262086,243,146,97,11,1
262086,3861,1322,2539,12,3
262086,761,253,508,19,1
262086,2835,1054,1781,20,1
262086,3037,1025,2012,21,4
262086,1552,597,955,22,1
262086,1528,586,942,23,1
262086,10,5,5,24,1
262086,1518,581,937,25,1
262086,24,11,13,31,1
262086,1485,428,1057,32,3
262086,293,93,200,39,1
262086,1225,488,737,40,1
262086,4709,1770,2939,41,4
262086,2333,876,1457,42,1
262086,2114,741,1373,43,1
262086,36,15,21,44,1
262086,2078,726,1352,45,1
262086,219,135,84,51,1
262086,2376,894,1482,52,3
262086,468,160,308,59,1
262086,1610,566,1044,60,1
262129,793,338,455,1,4
262129,793,338,455,2,1
262129,793,338,455,3,1
262129,222,88,134,4,1
262129,571,250,321,5,1
262129,31,19,12,19,1
262129,540,231,309,20,1
262129,793,338,455,21,4
262129,793,338,455,22,1
262129,793,338,455,23,1
262129,222,88,134,24,1
262129,571,250,321,25,1
262129,31,19,12,39,1
262129,540,231,309,40,1
262235,55,3,52,1,4
262235,55,3,52,2,1
262235,55,3,52,3,1
262235,3,0,3,4,1
262235,52,3,49,5,1
262235,52,3,49,20,1
262235,55,3,52,21,4
262235,55,3,52,22,1
262235,55,3,52,23,1
262235,3,0,3,24,1
262235,52,3,49,25,1
262235,52,3,49,40,1
262299,84,7,77,1,4
262299,84,7,77,2,1
262299,84,7,77,3,1
262299,25,1,24,4,1
262299,59,6,53,5,1
262299,59,6,53,20,1
262299,68,7,61,21,4
262299,68,7,61,22,1
262299,68,7,61,23,1
262299,20,1,19,24,1
262299,48,6,42,25,1
262299,48,6,42,40,1
262299,16,0,16,41,4
262299,16,0,16,42,1
262299,16,0,16,43,1
262299,5,0,5,44,1
262299,11,0,11,45,1
262299,11,0,11,60,1
262332,1551,740,811,1,4
262332,1551,740,811,2,1
262332,1548,739,809,3,1
262332,119,42,77,4,1
262332,1429,697,732,5,1
262332,3,1,2,11,1
262332,129,42,87,19,1
262332,1300,655,645,20,1
262332,1551,740,811,21,4
262332,1551,740,811,22,1
262332,1548,739,809,23,1
262332,119,42,77,24,1
262332,1429,697,732,25,1
262332,3,1,2,31,1
262332,129,42,87,39,1
262332,1300,655,645,40,1
262341,693,628,65,1,4
262341,693,628,65,2,1
262341,693,628,65,3,1
262341,320,295,25,4,1
262341,373,333,40,5,1
262341,373,333,40,20,1
262341,693,628,65,21,4
262341,693,628,65,22,1
262341,693,628,65,23,1
262341,320,295,25,24,1
262341,373,333,40,25,1
262341,373,333,40,40,1
262369,157,2,155,1,4
262369,157,2,155,2,1
262369,157,2,155,3,1
262369,106,1,105,4,1
262369,51,1,50,5,1
262369,51,1,50,20,1
262369,157,2,155,21,4
262369,157,2,155,22,1
262369,157,2,155,23,1
262369,106,1,105,24,1
262369,51,1,50,25,1
262369,51,1,50,40,1
262402,212,206,6,1,4
262402,212,206,6,2,1
262402,212,206,6,3,1
262402,93,90,3,4,1
262402,119,116,3,5,1
262402,119,116,3,20,1
262402,212,206,6,21,4
262402,212,206,6,22,1
262402,212,206,6,23,1
262402,93,90,3,24,1
262402,119,116,3,25,1
262402,119,116,3,40,1
262457,686,176,510,1,4
262457,686,176,510,2,1
262457,686,176,510,3,1
262457,54,12,42,4,1
262457,632,164,468,5,1
262457,104,26,78,19,1
262457,528,138,390,20,1
262457,686,176,510,21,4
262457,686,176,510,22,1
262457,686,176,510,23,1
262457,54,12,42,24,1
262457,632,164,468,25,1
262457,104,26,78,39,1
262457,528,138,390,40,1
262466,72,27,45,1,4
262466,72,27,45,2,1
262466,72,27,45,3,1
262466,72,27,45,5,1
262466,72,27,45,20,1
262466,72,27,45,41,4
262466,72,27,45,42,1
262466,72,27,45,43,1
262466,72,27,45,45,1
262466,72,27,45,60,1
262509,466,103,363,1,4
262509,466,103,363,2,1
262509,466,103,363,3,1
262509,81,19,62,4,1
262509,385,84,301,5,1
262509,26,1,25,19,1
262509,359,83,276,20,1
262509,466,103,363,21,4
262509,466,103,363,22,1
262509,466,103,363,23,1
262509,81,19,62,24,1
262509,385,84,301,25,1
262509,26,1,25,39,1
262509,359,83,276,40,1
262660,80,2,78,1,4
262660,80,2,78,2,1
262660,80,2,78,3,1
262660,25,2,23,4,1
262660,55,0,55,5,1
262660,55,0,55,20,1
262660,52,1,51,21,4
262660,52,1,51,22,1
262660,52,1,51,23,1
262660,15,1,14,24,1
262660,37,0,37,25,1
262660,37,0,37,40,1
262660,28,1,27,41,4
262660,28,1,27,42,1
262660,28,1,27,43,1
262660,10,1,9,44,1
262660,18,0,18,45,1
262660,18,0,18,60,1
362700,355,56,299,1,4
362700,355,56,299,2,1
362700,355,56,299,3,1
362700,35,2,33,4,1
362700,320,54,266,5,1
362700,320,54,266,20,1
362700,331,49,282,21,4
362700,331,49,282,22,1
362700,331,49,282,23,1
362700,34,2,32,24,1
362700,297,47,250,25,1
362700,297,47,250,40,1
362700,24,7,17,41,4
362700,24,7,17,42,1
362700,24,7,17,43,1
362700,1,0,1,44,1
362700,23,7,16,45,1
362700,23,7,16,60,1
362782,171,2,169,1,4
362782,171,2,169,2,1
362782,171,2,169,3,1
362782,22,0,22,4,1
362782,149,2,147,5,1
362782,149,2,147,20,1
362782,129,0,129,21,4
362782,129,0,129,22,1
362782,129,0,129,23,1
362782,21,0,21,24,1
362782,108,0,108,25,1
362782,108,0,108,40,1
362782,42,2,40,41,4
362782,42,2,40,42,1
362782,42,2,40,43,1
362782,1,0,1,44,1
362782,41,2,39,45,1
362782,41,2,39,60,1
363013,62,5,57,1,4
363013,62,5,57,2,1
363013,62,5,57,3,1
363013,21,2,19,4,1
363013,41,3,38,5,1
363013,41,3,38,20,1
363013,62,5,57,21,4
363013,62,5,57,22,1
363013,62,5,57,23,1
363013,21,2,19,24,1
363013,41,3,38,25,1
363013,41,3,38,40,1
363077,268,38,230,1,4
363077,268,38,230,2,1
363077,268,38,230,3,1
363077,66,15,51,4,1
363077,202,23,179,5,1
363077,202,23,179,20,1
363077,152,23,129,21,4
363077,152,23,129,22,1
363077,152,23,129,23,1
363077,44,8,36,24,1
363077,108,15,93,25,1
363077,108,15,93,40,1
363077,116,15,101,41,4
363077,116,15,101,42,1
363077,116,15,101,43,1
363077,22,7,15,44,1
363077,94,8,86,45,1
363077,94,8,86,60,1
363147,87,5,82,1,4
363147,87,5,82,2,1
363147,87,5,82,3,1
363147,13,2,11,4,1
363147,74,3,71,5,1
363147,74,3,71,20,1
363147,21,2,19,21,4
363147,21,2,19,22,1
363147,21,2,19,23,1
363147,5,1,4,24,1
363147,16,1,15,25,1
363147,16,1,15,40,1
363147,66,3,63,41,4
363147,66,3,63,42,1
363147,66,3,63,43,1
363147,8,1,7,44,1
363147,58,2,56,45,1
363147,58,2,56,60,1
363165,914,517,397,1,4
363165,914,517,397,2,1
363165,914,517,397,3,1
363165,269,156,113,4,1
363165,645,361,284,5,1
363165,645,361,284,20,1
363165,503,305,198,21,4
363165,503,305,198,22,1
363165,503,305,198,23,1
363165,139,76,63,24,1
363165,364,229,135,25,1
363165,364,229,135,40,1
363165,411,212,199,41,4
363165,411,212,199,42,1
363165,411,212,199,43,1
363165,130,80,50,44,1
363165,281,132,149,45,1
363165,281,132,149,60,1
363387,1256,325,931,1,4
363387,1256,325,931,2,1
363387,1252,323,929,3,1
363387,125,34,91,4,1
363387,1127,289,838,5,1
363387,4,2,2,11,1
363387,122,30,92,19,1
363387,1005,259,746,20,1
363387,914,236,678,21,4
363387,914,236,678,22,1
363387,913,235,678,23,1
363387,66,15,51,24,1
363387,847,220,627,25,1
363387,1,1,0,31,1
363387,68,19,49,39,1
363387,779,201,578,40,1
363387,342,89,253,41,4
363387,342,89,253,42,1
363387,339,88,251,43,1
363387,59,19,40,44,1
363387,280,69,211,45,1
363387,3,1,2,51,1
363387,54,11,43,59,1
363387,226,58,168,60,1
363439,255,42,213,1,4
363439,255,42,213,2,1
363439,255,42,213,3,1
363439,22,3,19,4,1
363439,233,39,194,5,1
363439,37,8,29,19,1
363439,196,31,165,20,1
363439,185,28,157,21,4
363439,185,28,157,22,1
363439,185,28,157,23,1
363439,22,3,19,24,1
363439,163,25,138,25,1
363439,25,5,20,39,1
363439,138,20,118,40,1
363439,70,14,56,41,4
363439,70,14,56,42,1
363439,70,14,56,43,1
363439,70,14,56,45,1
363439,12,3,9,59,1
363439,58,11,47,60,1
363590,451,70,381,1,4
363590,451,70,381,2,1
363590,451,70,381,3,1
363590,59,6,53,4,1
363590,392,64,328,5,1
363590,58,10,48,19,1
363590,334,54,280,20,1
363590,440,64,376,21,4
363590,440,64,376,22,1
363590,440,64,376,23,1
363590,59,6,53,24,1
363590,381,58,323,25,1
363590,57,10,47,39,1
363590,324,48,276,40,1
363590,11,6,5,41,4
363590,11,6,5,42,1
363590,11,6,5,43,1
363590,11,6,5,45,1
363590,1,0,1,59,1
363590,10,6,4,60,1
363633,1657,759,898,1,4
363633,1657,759,898,2,1
363633,868,389,479,3,1
363633,121,69,52,4,1
363633,747,320,427,5,1
363633,789,370,419,11,1
363633,34,13,21,19,1
363633,713,307,406,20,1
363633,527,238,289,21,4
363633,527,238,289,22,1
363633,509,228,281,23,1
363633,87,52,35,24,1
363633,422,176,246,25,1
363633,18,10,8,31,1
363633,18,5,13,39,1
363633,404,171,233,40,1
363633,1130,521,609,41,4
363633,1130,521,609,42,1
363633,359,161,198,43,1
363633,34,17,17,44,1
363633,325,144,181,45,1
363633,771,360,411,51,1
363633,16,8,8,59,1
363633,309,136,173,60,1
363679,134,5,129,1,4
363679,134,5,129,2,1
363679,134,5,129,3,1
363679,63,1,62,4,1
363679,71,4,67,5,1
363679,71,4,67,20,1
363679,98,4,94,21,4
363679,98,4,94,22,1
363679,98,4,94,23,1
363679,50,1,49,24,1
363679,48,3,45,25,1
363679,48,3,45,40,1
363679,36,1,35,41,4
363679,36,1,35,42,1
363679,36,1,35,43,1
363679,13,0,13,44,1
363679,23,1,22,45,1
363679,23,1,22,60,1
363712,51,51,0,1,4
363712,51,51,0,2,1
363712,51,51,0,3,1
363712,18,18,0,4,1
363712,33,33,0,5,1
363712,18,18,0,19,1
363712,15,15,0,20,1
363712,51,51,0,21,4
363712,51,51,0,22,1
363712,51,51,0,23,1
363712,18,18,0,24,1
363712,33,33,0,25,1
363712,18,18,0,39,1
363712,15,15,0,40,1
363721,336,140,196,1,4
363721,336,140,196,12,3
363721,195,82,113,21,4
363721,195,82,113,32,3
363721,141,58,83,41,4
363721,141,58,83,52,3
363882,53,1,52,1,4
363882,53,1,52,2,1
363882,53,1,52,3,1
363882,6,0,6,4,1
363882,47,1,46,5,1
363882,47,1,46,20,1
363882,3,0,3,21,4
363882,3,0,3,22,1
363882,3,0,3,23,1
363882,1,0,1,24,1
363882,2,0,2,25,1
363882,2,0,2,40,1
363882,50,1,49,41,4
363882,50,1,49,42,1
363882,50,1,49,43,1
363882,5,0,5,44,1
363882,45,1,44,45,1
363882,45,1,44,60,1
363907,1529,645,884,1,4
363907,1161,568,593,2,1
363907,1159,567,592,3,1
363907,159,74,85,4,1
363907,1000,493,507,5,1
363907,2,1,1,11,1
363907,368,77,291,12,3
363907,64,36,28,19,1
363907,936,457,479,20,1
363907,1087,480,607,21,4
363907,936,444,492,22,1
363907,936,444,492,23,1
363907,152,71,81,24,1
363907,784,373,411,25,1
363907,151,36,115,32,3
363907,53,32,21,39,1
363907,731,341,390,40,1
363907,442,165,277,41,4
363907,225,124,101,42,1
363907,223,123,100,43,1
363907,7,3,4,44,1
363907,216,120,96,45,1
363907,2,1,1,51,1
363907,217,41,176,52,3
363907,11,4,7,59,1
363907,205,116,89,60,1
363916,604,173,431,1,4
363916,489,157,332,2,1
363916,483,156,327,3,1
363916,29,8,21,4,1
363916,454,148,306,5,1
363916,6,1,5,11,1
363916,115,16,99,12,3
363916,32,14,18,19,1
363916,422,134,288,20,1
363916,445,133,312,21,4
363916,407,129,278,22,1
363916,406,129,277,23,1
363916,28,8,20,24,1
363916,378,121,257,25,1
363916,1,0,1,31,1
363916,38,4,34,32,3
363916,31,13,18,39,1
363916,347,108,239,40,1
363916,159,40,119,41,4
363916,82,28,54,42,1
363916,77,27,50,43,1
363916,1,0,1,44,1
363916,76,27,49,45,1
363916,5,1,4,51,1
363916,77,12,65,52,3
363916,1,1,0,59,1
363916,75,26,49,60,1
363934,1017,877,140,1,4
363934,959,833,126,2,1
363934,959,833,126,3,1
363934,107,94,13,4,1
363934,852,739,113,5,1
363934,58,44,14,12,3
363934,118,94,24,19,1
363934,734,645,89,20,1
363934,1014,875,139,21,4
363934,959,833,126,22,1
363934,959,833,126,23,1
363934,107,94,13,24,1
363934,852,739,113,25,1
363934,55,42,13,32,3
363934,118,94,24,39,1
363934,734,645,89,40,1
363934,3,2,1,41,4
363934,3,2,1,52,3
364016,9477,4145,5332,1,4
364016,9477,4145,5332,2,1
364016,7068,3145,3923,3,1
364016,1368,667,701,4,1
364016,5700,2478,3222,5,1
364016,2409,1000,1409,11,1
364016,851,378,473,19,1
364016,4849,2100,2749,20,1
364016,2671,1382,1289,21,4
364016,2671,1382,1289,22,1
364016,2378,1223,1155,23,1
364016,780,391,389,24,1
364016,1598,832,766,25,1
364016,293,159,134,31,1
364016,205,115,90,39,1
364016,1393,717,676,40,1
364016,6806,2763,4043,41,4
364016,6806,2763,4043,42,1
364016,4690,1922,2768,43,1
364016,588,276,312,44,1
364016,4102,1646,2456,45,1
364016,2116,841,1275,51,1
364016,646,263,383,59,1
364016,3456,1383,2073,60,1
364025,14399,6769,7630,1,4
364025,14399,6769,7630,2,1
364025,9621,4694,4927,3,1
364025,2004,996,1008,4,1
364025,7617,3698,3919,5,1
364025,4778,2075,2703,11,1
364025,879,417,462,19,1
364025,6738,3281,3457,20,1
364025,4467,2330,2137,21,4
364025,4467,2330,2137,22,1
364025,3867,2043,1824,23,1
364025,1269,629,640,24,1
364025,2598,1414,1184,25,1
364025,600,287,313,31,1
364025,266,156,110,39,1
364025,2332,1258,1074,40,1
364025,9932,4439,5493,41,4
364025,9932,4439,5493,42,1
364025,5754,2651,3103,43,1
364025,735,367,368,44,1
364025,5019,2284,2735,45,1
364025,4178,1788,2390,51,1
364025,613,261,352,59,1
364025,4406,2023,2383,60,1
364122,6,2,4,1,4
364122,6,2,4,2,1
364122,6,2,4,3,1
364122,6,2,4,5,1
364122,6,2,4,20,1
364122,6,2,4,21,4
364122,6,2,4,22,1
364122,6,2,4,23,1
364122,6,2,4,25,1
364122,6,2,4,40,1
364168,396,333,63,1,4
364168,396,333,63,2,1
364168,396,333,63,3,1
364168,159,127,32,4,1
364168,237,206,31,5,1
364168,2,2,0,19,1
364168,235,204,31,20,1
364168,385,324,61,21,4
364168,385,324,61,22,1
364168,385,324,61,23,1
364168,150,118,32,24,1
364168,235,206,29,25,1
364168,2,2,0,39,1
364168,233,204,29,40,1
364168,11,9,2,41,4
364168,11,9,2,42,1
364168,11,9,2,43,1
364168,9,9,0,44,1
364168,2,0,2,45,1
364168,2,0,2,60,1
364326,371,34,337,1,4
364326,371,34,337,2,1
364326,371,34,337,3,1
364326,371,34,337,5,1
364326,371,34,337,20,1
364326,371,34,337,21,4
364326,371,34,337,22,1
364326,371,34,337,23,1
364326,371,34,337,25,1
364326,371,34,337,40,1
364335,915,125,790,1,4
364335,915,125,790,2,1
364335,915,125,790,3,1
364335,108,11,97,4,1
364335,807,114,693,5,1
364335,807,114,693,20,1
364335,915,125,790,21,4
364335,915,125,790,22,1
364335,915,125,790,23,1
364335,108,11,97,24,1
364335,807,114,693,25,1
364335,807,114,693,40,1
364548,296,134,162,1,4
364548,296,134,162,2,1
364548,296,134,162,3,1
364548,278,129,149,4,1
364548,18,5,13,5,1
364548,18,5,13,20,1
364548,265,109,156,21,4
364548,265,109,156,22,1
364548,265,109,156,23,1
364548,248,105,143,24,1
364548,17,4,13,25,1
364548,17,4,13,40,1
364548,31,25,6,41,4
364548,31,25,6,42,1
364548,31,25,6,43,1
364548,30,24,6,44,1
364548,1,1,0,45,1
364548,1,1,0,60,1
364575,39,5,34,1,4
364575,39,5,34,2,1
364575,39,5,34,3,1
364575,24,3,21,4,1
364575,15,2,13,5,1
364575,15,2,13,20,1
364575,39,5,34,21,4
364575,39,5,34,22,1
364575,39,5,34,23,1
364575,24,3,21,24,1
364575,15,2,13,25,1
364575,15,2,13,40,1
364584,129,24,105,1,4
364584,129,24,105,2,1
364584,129,24,105,3,1
364584,32,4,28,4,1
364584,97,20,77,5,1
364584,97,20,77,20,1
364584,65,16,49,21,4
364584,65,16,49,22,1
364584,65,16,49,23,1
364584,26,3,23,24,1
364584,39,13,26,25,1
364584,39,13,26,40,1
364584,64,8,56,41,4
364584,64,8,56,42,1
364584,64,8,56,43,1
364584,6,1,5,44,1
364584,58,7,51,45,1
364584,58,7,51,60,1
364593,2,0,2,1,4
364593,2,0,2,2,1
364593,2,0,2,3,1
364593,2,0,2,5,1
364593,2,0,2,20,1
364593,2,0,2,21,4
364593,2,0,2,22,1
364593,2,0,2,23,1
364593,2,0,2,25,1
364593,2,0,2,40,1
364618,34,2,32,1,4
364618,34,2,32,2,1
364618,34,2,32,3,1
364618,21,1,20,4,1
364618,13,1,12,5,1
364618,13,1,12,20,1
364618,34,2,32,21,4
364618,34,2,32,22,1
364618,34,2,32,23,1
364618,21,1,20,24,1
364618,13,1,12,25,1
364618,13,1,12,40,1
364627,421,194,227,1,4
364627,421,194,227,2,1
364627,421,194,227,3,1
364627,270,121,149,4,1
364627,151,73,78,5,1
364627,151,73,78,20,1
364627,107,23,84,21,4
364627,107,23,84,22,1
364627,107,23,84,23,1
364627,67,16,51,24,1
364627,40,7,33,25,1
364627,40,7,33,40,1
364627,314,171,143,41,4
364627,314,171,143,42,1
364627,314,171,143,43,1
364627,203,105,98,44,1
364627,111,66,45,45,1
364627,111,66,45,60,1
364636,55,30,25,1,4
364636,55,30,25,2,1
364636,55,30,25,3,1
364636,32,21,11,4,1
364636,23,9,14,5,1
364636,23,9,14,20,1
364636,55,30,25,21,4
364636,55,30,25,22,1
364636,55,30,25,23,1
364636,32,21,11,24,1
364636,23,9,14,25,1
364636,23,9,14,40,1
364751,221,10,211,1,4
364751,221,10,211,2,1
364751,221,10,211,3,1
364751,66,3,63,4,1
364751,155,7,148,5,1
364751,155,7,148,20,1
364751,221,10,211,21,4
364751,221,10,211,22,1
364751,221,10,211,23,1
364751,66,3,63,24,1
364751,155,7,148,25,1
364751,155,7,148,40,1
364760,75,7,68,1,4
364760,75,7,68,2,1
364760,75,7,68,3,1
364760,61,5,56,4,1
364760,14,2,12,5,1
364760,14,2,12,20,1
364760,39,3,36,21,4
364760,39,3,36,22,1
364760,39,3,36,23,1
364760,34,3,31,24,1
364760,5,0,5,25,1
364760,5,0,5,40,1
364760,36,4,32,41,4
364760,36,4,32,42,1
364760,36,4,32,43,1
364760,27,2,25,44,1
364760,9,2,7,45,1
364760,9,2,7,60,1
364812,52,0,52,1,4
364812,52,0,52,2,1
364812,52,0,52,3,1
364812,28,0,28,4,1
364812,24,0,24,5,1
364812,24,0,24,20,1
364812,4,0,4,21,4
364812,4,0,4,22,1
364812,4,0,4,23,1
364812,1,0,1,24,1
364812,3,0,3,25,1
364812,3,0,3,40,1
364812,48,0,48,41,4
364812,48,0,48,42,1
364812,48,0,48,43,1
364812,27,0,27,44,1
364812,21,0,21,45,1
364812,21,0,21,60,1
364946,198,85,113,1,4
364946,198,85,113,2,1
364946,198,85,113,3,1
364946,98,45,53,4,1
364946,100,40,60,5,1
364946,100,40,60,20,1
364946,72,29,43,21,4
364946,72,29,43,22,1
364946,72,29,43,23,1
364946,24,13,11,24,1
364946,48,16,32,25,1
364946,48,16,32,40,1
364946,126,56,70,41,4
364946,126,56,70,42,1
364946,126,56,70,43,1
364946,74,32,42,44,1
364946,52,24,28,45,1
364946,52,24,28,60,1
364955,645,124,521,1,4
364955,645,124,521,2,1
364955,645,124,521,3,1
364955,126,12,114,4,1
364955,519,112,407,5,1
364955,38,11,27,19,1
364955,481,101,380,20,1
364955,645,124,521,21,4
364955,645,124,521,22,1
364955,645,124,521,23,1
364955,126,12,114,24,1
364955,519,112,407,25,1
364955,38,11,27,39,1
364955,481,101,380,40,1
364964,134,49,85,1,4
364964,134,49,85,2,1
364964,134,49,85,3,1
364964,73,36,37,4,1
364964,61,13,48,5,1
364964,61,13,48,20,1
364964,72,4,68,21,4
364964,72,4,68,22,1
364964,72,4,68,23,1
364964,31,1,30,24,1
364964,41,3,38,25,1
364964,41,3,38,40,1
364964,62,45,17,41,4
364964,62,45,17,42,1
364964,62,45,17,43,1
364964,42,35,7,44,1
364964,20,10,10,45,1
364964,20,10,10,60,1
364973,655,358,297,1,4
364973,655,358,297,2,1
364973,655,358,297,3,1
364973,132,66,66,4,1
364973,523,292,231,5,1
364973,37,23,14,19,1
364973,486,269,217,20,1
364973,655,358,297,21,4
364973,655,358,297,22,1
364973,655,358,297,23,1
364973,132,66,66,24,1
364973,523,292,231,25,1
364973,37,23,14,39,1
364973,486,269,217,40,1
365055,1158,522,636,1,4
365055,1158,522,636,2,1
365055,1158,522,636,3,1
365055,296,146,150,4,1
365055,862,376,486,5,1
365055,77,32,45,19,1
365055,785,344,441,20,1
365055,920,416,504,21,4
365055,920,416,504,22,1
365055,920,416,504,23,1
365055,262,131,131,24,1
365055,658,285,373,25,1
365055,62,23,39,39,1
365055,596,262,334,40,1
365055,238,106,132,41,4
365055,238,106,132,42,1
365055,238,106,132,43,1
365055,34,15,19,44,1
365055,204,91,113,45,1
365055,15,9,6,59,1
365055,189,82,107,60,1
365073,94,2,92,1,4
365073,94,2,92,2,1
365073,94,2,92,3,1
365073,10,0,10,4,1
365073,84,2,82,5,1
365073,84,2,82,20,1
365073,68,2,66,21,4
365073,68,2,66,22,1
365073,68,2,66,23,1
365073,3,0,3,24,1
365073,65,2,63,25,1
365073,65,2,63,40,1
365073,26,0,26,41,4
365073,26,0,26,42,1
365073,26,0,26,43,1
365073,7,0,7,44,1
365073,19,0,19,45,1
365073,19,0,19,60,1
365091,328,17,311,1,4
365091,328,17,311,2,1
365091,328,17,311,3,1
365091,21,2,19,4,1
365091,307,15,292,5,1
365091,307,15,292,20,1
365091,328,17,311,21,4
365091,328,17,311,22,1
365091,328,17,311,23,1
365091,21,2,19,24,1
365091,307,15,292,25,1
365091,307,15,292,40,1
365125,136,8,128,1,4
365125,136,8,128,2,1
365125,136,8,128,3,1
365125,22,0,22,4,1
365125,114,8,106,5,1
365125,114,8,106,20,1
365125,136,8,128,21,4
365125,136,8,128,22,1
365125,136,8,128,23,1
365125,22,0,22,24,1
365125,114,8,106,25,1
365125,114,8,106,40,1
365198,470,203,267,1,4
365198,470,203,267,2,1
365198,92,27,65,3,1
365198,22,6,16,4,1
365198,70,21,49,5,1
365198,378,176,202,11,1
365198,70,21,49,20,1
365198,63,10,53,21,4
365198,63,10,53,22,1
365198,63,10,53,23,1
365198,17,3,14,24,1
365198,46,7,39,25,1
365198,46,7,39,40,1
365198,407,193,214,41,4
365198,407,193,214,42,1
365198,29,17,12,43,1
365198,5,3,2,44,1
365198,24,14,10,45,1
365198,378,176,202,51,1
365198,24,14,10,60,1
365204,2746,816,1930,1,4
365204,2746,816,1930,2,1
365204,2746,816,1930,3,1
365204,2026,578,1448,4,1
365204,720,238,482,5,1
365204,720,238,482,20,1
365204,2746,816,1930,21,4
365204,2746,816,1930,22,1
365204,2746,816,1930,23,1
365204,2026,578,1448,24,1
365204,720,238,482,25,1
365204,720,238,482,40,1
365213,543,282,261,1,4
365213,543,282,261,2,1
365213,252,119,133,3,1
365213,81,49,32,4,1
365213,171,70,101,5,1
365213,291,163,128,11,1
365213,171,70,101,20,1
365213,100,50,50,21,4
365213,100,50,50,22,1
365213,100,50,50,23,1
365213,16,14,2,24,1
365213,84,36,48,25,1
365213,84,36,48,40,1
365213,443,232,211,41,4
365213,443,232,211,42,1
365213,152,69,83,43,1
365213,65,35,30,44,1
365213,87,34,53,45,1
365213,291,163,128,51,1
365213,87,34,53,60,1
365240,171,94,77,1,4
365240,171,94,77,2,1
365240,171,94,77,3,1
365240,53,28,25,4,1
365240,118,66,52,5,1
365240,118,66,52,20,1
365240,115,53,62,21,4
365240,115,53,62,22,1
365240,115,53,62,23,1
365240,42,21,21,24,1
365240,73,32,41,25,1
365240,73,32,41,40,1
365240,56,41,15,41,4
365240,56,41,15,42,1
365240,56,41,15,43,1
365240,11,7,4,44,1
365240,45,34,11,45,1
365240,45,34,11,60,1
365374,1402,773,629,1,4
365374,1402,773,629,2,1
365374,360,168,192,3,1
365374,127,78,49,4,1
365374,233,90,143,5,1
365374,1042,605,437,11,1
365374,233,90,143,20,1
365374,258,105,153,21,4
365374,258,105,153,22,1
365374,258,105,153,23,1
365374,67,35,32,24,1
365374,191,70,121,25,1
365374,191,70,121,40,1
365374,1144,668,476,41,4
365374,1144,668,476,42,1
365374,102,63,39,43,1
365374,60,43,17,44,1
365374,42,20,22,45,1
365374,1042,605,437,51,1
365374,42,20,22,60,1
365383,119,16,103,1,4
365383,119,16,103,2,1
365383,119,16,103,3,1
365383,108,15,93,4,1
365383,11,1,10,5,1
365383,11,1,10,20,1
365383,119,16,103,21,4
365383,119,16,103,22,1
365383,119,16,103,23,1
365383,108,15,93,24,1
365383,11,1,10,25,1
365383,11,1,10,40,1
365426,322,151,171,1,4
365426,322,151,171,12,3
365426,227,95,132,21,4
365426,227,95,132,32,3
365426,95,56,39,41,4
365426,95,56,39,52,3
365453,17,0,17,1,4
365453,17,0,17,2,1
365453,17,0,17,3,1
365453,3,0,3,4,1
365453,14,0,14,5,1
365453,14,0,14,20,1
365453,17,0,17,21,4
365453,17,0,17,22,1
365453,17,0,17,23,1
365453,3,0,3,24,1
365453,14,0,14,25,1
365453,14,0,14,40,1
365480,807,438,369,1,4
365480,807,438,369,2,1
365480,304,156,148,3,1
365480,121,76,45,4,1
365480,183,80,103,5,1
365480,503,282,221,11,1
365480,183,80,103,20,1
365480,155,62,93,21,4
365480,155,62,93,22,1
365480,155,62,93,23,1
365480,45,24,21,24,1
365480,110,38,72,25,1
365480,110,38,72,40,1
365480,652,376,276,41,4
365480,652,376,276,42,1
365480,149,94,55,43,1
365480,76,52,24,44,1
365480,73,42,31,45,1
365480,503,282,221,51,1
365480,73,42,31,60,1
365505,55,9,46,1,4
365505,55,9,46,2,1
365505,55,9,46,3,1
365505,55,9,46,4,1
365505,55,9,46,21,4
365505,55,9,46,22,1
365505,55,9,46,23,1
365505,55,9,46,24,1
365569,28,10,18,1,4
365569,28,10,18,2,1
365569,28,10,18,3,1
365569,20,6,14,4,1
365569,8,4,4,5,1
365569,8,4,4,20,1
365569,16,5,11,21,4
365569,16,5,11,22,1
365569,16,5,11,23,1
365569,13,5,8,24,1
365569,3,0,3,25,1
365569,3,0,3,40,1
365569,12,5,7,41,4
365569,12,5,7,42,1
365569,12,5,7,43,1
365569,7,1,6,44,1
365569,5,4,1,45,1
365569,5,4,1,60,1
365693,144,2,142,1,4
365693,144,2,142,2,1
365693,144,2,142,3,1
365693,103,1,102,4,1
365693,41,1,40,5,1
365693,41,1,40,20,1
365693,118,2,116,21,4
365693,118,2,116,22,1
365693,118,2,116,23,1
365693,85,1,84,24,1
365693,33,1,32,25,1
365693,33,1,32,40,1
365693,26,0,26,41,4
365693,26,0,26,42,1
365693,26,0,26,43,1
365693,18,0,18,44,1
365693,8,0,8,45,1
365693,8,0,8,60,1
365763,53,25,28,1,4
365763,53,25,28,2,1
365763,43,22,21,3,1
365763,31,16,15,4,1
365763,12,6,6,5,1
365763,10,3,7,11,1
365763,12,6,6,20,1
365763,53,25,28,21,4
365763,53,25,28,22,1
365763,43,22,21,23,1
365763,31,16,15,24,1
365763,12,6,6,25,1
365763,10,3,7,31,1
365763,12,6,6,40,1
365824,186,13,173,1,4
365824,186,13,173,2,1
365824,186,13,173,3,1
365824,62,4,58,4,1
365824,124,9,115,5,1
365824,124,9,115,20,1
365824,186,13,173,21,4
365824,186,13,173,22,1
365824,186,13,173,23,1
365824,62,4,58,24,1
365824,124,9,115,25,1
365824,124,9,115,40,1
365833,176,13,163,1,4
365833,176,13,163,2,1
365833,176,13,163,3,1
365833,51,4,47,4,1
365833,125,9,116,5,1
365833,125,9,116,20,1
365833,176,13,163,21,4
365833,176,13,163,22,1
365833,176,13,163,23,1
365833,51,4,47,24,1
365833,125,9,116,25,1
365833,125,9,116,40,1
366003,126,79,47,1,4
366003,110,65,45,2,1
366003,107,63,44,3,1
366003,31,21,10,4,1
366003,76,42,34,5,1
366003,3,2,1,11,1
366003,16,14,2,12,3
366003,76,42,34,20,1
366003,30,21,9,21,4
366003,21,12,9,22,1
366003,21,12,9,23,1
366003,13,6,7,24,1
366003,8,6,2,25,1
366003,9,9,0,32,3
366003,8,6,2,40,1
366003,96,58,38,41,4
366003,89,53,36,42,1
366003,86,51,35,43,1
366003,18,15,3,44,1
366003,68,36,32,45,1
366003,3,2,1,51,1
366003,7,5,2,52,3
366003,68,36,32,60,1
366155,27,22,5,1,4
366155,27,22,5,2,1
366155,27,22,5,3,1
366155,12,10,2,4,1
366155,15,12,3,5,1
366155,15,12,3,20,1
366155,27,22,5,21,4
366155,27,22,5,22,1
366155,27,22,5,23,1
366155,12,10,2,24,1
366155,15,12,3,25,1
366155,15,12,3,40,1
366191,1343,1303,40,1,4
366191,1343,1303,40,2,1
366191,1343,1303,40,3,1
366191,373,363,10,4,1
366191,970,940,30,5,1
366191,970,940,30,20,1
366191,1343,1303,40,21,4
366191,1343,1303,40,22,1
366191,1343,1303,40,23,1
366191,373,363,10,24,1
366191,970,940,30,25,1
366191,970,940,30,40,1
366252,5678,3575,2103,1,4
366252,5678,3575,2103,2,1
366252,5615,3548,2067,3,1
366252,1418,975,443,4,1
366252,4197,2573,1624,5,1
366252,63,27,36,11,1
366252,435,240,195,19,1
366252,3762,2333,1429,20,1
366252,4774,3201,1573,21,4
366252,4774,3201,1573,22,1
366252,4766,3197,1569,23,1
366252,1387,962,425,24,1
366252,3379,2235,1144,25,1
366252,8,4,4,31,1
366252,365,220,145,39,1
366252,3014,2015,999,40,1
366252,904,374,530,41,4
366252,904,374,530,42,1
366252,849,351,498,43,1
366252,31,13,18,44,1
366252,818,338,480,45,1
366252,55,23,32,51,1
366252,70,20,50,59,1
366252,748,318,430,60,1
366261,219,96,123,1,4
366261,219,96,123,2,1
366261,219,96,123,3,1
366261,39,15,24,4,1
366261,180,81,99,5,1
366261,21,7,14,19,1
366261,159,74,85,20,1
366261,200,89,111,21,4
366261,200,89,111,22,1
366261,200,89,111,23,1
366261,39,15,24,24,1
366261,161,74,87,25,1
366261,6,2,4,39,1
366261,155,72,83,40,1
366261,19,7,12,41,4
366261,19,7,12,42,1
366261,19,7,12,43,1
366261,19,7,12,45,1
366261,15,5,10,59,1
366261,4,2,2,60,1
366270,678,21,657,1,4
366270,678,21,657,2,1
366270,678,21,657,3,1
366270,48,2,46,4,1
366270,630,19,611,5,1
366270,162,4,158,19,1
366270,468,15,453,20,1
366270,678,21,657,21,4
366270,678,21,657,22,1
366270,678,21,657,23,1
366270,48,2,46,24,1
366270,630,19,611,25,1
366270,162,4,158,39,1
366270,468,15,453,40,1
366289,134,62,72,1,4
366289,134,62,72,2,1
366289,4,2,2,3,1
366289,4,2,2,4,1
366289,130,60,70,11,1
366289,134,62,72,21,4
366289,134,62,72,22,1
366289,4,2,2,23,1
366289,4,2,2,24,1
366289,130,60,70,31,1
366340,404,199,205,1,4
366340,404,199,205,2,1
366340,316,159,157,3,1
366340,124,55,69,4,1
366340,192,104,88,5,1
366340,88,40,48,11,1
366340,192,104,88,20,1
366340,206,105,101,21,4
366340,206,105,101,22,1
366340,205,105,100,23,1
366340,43,23,20,24,1
366340,162,82,80,25,1
366340,1,0,1,31,1
366340,162,82,80,40,1
366340,198,94,104,41,4
366340,198,94,104,42,1
366340,111,54,57,43,1
366340,81,32,49,44,1
366340,30,22,8,45,1
366340,87,40,47,51,1
366340,30,22,8,60,1
366368,104,54,50,1,4
366368,104,54,50,12,3
366368,104,54,50,21,4
366368,104,54,50,32,3
366395,26711,12423,14288,1,4
366395,26711,12423,14288,2,1
366395,22701,10660,12041,3,1
366395,5445,2881,2564,4,1
366395,17256,7779,9477,5,1
366395,4010,1763,2247,11,1
366395,1322,652,670,19,1
366395,15934,7127,8807,20,1
366395,14831,7386,7445,21,4
366395,14831,7386,7445,22,1
366395,14813,7377,7436,23,1
366395,4603,2455,2148,24,1
366395,10210,4922,5288,25,1
366395,18,9,9,31,1
366395,1019,521,498,39,1
366395,9191,4401,4790,40,1
366395,11880,5037,6843,41,4
366395,11880,5037,6843,42,1
366395,7888,3283,4605,43,1
366395,842,426,416,44,1
366395,7046,2857,4189,45,1
366395,3992,1754,2238,51,1
366395,303,131,172,59,1
366395,6743,2726,4017,60,1
366401,8631,4286,4345,1,4
366401,8631,4286,4345,2,1
366401,7955,3978,3977,3,1
366401,1693,904,789,4,1
366401,6262,3074,3188,5,1
366401,676,308,368,11,1
366401,789,367,422,19,1
366401,5473,2707,2766,20,1
366401,2923,1572,1351,21,4
366401,2923,1572,1351,22,1
366401,2890,1552,1338,23,1
366401,868,476,392,24,1
366401,2022,1076,946,25,1
366401,33,20,13,31,1
366401,144,84,60,39,1
366401,1878,992,886,40,1
366401,5708,2714,2994,41,4
366401,5708,2714,2994,42,1
366401,5065,2426,2639,43,1
366401,825,428,397,44,1
366401,4240,1998,2242,45,1
366401,643,288,355,51,1
366401,645,283,362,59,1
366401,3595,1715,1880,60,1
366438,92,3,89,1,4
366438,92,3,89,2,1
366438,92,3,89,3,1
366438,69,3,66,4,1
366438,23,0,23,5,1
366438,23,0,23,20,1
366438,40,0,40,21,4
366438,40,0,40,22,1
366438,40,0,40,23,1
366438,25,0,25,24,1
366438,15,0,15,25,1
366438,15,0,15,40,1
366438,52,3,49,41,4
366438,52,3,49,42,1
366438,52,3,49,43,1
366438,44,3,41,44,1
366438,8,0,8,45,1
366438,8,0,8,60,1
366447,1244,567,677,1,4
366447,1244,567,677,2,1
366447,1109,513,596,3,1
366447,270,159,111,4,1
366447,839,354,485,5,1
366447,135,54,81,11,1
366447,134,41,93,19,1
366447,705,313,392,20,1
366447,356,173,183,21,4
366447,356,173,183,22,1
366447,344,165,179,23,1
366447,79,54,25,24,1
366447,265,111,154,25,1
366447,12,8,4,31,1
366447,39,11,28,39,1
366447,226,100,126,40,1
366447,888,394,494,41,4
366447,888,394,494,42,1
366447,765,348,417,43,1
366447,191,105,86,44,1
366447,574,243,331,45,1
366447,123,46,77,51,1
366447,95,30,65,59,1
366447,479,213,266,60,1
366465,2216,694,1522,1,4
366465,2216,694,1522,2,1
366465,2149,674,1475,3,1
366465,350,154,196,4,1
366465,1799,520,1279,5,1
366465,67,20,47,11,1
366465,582,187,395,19,1
366465,1217,333,884,20,1
366465,854,310,544,21,4
366465,854,310,544,22,1
366465,854,310,544,23,1
366465,157,76,81,24,1
366465,697,234,463,25,1
366465,242,98,144,39,1
366465,455,136,319,40,1
366465,1362,384,978,41,4
366465,1362,384,978,42,1
366465,1295,364,931,43,1
366465,193,78,115,44,1
366465,1102,286,816,45,1
366465,67,20,47,51,1
366465,340,89,251,59,1
366465,762,197,565,60,1
366535,472,124,348,1,4
366535,472,124,348,2,1
366535,472,124,348,3,1
366535,171,44,127,4,1
366535,301,80,221,5,1
366535,32,32,0,19,1
366535,269,48,221,20,1
366535,472,124,348,21,4
366535,472,124,348,22,1
366535,472,124,348,23,1
366535,171,44,127,24,1
366535,301,80,221,25,1
366535,32,32,0,39,1
366535,269,48,221,40,1
366544,383,80,303,1,4
366544,383,80,303,2,1
366544,383,80,303,3,1
366544,46,6,40,4,1
366544,337,74,263,5,1
366544,43,6,37,19,1
366544,294,68,226,20,1
366544,326,59,267,21,4
366544,326,59,267,22,1
366544,326,59,267,23,1
366544,46,6,40,24,1
366544,280,53,227,25,1
366544,39,4,35,39,1
366544,241,49,192,40,1
366544,57,21,36,41,4
366544,57,21,36,42,1
366544,57,21,36,43,1
366544,57,21,36,45,1
366544,4,2,2,59,1
366544,53,19,34,60,1
366553,1263,308,955,1,4
366553,1263,308,955,2,1
366553,1261,308,953,3,1
366553,156,38,118,4,1
366553,1105,270,835,5,1
366553,2,0,2,11,1
366553,236,37,199,19,1
366553,869,233,636,20,1
366553,880,245,635,21,4
366553,880,245,635,22,1
366553,880,245,635,23,1
366553,119,33,86,24,1
366553,761,212,549,25,1
366553,148,27,121,39,1
366553,613,185,428,40,1
366553,383,63,320,41,4
366553,383,63,320,42,1
366553,381,63,318,43,1
366553,37,5,32,44,1
366553,344,58,286,45,1
366553,2,0,2,51,1
366553,88,10,78,59,1
366553,256,48,208,60,1
366571,24,3,21,1,4
366571,24,3,21,2,1
366571,24,3,21,3,1
366571,24,3,21,5,1
366571,24,3,21,20,1
366571,24,3,21,21,4
366571,24,3,21,22,1
366571,24,3,21,23,1
366571,24,3,21,25,1
366571,24,3,21,40,1
366580,478,425,53,1,4
366580,478,425,53,2,1
366580,478,425,53,3,1
366580,50,43,7,4,1
366580,428,382,46,5,1
366580,9,7,2,19,1
366580,419,375,44,20,1
366580,368,331,37,21,4
366580,368,331,37,22,1
366580,368,331,37,23,1
366580,44,38,6,24,1
366580,324,293,31,25,1
366580,9,7,2,39,1
366580,315,286,29,40,1
366580,110,94,16,41,4
366580,110,94,16,42,1
366580,110,94,16,43,1
366580,6,5,1,44,1
366580,104,89,15,45,1
366580,104,89,15,60,1
366605,53,12,41,1,4
366605,53,12,41,12,3
366605,44,11,33,21,4
366605,44,11,33,32,3
366605,9,1,8,41,4
366605,9,1,8,52,3
366623,108,57,51,1,4
366623,108,57,51,2,1
366623,108,57,51,3,1
366623,6,3,3,4,1
366623,102,54,48,5,1
366623,102,54,48,20,1
366623,7,4,3,21,4
366623,7,4,3,22,1
366623,7,4,3,23,1
366623,3,2,1,24,1
366623,4,2,2,25,1
366623,4,2,2,40,1
366623,101,53,48,41,4
366623,101,53,48,42,1
366623,101,53,48,43,1
366623,3,1,2,44,1
366623,98,52,46,45,1
366623,98,52,46,60,1
366632,40,3,37,1,4
366632,40,3,37,2,1
366632,40,3,37,3,1
366632,21,0,21,4,1
366632,19,3,16,5,1
366632,19,3,16,20,1
366632,40,3,37,21,4
366632,40,3,37,22,1
366632,40,3,37,23,1
366632,21,0,21,24,1
366632,19,3,16,25,1
366632,19,3,16,40,1
366650,400,319,81,1,4
366650,400,319,81,2,1
366650,400,319,81,3,1
366650,67,52,15,4,1
366650,333,267,66,5,1
366650,5,3,2,19,1
366650,328,264,64,20,1
366650,294,241,53,21,4
366650,294,241,53,22,1
366650,294,241,53,23,1
366650,49,41,8,24,1
366650,245,200,45,25,1
366650,4,3,1,39,1
366650,241,197,44,40,1
366650,106,78,28,41,4
366650,106,78,28,42,1
366650,106,78,28,43,1
366650,18,11,7,44,1
366650,88,67,21,45,1
366650,1,0,1,59,1
366650,87,67,20,60,1
366678,432,361,71,1,4
366678,432,361,71,2,1
366678,432,361,71,3,1
366678,66,53,13,4,1
366678,366,308,58,5,1
366678,10,9,1,19,1
366678,356,299,57,20,1
366678,348,294,54,21,4
366678,348,294,54,22,1
366678,348,294,54,23,1
366678,61,50,11,24,1
366678,287,244,43,25,1
366678,9,8,1,39,1
366678,278,236,42,40,1
366678,84,67,17,41,4
366678,84,67,17,42,1
366678,84,67,17,43,1
366678,5,3,2,44,1
366678,79,64,15,45,1
366678,1,1,0,59,1
366678,78,63,15,60,1
366696,650,512,138,1,4
366696,650,512,138,2,1
366696,650,512,138,3,1
366696,109,80,29,4,1
366696,541,432,109,5,1
366696,5,5,0,19,1
366696,536,427,109,20,1
366696,575,453,122,21,4
366696,575,453,122,22,1
366696,575,453,122,23,1
366696,105,77,28,24,1
366696,470,376,94,25,1
366696,5,5,0,39,1
366696,465,371,94,40,1
366696,75,59,16,41,4
366696,75,59,16,42,1
366696,75,59,16,43,1
366696,4,3,1,44,1
366696,71,56,15,45,1
366696,71,56,15,60,1
366711,11300,4418,6882,1,4
366711,10738,4245,6493,2,1
366711,10689,4231,6458,3,1
366711,2158,761,1397,4,1
366711,8531,3470,5061,5,1
366711,49,14,35,11,1
366711,562,173,389,12,3
366711,1614,695,919,19,1
366711,6917,2775,4142,20,1
366711,9177,3535,5642,21,4
366711,8852,3436,5416,22,1
366711,8824,3428,5396,23,1
366711,2100,734,1366,24,1
366711,6724,2694,4030,25,1
366711,28,8,20,31,1
366711,325,99,226,32,3
366711,1186,519,667,39,1
366711,5538,2175,3363,40,1
366711,2123,883,1240,41,4
366711,1886,809,1077,42,1
366711,1865,803,1062,43,1
366711,58,27,31,44,1
366711,1807,776,1031,45,1
366711,21,6,15,51,1
366711,237,74,163,52,3
366711,428,176,252,59,1
366711,1379,600,779,60,1
366748,795,285,510,1,4
366748,326,138,188,2,1
366748,311,133,178,3,1
366748,15,5,10,4,1
366748,296,128,168,5,1
366748,15,5,10,11,1
366748,469,147,322,12,3
366748,120,45,75,19,1
366748,176,83,93,20,1
366748,289,109,180,21,4
366748,130,52,78,22,1
366748,118,49,69,23,1
366748,6,1,5,24,1
366748,112,48,64,25,1
366748,12,3,9,31,1
366748,159,57,102,32,3
366748,44,18,26,39,1
366748,68,30,38,40,1
366748,506,176,330,41,4
366748,196,86,110,42,1
366748,193,84,109,43,1
366748,9,4,5,44,1
366748,184,80,104,45,1
366748,3,2,1,51,1
366748,310,90,220,52,3
366748,76,27,49,59,1
366748,108,53,55,60,1
366793,77,36,41,1,4
366793,77,36,41,12,3
366793,35,15,20,21,4
366793,35,15,20,32,3
366793,42,21,21,41,4
366793,42,21,21,52,3
366960,490,99,391,1,4
366960,490,99,391,2,1
366960,490,99,391,3,1
366960,88,11,77,4,1
366960,402,88,314,5,1
366960,13,4,9,19,1
366960,389,84,305,20,1
366960,490,99,391,21,4
366960,490,99,391,22,1
366960,490,99,391,23,1
366960,88,11,77,24,1
366960,402,88,314,25,1
366960,13,4,9,39,1
366960,389,84,305,40,1
367024,875,240,635,1,4
367024,780,210,570,2,1
367024,779,210,569,3,1
367024,91,28,63,4,1
367024,688,182,506,5,1
367024,1,0,1,11,1
367024,95,30,65,12,3
367024,231,67,164,19,1
367024,457,115,342,20,1
367024,553,152,401,21,4
367024,502,134,368,22,1
367024,502,134,368,23,1
367024,60,17,43,24,1
367024,442,117,325,25,1
367024,51,18,33,32,3
367024,141,46,95,39,1
367024,301,71,230,40,1
367024,322,88,234,41,4
367024,278,76,202,42,1
367024,277,76,201,43,1
367024,31,11,20,44,1
367024,246,65,181,45,1
367024,1,0,1,51,1
367024,44,12,32,52,3
367024,90,21,69,59,1
367024,156,44,112,60,1
367051,111,2,109,1,4
367051,111,2,109,2,1
367051,111,2,109,3,1
367051,46,1,45,4,1
367051,65,1,64,5,1
367051,65,1,64,20,1
367051,58,2,56,21,4
367051,58,2,56,22,1
367051,58,2,56,23,1
367051,19,1,18,24,1
367051,39,1,38,25,1
367051,39,1,38,40,1
367051,53,0,53,41,4
367051,53,0,53,42,1
367051,53,0,53,43,1
367051,27,0,27,44,1
367051,26,0,26,45,1
367051,26,0,26,60,1
367088,74,2,72,1,4
367088,74,2,72,2,1
367088,74,2,72,3,1
367088,25,2,23,4,1
367088,49,0,49,5,1
367088,49,0,49,20,1
367088,74,2,72,21,4
367088,74,2,72,22,1
367088,74,2,72,23,1
367088,25,2,23,24,1
367088,49,0,49,25,1
367088,49,0,49,40,1
367097,113,39,74,1,4
367097,113,39,74,2,1
367097,113,39,74,3,1
367097,47,16,31,4,1
367097,66,23,43,5,1
367097,66,23,43,20,1
367097,113,39,74,21,4
367097,113,39,74,22,1
367097,113,39,74,23,1
367097,47,16,31,24,1
367097,66,23,43,25,1
367097,66,23,43,40,1
367103,30,9,21,1,4
367103,30,9,21,2,1
367103,30,9,21,3,1
367103,5,0,5,4,1
367103,25,9,16,5,1
367103,25,9,16,20,1
367103,30,9,21,21,4
367103,30,9,21,22,1
367103,30,9,21,23,1
367103,5,0,5,24,1
367103,25,9,16,25,1
367103,25,9,16,40,1
367112,580,112,468,1,4
367112,580,112,468,2,1
367112,580,112,468,3,1
367112,125,28,97,4,1
367112,455,84,371,5,1
367112,66,15,51,19,1
367112,389,69,320,20,1
367112,382,75,307,21,4
367112,382,75,307,22,1
367112,382,75,307,23,1
367112,107,22,85,24,1
367112,275,53,222,25,1
367112,26,8,18,39,1
367112,249,45,204,40,1
367112,198,37,161,41,4
367112,198,37,161,42,1
367112,198,37,161,43,1
367112,18,6,12,44,1
367112,180,31,149,45,1
367112,40,7,33,59,1
367112,140,24,116,60,1
367130,116,7,109,1,4
367130,116,7,109,2,1
367130,116,7,109,3,1
367130,39,3,36,4,1
367130,77,4,73,5,1
367130,77,4,73,20,1
367130,78,5,73,21,4
367130,78,5,73,22,1
367130,78,5,73,23,1
367130,30,3,27,24,1
367130,48,2,46,25,1
367130,48,2,46,40,1
367130,38,2,36,41,4
367130,38,2,36,42,1
367130,38,2,36,43,1
367130,9,0,9,44,1
367130,29,2,27,45,1
367130,29,2,27,60,1
367158,80,2,78,1,4
367158,80,2,78,2,1
367158,80,2,78,3,1
367158,17,1,16,4,1
367158,63,1,62,5,1
367158,63,1,62,20,1
367158,80,2,78,21,4
367158,80,2,78,22,1
367158,80,2,78,23,1
367158,17,1,16,24,1
367158,63,1,62,25,1
367158,63,1,62,40,1
367194,596,445,151,1,4
367194,576,430,146,2,1
367194,556,419,137,3,1
367194,101,74,27,4,1
367194,455,345,110,5,1
367194,20,11,9,11,1
367194,20,15,5,12,3
367194,94,69,25,19,1
367194,361,276,85,20,1
367194,393,292,101,21,4
367194,381,283,98,22,1
367194,381,283,98,23,1
367194,87,65,22,24,1
367194,294,218,76,25,1
367194,12,9,3,32,3
367194,62,43,19,39,1
367194,232,175,57,40,1
367194,203,153,50,41,4
367194,195,147,48,42,1
367194,175,136,39,43,1
367194,14,9,5,44,1
367194,161,127,34,45,1
367194,20,11,9,51,1
367194,8,6,2,52,3
367194,32,26,6,59,1
367194,129,101,28,60,1
367316,177,16,161,1,4
367316,177,16,161,2,1
367316,177,16,161,3,1
367316,107,12,95,4,1
367316,70,4,66,5,1
367316,70,4,66,20,1
367316,177,16,161,21,4
367316,177,16,161,22,1
367316,177,16,161,23,1
367316,107,12,95,24,1
367316,70,4,66,25,1
367316,70,4,66,40,1
367334,179,164,15,1,4
367334,179,164,15,2,1
367334,179,164,15,3,1
367334,125,117,8,4,1
367334,54,47,7,5,1
367334,54,47,7,20,1
367334,114,105,9,21,4
367334,114,105,9,22,1
367334,114,105,9,23,1
367334,83,78,5,24,1
367334,31,27,4,25,1
367334,31,27,4,40,1
367334,65,59,6,41,4
367334,65,59,6,42,1
367334,65,59,6,43,1
367334,42,39,3,44,1
367334,23,20,3,45,1
367334,23,20,3,60,1
367361,31,9,22,1,4
367361,31,9,22,2,1
367361,30,9,21,3,1
367361,12,3,9,4,1
367361,18,6,12,5,1
367361,1,0,1,11,1
367361,18,6,12,20,1
367361,30,9,21,21,4
367361,30,9,21,22,1
367361,30,9,21,23,1
367361,12,3,9,24,1
367361,18,6,12,25,1
367361,18,6,12,40,1
367361,1,0,1,41,4
367361,1,0,1,42,1
367361,1,0,1,51,1
367398,267,52,215,1,4
367398,267,52,215,2,1
367398,267,52,215,3,1
367398,214,42,172,4,1
367398,53,10,43,5,1
367398,53,10,43,20,1
367398,154,29,125,21,4
367398,154,29,125,22,1
367398,154,29,125,23,1
367398,118,22,96,24,1
367398,36,7,29,25,1
367398,36,7,29,40,1
367398,113,23,90,41,4
367398,113,23,90,42,1
367398,113,23,90,43,1
367398,96,20,76,44,1
367398,17,3,14,45,1
367398,17,3,14,60,1
367431,34,5,29,1,4
367431,34,5,29,2,1
367431,34,5,29,3,1
367431,23,3,20,4,1
367431,11,2,9,5,1
367431,11,2,9,20,1
367431,34,5,29,21,4
367431,34,5,29,22,1
367431,34,5,29,23,1
367431,23,3,20,24,1
367431,11,2,9,25,1
367431,11,2,9,40,1
367459,8020,3353,4667,1,4
367459,8020,3353,4667,2,1
367459,6698,2811,3887,3,1
367459,1559,716,843,4,1
367459,5139,2095,3044,5,1
367459,1322,542,780,11,1
367459,566,244,322,19,1
367459,4573,1851,2722,20,1
367459,2843,1322,1521,21,4
367459,2843,1322,1521,22,1
367459,2752,1265,1487,23,1
367459,952,449,503,24,1
367459,1800,816,984,25,1
367459,91,57,34,31,1
367459,253,127,126,39,1
367459,1547,689,858,40,1
367459,5177,2031,3146,41,4
367459,5177,2031,3146,42,1
367459,3946,1546,2400,43,1
367459,607,267,340,44,1
367459,3339,1279,2060,45,1
367459,1231,485,746,51,1
367459,313,117,196,59,1
367459,3026,1162,1864,60,1
367662,55,1,54,1,4
367662,55,1,54,2,1
367662,55,1,54,3,1
367662,51,1,50,4,1
367662,4,0,4,5,1
367662,4,0,4,20,1
367662,7,0,7,21,4
367662,7,0,7,22,1
367662,7,0,7,23,1
367662,6,0,6,24,1
367662,1,0,1,25,1
367662,1,0,1,40,1
367662,48,1,47,41,4
367662,48,1,47,42,1
367662,48,1,47,43,1
367662,45,1,44,44,1
367662,3,0,3,45,1
367662,3,0,3,60,1
367839,375,153,222,1,4
367839,343,145,198,2,1
367839,343,145,198,3,1
367839,35,18,17,4,1
367839,308,127,181,5,1
367839,32,8,24,12,3
367839,33,9,24,19,1
367839,275,118,157,20,1
367839,349,145,204,21,4
367839,329,138,191,22,1
367839,329,138,191,23,1
367839,32,15,17,24,1
367839,297,123,174,25,1
367839,20,7,13,32,3
367839,28,8,20,39,1
367839,269,115,154,40,1
367839,26,8,18,41,4
367839,14,7,7,42,1
367839,14,7,7,43,1
367839,3,3,0,44,1
367839,11,4,7,45,1
367839,12,1,11,52,3
367839,5,1,4,59,1
367839,6,3,3,60,1
367875,202,97,105,1,4
367875,202,97,105,2,1
367875,202,97,105,3,1
367875,87,38,49,4,1
367875,115,59,56,5,1
367875,115,59,56,20,1
367875,202,97,105,21,4
367875,202,97,105,22,1
367875,202,97,105,23,1
367875,87,38,49,24,1
367875,115,59,56,25,1
367875,115,59,56,40,1
367884,2078,735,1343,1,4
367884,1877,677,1200,2,1
367884,1864,672,1192,3,1
367884,170,72,98,4,1
367884,1694,600,1094,5,1
367884,13,5,8,11,1
367884,201,58,143,12,3
367884,287,103,184,19,1
367884,1407,497,910,20,1
367884,1323,512,811,21,4
367884,1303,505,798,22,1
367884,1303,505,798,23,1
367884,145,61,84,24,1
367884,1158,444,714,25,1
367884,20,7,13,32,3
367884,221,85,136,39,1
367884,937,359,578,40,1
367884,755,223,532,41,4
367884,574,172,402,42,1
367884,561,167,394,43,1
367884,25,11,14,44,1
367884,536,156,380,45,1
367884,13,5,8,51,1
367884,181,51,130,52,3
367884,66,18,48,59,1
367884,470,138,332,60,1
367909,449,97,352,1,4
367909,449,97,352,2,1
367909,449,97,352,3,1
367909,44,11,33,4,1
367909,405,86,319,5,1
367909,58,14,44,19,1
367909,347,72,275,20,1
367909,319,63,256,21,4
367909,319,63,256,22,1
367909,319,63,256,23,1
367909,44,11,33,24,1
367909,275,52,223,25,1
367909,38,9,29,39,1
367909,237,43,194,40,1
367909,130,34,96,41,4
367909,130,34,96,42,1
367909,130,34,96,43,1
367909,130,34,96,45,1
367909,20,5,15,59,1
367909,110,29,81,60,1
367936,1920,447,1473,1,4
367936,435,132,303,2,1
367936,434,132,302,3,1
367936,51,19,32,4,1
367936,383,113,270,5,1
367936,1,0,1,11,1
367936,1485,315,1170,12,3
367936,103,24,79,19,1
367936,280,89,191,20,1
367936,236,58,178,21,4
367936,112,33,79,22,1
367936,112,33,79,23,1
367936,17,7,10,24,1
367936,95,26,69,25,1
367936,124,25,99,32,3
367936,32,8,24,39,1
367936,63,18,45,40,1
367936,1684,389,1295,41,4
367936,323,99,224,42,1
367936,322,99,223,43,1
367936,34,12,22,44,1
367936,288,87,201,45,1
367936,1,0,1,51,1
367936,1361,290,1071,52,3
367936,71,16,55,59,1
367936,217,71,146,60,1
367954,1705,637,1068,1,4
367954,1705,637,1068,12,3
367954,1363,503,860,21,4
367954,1363,503,860,32,3
367954,342,134,208,41,4
367954,342,134,208,52,3
367972,131,12,119,1,4
367972,131,12,119,2,1
367972,131,12,119,3,1
367972,30,1,29,4,1
367972,101,11,90,5,1
367972,101,11,90,20,1
367972,131,12,119,21,4
367972,131,12,119,22,1
367972,131,12,119,23,1
367972,30,1,29,24,1
367972,101,11,90,25,1
367972,101,11,90,40,1
367981,87,4,83,1,4
367981,87,4,83,2,1
367981,87,4,83,3,1
367981,3,0,3,4,1
367981,84,4,80,5,1
367981,84,4,80,20,1
367981,36,1,35,21,4
367981,36,1,35,22,1
367981,36,1,35,23,1
367981,2,0,2,24,1
367981,34,1,33,25,1
367981,34,1,33,40,1
367981,51,3,48,41,4
367981,51,3,48,42,1
367981,51,3,48,43,1
367981,1,0,1,44,1
367981,50,3,47,45,1
367981,50,3,47,60,1
368036,30,6,24,1,4
368036,30,6,24,2,1
368036,30,6,24,3,1
368036,16,4,12,4,1
368036,14,2,12,5,1
368036,14,2,12,20,1
368036,30,6,24,21,4
368036,30,6,24,22,1
368036,30,6,24,23,1
368036,16,4,12,24,1
368036,14,2,12,25,1
368036,14,2,12,40,1
368230,180,21,159,1,4
368230,180,21,159,2,1
368230,180,21,159,3,1
368230,65,9,56,4,1
368230,115,12,103,5,1
368230,115,12,103,20,1
368230,134,17,117,21,4
368230,134,17,117,22,1
368230,134,17,117,23,1
368230,57,9,48,24,1
368230,77,8,69,25,1
368230,77,8,69,40,1
368230,46,4,42,41,4
368230,46,4,42,42,1
368230,46,4,42,43,1
368230,8,0,8,44,1
368230,38,4,34,45,1
368230,38,4,34,60,1
368364,104,44,60,1,4
368364,104,44,60,2,1
368364,104,44,60,3,1
368364,77,35,42,4,1
368364,27,9,18,5,1
368364,27,9,18,20,1
368364,74,30,44,21,4
368364,74,30,44,22,1
368364,74,30,44,23,1
368364,52,23,29,24,1
368364,22,7,15,25,1
368364,22,7,15,40,1
368364,30,14,16,41,4
368364,30,14,16,42,1
368364,30,14,16,43,1
368364,25,12,13,44,1
368364,5,2,3,45,1
368364,5,2,3,60,1
368407,90,8,82,1,4
368407,90,8,82,2,1
368407,90,8,82,3,1
368407,25,3,22,4,1
368407,65,5,60,5,1
368407,65,5,60,20,1
368407,64,6,58,21,4
368407,64,6,58,22,1
368407,64,6,58,23,1
368407,20,3,17,24,1
368407,44,3,41,25,1
368407,44,3,41,40,1
368407,26,2,24,41,4
368407,26,2,24,42,1
368407,26,2,24,43,1
368407,5,0,5,44,1
368407,21,2,19,45,1
368407,21,2,19,60,1
368443,497,142,355,1,4
368443,497,142,355,2,1
368443,497,142,355,3,1
368443,50,12,38,4,1
368443,447,130,317,5,1
368443,105,28,77,19,1
368443,342,102,240,20,1
368443,433,122,311,21,4
368443,433,122,311,22,1
368443,433,122,311,23,1
368443,45,11,34,24,1
368443,388,111,277,25,1
368443,102,28,74,39,1
368443,286,83,203,40,1
368443,64,20,44,41,4
368443,64,20,44,42,1
368443,64,20,44,43,1
368443,5,1,4,44,1
368443,59,19,40,45,1
368443,3,0,3,59,1
368443,56,19,37,60,1
368452,279,128,151,1,4
368452,279,128,151,2,1
368452,279,128,151,3,1
368452,83,29,54,4,1
368452,196,99,97,5,1
368452,19,11,8,19,1
368452,177,88,89,20,1
368452,279,128,151,21,4
368452,279,128,151,22,1
368452,279,128,151,23,1
368452,83,29,54,24,1
368452,196,99,97,25,1
368452,19,11,8,39,1
368452,177,88,89,40,1
368540,38,3,35,1,4
368540,38,3,35,2,1
368540,38,3,35,3,1
368540,8,0,8,4,1
368540,30,3,27,5,1
368540,30,3,27,20,1
368540,38,3,35,21,4
368540,38,3,35,22,1
368540,38,3,35,23,1
368540,8,0,8,24,1
368540,30,3,27,25,1
368540,30,3,27,40,1
368601,720,507,213,1,4
368601,720,507,213,2,1
368601,720,507,213,3,1
368601,114,72,42,4,1
368601,606,435,171,5,1
368601,15,10,5,19,1
368601,591,425,166,20,1
368601,578,419,159,21,4
368601,578,419,159,22,1
368601,578,419,159,23,1
368601,93,56,37,24,1
368601,485,363,122,25,1
368601,10,6,4,39,1
368601,475,357,118,40,1
368601,142,88,54,41,4
368601,142,88,54,42,1
368601,142,88,54,43,1
368601,21,16,5,44,1
368601,121,72,49,45,1
368601,5,4,1,59,1
368601,116,68,48,60,1
368629,787,177,610,1,4
368629,787,177,610,2,1
368629,787,177,610,3,1
368629,228,44,184,4,1
368629,559,133,426,5,1
368629,559,133,426,20,1
368629,787,177,610,21,4
368629,787,177,610,22,1
368629,787,177,610,23,1
368629,228,44,184,24,1
368629,559,133,426,25,1
368629,559,133,426,40,1
368647,25,0,25,1,4
368647,25,0,25,2,1
368647,25,0,25,3,1
368647,25,0,25,5,1
368647,25,0,25,20,1
368647,25,0,25,21,4
368647,25,0,25,22,1
368647,25,0,25,23,1
368647,25,0,25,25,1
368647,25,0,25,40,1
368771,111,29,82,1,4
368771,111,29,82,2,1
368771,111,29,82,3,1
368771,5,2,3,4,1
368771,106,27,79,5,1
368771,106,27,79,20,1
368771,111,29,82,21,4
368771,111,29,82,22,1
368771,111,29,82,23,1
368771,5,2,3,24,1
368771,106,27,79,25,1
368771,106,27,79,40,1
368780,396,127,269,1,4
368780,396,127,269,2,1
368780,396,127,269,3,1
368780,124,50,74,4,1
368780,272,77,195,5,1
368780,272,77,195,20,1
368780,396,127,269,21,4
368780,396,127,269,22,1
368780,396,127,269,23,1
368780,124,50,74,24,1
368780,272,77,195,25,1
368780,272,77,195,40,1
368805,422,107,315,1,4
368805,422,107,315,2,1
368805,422,107,315,3,1
368805,51,14,37,4,1
368805,371,93,278,5,1
368805,31,7,24,19,1
368805,340,86,254,20,1
368805,378,91,287,21,4
368805,378,91,287,22,1
368805,378,91,287,23,1
368805,51,14,37,24,1
368805,327,77,250,25,1
368805,28,6,22,39,1
368805,299,71,228,40,1
368805,44,16,28,41,4
368805,44,16,28,42,1
368805,44,16,28,43,1
368805,44,16,28,45,1
368805,3,1,2,59,1
368805,41,15,26,60,1
368832,40,5,35,1,4
368832,40,5,35,2,1
368832,40,5,35,3,1
368832,12,1,11,4,1
368832,28,4,24,5,1
368832,28,4,24,20,1
368832,26,4,22,21,4
368832,26,4,22,22,1
368832,26,4,22,23,1
368832,7,1,6,24,1
368832,19,3,16,25,1
368832,19,3,16,40,1
368832,14,1,13,41,4
368832,14,1,13,42,1
368832,14,1,13,43,1
368832,5,0,5,44,1
368832,9,1,8,45,1
368832,9,1,8,60,1
368911,1533,409,1124,1,4
368911,1533,409,1124,2,1
368911,1351,358,993,3,1
368911,287,115,172,4,1
368911,1064,243,821,5,1
368911,182,51,131,11,1
368911,139,42,97,19,1
368911,925,201,724,20,1
368911,442,152,290,21,4
368911,442,152,290,22,1
368911,427,147,280,23,1
368911,99,47,52,24,1
368911,328,100,228,25,1
368911,15,5,10,31,1
368911,56,20,36,39,1
368911,272,80,192,40,1
368911,1091,257,834,41,4
368911,1091,257,834,42,1
368911,924,211,713,43,1
368911,188,68,120,44,1
368911,736,143,593,45,1
368911,167,46,121,51,1
368911,83,22,61,59,1
368911,653,121,532,60,1
369002,529,262,267,1,4
369002,529,262,267,12,3
369002,269,134,135,21,4
369002,269,134,135,32,3
369002,260,128,132,41,4
369002,260,128,132,52,3
369084,476,291,185,1,4
369084,476,291,185,2,1
369084,476,291,185,3,1
369084,55,30,25,4,1
369084,421,261,160,5,1
369084,25,16,9,19,1
369084,396,245,151,20,1
369084,350,219,131,21,4
369084,350,219,131,22,1
369084,350,219,131,23,1
369084,53,30,23,24,1
369084,297,189,108,25,1
369084,21,14,7,39,1
369084,276,175,101,40,1
369084,126,72,54,41,4
369084,126,72,54,42,1
369084,126,72,54,43,1
369084,2,0,2,44,1
369084,124,72,52,45,1
369084,4,2,2,59,1
369084,120,70,50,60,1
369109,106,15,91,1,4
369109,106,15,91,2,1
369109,106,15,91,3,1
369109,26,5,21,4,1
369109,80,10,70,5,1
369109,80,10,70,20,1
369109,47,11,36,21,4
369109,47,11,36,22,1
369109,47,11,36,23,1
369109,24,5,19,24,1
369109,23,6,17,25,1
369109,23,6,17,40,1
369109,59,4,55,41,4
369109,59,4,55,42,1
369109,59,4,55,43,1
369109,2,0,2,44,1
369109,57,4,53,45,1
369109,57,4,53,60,1
369400,3208,3125,83,1,4
369400,3208,3125,83,2,1
369400,3208,3125,83,3,1
369400,648,633,15,4,1
369400,2560,2492,68,5,1
369400,2560,2492,68,20,1
369400,3208,3125,83,21,4
369400,3208,3125,83,22,1
369400,3208,3125,83,23,1
369400,648,633,15,24,1
369400,2560,2492,68,25,1
369400,2560,2492,68,40,1
369419,840,397,443,1,4
369419,840,397,443,2,1
369419,840,397,443,3,1
369419,703,339,364,4,1
369419,137,58,79,5,1
369419,137,58,79,20,1
369419,840,397,443,21,4
369419,840,397,443,22,1
369419,840,397,443,23,1
369419,703,339,364,24,1
369419,137,58,79,25,1
369419,137,58,79,40,1
369446,80,6,74,1,4
369446,80,6,74,2,1
369446,80,6,74,3,1
369446,10,1,9,4,1
369446,70,5,65,5,1
369446,70,5,65,20,1
369446,38,3,35,21,4
369446,38,3,35,22,1
369446,38,3,35,23,1
369446,7,0,7,24,1
369446,31,3,28,25,1
369446,31,3,28,40,1
369446,42,3,39,41,4
369446,42,3,39,42,1
369446,42,3,39,43,1
369446,3,1,2,44,1
369446,39,2,37,45,1
369446,39,2,37,60,1
369455,108,52,56,1,4
369455,108,52,56,2,1
369455,108,52,56,3,1
369455,108,52,56,5,1
369455,108,52,56,19,1
369455,108,52,56,21,4
369455,108,52,56,22,1
369455,108,52,56,23,1
369455,108,52,56,25,1
369455,108,52,56,39,1
369516,448,151,297,1,4
369516,431,144,287,2,1
369516,431,144,287,3,1
369516,51,22,29,4,1
369516,380,122,258,5,1
369516,17,7,10,12,3
369516,67,20,47,19,1
369516,313,102,211,20,1
369516,448,151,297,21,4
369516,431,144,287,22,1
369516,431,144,287,23,1
369516,51,22,29,24,1
369516,380,122,258,25,1
369516,17,7,10,32,3
369516,67,20,47,39,1
369516,313,102,211,40,1
369659,224,54,170,1,4
369659,224,54,170,12,3
369659,204,48,156,21,4
369659,204,48,156,32,3
369659,20,6,14,41,4
369659,20,6,14,52,3
369668,197,75,122,1,4
369668,197,75,122,2,1
369668,195,75,120,3,1
369668,176,75,101,4,1
369668,19,0,19,5,1
369668,2,0,2,11,1
369668,19,0,19,20,1
369668,178,75,103,21,4
369668,178,75,103,22,1
369668,176,75,101,23,1
369668,176,75,101,24,1
369668,2,0,2,31,1
369668,19,0,19,41,4
369668,19,0,19,42,1
369668,19,0,19,43,1
369668,19,0,19,45,1
369668,19,0,19,60,1
369686,169,15,154,1,4
369686,169,15,154,2,1
369686,169,15,154,3,1
369686,95,11,84,4,1
369686,74,4,70,5,1
369686,74,4,70,20,1
369686,169,15,154,21,4
369686,169,15,154,22,1
369686,169,15,154,23,1
369686,95,11,84,24,1
369686,74,4,70,25,1
369686,74,4,70,40,1
369695,98,8,90,1,4
369695,98,8,90,2,1
369695,98,8,90,3,1
369695,27,1,26,4,1
369695,71,7,64,5,1
369695,71,7,64,20,1
369695,98,8,90,21,4
369695,98,8,90,22,1
369695,98,8,90,23,1
369695,27,1,26,24,1
369695,71,7,64,25,1
369695,71,7,64,40,1
369783,521,47,474,1,4
369783,521,47,474,2,1
369783,521,47,474,3,1
369783,100,8,92,4,1
369783,421,39,382,5,1
369783,421,39,382,20,1
369783,521,47,474,21,4
369783,521,47,474,22,1
369783,521,47,474,23,1
369783,100,8,92,24,1
369783,421,39,382,25,1
369783,421,39,382,40,1
369792,17,6,11,1,4
369792,17,6,11,2,1
369792,17,6,11,3,1
369792,17,6,11,5,1
369792,17,6,11,20,1
369792,17,6,11,21,4
369792,17,6,11,22,1
369792,17,6,11,23,1
369792,17,6,11,25,1
369792,17,6,11,40,1
369817,81,50,31,1,4
369817,81,50,31,12,3
369817,3,1,2,21,4
369817,3,1,2,32,3
369817,78,49,29,41,4
369817,78,49,29,52,3
369862,304,46,258,1,4
369862,304,46,258,2,1
369862,304,46,258,3,1
369862,97,19,78,4,1
369862,207,27,180,5,1
369862,32,4,28,19,1
369862,175,23,152,20,1
369862,183,27,156,21,4
369862,183,27,156,22,1
369862,183,27,156,23,1
369862,62,12,50,24,1
369862,121,15,106,25,1
369862,18,4,14,39,1
369862,103,11,92,40,1
369862,121,19,102,41,4
369862,121,19,102,42,1
369862,121,19,102,43,1
369862,35,7,28,44,1
369862,86,12,74,45,1
369862,14,0,14,59,1
369862,72,12,60,60,1
369905,614,104,510,1,4
369905,614,104,510,2,1
369905,613,103,510,3,1
369905,32,10,22,4,1
369905,581,93,488,5,1
369905,1,1,0,11,1
369905,93,10,83,19,1
369905,488,83,405,20,1
369905,237,46,191,21,4
369905,237,46,191,22,1
369905,237,46,191,23,1
369905,21,5,16,24,1
369905,216,41,175,25,1
369905,37,4,33,39,1
369905,179,37,142,40,1
369905,377,58,319,41,4
369905,377,58,319,42,1
369905,376,57,319,43,1
369905,11,5,6,44,1
369905,365,52,313,45,1
369905,1,1,0,51,1
369905,56,6,50,59,1
369905,309,46,263,60,1
369950,187,164,23,1,4
369950,187,164,23,2,1
369950,187,164,23,3,1
369950,29,27,2,4,1
369950,158,137,21,5,1
369950,158,137,21,20,1
369950,187,164,23,21,4
369950,187,164,23,22,1
369950,187,164,23,23,1
369950,29,27,2,24,1
369950,158,137,21,25,1
369950,158,137,21,40,1
371034,26,10,16,1,4
371034,26,10,16,2,1
371034,26,10,16,3,1
371034,16,5,11,4,1
371034,10,5,5,5,1
371034,10,5,5,20,1
371034,26,10,16,21,4
371034,26,10,16,22,1
371034,26,10,16,23,1
371034,16,5,11,24,1
371034,10,5,5,25,1
371034,10,5,5,40,1
371052,359,33,326,1,4
371052,359,33,326,2,1
371052,359,33,326,3,1
371052,59,3,56,4,1
371052,300,30,270,5,1
371052,69,9,60,19,1
371052,231,21,210,20,1
371052,359,33,326,21,4
371052,359,33,326,22,1
371052,359,33,326,23,1
371052,59,3,56,24,1
371052,300,30,270,25,1
371052,69,9,60,39,1
371052,231,21,210,40,1
371140,36,1,35,1,4
371140,36,1,35,2,1
371140,36,1,35,3,1
371140,19,0,19,4,1
371140,17,1,16,5,1
371140,17,1,16,20,1
371140,28,1,27,21,4
371140,28,1,27,22,1
371140,28,1,27,23,1
371140,14,0,14,24,1
371140,14,1,13,25,1
371140,14,1,13,40,1
371140,8,0,8,41,4
371140,8,0,8,42,1
371140,8,0,8,43,1
371140,5,0,5,44,1
371140,3,0,3,45,1
371140,3,0,3,60,1
371265,782,191,591,1,4
371265,782,191,591,2,1
371265,782,191,591,3,1
371265,136,28,108,4,1
371265,646,163,483,5,1
371265,646,163,483,20,1
371265,782,191,591,21,4
371265,782,191,591,22,1
371265,782,191,591,23,1
371265,136,28,108,24,1
371265,646,163,483,25,1
371265,646,163,483,40,1
371690,1317,240,1077,1,4
371690,1317,240,1077,2,1
371690,1317,240,1077,3,1
371690,514,111,403,4,1
371690,803,129,674,5,1
371690,803,129,674,20,1
371690,579,100,479,21,4
371690,579,100,479,22,1
371690,579,100,479,23,1
371690,407,77,330,24,1
371690,172,23,149,25,1
371690,172,23,149,40,1
371690,738,140,598,41,4
371690,738,140,598,42,1
371690,738,140,598,43,1
371690,107,34,73,44,1
371690,631,106,525,45,1
371690,631,106,525,60,1
371760,1418,440,978,1,4
371760,1418,440,978,2,1
371760,1409,437,972,3,1
371760,168,62,106,4,1
371760,1241,375,866,5,1
371760,9,3,6,11,1
371760,112,34,78,19,1
371760,1129,341,788,20,1
371760,1011,316,695,21,4
371760,1011,316,695,22,1
371760,1010,315,695,23,1
371760,114,43,71,24,1
371760,896,272,624,25,1
371760,1,1,0,31,1
371760,57,18,39,39,1
371760,839,254,585,40,1
371760,407,124,283,41,4
371760,407,124,283,42,1
371760,399,122,277,43,1
371760,54,19,35,44,1
371760,345,103,242,45,1
371760,8,2,6,51,1
371760,55,16,39,59,1
371760,290,87,203,60,1
371779,1249,377,872,1,4
371779,1249,377,872,2,1
371779,1244,375,869,3,1
371779,135,39,96,4,1
371779,1109,336,773,5,1
371779,5,2,3,11,1
371779,91,29,62,19,1
371779,1018,307,711,20,1
371779,823,244,579,21,4
371779,823,244,579,22,1
371779,823,244,579,23,1
371779,75,20,55,24,1
371779,748,224,524,25,1
371779,45,15,30,39,1
371779,703,209,494,40,1
371779,426,133,293,41,4
371779,426,133,293,42,1
371779,421,131,290,43,1
371779,60,19,41,44,1
371779,361,112,249,45,1
371779,5,2,3,51,1
371779,46,14,32,59,1
371779,315,98,217,60,1
371830,55,33,22,1,4
371830,55,33,22,2,1
371830,55,33,22,3,1
371830,27,18,9,4,1
371830,28,15,13,5,1
371830,28,15,13,20,1
371830,31,17,14,21,4
371830,31,17,14,22,1
371830,31,17,14,23,1
371830,17,11,6,24,1
371830,14,6,8,25,1
371830,14,6,8,40,1
371830,24,16,8,41,4
371830,24,16,8,42,1
371830,24,16,8,43,1
371830,10,7,3,44,1
371830,14,9,5,45,1
371830,14,9,5,60,1
371928,83,36,47,1,4
371928,83,36,47,2,1
371928,83,36,47,3,1
371928,37,14,23,4,1
371928,46,22,24,5,1
371928,46,22,24,20,1
371928,83,36,47,21,4
371928,83,36,47,22,1
371928,83,36,47,23,1
371928,37,14,23,24,1
371928,46,22,24,25,1
371928,46,22,24,40,1
371964,51,28,23,1,4
371964,51,28,23,2,1
371964,51,28,23,3,1
371964,49,26,23,4,1
371964,2,2,0,5,1
371964,2,2,0,20,1
371964,51,28,23,21,4
371964,51,28,23,22,1
371964,51,28,23,23,1
371964,49,26,23,24,1
371964,2,2,0,25,1
371964,2,2,0,40,1
371982,574,145,429,1,4
371982,574,145,429,2,1
371982,574,145,429,3,1
371982,71,17,54,4,1
371982,503,128,375,5,1
371982,54,8,46,19,1
371982,449,120,329,20,1
371982,510,123,387,21,4
371982,510,123,387,22,1
371982,510,123,387,23,1
371982,71,17,54,24,1
371982,439,106,333,25,1
371982,53,7,46,39,1
371982,386,99,287,40,1
371982,64,22,42,41,4
371982,64,22,42,42,1
371982,64,22,42,43,1
371982,64,22,42,45,1
371982,1,1,0,59,1
371982,63,21,42,60,1
372000,77,6,71,1,4
372000,77,6,71,2,1
372000,77,6,71,3,1
372000,27,2,25,4,1
372000,50,4,46,5,1
372000,50,4,46,20,1
372000,65,5,60,21,4
372000,65,5,60,22,1
372000,65,5,60,23,1
372000,17,2,15,24,1
372000,48,3,45,25,1
372000,48,3,45,40,1
372000,12,1,11,41,4
372000,12,1,11,42,1
372000,12,1,11,43,1
372000,10,0,10,44,1
372000,2,1,1,45,1
372000,2,1,1,60,1
372028,177,25,152,1,4
372028,177,25,152,2,1
372028,177,25,152,3,1
372028,50,9,41,4,1
372028,127,16,111,5,1
372028,127,16,111,20,1
372028,177,25,152,21,4
372028,177,25,152,22,1
372028,177,25,152,23,1
372028,50,9,41,24,1
372028,127,16,111,25,1
372028,127,16,111,40,1
372037,1029,289,740,1,4
372037,1029,289,740,2,1
372037,1029,289,740,3,1
372037,142,33,109,4,1
372037,887,256,631,5,1
372037,102,24,78,19,1
372037,785,232,553,20,1
372037,953,261,692,21,4
372037,953,261,692,22,1
372037,953,261,692,23,1
372037,140,33,107,24,1
372037,813,228,585,25,1
372037,96,21,75,39,1
372037,717,207,510,40,1
372037,76,28,48,41,4
372037,76,28,48,42,1
372037,76,28,48,43,1
372037,2,0,2,44,1
372037,74,28,46,45,1
372037,6,3,3,59,1
372037,68,25,43,60,1
372073,344,137,207,1,4
372073,344,137,207,2,1
372073,344,137,207,3,1
372073,54,23,31,4,1
372073,290,114,176,5,1
372073,67,22,45,19,1
372073,223,92,131,20,1
372073,344,137,207,21,4
372073,344,137,207,22,1
372073,344,137,207,23,1
372073,54,23,31,24,1
372073,290,114,176,25,1
372073,67,22,45,39,1
372073,223,92,131,40,1
372082,471,190,281,1,4
372082,471,190,281,2,1
372082,444,163,281,3,1
372082,44,15,29,4,1
372082,400,148,252,5,1
372082,27,27,0,11,1
372082,400,148,252,20,1
372082,251,101,150,21,4
372082,251,101,150,22,1
372082,251,101,150,23,1
372082,32,11,21,24,1
372082,219,90,129,25,1
372082,219,90,129,40,1
372082,220,89,131,41,4
372082,220,89,131,42,1
372082,193,62,131,43,1
372082,12,4,8,44,1
372082,181,58,123,45,1
372082,27,27,0,51,1
372082,181,58,123,60,1
372213,212044,64930,147114,1,4
372213,170144,53084,117060,2,1
372213,166816,51651,115165,3,1
372213,10685,3073,7612,4,1
372213,156131,48578,107553,5,1
372213,3328,1433,1895,11,1
372213,41900,11846,30054,12,3
372213,11422,4031,7391,19,1
372213,144709,44547,100162,20,1
372213,212044,64930,147114,21,4
372213,170144,53084,117060,22,1
372213,166816,51651,115165,23,1
372213,10685,3073,7612,24,1
372213,156131,48578,107553,25,1
372213,3328,1433,1895,31,1
372213,41900,11846,30054,32,3
372213,11422,4031,7391,39,1
372213,144709,44547,100162,40,1
372222,6122,3601,2521,1,4
372222,5340,3206,2134,2,1
372222,5339,3206,2133,3,1
372222,65,26,39,4,1
372222,5274,3180,2094,5,1
372222,1,0,1,11,1
372222,782,395,387,12,3
372222,472,285,187,19,1
372222,4802,2895,1907,20,1
372222,6122,3601,2521,21,4
372222,5340,3206,2134,22,1
372222,5339,3206,2133,23,1
372222,65,26,39,24,1
372222,5274,3180,2094,25,1
372222,1,0,1,31,1
372222,782,395,387,32,3
372222,472,285,187,39,1
372222,4802,2895,1907,40,1
372240,32,3,29,1,4
372240,32,3,29,2,1
372240,32,3,29,3,1
372240,14,2,12,4,1
372240,18,1,17,5,1
372240,18,1,17,20,1
372240,32,3,29,21,4
372240,32,3,29,22,1
372240,32,3,29,23,1
372240,14,2,12,24,1
372240,18,1,17,25,1
372240,18,1,17,40,1
372329,258,45,213,1,4
372329,258,45,213,2,1
372329,258,45,213,3,1
372329,232,33,199,4,1
372329,26,12,14,5,1
372329,26,12,14,20,1
372329,258,45,213,21,4
372329,258,45,213,22,1
372329,258,45,213,23,1
372329,232,33,199,24,1
372329,26,12,14,25,1
372329,26,12,14,40,1
372356,101,3,98,1,4
372356,101,3,98,2,1
372356,101,3,98,3,1
372356,14,0,14,4,1
372356,87,3,84,5,1
372356,87,3,84,20,1
372356,101,3,98,21,4
372356,101,3,98,22,1
372356,101,3,98,23,1
372356,14,0,14,24,1
372356,87,3,84,25,1
372356,87,3,84,40,1
372462,144,8,136,1,4
372462,144,8,136,2,1
372462,144,8,136,3,1
372462,10,0,10,4,1
372462,134,8,126,5,1
372462,134,8,126,20,1
372462,137,8,129,21,4
372462,137,8,129,22,1
372462,137,8,129,23,1
372462,10,0,10,24,1
372462,127,8,119,25,1
372462,127,8,119,40,1
372462,7,0,7,41,4
372462,7,0,7,42,1
372462,7,0,7,43,1
372462,7,0,7,45,1
372462,7,0,7,60,1
372578,269,147,122,1,4
372578,269,147,122,2,1
372578,269,147,122,3,1
372578,30,22,8,4,1
372578,239,125,114,5,1
372578,23,7,16,19,1
372578,216,118,98,20,1
372578,183,107,76,21,4
372578,183,107,76,22,1
372578,183,107,76,23,1
372578,27,19,8,24,1
372578,156,88,68,25,1
372578,8,2,6,39,1
372578,148,86,62,40,1
372578,86,40,46,41,4
372578,86,40,46,42,1
372578,86,40,46,43,1
372578,3,3,0,44,1
372578,83,37,46,45,1
372578,15,5,10,59,1
372578,68,32,36,60,1
372718,224,32,192,1,4
372718,224,32,192,2,1
372718,224,32,192,3,1
372718,30,5,25,4,1
372718,194,27,167,5,1
372718,194,27,167,20,1
372718,183,26,157,21,4
372718,183,26,157,22,1
372718,183,26,157,23,1
372718,27,5,22,24,1
372718,156,21,135,25,1
372718,156,21,135,40,1
372718,41,6,35,41,4
372718,41,6,35,42,1
372718,41,6,35,43,1
372718,3,0,3,44,1
372718,38,6,32,45,1
372718,38,6,32,60,1
372772,279,77,202,1,4
372772,279,77,202,2,1
372772,279,77,202,3,1
372772,66,20,46,4,1
372772,213,57,156,5,1
372772,14,2,12,19,1
372772,199,55,144,20,1
372772,279,77,202,21,4
372772,279,77,202,22,1
372772,279,77,202,23,1
372772,66,20,46,24,1
372772,213,57,156,25,1
372772,14,2,12,39,1
372772,199,55,144,40,1
372921,617,266,351,1,4
372921,617,266,351,2,1
372921,617,266,351,3,1
372921,119,58,61,4,1
372921,498,208,290,5,1
372921,73,22,51,19,1
372921,425,186,239,20,1
372921,617,266,351,21,4
372921,617,266,351,22,1
372921,617,266,351,23,1
372921,119,58,61,24,1
372921,498,208,290,25,1
372921,73,22,51,39,1
372921,425,186,239,40,1
372958,495,118,377,1,4
372958,495,118,377,2,1
372958,495,118,377,3,1
372958,144,28,116,4,1
372958,351,90,261,5,1
372958,1,0,1,19,1
372958,350,90,260,20,1
372958,495,118,377,21,4
372958,495,118,377,22,1
372958,495,118,377,23,1
372958,144,28,116,24,1
372958,351,90,261,25,1
372958,1,0,1,39,1
372958,350,90,260,40,1
373058,239,96,143,1,4
373058,239,96,143,2,1
373058,239,96,143,3,1
373058,39,18,21,4,1
373058,200,78,122,5,1
373058,20,5,15,19,1
373058,180,73,107,20,1
373058,239,96,143,21,4
373058,239,96,143,22,1
373058,239,96,143,23,1
373058,39,18,21,24,1
373058,200,78,122,25,1
373058,20,5,15,39,1
373058,180,73,107,40,1
373085,364,97,267,1,4
373085,364,97,267,2,1
373085,364,97,267,3,1
373085,62,25,37,4,1
373085,302,72,230,5,1
373085,20,8,12,19,1
373085,282,64,218,20,1
373085,364,97,267,21,4
373085,364,97,267,22,1
373085,364,97,267,23,1
373085,62,25,37,24,1
373085,302,72,230,25,1
373085,20,8,12,39,1
373085,282,64,218,40,1
373216,175,3,172,1,4
373216,175,3,172,2,1
373216,175,3,172,3,1
373216,122,1,121,4,1
373216,53,2,51,5,1
373216,53,2,51,20,1
373216,175,3,172,21,4
373216,175,3,172,22,1
373216,175,3,172,23,1
373216,122,1,121,24,1
373216,53,2,51,25,1
373216,53,2,51,40,1
373340,53,1,52,1,4
373340,53,1,52,2,1
373340,53,1,52,3,1
373340,6,0,6,4,1
373340,47,1,46,5,1
373340,47,1,46,20,1
373340,39,0,39,21,4
373340,39,0,39,22,1
373340,39,0,39,23,1
373340,6,0,6,24,1
373340,33,0,33,25,1
373340,33,0,33,40,1
373340,14,1,13,41,4
373340,14,1,13,42,1
373340,14,1,13,43,1
373340,14,1,13,45,1
373340,14,1,13,60,1
373526,256,221,35,1,4
373526,256,221,35,2,1
373526,256,221,35,3,1
373526,119,98,21,4,1
373526,137,123,14,5,1
373526,137,123,14,20,1
373526,256,221,35,21,4
373526,256,221,35,22,1
373526,256,221,35,23,1
373526,119,98,21,24,1
373526,137,123,14,25,1
373526,137,123,14,40,1
373605,36,2,34,1,4
373605,36,2,34,2,1
373605,36,2,34,3,1
373605,18,1,17,4,1
373605,18,1,17,5,1
373605,18,1,17,20,1
373605,36,2,34,21,4
373605,36,2,34,22,1
373605,36,2,34,23,1
373605,18,1,17,24,1
373605,18,1,17,25,1
373605,18,1,17,40,1
373678,168,84,84,1,4
373678,168,84,84,2,1
373678,168,84,84,3,1
373678,50,29,21,4,1
373678,118,55,63,5,1
373678,118,55,63,20,1
373678,117,60,57,21,4
373678,117,60,57,22,1
373678,117,60,57,23,1
373678,30,21,9,24,1
373678,87,39,48,25,1
373678,87,39,48,40,1
373678,51,24,27,41,4
373678,51,24,27,42,1
373678,51,24,27,43,1
373678,20,8,12,44,1
373678,31,16,15,45,1
373678,31,16,15,60,1
373696,176,87,89,1,4
373696,176,87,89,2,1
373696,176,87,89,3,1
373696,65,27,38,4,1
373696,111,60,51,5,1
373696,111,60,51,20,1
373696,176,87,89,21,4
373696,176,87,89,22,1
373696,176,87,89,23,1
373696,65,27,38,24,1
373696,111,60,51,25,1
373696,111,60,51,40,1
373711,59,1,58,1,4
373711,59,1,58,2,1
373711,59,1,58,3,1
373711,12,1,11,4,1
373711,47,0,47,5,1
373711,47,0,47,20,1
373711,59,1,58,21,4
373711,59,1,58,22,1
373711,59,1,58,23,1
373711,12,1,11,24,1
373711,47,0,47,25,1
373711,47,0,47,40,1
373784,1078,712,366,1,4
373784,1078,712,366,2,1
373784,1078,712,366,3,1
373784,200,143,57,4,1
373784,878,569,309,5,1
373784,878,569,309,20,1
373784,1078,712,366,21,4
373784,1078,712,366,22,1
373784,1078,712,366,23,1
373784,200,143,57,24,1
373784,878,569,309,25,1
373784,878,569,309,40,1
373827,457,356,101,1,4
373827,457,356,101,2,1
373827,456,355,101,3,1
373827,94,74,20,4,1
373827,362,281,81,5,1
373827,1,1,0,11,1
373827,22,20,2,19,1
373827,340,261,79,20,1
373827,429,334,95,21,4
373827,429,334,95,22,1
373827,429,334,95,23,1
373827,93,73,20,24,1
373827,336,261,75,25,1
373827,21,19,2,39,1
373827,315,242,73,40,1
373827,28,22,6,41,4
373827,28,22,6,42,1
373827,27,21,6,43,1
373827,1,1,0,44,1
373827,26,20,6,45,1
373827,1,1,0,51,1
373827,1,1,0,59,1
373827,25,19,6,60,1
373890,356,61,295,1,4
373890,356,61,295,2,1
373890,356,61,295,3,1
373890,75,18,57,4,1
373890,281,43,238,5,1
373890,281,43,238,20,1
373890,356,61,295,21,4
373890,356,61,295,22,1
373890,356,61,295,23,1
373890,75,18,57,24,1
373890,281,43,238,25,1
373890,281,43,238,40,1
374024,380,80,300,1,4
374024,380,80,300,12,3
374024,380,80,300,41,4
374024,380,80,300,52,3
374112,26,4,22,1,4
374112,26,4,22,2,1
374112,26,4,22,3,1
374112,6,2,4,4,1
374112,20,2,18,5,1
374112,20,2,18,20,1
374112,24,2,22,21,4
374112,24,2,22,22,1
374112,24,2,22,23,1
374112,4,0,4,24,1
374112,20,2,18,25,1
374112,20,2,18,40,1
374112,2,2,0,41,4
374112,2,2,0,42,1
374112,2,2,0,43,1
374112,2,2,0,44,1
374316,121,59,62,1,4
374316,121,59,62,2,1
374316,121,59,62,3,1
374316,7,2,5,4,1
374316,114,57,57,5,1
374316,114,57,57,20,1
374316,77,35,42,21,4
374316,77,35,42,22,1
374316,77,35,42,23,1
374316,4,1,3,24,1
374316,73,34,39,25,1
374316,73,34,39,40,1
374316,44,24,20,41,4
374316,44,24,20,42,1
374316,44,24,20,43,1
374316,3,1,2,44,1
374316,41,23,18,45,1
374316,41,23,18,60,1
374343,76,2,74,1,4
374343,76,2,74,2,1
374343,76,2,74,3,1
374343,25,2,23,4,1
374343,51,0,51,5,1
374343,51,0,51,20,1
374343,76,2,74,21,4
374343,76,2,74,22,1
374343,76,2,74,23,1
374343,25,2,23,24,1
374343,51,0,51,25,1
374343,51,0,51,40,1
374440,46,0,46,1,4
374440,46,0,46,2,1
374440,46,0,46,3,1
374440,17,0,17,4,1
374440,29,0,29,5,1
374440,29,0,29,20,1
374440,46,0,46,21,4
374440,46,0,46,22,1
374440,46,0,46,23,1
374440,17,0,17,24,1
374440,29,0,29,25,1
374440,29,0,29,40,1
374574,579,94,485,1,4
374574,579,94,485,2,1
374574,579,94,485,3,1
374574,154,19,135,4,1
374574,425,75,350,5,1
374574,425,75,350,20,1
374574,361,74,287,21,4
374574,361,74,287,22,1
374574,361,74,287,23,1
374574,101,15,86,24,1
374574,260,59,201,25,1
374574,260,59,201,40,1
374574,218,20,198,41,4
374574,218,20,198,42,1
374574,218,20,198,43,1
374574,53,4,49,44,1
374574,165,16,149,45,1
374574,165,16,149,60,1
374592,98,22,76,1,4
374592,98,22,76,2,1
374592,98,22,76,3,1
374592,96,22,74,4,1
374592,2,0,2,5,1
374592,2,0,2,20,1
374592,98,22,76,21,4
374592,98,22,76,22,1
374592,98,22,76,23,1
374592,96,22,74,24,1
374592,2,0,2,25,1
374592,2,0,2,40,1
374875,994,241,753,1,4
374875,994,241,753,2,1
374875,994,241,753,3,1
374875,187,41,146,4,1
374875,807,200,607,5,1
374875,75,24,51,19,1
374875,732,176,556,20,1
374875,994,241,753,21,4
374875,994,241,753,22,1
374875,994,241,753,23,1
374875,187,41,146,24,1
374875,807,200,607,25,1
374875,75,24,51,39,1
374875,732,176,556,40,1
374927,68,3,65,1,4
374927,68,3,65,2,1
374927,68,3,65,3,1
374927,33,0,33,4,1
374927,35,3,32,5,1
374927,35,3,32,20,1
374927,41,3,38,21,4
374927,41,3,38,22,1
374927,41,3,38,23,1
374927,21,0,21,24,1
374927,20,3,17,25,1
374927,20,3,17,40,1
374927,27,0,27,41,4
374927,27,0,27,42,1
374927,27,0,27,43,1
374927,12,0,12,44,1
374927,15,0,15,45,1
374927,15,0,15,60,1
374972,570,160,410,1,4
374972,570,160,410,2,1
374972,499,129,370,3,1
374972,51,19,32,4,1
374972,448,110,338,5,1
374972,71,31,40,11,1
374972,84,26,58,19,1
374972,364,84,280,20,1
374972,316,87,229,21,4
374972,316,87,229,22,1
374972,316,87,229,23,1
374972,45,17,28,24,1
374972,271,70,201,25,1
374972,62,19,43,39,1
374972,209,51,158,40,1
374972,254,73,181,41,4
374972,254,73,181,42,1
374972,183,42,141,43,1
374972,6,2,4,44,1
374972,177,40,137,45,1
374972,71,31,40,51,1
374972,22,7,15,59,1
374972,155,33,122,60,1
374990,78,5,73,1,4
374990,78,5,73,2,1
374990,78,5,73,3,1
374990,25,2,23,4,1
374990,53,3,50,5,1
374990,53,3,50,20,1
374990,51,5,46,21,4
374990,51,5,46,22,1
374990,51,5,46,23,1
374990,20,2,18,24,1
374990,31,3,28,25,1
374990,31,3,28,40,1
374990,27,0,27,41,4
374990,27,0,27,42,1
374990,27,0,27,43,1
374990,5,0,5,44,1
374990,22,0,22,45,1
374990,22,0,22,60,1
375106,89,77,12,1,4
375106,89,77,12,2,1
375106,89,77,12,3,1
375106,58,53,5,4,1
375106,31,24,7,5,1
375106,31,24,7,20,1
375106,81,69,12,21,4
375106,81,69,12,22,1
375106,81,69,12,23,1
375106,51,46,5,24,1
375106,30,23,7,25,1
375106,30,23,7,40,1
375106,8,8,0,41,4
375106,8,8,0,42,1
375106,8,8,0,43,1
375106,7,7,0,44,1
375106,1,1,0,45,1
375106,1,1,0,60,1
375230,125,125,0,1,4
375230,125,125,0,2,1
375230,125,125,0,3,1
375230,10,10,0,4,1
375230,115,115,0,5,1
375230,40,40,0,19,1
375230,75,75,0,20,1
375230,125,125,0,21,4
375230,125,125,0,22,1
375230,125,125,0,23,1
375230,10,10,0,24,1
375230,115,115,0,25,1
375230,40,40,0,39,1
375230,75,75,0,40,1
375300,135,12,123,1,4
375300,135,12,123,2,1
375300,135,12,123,3,1
375300,64,3,61,4,1
375300,71,9,62,5,1
375300,71,9,62,20,1
375300,135,12,123,21,4
375300,135,12,123,22,1
375300,135,12,123,23,1
375300,64,3,61,24,1
375300,71,9,62,25,1
375300,71,9,62,40,1
375319,64,5,59,1,4
375319,64,5,59,2,1
375319,64,5,59,3,1
375319,29,3,26,4,1
375319,35,2,33,5,1
375319,35,2,33,20,1
375319,64,5,59,21,4
375319,64,5,59,22,1
375319,64,5,59,23,1
375319,29,3,26,24,1
375319,35,2,33,25,1
375319,35,2,33,40,1
375373,252,78,174,1,4
375373,252,78,174,2,1
375373,252,78,174,3,1
375373,151,59,92,4,1
375373,101,19,82,5,1
375373,101,19,82,20,1
375373,252,78,174,21,4
375373,252,78,174,22,1
375373,252,78,174,23,1
375373,151,59,92,24,1
375373,101,19,82,25,1
375373,101,19,82,40,1
375407,145,45,100,1,4
375407,145,45,100,2,1
375407,145,45,100,3,1
375407,41,14,27,4,1
375407,104,31,73,5,1
375407,104,31,73,20,1
375407,114,34,80,21,4
375407,114,34,80,22,1
375407,114,34,80,23,1
375407,33,12,21,24,1
375407,81,22,59,25,1
375407,81,22,59,40,1
375407,31,11,20,41,4
375407,31,11,20,42,1
375407,31,11,20,43,1
375407,8,2,6,44,1
375407,23,9,14,45,1
375407,23,9,14,60,1
375416,438,110,328,1,4
375416,438,110,328,2,1
375416,438,110,328,3,1
375416,160,41,119,4,1
375416,278,69,209,5,1
375416,6,1,5,19,1
375416,272,68,204,20,1
375416,438,110,328,21,4
375416,438,110,328,22,1
375416,438,110,328,23,1
375416,160,41,119,24,1
375416,278,69,209,25,1
375416,6,1,5,39,1
375416,272,68,204,40,1
375489,448,64,384,1,4
375489,448,64,384,2,1
375489,448,64,384,3,1
375489,86,11,75,4,1
375489,362,53,309,5,1
375489,24,3,21,19,1
375489,338,50,288,20,1
375489,448,64,384,21,4
375489,448,64,384,22,1
375489,448,64,384,23,1
375489,86,11,75,24,1
375489,362,53,309,25,1
375489,24,3,21,39,1
375489,338,50,288,40,1
375540,111,4,107,1,4
375540,111,4,107,2,1
375540,111,4,107,3,1
375540,56,2,54,4,1
375540,55,2,53,5,1
375540,55,2,53,20,1
375540,42,1,41,21,4
375540,42,1,41,22,1
375540,42,1,41,23,1
375540,18,1,17,24,1
375540,24,0,24,25,1
375540,24,0,24,40,1
375540,69,3,66,41,4
375540,69,3,66,42,1
375540,69,3,66,43,1
375540,38,1,37,44,1
375540,31,2,29,45,1
375540,31,2,29,60,1
375568,18,0,18,1,4
375568,18,0,18,2,1
375568,18,0,18,3,1
375568,7,0,7,4,1
375568,11,0,11,5,1
375568,11,0,11,20,1
375568,8,0,8,21,4
375568,8,0,8,22,1
375568,8,0,8,23,1
375568,4,0,4,24,1
375568,4,0,4,25,1
375568,4,0,4,40,1
375568,10,0,10,41,4
375568,10,0,10,42,1
375568,10,0,10,43,1
375568,3,0,3,44,1
375568,7,0,7,45,1
375568,7,0,7,60,1
375647,47,10,37,1,4
375647,47,10,37,2,1
375647,47,10,37,3,1
375647,28,7,21,4,1
375647,19,3,16,5,1
375647,19,3,16,20,1
375647,47,10,37,21,4
375647,47,10,37,22,1
375647,47,10,37,23,1
375647,28,7,21,24,1
375647,19,3,16,25,1
375647,19,3,16,40,1
375656,164,61,103,1,4
375656,164,61,103,2,1
375656,96,28,68,3,1
375656,54,13,41,4,1
375656,42,15,27,5,1
375656,68,33,35,11,1
375656,42,15,27,20,1
375656,66,18,48,21,4
375656,66,18,48,22,1
375656,66,18,48,23,1
375656,36,7,29,24,1
375656,30,11,19,25,1
375656,30,11,19,40,1
375656,98,43,55,41,4
375656,98,43,55,42,1
375656,30,10,20,43,1
375656,18,6,12,44,1
375656,12,4,8,45,1
375656,68,33,35,51,1
375656,12,4,8,60,1
375683,923,593,330,1,4
375683,923,593,330,2,1
375683,923,593,330,3,1
375683,726,442,284,4,1
375683,197,151,46,5,1
375683,197,151,46,20,1
375683,204,160,44,21,4
375683,204,160,44,22,1
375683,204,160,44,23,1
375683,67,46,21,24,1
375683,137,114,23,25,1
375683,137,114,23,40,1
375683,719,433,286,41,4
375683,719,433,286,42,1
375683,719,433,286,43,1
375683,659,396,263,44,1
375683,60,37,23,45,1
375683,60,37,23,60,1
375692,123,64,59,1,4
375692,123,64,59,2,1
375692,26,7,19,3,1
375692,15,3,12,4,1
375692,11,4,7,5,1
375692,97,57,40,11,1
375692,11,4,7,20,1
375692,17,4,13,21,4
375692,17,4,13,22,1
375692,17,4,13,23,1
375692,8,1,7,24,1
375692,9,3,6,25,1
375692,9,3,6,40,1
375692,106,60,46,41,4
375692,106,60,46,42,1
375692,9,3,6,43,1
375692,7,2,5,44,1
375692,2,1,1,45,1
375692,97,57,40,51,1
375692,2,1,1,60,1
375708,288,154,134,1,4
375708,288,154,134,2,1
375708,288,154,134,3,1
375708,173,96,77,4,1
375708,115,58,57,5,1
375708,115,58,57,20,1
375708,73,19,54,21,4
375708,73,19,54,22,1
375708,73,19,54,23,1
375708,36,8,28,24,1
375708,37,11,26,25,1
375708,37,11,26,40,1
375708,215,135,80,41,4
375708,215,135,80,42,1
375708,215,135,80,43,1
375708,137,88,49,44,1
375708,78,47,31,45,1
375708,78,47,31,60,1
375717,101,53,48,1,4
375717,101,53,48,2,1
375717,60,21,39,3,1
375717,29,15,14,4,1
375717,31,6,25,5,1
375717,41,32,9,11,1
375717,31,6,25,20,1
375717,45,18,27,21,4
375717,45,18,27,22,1
375717,45,18,27,23,1
375717,22,13,9,24,1
375717,23,5,18,25,1
375717,23,5,18,40,1
375717,56,35,21,41,4
375717,56,35,21,42,1
375717,15,3,12,43,1
375717,7,2,5,44,1
375717,8,1,7,45,1
375717,41,32,9,51,1
375717,8,1,7,60,1
375726,195,87,108,1,4
375726,195,87,108,2,1
375726,195,87,108,3,1
375726,106,46,60,4,1
375726,89,41,48,5,1
375726,89,41,48,20,1
375726,107,52,55,21,4
375726,107,52,55,22,1
375726,107,52,55,23,1
375726,48,23,25,24,1
375726,59,29,30,25,1
375726,59,29,30,40,1
375726,88,35,53,41,4
375726,88,35,53,42,1
375726,88,35,53,43,1
375726,58,23,35,44,1
375726,30,12,18,45,1
375726,30,12,18,60,1
375735,75,28,47,1,4
375735,75,28,47,2,1
375735,75,28,47,3,1
375735,62,27,35,4,1
375735,13,1,12,5,1
375735,13,1,12,20,1
375735,40,16,24,21,4
375735,40,16,24,22,1
375735,40,16,24,23,1
375735,36,16,20,24,1
375735,4,0,4,25,1
375735,4,0,4,40,1
375735,35,12,23,41,4
375735,35,12,23,42,1
375735,35,12,23,43,1
375735,26,11,15,44,1
375735,9,1,8,45,1
375735,9,1,8,60,1
375744,246,168,78,1,4
375744,246,168,78,2,1
375744,246,168,78,3,1
375744,20,13,7,4,1
375744,226,155,71,5,1
375744,226,155,71,20,1
375744,102,60,42,21,4
375744,102,60,42,22,1
375744,102,60,42,23,1
375744,4,3,1,24,1
375744,98,57,41,25,1
375744,98,57,41,40,1
375744,144,108,36,41,4
375744,144,108,36,42,1
375744,144,108,36,43,1
375744,16,10,6,44,1
375744,128,98,30,45,1
375744,128,98,30,60,1
375753,57,45,12,1,4
375753,57,45,12,2,1
375753,26,24,2,3,1
375753,21,20,1,4,1
375753,5,4,1,5,1
375753,31,21,10,11,1
375753,5,4,1,20,1
375753,26,24,2,21,4
375753,26,24,2,22,1
375753,26,24,2,23,1
375753,21,20,1,24,1
375753,5,4,1,25,1
375753,5,4,1,40,1
375753,31,21,10,41,4
375753,31,21,10,42,1
375753,31,21,10,51,1
375762,101,36,65,1,4
375762,101,36,65,2,1
375762,52,23,29,3,1
375762,21,10,11,4,1
375762,31,13,18,5,1
375762,49,13,36,11,1
375762,31,13,18,20,1
375762,35,15,20,21,4
375762,35,15,20,22,1
375762,35,15,20,23,1
375762,15,8,7,24,1
375762,20,7,13,25,1
375762,20,7,13,40,1
375762,66,21,45,41,4
375762,66,21,45,42,1
375762,17,8,9,43,1
375762,6,2,4,44,1
375762,11,6,5,45,1
375762,49,13,36,51,1
375762,11,6,5,60,1
375841,563,301,262,1,4
375841,563,301,262,2,1
375841,563,301,262,3,1
375841,88,43,45,4,1
375841,475,258,217,5,1
375841,34,15,19,19,1
375841,441,243,198,20,1
375841,563,301,262,21,4
375841,563,301,262,22,1
375841,563,301,262,23,1
375841,88,43,45,24,1
375841,475,258,217,25,1
375841,34,15,19,39,1
375841,441,243,198,40,1
375939,405,102,303,1,4
375939,405,102,303,2,1
375939,405,102,303,3,1
375939,122,32,90,4,1
375939,283,70,213,5,1
375939,42,7,35,19,1
375939,241,63,178,20,1
375939,405,102,303,21,4
375939,405,102,303,22,1
375939,405,102,303,23,1
375939,122,32,90,24,1
375939,283,70,213,25,1
375939,42,7,35,39,1
375939,241,63,178,40,1
375966,142,12,130,1,4
375966,142,12,130,2,1
375966,142,12,130,3,1
375966,11,1,10,4,1
375966,131,11,120,5,1
375966,131,11,120,20,1
375966,63,7,56,21,4
375966,63,7,56,22,1
375966,63,7,56,23,1
375966,8,1,7,24,1
375966,55,6,49,25,1
375966,55,6,49,40,1
375966,79,5,74,41,4
375966,79,5,74,42,1
375966,79,5,74,43,1
375966,3,0,3,44,1
375966,76,5,71,45,1
375966,76,5,71,60,1
375984,337,33,304,1,4
375984,337,33,304,2,1
375984,337,33,304,3,1
375984,112,12,100,4,1
375984,225,21,204,5,1
375984,225,21,204,20,1
375984,281,32,249,21,4
375984,281,32,249,22,1
375984,281,32,249,23,1
375984,105,12,93,24,1
375984,176,20,156,25,1
375984,176,20,156,40,1
375984,56,1,55,41,4
375984,56,1,55,42,1
375984,56,1,55,43,1
375984,7,0,7,44,1
375984,49,1,48,45,1
375984,49,1,48,60,1
376136,96,9,87,1,4
376136,96,9,87,2,1
376136,96,9,87,3,1
376136,96,9,87,5,1
376136,96,9,87,20,1
376136,47,5,42,21,4
376136,47,5,42,22,1
376136,47,5,42,23,1
376136,47,5,42,25,1
376136,47,5,42,40,1
376136,49,4,45,41,4
376136,49,4,45,42,1
376136,49,4,45,43,1
376136,49,4,45,45,1
376136,49,4,45,60,1
376224,743,207,536,1,4
376224,743,207,536,2,1
376224,743,207,536,3,1
376224,182,61,121,4,1
376224,561,146,415,5,1
376224,85,26,59,19,1
376224,476,120,356,20,1
376224,651,188,463,21,4
376224,651,188,463,22,1
376224,651,188,463,23,1
376224,182,61,121,24,1
376224,469,127,342,25,1
376224,76,26,50,39,1
376224,393,101,292,40,1
376224,92,19,73,41,4
376224,92,19,73,42,1
376224,92,19,73,43,1
376224,92,19,73,45,1
376224,9,0,9,59,1
376224,83,19,64,60,1
376242,87,58,29,1,4
376242,87,58,29,2,1
376242,87,58,29,3,1
376242,35,20,15,4,1
376242,52,38,14,5,1
376242,52,38,14,20,1
376242,87,58,29,21,4
376242,87,58,29,22,1
376242,87,58,29,23,1
376242,35,20,15,24,1
376242,52,38,14,25,1
376242,52,38,14,40,1
376288,82,19,63,1,4
376288,82,19,63,2,1
376288,82,19,63,3,1
376288,58,16,42,4,1
376288,24,3,21,5,1
376288,24,3,21,20,1
376288,82,19,63,21,4
376288,82,19,63,22,1
376288,82,19,63,23,1
376288,58,16,42,24,1
376288,24,3,21,25,1
376288,24,3,21,40,1
376321,752,241,511,1,4
376321,752,241,511,2,1
376321,752,241,511,3,1
376321,417,152,265,4,1
376321,335,89,246,5,1
376321,335,89,246,19,1
376321,517,159,358,21,4
376321,517,159,358,22,1
376321,517,159,358,23,1
376321,313,113,200,24,1
376321,204,46,158,25,1
376321,204,46,158,39,1
376321,235,82,153,41,4
376321,235,82,153,42,1
376321,235,82,153,43,1
376321,104,39,65,44,1
376321,131,43,88,45,1
376321,131,43,88,59,1
376330,325,60,265,1,4
376330,325,60,265,2,1
376330,325,60,265,3,1
376330,35,12,23,4,1
376330,290,48,242,5,1
376330,290,48,242,20,1
376330,319,58,261,21,4
376330,319,58,261,22,1
376330,319,58,261,23,1
376330,35,12,23,24,1
376330,284,46,238,25,1
376330,284,46,238,40,1
376330,6,2,4,41,4
376330,6,2,4,42,1
376330,6,2,4,43,1
376330,6,2,4,45,1
376330,6,2,4,60,1
376385,1260,465,795,1,4
376385,1260,465,795,2,1
376385,1260,465,795,3,1
376385,754,296,458,4,1
376385,506,169,337,5,1
376385,155,64,91,19,1
376385,351,105,246,20,1
376385,1191,447,744,21,4
376385,1191,447,744,22,1
376385,1191,447,744,23,1
376385,739,290,449,24,1
376385,452,157,295,25,1
376385,129,57,72,39,1
376385,323,100,223,40,1
376385,69,18,51,41,4
376385,69,18,51,42,1
376385,69,18,51,43,1
376385,15,6,9,44,1
376385,54,12,42,45,1
376385,26,7,19,59,1
376385,28,5,23,60,1
376446,84,2,82,1,4
376446,84,2,82,2,1
376446,84,2,82,3,1
376446,8,0,8,4,1
376446,76,2,74,5,1
376446,76,2,74,20,1
376446,63,1,62,21,4
376446,63,1,62,22,1
376446,63,1,62,23,1
376446,6,0,6,24,1
376446,57,1,56,25,1
376446,57,1,56,40,1
376446,21,1,20,41,4
376446,21,1,20,42,1
376446,21,1,20,43,1
376446,2,0,2,44,1
376446,19,1,18,45,1
376446,19,1,18,60,1
376631,37,6,31,1,4
376631,37,6,31,2,1
376631,37,6,31,3,1
376631,20,3,17,4,1
376631,17,3,14,5,1
376631,17,3,14,20,1
376631,27,4,23,21,4
376631,27,4,23,22,1
376631,27,4,23,23,1
376631,16,3,13,24,1
376631,11,1,10,25,1
376631,11,1,10,40,1
376631,10,2,8,41,4
376631,10,2,8,42,1
376631,10,2,8,43,1
376631,4,0,4,44,1
376631,6,2,4,45,1
376631,6,2,4,60,1
376668,30,10,20,1,4
376668,30,10,20,2,1
376668,30,10,20,3,1
376668,23,7,16,4,1
376668,7,3,4,5,1
376668,7,3,4,20,1
376668,16,1,15,21,4
376668,16,1,15,22,1
376668,16,1,15,23,1
376668,14,1,13,24,1
376668,2,0,2,25,1
376668,2,0,2,40,1
376668,14,9,5,41,4
376668,14,9,5,42,1
376668,14,9,5,43,1
376668,9,6,3,44,1
376668,5,3,2,45,1
376668,5,3,2,60,1
376677,119,43,76,1,4
376677,119,43,76,2,1
376677,119,43,76,3,1
376677,16,9,7,4,1
376677,103,34,69,5,1
376677,103,34,69,20,1
376677,117,42,75,21,4
376677,117,42,75,22,1
376677,117,42,75,23,1
376677,16,9,7,24,1
376677,101,33,68,25,1
376677,101,33,68,40,1
376677,2,1,1,41,4
376677,2,1,1,42,1
376677,2,1,1,43,1
376677,2,1,1,45,1
376677,2,1,1,60,1
376695,1000,513,487,1,4
376695,1000,513,487,2,1
376695,988,510,478,3,1
376695,260,130,130,4,1
376695,728,380,348,5,1
376695,12,3,9,11,1
376695,3,2,1,19,1
376695,725,378,347,20,1
376695,673,333,340,21,4
376695,673,333,340,22,1
376695,673,333,340,23,1
376695,235,117,118,24,1
376695,438,216,222,25,1
376695,2,1,1,39,1
376695,436,215,221,40,1
376695,327,180,147,41,4
376695,327,180,147,42,1
376695,315,177,138,43,1
376695,25,13,12,44,1
376695,290,164,126,45,1
376695,12,3,9,51,1
376695,1,1,0,59,1
376695,289,163,126,60,1
376987,102,6,96,1,4
376987,102,6,96,2,1
376987,102,6,96,3,1
376987,92,5,87,4,1
376987,10,1,9,5,1
376987,10,1,9,20,1
376987,102,6,96,21,4
376987,102,6,96,22,1
376987,102,6,96,23,1
376987,92,5,87,24,1
376987,10,1,9,25,1
376987,10,1,9,40,1
377069,585,516,69,1,4
377069,585,516,69,2,1
377069,585,516,69,3,1
377069,86,72,14,4,1
377069,499,444,55,5,1
377069,15,12,3,19,1
377069,484,432,52,20,1
377069,459,404,55,21,4
377069,459,404,55,22,1
377069,459,404,55,23,1
377069,73,62,11,24,1
377069,386,342,44,25,1
377069,14,11,3,39,1
377069,372,331,41,40,1
377069,126,112,14,41,4
377069,126,112,14,42,1
377069,126,112,14,43,1
377069,13,10,3,44,1
377069,113,102,11,45,1
377069,1,1,0,59,1
377069,112,101,11,60,1
377111,408,108,300,1,4
377111,408,108,300,2,1
377111,408,108,300,3,1
377111,120,34,86,4,1
377111,288,74,214,5,1
377111,2,1,1,19,1
377111,286,73,213,20,1
377111,408,108,300,21,4
377111,408,108,300,22,1
377111,408,108,300,23,1
377111,120,34,86,24,1
377111,288,74,214,25,1
377111,2,1,1,39,1
377111,286,73,213,40,1
377193,35,3,32,1,4
377193,35,3,32,2,1
377193,35,3,32,3,1
377193,1,1,0,4,1
377193,34,2,32,5,1
377193,34,2,32,20,1
377193,15,2,13,21,4
377193,15,2,13,22,1
377193,15,2,13,23,1
377193,15,2,13,25,1
377193,15,2,13,40,1
377193,20,1,19,41,4
377193,20,1,19,42,1
377193,20,1,19,43,1
377193,1,1,0,44,1
377193,19,0,19,45,1
377193,19,0,19,60,1
377218,156,155,1,1,4
377218,156,155,1,2,1
377218,156,155,1,3,1
377218,21,21,0,4,1
377218,135,134,1,5,1
377218,45,45,0,19,1
377218,90,89,1,20,1
377218,156,155,1,21,4
377218,156,155,1,22,1
377218,156,155,1,23,1
377218,21,21,0,24,1
377218,135,134,1,25,1
377218,45,45,0,39,1
377218,90,89,1,40,1
377272,59,8,51,1,4
377272,59,8,51,2,1
377272,59,8,51,3,1
377272,54,8,46,4,1
377272,5,0,5,5,1
377272,5,0,5,20,1
377272,59,8,51,21,4
377272,59,8,51,22,1
377272,59,8,51,23,1
377272,54,8,46,24,1
377272,5,0,5,25,1
377272,5,0,5,40,1
377281,68,8,60,1,4
377281,68,8,60,2,1
377281,68,8,60,3,1
377281,65,7,58,4,1
377281,3,1,2,5,1
377281,3,1,2,20,1
377281,68,8,60,21,4
377281,68,8,60,22,1
377281,68,8,60,23,1
377281,65,7,58,24,1
377281,3,1,2,25,1
377281,3,1,2,40,1
377315,82,1,81,1,4
377315,82,1,81,2,1
377315,82,1,81,3,1
377315,30,1,29,4,1
377315,52,0,52,5,1
377315,52,0,52,20,1
377315,82,1,81,21,4
377315,82,1,81,22,1
377315,82,1,81,23,1
377315,30,1,29,24,1
377315,52,0,52,25,1
377315,52,0,52,40,1
377342,207,44,163,1,4
377342,207,44,163,2,1
377342,207,44,163,3,1
377342,179,38,141,4,1
377342,28,6,22,5,1
377342,28,6,22,20,1
377342,207,44,163,21,4
377342,207,44,163,22,1
377342,207,44,163,23,1
377342,179,38,141,24,1
377342,28,6,22,25,1
377342,28,6,22,40,1
377449,138,28,110,1,4
377449,138,28,110,2,1
377449,138,28,110,3,1
377449,39,10,29,4,1
377449,99,18,81,5,1
377449,99,18,81,20,1
377449,86,22,64,21,4
377449,86,22,64,22,1
377449,86,22,64,23,1
377449,24,8,16,24,1
377449,62,14,48,25,1
377449,62,14,48,40,1
377449,52,6,46,41,4
377449,52,6,46,42,1
377449,52,6,46,43,1
377449,15,2,13,44,1
377449,37,4,33,45,1
377449,37,4,33,60,1
377458,260,17,243,1,4
377458,260,17,243,2,1
377458,260,17,243,3,1
377458,63,5,58,4,1
377458,197,12,185,5,1
377458,197,12,185,20,1
377458,170,14,156,21,4
377458,170,14,156,22,1
377458,170,14,156,23,1
377458,40,3,37,24,1
377458,130,11,119,25,1
377458,130,11,119,40,1
377458,90,3,87,41,4
377458,90,3,87,42,1
377458,90,3,87,43,1
377458,23,2,21,44,1
377458,67,1,66,45,1
377458,67,1,66,60,1
377485,58,2,56,1,4
377485,58,2,56,2,1
377485,30,2,28,3,1
377485,15,0,15,4,1
377485,15,2,13,5,1
377485,28,0,28,11,1
377485,15,2,13,20,1
377485,19,0,19,21,4
377485,19,0,19,22,1
377485,19,0,19,23,1
377485,14,0,14,24,1
377485,5,0,5,25,1
377485,5,0,5,40,1
377485,39,2,37,41,4
377485,39,2,37,42,1
377485,11,2,9,43,1
377485,1,0,1,44,1
377485,10,2,8,45,1
377485,28,0,28,51,1
377485,10,2,8,60,1
377546,94,28,66,1,4
377546,94,28,66,2,1
377546,94,28,66,3,1
377546,33,10,23,4,1
377546,61,18,43,5,1
377546,11,2,9,19,1
377546,50,16,34,20,1
377546,89,25,64,21,4
377546,89,25,64,22,1
377546,89,25,64,23,1
377546,33,10,23,24,1
377546,56,15,41,25,1
377546,10,2,8,39,1
377546,46,13,33,40,1
377546,5,3,2,41,4
377546,5,3,2,42,1
377546,5,3,2,43,1
377546,5,3,2,45,1
377546,1,0,1,59,1
377546,4,3,1,60,1
377555,4604,2256,2348,1,4
377555,4104,2054,2050,2,1
377555,4077,2043,2034,3,1
377555,570,258,312,4,1
377555,3507,1785,1722,5,1
377555,27,11,16,11,1
377555,500,202,298,12,3
377555,744,333,411,19,1
377555,2763,1452,1311,20,1
377555,3699,1877,1822,21,4
377555,3432,1761,1671,22,1
377555,3429,1760,1669,23,1
377555,554,251,303,24,1
377555,2875,1509,1366,25,1
377555,3,1,2,31,1
377555,267,116,151,32,3
377555,571,271,300,39,1
377555,2304,1238,1066,40,1
377555,905,379,526,41,4
377555,672,293,379,42,1
377555,648,283,365,43,1
377555,16,7,9,44,1
377555,632,276,356,45,1
377555,24,10,14,51,1
377555,233,86,147,52,3
377555,173,62,111,59,1
377555,459,214,245,60,1
377564,4295,1900,2395,1,4
377564,3626,1692,1934,2,1
377564,3587,1673,1914,3,1
377564,410,176,234,4,1
377564,3177,1497,1680,5,1
377564,39,19,20,11,1
377564,669,208,461,12,3
377564,755,315,440,19,1
377564,2422,1182,1240,20,1
377564,3463,1599,1864,21,4
377564,3114,1463,1651,22,1
377564,3107,1460,1647,23,1
377564,392,164,228,24,1
377564,2715,1296,1419,25,1
377564,7,3,4,31,1
377564,349,136,213,32,3
377564,653,282,371,39,1
377564,2062,1014,1048,40,1
377564,832,301,531,41,4
377564,512,229,283,42,1
377564,480,213,267,43,1
377564,18,12,6,44,1
377564,462,201,261,45,1
377564,32,16,16,51,1
377564,320,72,248,52,3
377564,102,33,69,59,1
377564,360,168,192,60,1
377643,125,4,121,1,4
377643,125,4,121,2,1
377643,125,4,121,3,1
377643,32,0,32,4,1
377643,93,4,89,5,1
377643,93,4,89,20,1
377643,125,4,121,21,4
377643,125,4,121,22,1
377643,125,4,121,23,1
377643,32,0,32,24,1
377643,93,4,89,25,1
377643,93,4,89,40,1
377652,223,21,202,1,4
377652,223,21,202,2,1
377652,223,21,202,3,1
377652,156,16,140,4,1
377652,67,5,62,5,1
377652,52,2,50,19,1
377652,15,3,12,20,1
377652,223,21,202,21,4
377652,223,21,202,22,1
377652,223,21,202,23,1
377652,156,16,140,24,1
377652,67,5,62,25,1
377652,52,2,50,39,1
377652,15,3,12,40,1
377661,55,4,51,1,4
377661,55,4,51,2,1
377661,55,4,51,3,1
377661,35,2,33,4,1
377661,20,2,18,5,1
377661,20,2,18,20,1
377661,55,4,51,21,4
377661,55,4,51,22,1
377661,55,4,51,23,1
377661,35,2,33,24,1
377661,20,2,18,25,1
377661,20,2,18,40,1
377670,66,3,63,1,4
377670,66,3,63,2,1
377670,66,3,63,3,1
377670,50,2,48,4,1
377670,16,1,15,5,1
377670,16,1,15,20,1
377670,66,3,63,21,4
377670,66,3,63,22,1
377670,66,3,63,23,1
377670,50,2,48,24,1
377670,16,1,15,25,1
377670,16,1,15,40,1
377722,372,5,367,1,4
377722,372,5,367,2,1
377722,372,5,367,3,1
377722,78,2,76,4,1
377722,294,3,291,5,1
377722,294,3,291,20,1
377722,372,5,367,21,4
377722,372,5,367,22,1
377722,372,5,367,23,1
377722,78,2,76,24,1
377722,294,3,291,25,1
377722,294,3,291,40,1
377759,50,46,4,1,4
377759,50,46,4,2,1
377759,50,46,4,3,1
377759,21,19,2,4,1
377759,29,27,2,5,1
377759,29,27,2,20,1
377759,50,46,4,21,4
377759,50,46,4,22,1
377759,50,46,4,23,1
377759,21,19,2,24,1
377759,29,27,2,25,1
377759,29,27,2,40,1
378105,233,30,203,1,4
378105,233,30,203,2,1
378105,233,30,203,3,1
378105,85,9,76,4,1
378105,148,21,127,5,1
378105,148,21,127,20,1
378105,178,23,155,21,4
378105,178,23,155,22,1
378105,178,23,155,23,1
378105,66,9,57,24,1
378105,112,14,98,25,1
378105,112,14,98,40,1
378105,55,7,48,41,4
378105,55,7,48,42,1
378105,55,7,48,43,1
378105,19,0,19,44,1
378105,36,7,29,45,1
378105,36,7,29,60,1
378406,457,369,88,1,4
378406,457,369,88,2,1
378406,457,369,88,3,1
378406,53,44,9,4,1
378406,404,325,79,5,1
378406,7,6,1,19,1
378406,397,319,78,20,1
378406,360,290,70,21,4
378406,360,290,70,22,1
378406,360,290,70,23,1
378406,45,37,8,24,1
378406,315,253,62,25,1
378406,7,6,1,39,1
378406,308,247,61,40,1
378406,97,79,18,41,4
378406,97,79,18,42,1
378406,97,79,18,43,1
378406,8,7,1,44,1
378406,89,72,17,45,1
378406,89,72,17,60,1
378576,510,131,379,1,4
378576,125,33,92,2,1
378576,124,33,91,3,1
378576,37,8,29,4,1
378576,87,25,62,5,1
378576,1,0,1,11,1
378576,385,98,287,12,3
378576,6,1,5,19,1
378576,81,24,57,20,1
378576,305,79,226,21,4
378576,48,14,34,22,1
378576,48,14,34,23,1
378576,21,6,15,24,1
378576,27,8,19,25,1
378576,257,65,192,32,3
378576,3,0,3,39,1
378576,24,8,16,40,1
378576,205,52,153,41,4
378576,77,19,58,42,1
378576,76,19,57,43,1
378576,16,2,14,44,1
378576,60,17,43,45,1
378576,1,0,1,51,1
378576,128,33,95,52,3
378576,3,1,2,59,1
378576,57,16,41,60,1
378886,198,95,103,1,4
378886,198,95,103,2,1
378886,198,95,103,3,1
378886,19,10,9,4,1
378886,179,85,94,5,1
378886,179,85,94,20,1
378886,72,32,40,21,4
378886,72,32,40,22,1
378886,72,32,40,23,1
378886,12,5,7,24,1
378886,60,27,33,25,1
378886,60,27,33,40,1
378886,126,63,63,41,4
378886,126,63,63,42,1
378886,126,63,63,43,1
378886,7,5,2,44,1
378886,119,58,61,45,1
378886,119,58,61,60,1
378956,692,662,30,1,4
378956,692,662,30,2,1
378956,692,662,30,3,1
378956,99,96,3,4,1
378956,593,566,27,5,1
378956,593,566,27,20,1
378956,692,662,30,21,4
378956,692,662,30,22,1
378956,692,662,30,23,1
378956,99,96,3,24,1
378956,593,566,27,25,1
378956,593,566,27,40,1
379029,317,52,265,1,4
379029,317,52,265,2,1
379029,317,52,265,3,1
379029,26,6,20,4,1
379029,291,46,245,5,1
379029,21,2,19,19,1
379029,270,44,226,20,1
379029,317,52,265,21,4
379029,317,52,265,22,1
379029,317,52,265,23,1
379029,26,6,20,24,1
379029,291,46,245,25,1
379029,21,2,19,39,1
379029,270,44,226,40,1
379135,85,75,10,1,4
379135,85,75,10,2,1
379135,85,75,10,3,1
379135,40,35,5,4,1
379135,45,40,5,5,1
379135,45,40,5,20,1
379135,73,64,9,21,4
379135,73,64,9,22,1
379135,73,64,9,23,1
379135,34,29,5,24,1
379135,39,35,4,25,1
379135,39,35,4,40,1
379135,12,11,1,41,4
379135,12,11,1,42,1
379135,12,11,1,43,1
379135,6,6,0,44,1
379135,6,5,1,45,1
379135,6,5,1,60,1
379621,51,14,37,1,4
379621,51,14,37,2,1
379621,51,14,37,3,1
379621,19,5,14,4,1
379621,32,9,23,5,1
379621,32,9,23,20,1
379621,51,14,37,21,4
379621,51,14,37,22,1
379621,51,14,37,23,1
379621,19,5,14,24,1
379621,32,9,23,25,1
379621,32,9,23,40,1
379746,46,4,42,1,4
379746,46,4,42,2,1
379746,46,4,42,3,1
379746,27,3,24,4,1
379746,19,1,18,5,1
379746,19,1,18,20,1
379746,46,4,42,21,4
379746,46,4,42,22,1
379746,46,4,42,23,1
379746,27,3,24,24,1
379746,19,1,18,25,1
379746,19,1,18,40,1
379782,182,36,146,1,4
379782,125,21,104,2,1
379782,125,21,104,3,1
379782,3,2,1,4,1
379782,122,19,103,5,1
379782,57,15,42,12,3
379782,22,2,20,19,1
379782,100,17,83,20,1
379782,182,36,146,21,4
379782,125,21,104,22,1
379782,125,21,104,23,1
379782,3,2,1,24,1
379782,122,19,103,25,1
379782,57,15,42,32,3
379782,22,2,20,39,1
379782,100,17,83,40,1
380067,177,2,175,1,4
380067,177,2,175,2,1
380067,177,2,175,3,1
380067,103,1,102,4,1
380067,74,1,73,5,1
380067,74,1,73,20,1
380067,177,2,175,21,4
380067,177,2,175,22,1
380067,177,2,175,23,1
380067,103,1,102,24,1
380067,74,1,73,25,1
380067,74,1,73,40,1
380094,354,82,272,1,4
380094,354,82,272,2,1
380094,354,82,272,3,1
380094,135,28,107,4,1
380094,219,54,165,5,1
380094,1,0,1,19,1
380094,218,54,164,20,1
380094,354,82,272,21,4
380094,354,82,272,22,1
380094,354,82,272,23,1
380094,135,28,107,24,1
380094,219,54,165,25,1
380094,1,0,1,39,1
380094,218,54,164,40,1
380359,531,194,337,1,4
380359,531,194,337,2,1
380359,514,186,328,3,1
380359,133,60,73,4,1
380359,381,126,255,5,1
380359,17,8,9,11,1
380359,22,5,17,19,1
380359,359,121,238,20,1
380359,298,121,177,21,4
380359,298,121,177,22,1
380359,292,118,174,23,1
380359,92,47,45,24,1
380359,200,71,129,25,1
380359,6,3,3,31,1
380359,7,3,4,39,1
380359,193,68,125,40,1
380359,233,73,160,41,4
380359,233,73,160,42,1
380359,222,68,154,43,1
380359,41,13,28,44,1
380359,181,55,126,45,1
380359,11,5,6,51,1
380359,15,2,13,59,1
380359,166,53,113,60,1
380368,2272,1052,1220,1,4
380368,2272,1052,1220,2,1
380368,996,466,530,3,1
380368,190,109,81,4,1
380368,806,357,449,5,1
380368,1276,586,690,11,1
380368,145,82,63,19,1
380368,661,275,386,20,1
380368,824,411,413,21,4
380368,824,411,413,22,1
380368,626,330,296,23,1
380368,168,105,63,24,1
380368,458,225,233,25,1
380368,198,81,117,31,1
380368,89,58,31,39,1
380368,369,167,202,40,1
380368,1448,641,807,41,4
380368,1448,641,807,42,1
380368,370,136,234,43,1
380368,22,4,18,44,1
380368,348,132,216,45,1
380368,1078,505,573,51,1
380368,56,24,32,59,1
380368,292,108,184,60,1
380377,681,232,449,1,4
380377,681,232,449,2,1
380377,653,226,427,3,1
380377,104,51,53,4,1
380377,549,175,374,5,1
380377,28,6,22,11,1
380377,8,1,7,19,1
380377,541,174,367,20,1
380377,514,189,325,21,4
380377,514,189,325,22,1
380377,512,188,324,23,1
380377,79,42,37,24,1
380377,433,146,287,25,1
380377,2,1,1,31,1
380377,4,1,3,39,1
380377,429,145,284,40,1
380377,167,43,124,41,4
380377,167,43,124,42,1
380377,141,38,103,43,1
380377,25,9,16,44,1
380377,116,29,87,45,1
380377,26,5,21,51,1
380377,4,0,4,59,1
380377,112,29,83,60,1
380401,79,1,78,1,4
380401,79,1,78,2,1
380401,79,1,78,3,1
380401,19,0,19,4,1
380401,60,1,59,5,1
380401,60,1,59,20,1
380401,52,0,52,21,4
380401,52,0,52,22,1
380401,52,0,52,23,1
380401,11,0,11,24,1
380401,41,0,41,25,1
380401,41,0,41,40,1
380401,27,1,26,41,4
380401,27,1,26,42,1
380401,27,1,26,43,1
380401,8,0,8,44,1
380401,19,1,18,45,1
380401,19,1,18,60,1
380438,336,85,251,1,4
380438,336,85,251,2,1
380438,307,82,225,3,1
380438,115,29,86,4,1
380438,192,53,139,5,1
380438,29,3,26,11,1
380438,19,4,15,19,1
380438,173,49,124,20,1
380438,137,37,100,21,4
380438,137,37,100,22,1
380438,110,34,76,23,1
380438,59,14,45,24,1
380438,51,20,31,25,1
380438,27,3,24,31,1
380438,9,3,6,39,1
380438,42,17,25,40,1
380438,199,48,151,41,4
380438,199,48,151,42,1
380438,197,48,149,43,1
380438,56,15,41,44,1
380438,141,33,108,45,1
380438,2,0,2,51,1
380438,10,1,9,59,1
380438,131,32,99,60,1
380456,132,4,128,1,4
380456,132,4,128,2,1
380456,132,4,128,3,1
380456,23,0,23,4,1
380456,109,4,105,5,1
380456,109,4,105,20,1
380456,106,2,104,21,4
380456,106,2,104,22,1
380456,106,2,104,23,1
380456,21,0,21,24,1
380456,85,2,83,25,1
380456,85,2,83,40,1
380456,26,2,24,41,4
380456,26,2,24,42,1
380456,26,2,24,43,1
380456,2,0,2,44,1
380456,24,2,22,45,1
380456,24,2,22,60,1
380465,1703,923,780,1,4
380465,1056,643,413,2,1
380465,958,566,392,3,1
380465,13,3,10,4,1
380465,945,563,382,5,1
380465,98,77,21,11,1
380465,647,280,367,12,3
380465,69,45,24,19,1
380465,876,518,358,20,1
380465,1703,923,780,21,4
380465,1056,643,413,22,1
380465,958,566,392,23,1
380465,13,3,10,24,1
380465,945,563,382,25,1
380465,98,77,21,31,1
380465,647,280,367,32,3
380465,69,45,24,39,1
380465,876,518,358,40,1
380474,346,74,272,1,4
380474,346,74,272,2,1
380474,346,74,272,3,1
380474,130,23,107,4,1
380474,216,51,165,5,1
380474,216,51,165,20,1
380474,193,44,149,21,4
380474,193,44,149,22,1
380474,193,44,149,23,1
380474,78,14,64,24,1
380474,115,30,85,25,1
380474,115,30,85,40,1
380474,153,30,123,41,4
380474,153,30,123,42,1
380474,153,30,123,43,1
380474,52,9,43,44,1
380474,101,21,80,45,1
380474,101,21,80,60,1
381255,187,130,57,1,4
381255,187,130,57,2,1
381255,187,130,57,3,1
381255,50,31,19,4,1
381255,137,99,38,5,1
381255,137,99,38,20,1
381255,64,38,26,21,4
381255,64,38,26,22,1
381255,64,38,26,23,1
381255,36,21,15,24,1
381255,28,17,11,25,1
381255,28,17,11,40,1
381255,123,92,31,41,4
381255,123,92,31,42,1
381255,123,92,31,43,1
381255,14,10,4,44,1
381255,109,82,27,45,1
381255,109,82,27,60,1
381282,133,87,46,1,4
381282,133,87,46,2,1
381282,133,87,46,3,1
381282,38,24,14,4,1
381282,95,63,32,5,1
381282,95,63,32,20,1
381282,111,81,30,21,4
381282,111,81,30,22,1
381282,111,81,30,23,1
381282,32,23,9,24,1
381282,79,58,21,25,1
381282,79,58,21,40,1
381282,22,6,16,41,4
381282,22,6,16,42,1
381282,22,6,16,43,1
381282,6,1,5,44,1
381282,16,5,11,45,1
381282,16,5,11,60,1
381325,155,54,101,1,4
381325,155,54,101,2,1
381325,155,54,101,3,1
381325,45,11,34,4,1
381325,110,43,67,5,1
381325,110,43,67,20,1
381325,105,34,71,21,4
381325,105,34,71,22,1
381325,105,34,71,23,1
381325,36,8,28,24,1
381325,69,26,43,25,1
381325,69,26,43,40,1
381325,50,20,30,41,4
381325,50,20,30,42,1
381325,50,20,30,43,1
381325,9,3,6,44,1
381325,41,17,24,45,1
381325,41,17,24,60,1
381334,72,33,39,1,4
381334,72,33,39,2,1
381334,72,33,39,3,1
381334,18,9,9,4,1
381334,54,24,30,5,1
381334,54,24,30,20,1
381334,28,11,17,21,4
381334,28,11,17,22,1
381334,28,11,17,23,1
381334,14,6,8,24,1
381334,14,5,9,25,1
381334,14,5,9,40,1
381334,44,22,22,41,4
381334,44,22,22,42,1
381334,44,22,22,43,1
381334,4,3,1,44,1
381334,40,19,21,45,1
381334,40,19,21,60,1
381352,136,36,100,1,4
381352,136,36,100,12,3
381352,115,29,86,21,4
381352,115,29,86,32,3
381352,21,7,14,41,4
381352,21,7,14,52,3
381361,82,18,64,1,4
381361,82,18,64,2,1
381361,82,18,64,3,1
381361,14,4,10,4,1
381361,68,14,54,5,1
381361,68,14,54,20,1
381361,82,18,64,21,4
381361,82,18,64,22,1
381361,82,18,64,23,1
381361,14,4,10,24,1
381361,68,14,54,25,1
381361,68,14,54,40,1
381370,301,13,288,1,4
381370,301,13,288,2,1
381370,301,13,288,3,1
381370,119,10,109,4,1
381370,182,3,179,5,1
381370,182,3,179,20,1
381370,212,11,201,21,4
381370,212,11,201,22,1
381370,212,11,201,23,1
381370,90,9,81,24,1
381370,122,2,120,25,1
381370,122,2,120,40,1
381370,89,2,87,41,4
381370,89,2,87,42,1
381370,89,2,87,43,1
381370,29,1,28,44,1
381370,60,1,59,45,1
381370,60,1,59,60,1
381404,231,12,219,1,4
381404,231,12,219,2,1
381404,231,12,219,3,1
381404,96,2,94,4,1
381404,135,10,125,5,1
381404,135,10,125,20,1
381404,131,6,125,21,4
381404,131,6,125,22,1
381404,131,6,125,23,1
381404,53,1,52,24,1
381404,78,5,73,25,1
381404,78,5,73,40,1
381404,100,6,94,41,4
381404,100,6,94,42,1
381404,100,6,94,43,1
381404,43,1,42,44,1
381404,57,5,52,45,1
381404,57,5,52,60,1
381459,187,140,47,1,4
381459,187,140,47,12,3
381459,31,27,4,21,4
381459,31,27,4,32,3
381459,156,113,43,41,4
381459,156,113,43,52,3
381486,14,0,14,1,4
381486,14,0,14,2,1
381486,14,0,14,3,1
381486,6,0,6,4,1
381486,8,0,8,5,1
381486,8,0,8,20,1
381486,14,0,14,21,4
381486,14,0,14,22,1
381486,14,0,14,23,1
381486,6,0,6,24,1
381486,8,0,8,25,1
381486,8,0,8,40,1
381529,249,67,182,1,4
381529,249,67,182,2,1
381529,229,63,166,3,1
381529,29,11,18,4,1
381529,200,52,148,5,1
381529,20,4,16,11,1
381529,200,52,148,20,1
381529,211,60,151,21,4
381529,211,60,151,22,1
381529,195,56,139,23,1
381529,26,10,16,24,1
381529,169,46,123,25,1
381529,16,4,12,31,1
381529,169,46,123,40,1
381529,38,7,31,41,4
381529,38,7,31,42,1
381529,34,7,27,43,1
381529,3,1,2,44,1
381529,31,6,25,45,1
381529,4,0,4,51,1
381529,31,6,25,60,1
381617,1039,275,764,1,4
381617,1039,275,764,2,1
381617,1036,274,762,3,1
381617,170,71,99,4,1
381617,866,203,663,5,1
381617,3,1,2,11,1
381617,64,15,49,19,1
381617,802,188,614,20,1
381617,626,176,450,21,4
381617,626,176,450,22,1
381617,626,176,450,23,1
381617,119,45,74,24,1
381617,507,131,376,25,1
381617,43,9,34,39,1
381617,464,122,342,40,1
381617,413,99,314,41,4
381617,413,99,314,42,1
381617,410,98,312,43,1
381617,51,26,25,44,1
381617,359,72,287,45,1
381617,3,1,2,51,1
381617,21,6,15,59,1
381617,338,66,272,60,1
381635,77,5,72,1,4
381635,77,5,72,2,1
381635,77,5,72,3,1
381635,32,2,30,4,1
381635,45,3,42,5,1
381635,45,3,42,20,1
381635,49,4,45,21,4
381635,49,4,45,22,1
381635,49,4,45,23,1
381635,24,2,22,24,1
381635,25,2,23,25,1
381635,25,2,23,40,1
381635,28,1,27,41,4
381635,28,1,27,42,1
381635,28,1,27,43,1
381635,8,0,8,44,1
381635,20,1,19,45,1
381635,20,1,19,60,1
381644,154,12,142,1,4
381644,154,12,142,2,1
381644,154,12,142,3,1
381644,46,5,41,4,1
381644,108,7,101,5,1
381644,108,7,101,20,1
381644,154,12,142,21,4
381644,154,12,142,22,1
381644,154,12,142,23,1
381644,46,5,41,24,1
381644,108,7,101,25,1
381644,108,7,101,40,1
381699,34,2,32,1,4
381699,34,2,32,2,1
381699,34,2,32,3,1
381699,28,1,27,4,1
381699,6,1,5,5,1
381699,6,1,5,20,1
381699,22,2,20,21,4
381699,22,2,20,22,1
381699,22,2,20,23,1
381699,18,1,17,24,1
381699,4,1,3,25,1
381699,4,1,3,40,1
381699,12,0,12,41,4
381699,12,0,12,42,1
381699,12,0,12,43,1
381699,10,0,10,44,1
381699,2,0,2,45,1
381699,2,0,2,60,1
381705,39,2,37,1,4
381705,39,2,37,2,1
381705,39,2,37,3,1
381705,33,2,31,4,1
381705,6,0,6,5,1
381705,6,0,6,20,1
381705,24,1,23,21,4
381705,24,1,23,22,1
381705,24,1,23,23,1
381705,21,1,20,24,1
381705,3,0,3,25,1
381705,3,0,3,40,1
381705,15,1,14,41,4
381705,15,1,14,42,1
381705,15,1,14,43,1
381705,12,1,11,44,1
381705,3,0,3,45,1
381705,3,0,3,60,1
381732,201,38,163,1,4
381732,201,38,163,2,1
381732,199,38,161,3,1
381732,38,5,33,4,1
381732,161,33,128,5,1
381732,2,0,2,11,1
381732,161,33,128,20,1
381732,119,21,98,21,4
381732,119,21,98,22,1
381732,119,21,98,23,1
381732,34,5,29,24,1
381732,85,16,69,25,1
381732,85,16,69,40,1
381732,82,17,65,41,4
381732,82,17,65,42,1
381732,80,17,63,43,1
381732,4,0,4,44,1
381732,76,17,59,45,1
381732,2,0,2,51,1
381732,76,17,59,60,1
381741,7,3,4,1,4
381741,7,3,4,2,1
381741,7,3,4,3,1
381741,7,3,4,5,1
381741,7,3,4,20,1
381741,7,3,4,21,4
381741,7,3,4,22,1
381741,7,3,4,23,1
381741,7,3,4,25,1
381741,7,3,4,40,1
381750,52,4,48,1,4
381750,52,4,48,2,1
381750,52,4,48,3,1
381750,20,2,18,4,1
381750,32,2,30,5,1
381750,32,2,30,20,1
381750,41,3,38,21,4
381750,41,3,38,22,1
381750,41,3,38,23,1
381750,15,2,13,24,1
381750,26,1,25,25,1
381750,26,1,25,40,1
381750,11,1,10,41,4
381750,11,1,10,42,1
381750,11,1,10,43,1
381750,5,0,5,44,1
381750,6,1,5,45,1
381750,6,1,5,60,1
381787,275,121,154,1,4
381787,275,121,154,2,1
381787,275,121,154,3,1
381787,20,12,8,4,1
381787,255,109,146,5,1
381787,1,0,1,19,1
381787,254,109,145,20,1
381787,185,72,113,21,4
381787,185,72,113,22,1
381787,185,72,113,23,1
381787,19,11,8,24,1
381787,166,61,105,25,1
381787,1,0,1,39,1
381787,165,61,104,40,1
381787,90,49,41,41,4
381787,90,49,41,42,1
381787,90,49,41,43,1
381787,1,1,0,44,1
381787,89,48,41,45,1
381787,89,48,41,60,1
381866,50,15,35,1,4
381866,50,15,35,2,1
381866,50,15,35,3,1
381866,18,8,10,4,1
381866,32,7,25,5,1
381866,32,7,25,20,1
381866,50,15,35,21,4
381866,50,15,35,22,1
381866,50,15,35,23,1
381866,18,8,10,24,1
381866,32,7,25,25,1
381866,32,7,25,40,1
381909,730,580,150,1,4
381909,730,580,150,2,1
381909,730,580,150,3,1
381909,97,77,20,4,1
381909,633,503,130,5,1
381909,3,3,0,19,1
381909,630,500,130,20,1
381909,606,477,129,21,4
381909,606,477,129,22,1
381909,606,477,129,23,1
381909,89,72,17,24,1
381909,517,405,112,25,1
381909,3,3,0,39,1
381909,514,402,112,40,1
381909,124,103,21,41,4
381909,124,103,21,42,1
381909,124,103,21,43,1
381909,8,5,3,44,1
381909,116,98,18,45,1
381909,116,98,18,60,1
381945,43,15,28,1,4
381945,43,15,28,2,1
381945,19,5,14,3,1
381945,19,5,14,4,1
381945,24,10,14,11,1
381945,43,15,28,21,4
381945,43,15,28,22,1
381945,19,5,14,23,1
381945,19,5,14,24,1
381945,24,10,14,31,1
382063,928,465,463,1,4
382063,449,271,178,2,1
382063,437,261,176,3,1
382063,3,1,2,4,1
382063,434,260,174,5,1
382063,12,10,2,11,1
382063,479,194,285,12,3
382063,23,17,6,19,1
382063,411,243,168,20,1
382063,928,465,463,21,4
382063,449,271,178,22,1
382063,437,261,176,23,1
382063,3,1,2,24,1
382063,434,260,174,25,1
382063,12,10,2,31,1
382063,479,194,285,32,3
382063,23,17,6,39,1
382063,411,243,168,40,1
382258,176,39,137,1,4
382258,176,39,137,2,1
382258,176,39,137,3,1
382258,90,29,61,4,1
382258,86,10,76,5,1
382258,86,10,76,20,1
382258,76,11,65,21,4
382258,76,11,65,22,1
382258,76,11,65,23,1
382258,28,7,21,24,1
382258,48,4,44,25,1
382258,48,4,44,40,1
382258,100,28,72,41,4
382258,100,28,72,42,1
382258,100,28,72,43,1
382258,62,22,40,44,1
382258,38,6,32,45,1
382258,38,6,32,60,1
382267,54,3,51,1,4
382267,54,3,51,2,1
382267,54,3,51,3,1
382267,10,3,7,4,1
382267,44,0,44,5,1
382267,44,0,44,20,1
382267,53,3,50,21,4
382267,53,3,50,22,1
382267,53,3,50,23,1
382267,9,3,6,24,1
382267,44,0,44,25,1
382267,44,0,44,40,1
382267,1,0,1,41,4
382267,1,0,1,42,1
382267,1,0,1,43,1
382267,1,0,1,44,1
382276,484,77,407,1,4
382276,484,77,407,2,1
382276,484,77,407,3,1
382276,152,26,126,4,1
382276,332,51,281,5,1
382276,332,51,281,20,1
382276,390,66,324,21,4
382276,390,66,324,22,1
382276,390,66,324,23,1
382276,125,24,101,24,1
382276,265,42,223,25,1
382276,265,42,223,40,1
382276,94,11,83,41,4
382276,94,11,83,42,1
382276,94,11,83,43,1
382276,27,2,25,44,1
382276,67,9,58,45,1
382276,67,9,58,60,1
382416,80,8,72,1,4
382416,80,8,72,2,1
382416,80,8,72,3,1
382416,7,0,7,4,1
382416,73,8,65,5,1
382416,73,8,65,20,1
382416,80,8,72,21,4
382416,80,8,72,22,1
382416,80,8,72,23,1
382416,7,0,7,24,1
382416,73,8,65,25,1
382416,73,8,65,40,1
382461,65,4,61,1,4
382461,65,4,61,2,1
382461,65,4,61,3,1
382461,7,0,7,4,1
382461,58,4,54,5,1
382461,58,4,54,20,1
382461,53,2,51,21,4
382461,53,2,51,22,1
382461,53,2,51,23,1
382461,6,0,6,24,1
382461,47,2,45,25,1
382461,47,2,45,40,1
382461,12,2,10,41,4
382461,12,2,10,42,1
382461,12,2,10,43,1
382461,1,0,1,44,1
382461,11,2,9,45,1
382461,11,2,9,60,1
382504,381,114,267,1,4
382504,381,114,267,2,1
382504,381,114,267,3,1
382504,214,63,151,4,1
382504,167,51,116,5,1
382504,167,51,116,20,1
382504,381,114,267,21,4
382504,381,114,267,22,1
382504,381,114,267,23,1
382504,214,63,151,24,1
382504,167,51,116,25,1
382504,167,51,116,40,1
382771,524,127,397,1,4
382771,524,127,397,2,1
382771,524,127,397,3,1
382771,151,39,112,4,1
382771,373,88,285,5,1
382771,101,22,79,19,1
382771,272,66,206,20,1
382771,366,91,275,21,4
382771,366,91,275,22,1
382771,366,91,275,23,1
382771,109,26,83,24,1
382771,257,65,192,25,1
382771,73,17,56,39,1
382771,184,48,136,40,1
382771,158,36,122,41,4
382771,158,36,122,42,1
382771,158,36,122,43,1
382771,42,13,29,44,1
382771,116,23,93,45,1
382771,28,5,23,59,1
382771,88,18,70,60,1
382780,247,24,223,1,4
382780,247,24,223,2,1
382780,247,24,223,3,1
382780,45,0,45,4,1
382780,202,24,178,5,1
382780,202,24,178,20,1
382780,247,24,223,21,4
382780,247,24,223,22,1
382780,247,24,223,23,1
382780,45,0,45,24,1
382780,202,24,178,25,1
382780,202,24,178,40,1
382896,357,62,295,1,4
382896,357,62,295,2,1
382896,357,62,295,3,1
382896,89,7,82,4,1
382896,268,55,213,5,1
382896,44,15,29,19,1
382896,224,40,184,20,1
382896,357,62,295,21,4
382896,357,62,295,22,1
382896,357,62,295,23,1
382896,89,7,82,24,1
382896,268,55,213,25,1
382896,44,15,29,39,1
382896,224,40,184,40,1
382902,90,2,88,1,4
382902,90,2,88,2,1
382902,90,2,88,3,1
382902,34,0,34,4,1
382902,56,2,54,5,1
382902,56,2,54,20,1
382902,90,2,88,21,4
382902,90,2,88,22,1
382902,90,2,88,23,1
382902,34,0,34,24,1
382902,56,2,54,25,1
382902,56,2,54,40,1
382911,149,77,72,1,4
382911,149,77,72,2,1
382911,147,77,70,3,1
382911,51,32,19,4,1
382911,96,45,51,5,1
382911,2,0,2,11,1
382911,8,4,4,19,1
382911,88,41,47,20,1
382911,122,68,54,21,4
382911,122,68,54,22,1
382911,122,68,54,23,1
382911,47,30,17,24,1
382911,75,38,37,25,1
382911,8,4,4,39,1
382911,67,34,33,40,1
382911,27,9,18,41,4
382911,27,9,18,42,1
382911,25,9,16,43,1
382911,4,2,2,44,1
382911,21,7,14,45,1
382911,2,0,2,51,1
382911,21,7,14,60,1
382957,457,108,349,1,4
382957,457,108,349,2,1
382957,457,108,349,3,1
382957,90,33,57,4,1
382957,367,75,292,5,1
382957,50,14,36,19,1
382957,317,61,256,20,1
382957,457,108,349,21,4
382957,457,108,349,22,1
382957,457,108,349,23,1
382957,90,33,57,24,1
382957,367,75,292,25,1
382957,50,14,36,39,1
382957,317,61,256,40,1
383020,74,14,60,1,4
383020,20,2,18,2,1
383020,20,2,18,3,1
383020,20,2,18,5,1
383020,54,12,42,12,3
383020,20,2,18,20,1
383020,48,11,37,21,4
383020,10,1,9,22,1
383020,10,1,9,23,1
383020,10,1,9,25,1
383020,38,10,28,32,3
383020,10,1,9,40,1
383020,26,3,23,41,4
383020,10,1,9,42,1
383020,10,1,9,43,1
383020,10,1,9,45,1
383020,16,2,14,52,3
383020,10,1,9,60,1
383084,4151,2131,2020,1,4
383084,4151,2131,2020,2,1
383084,3704,1938,1766,3,1
383084,2351,1203,1148,4,1
383084,1353,735,618,5,1
383084,447,193,254,11,1
383084,1353,735,618,20,1
383084,1684,904,780,21,4
383084,1684,904,780,22,1
383084,1534,834,700,23,1
383084,942,456,486,24,1
383084,592,378,214,25,1
383084,150,70,80,31,1
383084,592,378,214,40,1
383084,2467,1227,1240,41,4
383084,2467,1227,1240,42,1
383084,2170,1104,1066,43,1
383084,1409,747,662,44,1
383084,761,357,404,45,1
383084,297,123,174,51,1
383084,761,357,404,60,1
383163,435,15,420,1,4
383163,435,15,420,2,1
383163,435,15,420,3,1
383163,84,3,81,4,1
383163,351,12,339,5,1
383163,351,12,339,20,1
383163,49,1,48,21,4
383163,49,1,48,22,1
383163,49,1,48,23,1
383163,8,0,8,24,1
383163,41,1,40,25,1
383163,41,1,40,40,1
383163,386,14,372,41,4
383163,386,14,372,42,1
383163,386,14,372,43,1
383163,76,3,73,44,1
383163,310,11,299,45,1
383163,310,11,299,60,1
383172,35,10,25,1,4
383172,35,10,25,2,1
383172,35,10,25,3,1
383172,33,9,24,4,1
383172,2,1,1,5,1
383172,2,1,1,20,1
383172,35,10,25,21,4
383172,35,10,25,22,1
383172,35,10,25,23,1
383172,33,9,24,24,1
383172,2,1,1,25,1
383172,2,1,1,40,1
383190,3406,1413,1993,1,4
383190,3406,1413,1993,2,1
383190,2922,1264,1658,3,1
383190,727,365,362,4,1
383190,2195,899,1296,5,1
383190,484,149,335,11,1
383190,300,121,179,19,1
383190,1895,778,1117,20,1
383190,1598,767,831,21,4
383190,1598,767,831,22,1
383190,1586,761,825,23,1
383190,457,228,229,24,1
383190,1129,533,596,25,1
383190,12,6,6,31,1
383190,166,75,91,39,1
383190,963,458,505,40,1
383190,1808,646,1162,41,4
383190,1808,646,1162,42,1
383190,1336,503,833,43,1
383190,270,137,133,44,1
383190,1066,366,700,45,1
383190,472,143,329,51,1
383190,134,46,88,59,1
383190,932,320,612,60,1
383251,97,4,93,1,4
383251,97,4,93,2,1
383251,97,4,93,3,1
383251,23,0,23,4,1
383251,74,4,70,5,1
383251,74,4,70,20,1
383251,97,4,93,21,4
383251,97,4,93,22,1
383251,97,4,93,23,1
383251,23,0,23,24,1
383251,74,4,70,25,1
383251,74,4,70,40,1
383279,185,14,171,1,4
383279,185,14,171,2,1
383279,185,14,171,3,1
383279,23,3,20,4,1
383279,162,11,151,5,1
383279,162,11,151,20,1
383279,89,8,81,21,4
383279,89,8,81,22,1
383279,89,8,81,23,1
383279,15,3,12,24,1
383279,74,5,69,25,1
383279,74,5,69,40,1
383279,96,6,90,41,4
383279,96,6,90,42,1
383279,96,6,90,43,1
383279,8,0,8,44,1
383279,88,6,82,45,1
383279,88,6,82,60,1
383297,311,5,306,1,4
383297,311,5,306,2,1
383297,311,5,306,3,1
383297,94,1,93,4,1
383297,217,4,213,5,1
383297,217,4,213,20,1
383297,224,2,222,21,4
383297,224,2,222,22,1
383297,224,2,222,23,1
383297,79,1,78,24,1
383297,145,1,144,25,1
383297,145,1,144,40,1
383297,87,3,84,41,4
383297,87,3,84,42,1
383297,87,3,84,43,1
383297,15,0,15,44,1
383297,72,3,69,45,1
383297,72,3,69,60,1
383312,89,32,57,1,4
383312,89,32,57,2,1
383312,89,32,57,3,1
383312,82,31,51,4,1
383312,7,1,6,5,1
383312,7,1,6,20,1
383312,89,32,57,21,4
383312,89,32,57,22,1
383312,89,32,57,23,1
383312,82,31,51,24,1
383312,7,1,6,25,1
383312,7,1,6,40,1
383330,95,36,59,1,4
383330,95,36,59,2,1
383330,95,36,59,3,1
383330,60,30,30,4,1
383330,35,6,29,5,1
383330,35,6,29,20,1
383330,72,26,46,21,4
383330,72,26,46,22,1
383330,72,26,46,23,1
383330,45,21,24,24,1
383330,27,5,22,25,1
383330,27,5,22,40,1
383330,23,10,13,41,4
383330,23,10,13,42,1
383330,23,10,13,43,1
383330,15,9,6,44,1
383330,8,1,7,45,1
383330,8,1,7,60,1
383367,264,81,183,1,4
383367,264,81,183,2,1
383367,264,81,183,3,1
383367,141,43,98,4,1
383367,123,38,85,5,1
383367,123,38,85,20,1
383367,226,76,150,21,4
383367,226,76,150,22,1
383367,226,76,150,23,1
383367,113,42,71,24,1
383367,113,34,79,25,1
383367,113,34,79,40,1
383367,38,5,33,41,4
383367,38,5,33,42,1
383367,38,5,33,43,1
383367,28,1,27,44,1
383367,10,4,6,45,1
383367,10,4,6,60,1
383400,72,11,61,1,4
383400,72,11,61,2,1
383400,72,11,61,3,1
383400,72,11,61,5,1
383400,72,11,61,20,1
383400,72,11,61,21,4
383400,72,11,61,22,1
383400,72,11,61,23,1
383400,72,11,61,25,1
383400,72,11,61,40,1
383464,132,10,122,1,4
383464,132,10,122,2,1
383464,132,10,122,3,1
383464,100,8,92,4,1
383464,32,2,30,5,1
383464,32,2,30,20,1
383464,132,10,122,21,4
383464,132,10,122,22,1
383464,132,10,122,23,1
383464,100,8,92,24,1
383464,32,2,30,25,1
383464,32,2,30,40,1
383507,11,3,8,1,4
383507,11,3,8,2,1
383507,11,3,8,3,1
383507,6,2,4,4,1
383507,5,1,4,5,1
383507,5,1,4,20,1
383507,11,3,8,21,4
383507,11,3,8,22,1
383507,11,3,8,23,1
383507,6,2,4,24,1
383507,5,1,4,25,1
383507,5,1,4,40,1
383525,85,14,71,1,4
383525,85,14,71,2,1
383525,85,14,71,3,1
383525,17,4,13,4,1
383525,68,10,58,5,1
383525,68,10,58,20,1
383525,85,14,71,21,4
383525,85,14,71,22,1
383525,85,14,71,23,1
383525,17,4,13,24,1
383525,68,10,58,25,1
383525,68,10,58,40,1
383765,63,2,61,1,4
383765,63,2,61,2,1
383765,63,2,61,3,1
383765,29,0,29,4,1
383765,34,2,32,5,1
383765,34,2,32,20,1
383765,63,2,61,21,4
383765,63,2,61,22,1
383765,63,2,61,23,1
383765,29,0,29,24,1
383765,34,2,32,25,1
383765,34,2,32,40,1
383792,277,5,272,1,4
383792,277,5,272,2,1
383792,277,5,272,3,1
383792,123,4,119,4,1
383792,154,1,153,5,1
383792,154,1,153,20,1
383792,277,5,272,21,4
383792,277,5,272,22,1
383792,277,5,272,23,1
383792,123,4,119,24,1
383792,154,1,153,25,1
383792,154,1,153,40,1
383899,838,180,658,1,4
383899,838,180,658,2,1
383899,838,180,658,3,1
383899,759,169,590,4,1
383899,79,11,68,5,1
383899,79,11,68,20,1
383899,698,147,551,21,4
383899,698,147,551,22,1
383899,698,147,551,23,1
383899,624,137,487,24,1
383899,74,10,64,25,1
383899,74,10,64,40,1
383899,140,33,107,41,4
383899,140,33,107,42,1
383899,140,33,107,43,1
383899,135,32,103,44,1
383899,5,1,4,45,1
383899,5,1,4,60,1
383950,256,34,222,1,4
383950,256,34,222,2,1
383950,256,34,222,3,1
383950,89,13,76,4,1
383950,167,21,146,5,1
383950,167,21,146,20,1
383950,237,32,205,21,4
383950,237,32,205,22,1
383950,237,32,205,23,1
383950,83,12,71,24,1
383950,154,20,134,25,1
383950,154,20,134,40,1
383950,19,2,17,41,4
383950,19,2,17,42,1
383950,19,2,17,43,1
383950,6,1,5,44,1
383950,13,1,12,45,1
383950,13,1,12,60,1
383996,895,349,546,1,4
383996,895,349,546,2,1
383996,568,206,362,3,1
383996,86,43,43,4,1
383996,482,163,319,5,1
383996,327,143,184,11,1
383996,60,18,42,19,1
383996,422,145,277,20,1
383996,235,99,136,21,4
383996,235,99,136,22,1
383996,203,85,118,23,1
383996,69,33,36,24,1
383996,134,52,82,25,1
383996,32,14,18,31,1
383996,13,4,9,39,1
383996,121,48,73,40,1
383996,660,250,410,41,4
383996,660,250,410,42,1
383996,365,121,244,43,1
383996,17,10,7,44,1
383996,348,111,237,45,1
383996,295,129,166,51,1
383996,47,14,33,59,1
383996,301,97,204,60,1
384209,594,176,418,1,4
384209,594,176,418,2,1
384209,594,176,418,3,1
384209,253,66,187,4,1
384209,341,110,231,5,1
384209,341,110,231,20,1
384209,594,176,418,21,4
384209,594,176,418,22,1
384209,594,176,418,23,1
384209,253,66,187,24,1
384209,341,110,231,25,1
384209,341,110,231,40,1
384254,190,132,58,1,4
384254,190,132,58,2,1
384254,190,132,58,3,1
384254,41,26,15,4,1
384254,149,106,43,5,1
384254,20,14,6,19,1
384254,129,92,37,20,1
384254,188,130,58,21,4
384254,188,130,58,22,1
384254,188,130,58,23,1
384254,41,26,15,24,1
384254,147,104,43,25,1
384254,20,14,6,39,1
384254,127,90,37,40,1
384254,2,2,0,41,4
384254,2,2,0,42,1
384254,2,2,0,43,1
384254,2,2,0,45,1
384254,2,2,0,60,1
384306,140,25,115,1,4
384306,140,25,115,12,3
384306,106,20,86,21,4
384306,106,20,86,32,3
384306,34,5,29,41,4
384306,34,5,29,52,3
384333,8832,3673,5159,1,4
384333,8832,3673,5159,2,1
384333,7634,3175,4459,3,1
384333,1636,780,856,4,1
384333,5998,2395,3603,5,1
384333,1198,498,700,11,1
384333,793,350,443,19,1
384333,5205,2045,3160,20,1
384333,2810,1255,1555,21,4
384333,2810,1255,1555,22,1
384333,2671,1197,1474,23,1
384333,855,402,453,24,1
384333,1816,795,1021,25,1
384333,139,58,81,31,1
384333,206,101,105,39,1
384333,1610,694,916,40,1
384333,6022,2418,3604,41,4
384333,6022,2418,3604,42,1
384333,4963,1978,2985,43,1
384333,781,378,403,44,1
384333,4182,1600,2582,45,1
384333,1059,440,619,51,1
384333,587,249,338,59,1
384333,3595,1351,2244,60,1
384342,5215,2414,2801,1,4
384342,5215,2414,2801,2,1
384342,4692,2193,2499,3,1
384342,783,403,380,4,1
384342,3909,1790,2119,5,1
384342,523,221,302,11,1
384342,474,235,239,19,1
384342,3435,1555,1880,20,1
384342,2241,1160,1081,21,4
384342,2241,1160,1081,22,1
384342,2177,1132,1045,23,1
384342,511,279,232,24,1
384342,1666,853,813,25,1
384342,64,28,36,31,1
384342,250,138,112,39,1
384342,1416,715,701,40,1
384342,2974,1254,1720,41,4
384342,2974,1254,1720,42,1
384342,2515,1061,1454,43,1
384342,272,124,148,44,1
384342,2243,937,1306,45,1
384342,459,193,266,51,1
384342,224,97,127,59,1
384342,2019,840,1179,60,1
384412,341,168,173,1,4
384412,330,163,167,2,1
384412,320,155,165,3,1
384412,12,5,7,4,1
384412,308,150,158,5,1
384412,10,8,2,11,1
384412,11,5,6,12,3
384412,21,6,15,19,1
384412,287,144,143,20,1
384412,341,168,173,21,4
384412,330,163,167,22,1
384412,320,155,165,23,1
384412,12,5,7,24,1
384412,308,150,158,25,1
384412,10,8,2,31,1
384412,11,5,6,32,3
384412,21,6,15,39,1
384412,287,144,143,40,1
384421,86,86,0,1,4
384421,86,86,0,2,1
384421,86,86,0,3,1
384421,32,32,0,4,1
384421,54,54,0,5,1
384421,1,1,0,19,1
384421,53,53,0,20,1
384421,86,86,0,21,4
384421,86,86,0,22,1
384421,86,86,0,23,1
384421,32,32,0,24,1
384421,54,54,0,25,1
384421,1,1,0,39,1
384421,53,53,0,40,1
385008,477,60,417,1,4
385008,477,60,417,2,1
385008,477,60,417,3,1
385008,54,6,48,4,1
385008,423,54,369,5,1
385008,45,4,41,19,1
385008,378,50,328,20,1
385008,465,59,406,21,4
385008,465,59,406,22,1
385008,465,59,406,23,1
385008,54,6,48,24,1
385008,411,53,358,25,1
385008,45,4,41,39,1
385008,366,49,317,40,1
385008,12,1,11,41,4
385008,12,1,11,42,1
385008,12,1,11,43,1
385008,12,1,11,45,1
385008,12,1,11,60,1
385132,99,8,91,1,4
385132,99,8,91,2,1
385132,99,8,91,3,1
385132,90,7,83,4,1
385132,9,1,8,5,1
385132,9,1,8,20,1
385132,89,7,82,21,4
385132,89,7,82,22,1
385132,89,7,82,23,1
385132,87,6,81,24,1
385132,2,1,1,25,1
385132,2,1,1,40,1
385132,10,1,9,41,4
385132,10,1,9,42,1
385132,10,1,9,43,1
385132,3,1,2,44,1
385132,7,0,7,45,1
385132,7,0,7,60,1
385503,464,68,396,1,4
385503,464,68,396,2,1
385503,464,68,396,3,1
385503,66,10,56,4,1
385503,398,58,340,5,1
385503,64,15,49,19,1
385503,334,43,291,20,1
385503,408,58,350,21,4
385503,408,58,350,22,1
385503,408,58,350,23,1
385503,61,10,51,24,1
385503,347,48,299,25,1
385503,56,13,43,39,1
385503,291,35,256,40,1
385503,56,10,46,41,4
385503,56,10,46,42,1
385503,56,10,46,43,1
385503,5,0,5,44,1
385503,51,10,41,45,1
385503,8,2,6,59,1
385503,43,8,35,60,1
385549,174,26,148,1,4
385549,174,26,148,2,1
385549,174,26,148,3,1
385549,47,4,43,4,1
385549,127,22,105,5,1
385549,127,22,105,20,1
385549,174,26,148,21,4
385549,174,26,148,22,1
385549,174,26,148,23,1
385549,47,4,43,24,1
385549,127,22,105,25,1
385549,127,22,105,40,1
385619,1252,625,627,1,4
385619,1184,581,603,2,1
385619,1184,581,603,3,1
385619,54,31,23,4,1
385619,1130,550,580,5,1
385619,68,44,24,12,3
385619,3,0,3,19,1
385619,1127,550,577,20,1
385619,1203,595,608,21,4
385619,1184,581,603,22,1
385619,1184,581,603,23,1
385619,54,31,23,24,1
385619,1130,550,580,25,1
385619,19,14,5,32,3
385619,3,0,3,39,1
385619,1127,550,577,40,1
385619,49,30,19,41,4
385619,49,30,19,52,3
386153,257,0,257,1,4
386153,257,0,257,2,1
386153,257,0,257,3,1
386153,257,0,257,4,1
386153,143,0,143,21,4
386153,143,0,143,22,1
386153,143,0,143,23,1
386153,143,0,143,24,1
386153,114,0,114,41,4
386153,114,0,114,42,1
386153,114,0,114,43,1
386153,114,0,114,44,1
386472,378,93,285,1,4
386472,378,93,285,2,1
386472,377,93,284,3,1
386472,12,2,10,4,1
386472,365,91,274,5,1
386472,1,0,1,11,1
386472,34,8,26,19,1
386472,331,83,248,20,1
386472,256,65,191,21,4
386472,256,65,191,22,1
386472,256,65,191,23,1
386472,11,2,9,24,1
386472,245,63,182,25,1
386472,20,5,15,39,1
386472,225,58,167,40,1
386472,122,28,94,41,4
386472,122,28,94,42,1
386472,121,28,93,43,1
386472,1,0,1,44,1
386472,120,28,92,45,1
386472,1,0,1,51,1
386472,14,3,11,59,1
386472,106,25,81,60,1
387660,3,3,0,1,4
387660,3,3,0,2,1
387660,3,3,0,3,1
387660,1,1,0,4,1
387660,2,2,0,5,1
387660,2,2,0,20,1
387660,3,3,0,21,4
387660,3,3,0,22,1
387660,3,3,0,23,1
387660,1,1,0,24,1
387660,2,2,0,25,1
387660,2,2,0,40,1
387819,105,21,84,1,4
387819,105,21,84,2,1
387819,105,21,84,3,1
387819,59,15,44,4,1
387819,46,6,40,5,1
387819,46,6,40,20,1
387819,91,18,73,21,4
387819,91,18,73,22,1
387819,91,18,73,23,1
387819,51,12,39,24,1
387819,40,6,34,25,1
387819,40,6,34,40,1
387819,14,3,11,41,4
387819,14,3,11,42,1
387819,14,3,11,43,1
387819,8,3,5,44,1
387819,6,0,6,45,1
387819,6,0,6,60,1
387925,262,33,229,1,4
387925,262,33,229,2,1
387925,262,33,229,3,1
387925,84,8,76,4,1
387925,178,25,153,5,1
387925,4,0,4,19,1
387925,174,25,149,20,1
387925,262,33,229,21,4
387925,262,33,229,22,1
387925,262,33,229,23,1
387925,84,8,76,24,1
387925,178,25,153,25,1
387925,4,0,4,39,1
387925,174,25,149,40,1
388043,710,148,562,1,4
388043,710,148,562,2,1
388043,704,147,557,3,1
388043,46,13,33,4,1
388043,658,134,524,5,1
388043,6,1,5,11,1
388043,151,27,124,19,1
388043,507,107,400,20,1
388043,503,113,390,21,4
388043,503,113,390,22,1
388043,503,113,390,23,1
388043,43,12,31,24,1
388043,460,101,359,25,1
388043,123,25,98,39,1
388043,337,76,261,40,1
388043,207,35,172,41,4
388043,207,35,172,42,1
388043,201,34,167,43,1
388043,3,1,2,44,1
388043,198,33,165,45,1
388043,6,1,5,51,1
388043,28,2,26,59,1
388043,170,31,139,60,1
388520,498,282,216,1,4
388520,498,282,216,2,1
388520,493,278,215,3,1
388520,46,22,24,4,1
388520,447,256,191,5,1
388520,5,4,1,11,1
388520,49,21,28,19,1
388520,398,235,163,20,1
388520,74,41,33,21,4
388520,74,41,33,22,1
388520,74,41,33,23,1
388520,14,7,7,24,1
388520,60,34,26,25,1
388520,15,6,9,39,1
388520,45,28,17,40,1
388520,424,241,183,41,4
388520,424,241,183,42,1
388520,419,237,182,43,1
388520,32,15,17,44,1
388520,387,222,165,45,1
388520,5,4,1,51,1
388520,34,15,19,59,1
388520,353,207,146,60,1
388663,139,13,126,1,4
388663,139,13,126,2,1
388663,139,13,126,3,1
388663,42,8,34,4,1
388663,97,5,92,5,1
388663,97,5,92,20,1
388663,139,13,126,21,4
388663,139,13,126,22,1
388663,139,13,126,23,1
388663,42,8,34,24,1
388663,97,5,92,25,1
388663,97,5,92,40,1
389727,365,60,305,1,4
389727,365,60,305,2,1
389727,365,60,305,3,1
389727,163,24,139,4,1
389727,202,36,166,5,1
389727,202,36,166,20,1
389727,246,42,204,21,4
389727,246,42,204,22,1
389727,246,42,204,23,1
389727,139,20,119,24,1
389727,107,22,85,25,1
389727,107,22,85,40,1
389727,119,18,101,41,4
389727,119,18,101,42,1
389727,119,18,101,43,1
389727,24,4,20,44,1
389727,95,14,81,45,1
389727,95,14,81,60,1
389860,385,179,206,1,4
389860,385,179,206,2,1
389860,385,179,206,3,1
389860,180,101,79,4,1
389860,205,78,127,5,1
389860,205,78,127,20,1
389860,270,139,131,21,4
389860,270,139,131,22,1
389860,270,139,131,23,1
389860,133,84,49,24,1
389860,137,55,82,25,1
389860,137,55,82,40,1
389860,115,40,75,41,4
389860,115,40,75,42,1
389860,115,40,75,43,1
389860,47,17,30,44,1
389860,68,23,45,45,1
389860,68,23,45,60,1
390701,29693,6911,22782,1,4
390701,29460,6845,22615,2,1
390701,29460,6845,22615,3,1
390701,314,127,187,4,1
390701,29146,6718,22428,5,1
390701,233,66,167,12,3
390701,6213,1590,4623,19,1
390701,22933,5128,17805,20,1
390701,15437,3309,12128,21,4
390701,15344,3291,12053,22,1
390701,15344,3291,12053,23,1
390701,180,61,119,24,1
390701,15164,3230,11934,25,1
390701,93,18,75,32,3
390701,3751,915,2836,39,1
390701,11413,2315,9098,40,1
390701,14256,3602,10654,41,4
390701,14116,3554,10562,42,1
390701,14116,3554,10562,43,1
390701,134,66,68,44,1
390701,13982,3488,10494,45,1
390701,140,48,92,52,3
390701,2462,675,1787,59,1
390701,11520,2813,8707,60,1
390905,350,171,179,1,4
390905,350,171,179,2,1
390905,350,171,179,3,1
390905,246,121,125,4,1
390905,104,50,54,5,1
390905,104,50,54,20,1
390905,350,171,179,21,4
390905,350,171,179,22,1
390905,350,171,179,23,1
390905,246,121,125,24,1
390905,104,50,54,25,1
390905,104,50,54,40,1
391005,241,10,231,1,4
391005,241,10,231,2,1
391005,241,10,231,3,1
391005,15,1,14,4,1
391005,226,9,217,5,1
391005,226,9,217,20,1
391005,241,10,231,21,4
391005,241,10,231,22,1
391005,241,10,231,23,1
391005,15,1,14,24,1
391005,226,9,217,25,1
391005,226,9,217,40,1
391333,34,3,31,1,4
391333,34,3,31,2,1
391333,34,3,31,3,1
391333,9,0,9,4,1
391333,25,3,22,5,1
391333,25,3,22,20,1
391333,34,3,31,21,4
391333,34,3,31,22,1
391333,34,3,31,23,1
391333,9,0,9,24,1
391333,25,3,22,25,1
391333,25,3,22,40,1
391546,64,7,57,1,4
391546,64,7,57,2,1
391546,64,7,57,3,1
391546,30,5,25,4,1
391546,34,2,32,5,1
391546,34,2,32,20,1
391546,5,3,2,21,4
391546,5,3,2,22,1
391546,5,3,2,23,1
391546,3,2,1,24,1
391546,2,1,1,25,1
391546,2,1,1,40,1
391546,59,4,55,41,4
391546,59,4,55,42,1
391546,59,4,55,43,1
391546,27,3,24,44,1
391546,32,1,31,45,1
391546,32,1,31,60,1
391564,230,20,210,1,4
391564,230,20,210,2,1
391564,230,20,210,3,1
391564,165,14,151,4,1
391564,65,6,59,5,1
391564,65,6,59,20,1
391564,175,15,160,21,4
391564,175,15,160,22,1
391564,175,15,160,23,1
391564,120,9,111,24,1
391564,55,6,49,25,1
391564,55,6,49,40,1
391564,55,5,50,41,4
391564,55,5,50,42,1
391564,55,5,50,43,1
391564,45,5,40,44,1
391564,10,0,10,45,1
391564,10,0,10,60,1
391582,28,2,26,1,4
391582,28,2,26,2,1
391582,28,2,26,3,1
391582,28,2,26,5,1
391582,28,2,26,20,1
391582,23,2,21,21,4
391582,23,2,21,22,1
391582,23,2,21,23,1
391582,23,2,21,25,1
391582,23,2,21,40,1
391582,5,0,5,41,4
391582,5,0,5,42,1
391582,5,0,5,43,1
391582,5,0,5,45,1
391582,5,0,5,60,1
391759,73,4,69,1,4
391759,73,4,69,2,1
391759,73,4,69,3,1
391759,39,2,37,4,1
391759,34,2,32,5,1
391759,34,2,32,20,1
391759,2,0,2,21,4
391759,2,0,2,22,1
391759,2,0,2,23,1
391759,1,0,1,24,1
391759,1,0,1,25,1
391759,1,0,1,40,1
391759,71,4,67,41,4
391759,71,4,67,42,1
391759,71,4,67,43,1
391759,38,2,36,44,1
391759,33,2,31,45,1
391759,33,2,31,60,1
391810,56,10,46,1,4
391810,56,10,46,2,1
391810,56,10,46,3,1
391810,10,1,9,4,1
391810,46,9,37,5,1
391810,46,9,37,20,1
391810,56,10,46,21,4
391810,56,10,46,22,1
391810,56,10,46,23,1
391810,10,1,9,24,1
391810,46,9,37,25,1
391810,46,9,37,40,1
392257,810,96,714,1,4
392257,810,96,714,2,1
392257,810,96,714,3,1
392257,802,94,708,4,1
392257,8,2,6,5,1
392257,6,1,5,19,1
392257,2,1,1,20,1
392257,810,96,714,21,4
392257,810,96,714,22,1
392257,810,96,714,23,1
392257,802,94,708,24,1
392257,8,2,6,25,1
392257,6,1,5,39,1
392257,2,1,1,40,1
392354,10,7,3,1,4
392354,10,7,3,2,1
392354,10,7,3,3,1
392354,1,1,0,4,1
392354,9,6,3,5,1
392354,9,6,3,20,1
392354,10,7,3,21,4
392354,10,7,3,22,1
392354,10,7,3,23,1
392354,1,1,0,24,1
392354,9,6,3,25,1
392354,9,6,3,40,1
392415,382,35,347,1,4
392415,382,35,347,2,1
392415,382,35,347,3,1
392415,58,6,52,4,1
392415,324,29,295,5,1
392415,324,29,295,20,1
392415,382,35,347,21,4
392415,382,35,347,22,1
392415,382,35,347,23,1
392415,58,6,52,24,1
392415,324,29,295,25,1
392415,324,29,295,40,1
392798,44,4,40,1,4
392798,44,4,40,2,1
392798,44,4,40,3,1
392798,6,1,5,4,1
392798,38,3,35,5,1
392798,38,3,35,20,1
392798,29,3,26,21,4
392798,29,3,26,22,1
392798,29,3,26,23,1
392798,3,1,2,24,1
392798,26,2,24,25,1
392798,26,2,24,40,1
392798,15,1,14,41,4
392798,15,1,14,42,1
392798,15,1,14,43,1
392798,3,0,3,44,1
392798,12,1,11,45,1
392798,12,1,11,60,1
392840,363,165,198,1,4
392840,363,165,198,2,1
392840,334,152,182,3,1
392840,58,23,35,4,1
392840,276,129,147,5,1
392840,29,13,16,11,1
392840,25,14,11,19,1
392840,251,115,136,20,1
392840,251,107,144,21,4
392840,251,107,144,22,1
392840,251,107,144,23,1
392840,53,21,32,24,1
392840,198,86,112,25,1
392840,20,10,10,39,1
392840,178,76,102,40,1
392840,112,58,54,41,4
392840,112,58,54,42,1
392840,83,45,38,43,1
392840,5,2,3,44,1
392840,78,43,35,45,1
392840,29,13,16,51,1
392840,5,4,1,59,1
392840,73,39,34,60,1
393180,425,145,280,1,4
393180,425,145,280,2,1
393180,425,145,280,3,1
393180,138,47,91,4,1
393180,287,98,189,5,1
393180,8,1,7,19,1
393180,279,97,182,20,1
393180,425,145,280,21,4
393180,425,145,280,22,1
393180,425,145,280,23,1
393180,138,47,91,24,1
393180,287,98,189,25,1
393180,8,1,7,39,1
393180,279,97,182,40,1
393524,159,13,146,1,4
393524,159,13,146,2,1
393524,159,13,146,3,1
393524,48,5,43,4,1
393524,111,8,103,5,1
393524,111,8,103,20,1
393524,159,13,146,21,4
393524,159,13,146,22,1
393524,159,13,146,23,1
393524,48,5,43,24,1
393524,111,8,103,25,1
393524,111,8,103,40,1
393649,1444,435,1009,1,4
393649,1444,435,1009,2,1
393649,1444,435,1009,3,1
393649,443,153,290,4,1
393649,1001,282,719,5,1
393649,1001,282,719,20,1
393649,1444,435,1009,21,4
393649,1444,435,1009,22,1
393649,1444,435,1009,23,1
393649,443,153,290,24,1
393649,1001,282,719,25,1
393649,1001,282,719,40,1
393861,142,25,117,1,4
393861,142,25,117,2,1
393861,142,25,117,3,1
393861,54,10,44,4,1
393861,88,15,73,5,1
393861,88,15,73,20,1
393861,101,15,86,21,4
393861,101,15,86,22,1
393861,101,15,86,23,1
393861,44,9,35,24,1
393861,57,6,51,25,1
393861,57,6,51,40,1
393861,41,10,31,41,4
393861,41,10,31,42,1
393861,41,10,31,43,1
393861,10,1,9,44,1
393861,31,9,22,45,1
393861,31,9,22,60,1
393977,54,1,53,1,4
393977,54,1,53,2,1
393977,54,1,53,3,1
393977,20,0,20,4,1
393977,34,1,33,5,1
393977,34,1,33,20,1
393977,54,1,53,21,4
393977,54,1,53,22,1
393977,54,1,53,23,1
393977,20,0,20,24,1
393977,34,1,33,25,1
393977,34,1,33,40,1
395195,101,19,82,1,4
395195,101,19,82,2,1
395195,101,19,82,3,1
395195,50,11,39,4,1
395195,51,8,43,5,1
395195,51,8,43,20,1
395195,101,19,82,21,4
395195,101,19,82,22,1
395195,101,19,82,23,1
395195,50,11,39,24,1
395195,51,8,43,25,1
395195,51,8,43,40,1
395362,1783,647,1136,1,4
395362,1783,647,1136,2,1
395362,1479,520,959,3,1
395362,306,131,175,4,1
395362,1173,389,784,5,1
395362,304,127,177,11,1
395362,104,32,72,19,1
395362,1069,357,712,20,1
395362,750,268,482,21,4
395362,750,268,482,22,1
395362,679,236,443,23,1
395362,157,64,93,24,1
395362,522,172,350,25,1
395362,71,32,39,31,1
395362,45,14,31,39,1
395362,477,158,319,40,1
395362,1033,379,654,41,4
395362,1033,379,654,42,1
395362,800,284,516,43,1
395362,149,67,82,44,1
395362,651,217,434,45,1
395362,233,95,138,51,1
395362,59,18,41,59,1
395362,592,199,393,60,1
395690,913,306,607,1,4
395690,913,306,607,2,1
395690,913,306,607,3,1
395690,626,218,408,4,1
395690,287,88,199,5,1
395690,287,88,199,20,1
395690,617,214,403,21,4
395690,617,214,403,22,1
395690,617,214,403,23,1
395690,422,153,269,24,1
395690,195,61,134,25,1
395690,195,61,134,40,1
395690,296,92,204,41,4
395690,296,92,204,42,1
395690,296,92,204,43,1
395690,204,65,139,44,1
395690,92,27,65,45,1
395690,92,27,65,60,1
397270,82,58,24,1,4
397270,33,21,12,2,1
397270,33,21,12,3,1
397270,10,7,3,4,1
397270,23,14,9,5,1
397270,49,37,12,12,3
397270,6,6,0,19,1
397270,17,8,9,20,1
397270,82,58,24,21,4
397270,33,21,12,22,1
397270,33,21,12,23,1
397270,10,7,3,24,1
397270,23,14,9,25,1
397270,49,37,12,32,3
397270,6,6,0,39,1
397270,17,8,9,40,1
397942,1014,131,883,1,4
397942,1014,131,883,2,1
397942,1014,131,883,3,1
397942,346,48,298,4,1
397942,668,83,585,5,1
397942,668,83,585,20,1
397942,1014,131,883,21,4
397942,1014,131,883,22,1
397942,1014,131,883,23,1
397942,346,48,298,24,1
397942,668,83,585,25,1
397942,668,83,585,40,1
398130,538,377,161,1,4
398130,538,377,161,2,1
398130,536,376,160,3,1
398130,63,49,14,4,1
398130,473,327,146,5,1
398130,2,1,1,11,1
398130,44,31,13,19,1
398130,429,296,133,20,1
398130,340,253,87,21,4
398130,340,253,87,22,1
398130,339,252,87,23,1
398130,53,41,12,24,1
398130,286,211,75,25,1
398130,1,1,0,31,1
398130,33,25,8,39,1
398130,253,186,67,40,1
398130,198,124,74,41,4
398130,198,124,74,42,1
398130,197,124,73,43,1
398130,10,8,2,44,1
398130,187,116,71,45,1
398130,1,0,1,51,1
398130,11,6,5,59,1
398130,176,110,66,60,1
398574,1400,1270,130,1,4
398574,1400,1270,130,2,1
398574,1400,1270,130,3,1
398574,253,237,16,4,1
398574,1147,1033,114,5,1
398574,64,58,6,19,1
398574,1083,975,108,20,1
398574,1400,1270,130,21,4
398574,1400,1270,130,22,1
398574,1400,1270,130,23,1
398574,253,237,16,24,1
398574,1147,1033,114,25,1
398574,64,58,6,39,1
398574,1083,975,108,40,1
399212,10939,6764,4175,1,4
399212,10939,6764,4175,2,1
399212,10055,6285,3770,3,1
399212,2151,1145,1006,4,1
399212,7904,5140,2764,5,1
399212,884,479,405,11,1
399212,1112,691,421,19,1
399212,6792,4449,2343,20,1
399212,1938,958,980,21,4
399212,1938,958,980,22,1
399212,1897,932,965,23,1
399212,769,345,424,24,1
399212,1128,587,541,25,1
399212,41,26,15,31,1
399212,99,52,47,39,1
399212,1029,535,494,40,1
399212,9001,5806,3195,41,4
399212,9001,5806,3195,42,1
399212,8158,5353,2805,43,1
399212,1382,800,582,44,1
399212,6776,4553,2223,45,1
399212,843,453,390,51,1
399212,1013,639,374,59,1
399212,5763,3914,1849,60,1
399869,496,472,24,1,4
399869,496,472,24,2,1
399869,493,469,24,3,1
399869,135,124,11,4,1
399869,358,345,13,5,1
399869,3,3,0,11,1
399869,358,345,13,20,1
399869,496,472,24,21,4
399869,496,472,24,22,1
399869,493,469,24,23,1
399869,135,124,11,24,1
399869,358,345,13,25,1
399869,3,3,0,31,1
399869,358,345,13,40,1
399911,412,150,262,1,4
399911,412,150,262,2,1
399911,412,150,262,3,1
399911,112,44,68,4,1
399911,300,106,194,5,1
399911,300,106,194,20,1
399911,412,150,262,21,4
399911,412,150,262,22,1
399911,412,150,262,23,1
399911,112,44,68,24,1
399911,300,106,194,25,1
399911,300,106,194,40,1
400080,947,214,733,1,4
400080,947,214,733,2,1
400080,947,214,733,3,1
400080,941,211,730,4,1
400080,6,3,3,5,1
400080,6,3,3,20,1
400080,947,214,733,21,4
400080,947,214,733,22,1
400080,947,214,733,23,1
400080,941,211,730,24,1
400080,6,3,3,25,1
400080,6,3,3,40,1
400187,506,85,421,1,4
400187,506,85,421,2,1
400187,506,85,421,3,1
400187,331,51,280,4,1
400187,175,34,141,5,1
400187,175,34,141,20,1
400187,368,66,302,21,4
400187,368,66,302,22,1
400187,368,66,302,23,1
400187,264,44,220,24,1
400187,104,22,82,25,1
400187,104,22,82,40,1
400187,138,19,119,41,4
400187,138,19,119,42,1
400187,138,19,119,43,1
400187,67,7,60,44,1
400187,71,12,59,45,1
400187,71,12,59,60,1
401223,261,113,148,1,4
401223,122,42,80,2,1
401223,122,42,80,3,1
401223,5,1,4,4,1
401223,117,41,76,5,1
401223,139,71,68,12,3
401223,12,5,7,19,1
401223,105,36,69,20,1
401223,167,71,96,21,4
401223,73,24,49,22,1
401223,73,24,49,23,1
401223,2,0,2,24,1
401223,71,24,47,25,1
401223,94,47,47,32,3
401223,7,4,3,39,1
401223,64,20,44,40,1
401223,94,42,52,41,4
401223,49,18,31,42,1
401223,49,18,31,43,1
401223,3,1,2,44,1
401223,46,17,29,45,1
401223,45,24,21,52,3
401223,5,1,4,59,1
401223,41,16,25,60,1
401250,211,47,164,1,4
401250,211,47,164,12,3
401250,154,37,117,21,4
401250,154,37,117,32,3
401250,57,10,47,41,4
401250,57,10,47,52,3
401339,169,84,85,1,4
401339,169,84,85,2,1
401339,169,84,85,3,1
401339,57,20,37,4,1
401339,112,64,48,5,1
401339,112,64,48,20,1
401339,169,84,85,21,4
401339,169,84,85,22,1
401339,169,84,85,23,1
401339,57,20,37,24,1
401339,112,64,48,25,1
401339,112,64,48,40,1
401481,52,0,52,1,4
401481,52,0,52,2,1
401481,52,0,52,3,1
401481,20,0,20,4,1
401481,32,0,32,5,1
401481,32,0,32,20,1
401481,16,0,16,21,4
401481,16,0,16,22,1
401481,16,0,16,23,1
401481,8,0,8,24,1
401481,8,0,8,25,1
401481,8,0,8,40,1
401481,36,0,36,41,4
401481,36,0,36,42,1
401481,36,0,36,43,1
401481,12,0,12,44,1
401481,24,0,24,45,1
401481,24,0,24,60,1
402563,102,2,100,1,4
402563,102,2,100,2,1
402563,102,2,100,3,1
402563,20,0,20,4,1
402563,82,2,80,5,1
402563,82,2,80,20,1
402563,102,2,100,21,4
402563,102,2,100,22,1
402563,102,2,100,23,1
402563,20,0,20,24,1
402563,82,2,80,25,1
402563,82,2,80,40,1
402615,276,117,159,1,4
402615,242,100,142,2,1
402615,242,100,142,3,1
402615,242,100,142,5,1
402615,34,17,17,12,3
402615,242,100,142,20,1
402615,144,58,86,21,4
402615,133,53,80,22,1
402615,133,53,80,23,1
402615,133,53,80,25,1
402615,11,5,6,32,3
402615,133,53,80,40,1
402615,132,59,73,41,4
402615,109,47,62,42,1
402615,109,47,62,43,1
402615,109,47,62,45,1
402615,23,12,11,52,3
402615,109,47,62,60,1
402776,224,86,138,1,4
402776,224,86,138,2,1
402776,224,86,138,3,1
402776,32,17,15,4,1
402776,192,69,123,5,1
402776,11,2,9,19,1
402776,181,67,114,20,1
402776,127,53,74,21,4
402776,127,53,74,22,1
402776,127,53,74,23,1
402776,22,12,10,24,1
402776,105,41,64,25,1
402776,3,0,3,39,1
402776,102,41,61,40,1
402776,97,33,64,41,4
402776,97,33,64,42,1
402776,97,33,64,43,1
402776,10,5,5,44,1
402776,87,28,59,45,1
402776,8,2,6,59,1
402776,79,26,53,60,1
402800,144,14,130,1,4
402800,144,14,130,2,1
402800,144,14,130,3,1
402800,23,2,21,4,1
402800,121,12,109,5,1
402800,121,12,109,20,1
402800,106,11,95,21,4
402800,106,11,95,22,1
402800,106,11,95,23,1
402800,18,2,16,24,1
402800,88,9,79,25,1
402800,88,9,79,40,1
402800,38,3,35,41,4
402800,38,3,35,42,1
402800,38,3,35,43,1
402800,5,0,5,44,1
402800,33,3,30,45,1
402800,33,3,30,60,1
402828,381,164,217,1,4
402828,381,164,217,12,3
402828,289,154,135,21,4
402828,289,154,135,32,3
402828,92,10,82,41,4
402828,92,10,82,52,3
403414,41,0,41,1,4
403414,41,0,41,2,1
403414,41,0,41,3,1
403414,6,0,6,4,1
403414,35,0,35,5,1
403414,35,0,35,20,1
403414,17,0,17,21,4
403414,17,0,17,22,1
403414,17,0,17,23,1
403414,4,0,4,24,1
403414,13,0,13,25,1
403414,13,0,13,40,1
403414,24,0,24,41,4
403414,24,0,24,42,1
403414,24,0,24,43,1
403414,2,0,2,44,1
403414,22,0,22,45,1
403414,22,0,22,60,1
403469,2194,778,1416,1,4
403469,2194,778,1416,2,1
403469,446,187,259,3,1
403469,96,36,60,4,1
403469,350,151,199,5,1
403469,1748,591,1157,11,1
403469,10,7,3,19,1
403469,340,144,196,20,1
403469,226,82,144,21,4
403469,226,82,144,22,1
403469,201,76,125,23,1
403469,69,24,45,24,1
403469,132,52,80,25,1
403469,25,6,19,31,1
403469,6,5,1,39,1
403469,126,47,79,40,1
403469,1968,696,1272,41,4
403469,1968,696,1272,42,1
403469,245,111,134,43,1
403469,27,12,15,44,1
403469,218,99,119,45,1
403469,1723,585,1138,51,1
403469,4,2,2,59,1
403469,214,97,117,60,1
403478,972,406,566,1,4
403478,972,406,566,2,1
403478,533,232,301,3,1
403478,174,88,86,4,1
403478,359,144,215,5,1
403478,439,174,265,11,1
403478,9,3,6,19,1
403478,350,141,209,20,1
403478,421,203,218,21,4
403478,421,203,218,22,1
403478,399,193,206,23,1
403478,160,80,80,24,1
403478,239,113,126,25,1
403478,22,10,12,31,1
403478,6,3,3,39,1
403478,233,110,123,40,1
403478,551,203,348,41,4
403478,551,203,348,42,1
403478,134,39,95,43,1
403478,14,8,6,44,1
403478,120,31,89,45,1
403478,417,164,253,51,1
403478,3,0,3,59,1
403478,117,31,86,60,1
403487,4512,2932,1580,1,4
403487,4512,2932,1580,2,1
403487,840,474,366,3,1
403487,364,232,132,4,1
403487,476,242,234,5,1
403487,3672,2458,1214,11,1
403487,39,22,17,19,1
403487,437,220,217,20,1
403487,554,295,259,21,4
403487,554,295,259,22,1
403487,528,282,246,23,1
403487,269,151,118,24,1
403487,259,131,128,25,1
403487,26,13,13,31,1
403487,26,16,10,39,1
403487,233,115,118,40,1
403487,3958,2637,1321,41,4
403487,3958,2637,1321,42,1
403487,312,192,120,43,1
403487,95,81,14,44,1
403487,217,111,106,45,1
403487,3646,2445,1201,51,1
403487,13,6,7,59,1
403487,204,105,99,60,1
404037,32,4,28,1,4
404037,32,4,28,2,1
404037,32,4,28,3,1
404037,3,1,2,4,1
404037,29,3,26,5,1
404037,29,3,26,20,1
404037,32,4,28,21,4
404037,32,4,28,22,1
404037,32,4,28,23,1
404037,3,1,2,24,1
404037,29,3,26,25,1
404037,29,3,26,40,1
404055,223,47,176,1,4
404055,223,47,176,2,1
404055,223,47,176,3,1
404055,80,15,65,4,1
404055,143,32,111,5,1
404055,143,32,111,20,1
404055,223,47,176,21,4
404055,223,47,176,22,1
404055,223,47,176,23,1
404055,80,15,65,24,1
404055,143,32,111,25,1
404055,143,32,111,40,1
404073,3105,861,2244,1,4
404073,3082,851,2231,2,1
404073,3066,844,2222,3,1
404073,315,108,207,4,1
404073,2751,736,2015,5,1
404073,16,7,9,11,1
404073,23,10,13,12,3
404073,384,100,284,19,1
404073,2367,636,1731,20,1
404073,1314,387,927,21,4
404073,1310,384,926,22,1
404073,1310,384,926,23,1
404073,175,68,107,24,1
404073,1135,316,819,25,1
404073,4,3,1,32,3
404073,156,51,105,39,1
404073,979,265,714,40,1
404073,1791,474,1317,41,4
404073,1772,467,1305,42,1
404073,1756,460,1296,43,1
404073,140,40,100,44,1
404073,1616,420,1196,45,1
404073,16,7,9,51,1
404073,19,7,12,52,3
404073,228,49,179,59,1
404073,1388,371,1017,60,1
404082,4383,1374,3009,1,4
404082,4358,1367,2991,2,1
404082,4345,1363,2982,3,1
404082,715,264,451,4,1
404082,3630,1099,2531,5,1
404082,13,4,9,11,1
404082,25,7,18,12,3
404082,327,98,229,19,1
404082,3303,1001,2302,20,1
404082,2256,761,1495,21,4
404082,2253,760,1493,22,1
404082,2252,760,1492,23,1
404082,563,208,355,24,1
404082,1689,552,1137,25,1
404082,1,0,1,31,1
404082,3,1,2,32,3
404082,164,57,107,39,1
404082,1525,495,1030,40,1
404082,2127,613,1514,41,4
404082,2105,607,1498,42,1
404082,2093,603,1490,43,1
404082,152,56,96,44,1
404082,1941,547,1394,45,1
404082,12,4,8,51,1
404082,22,6,16,52,3
404082,163,41,122,59,1
404082,1778,506,1272,60,1
404222,221,79,142,1,4
404222,221,79,142,12,3
404222,217,76,141,21,4
404222,217,76,141,32,3
404222,4,3,1,41,4
404222,4,3,1,52,3
404338,159,58,101,1,4
404338,128,48,80,2,1
404338,128,48,80,3,1
404338,12,1,11,4,1
404338,116,47,69,5,1
404338,31,10,21,12,3
404338,20,7,13,19,1
404338,96,40,56,20,1
404338,159,58,101,21,4
404338,128,48,80,22,1
404338,128,48,80,23,1
404338,12,1,11,24,1
404338,116,47,69,25,1
404338,31,10,21,32,3
404338,20,7,13,39,1
404338,96,40,56,40,1
404365,312,175,137,1,4
404365,312,175,137,2,1
404365,312,175,137,3,1
404365,42,25,17,4,1
404365,270,150,120,5,1
404365,29,13,16,19,1
404365,241,137,104,20,1
404365,312,175,137,21,4
404365,312,175,137,22,1
404365,312,175,137,23,1
404365,42,25,17,24,1
404365,270,150,120,25,1
404365,29,13,16,39,1
404365,241,137,104,40,1
404374,236,87,149,1,4
404374,236,87,149,2,1
404374,236,87,149,3,1
404374,32,13,19,4,1
404374,204,74,130,5,1
404374,20,6,14,19,1
404374,184,68,116,20,1
404374,236,87,149,21,4
404374,236,87,149,22,1
404374,236,87,149,23,1
404374,32,13,19,24,1
404374,204,74,130,25,1
404374,20,6,14,39,1
404374,184,68,116,40,1
404383,540,368,172,1,4
404383,540,368,172,2,1
404383,540,368,172,3,1
404383,59,42,17,4,1
404383,481,326,155,5,1
404383,39,19,20,19,1
404383,442,307,135,20,1
404383,540,368,172,21,4
404383,540,368,172,22,1
404383,540,368,172,23,1
404383,59,42,17,24,1
404383,481,326,155,25,1
404383,39,19,20,39,1
404383,442,307,135,40,1
404426,3694,1549,2145,1,4
404426,3694,1549,2145,2,1
404426,2794,1222,1572,3,1
404426,647,300,347,4,1
404426,2147,922,1225,5,1
404426,900,327,573,11,1
404426,416,222,194,19,1
404426,1731,700,1031,20,1
404426,1009,505,504,21,4
404426,1009,505,504,22,1
404426,979,490,489,23,1
404426,288,140,148,24,1
404426,691,350,341,25,1
404426,30,15,15,31,1
404426,151,97,54,39,1
404426,540,253,287,40,1
404426,2685,1044,1641,41,4
404426,2685,1044,1641,42,1
404426,1815,732,1083,43,1
404426,359,160,199,44,1
404426,1456,572,884,45,1
404426,870,312,558,51,1
404426,265,125,140,59,1
404426,1191,447,744,60,1
404499,756,94,662,1,4
404499,756,94,662,2,1
404499,756,94,662,3,1
404499,103,16,87,4,1
404499,653,78,575,5,1
404499,82,8,74,19,1
404499,571,70,501,20,1
404499,738,91,647,21,4
404499,738,91,647,22,1
404499,738,91,647,23,1
404499,103,16,87,24,1
404499,635,75,560,25,1
404499,82,8,74,39,1
404499,553,67,486,40,1
404499,18,3,15,41,4
404499,18,3,15,42,1
404499,18,3,15,43,1
404499,18,3,15,45,1
404499,18,3,15,60,1
404505,360,40,320,1,4
404505,360,40,320,2,1
404505,360,40,320,3,1
404505,53,6,47,4,1
404505,307,34,273,5,1
404505,55,6,49,19,1
404505,252,28,224,20,1
404505,325,36,289,21,4
404505,325,36,289,22,1
404505,325,36,289,23,1
404505,53,6,47,24,1
404505,272,30,242,25,1
404505,55,6,49,39,1
404505,217,24,193,40,1
404505,35,4,31,41,4
404505,35,4,31,42,1
404505,35,4,31,43,1
404505,35,4,31,45,1
404505,35,4,31,60,1
404514,588,62,526,1,4
404514,588,62,526,2,1
404514,588,62,526,3,1
404514,64,4,60,4,1
404514,524,58,466,5,1
404514,70,9,61,19,1
404514,454,49,405,20,1
404514,588,62,526,21,4
404514,588,62,526,22,1
404514,588,62,526,23,1
404514,64,4,60,24,1
404514,524,58,466,25,1
404514,70,9,61,39,1
404514,454,49,405,40,1
404648,1549,503,1046,1,4
404648,1545,503,1042,2,1
404648,1534,501,1033,3,1
404648,302,129,173,4,1
404648,1232,372,860,5,1
404648,11,2,9,11,1
404648,4,0,4,12,3
404648,101,32,69,19,1
404648,1131,340,791,20,1
404648,903,335,568,21,4
404648,903,335,568,22,1
404648,902,335,567,23,1
404648,210,105,105,24,1
404648,692,230,462,25,1
404648,1,0,1,31,1
404648,54,23,31,39,1
404648,638,207,431,40,1
404648,646,168,478,41,4
404648,642,168,474,42,1
404648,632,166,466,43,1
404648,92,24,68,44,1
404648,540,142,398,45,1
404648,10,2,8,51,1
404648,4,0,4,52,3
404648,47,9,38,59,1
404648,493,133,360,60,1
404684,404,136,268,1,4
404684,404,136,268,2,1
404684,404,136,268,3,1
404684,189,68,121,4,1
404684,215,68,147,5,1
404684,215,68,147,20,1
404684,404,136,268,21,4
404684,404,136,268,22,1
404684,404,136,268,23,1
404684,189,68,121,24,1
404684,215,68,147,25,1
404684,215,68,147,40,1
404718,105,2,103,1,4
404718,105,2,103,2,1
404718,105,2,103,3,1
404718,53,1,52,4,1
404718,52,1,51,5,1
404718,52,1,51,20,1
404718,105,2,103,21,4
404718,105,2,103,22,1
404718,105,2,103,23,1
404718,53,1,52,24,1
404718,52,1,51,25,1
404718,52,1,51,40,1
404806,402,114,288,1,4
404806,402,114,288,2,1
404806,402,114,288,3,1
404806,93,29,64,4,1
404806,309,85,224,5,1
404806,309,85,224,20,1
404806,223,57,166,21,4
404806,223,57,166,22,1
404806,223,57,166,23,1
404806,73,19,54,24,1
404806,150,38,112,25,1
404806,150,38,112,40,1
404806,179,57,122,41,4
404806,179,57,122,42,1
404806,179,57,122,43,1
404806,20,10,10,44,1
404806,159,47,112,45,1
404806,159,47,112,60,1
404912,951,163,788,1,4
404912,951,163,788,2,1
404912,940,163,777,3,1
404912,321,39,282,4,1
404912,619,124,495,5,1
404912,11,0,11,11,1
404912,619,124,495,20,1
404912,951,163,788,21,4
404912,951,163,788,22,1
404912,940,163,777,23,1
404912,321,39,282,24,1
404912,619,124,495,25,1
404912,11,0,11,31,1
404912,619,124,495,40,1
404921,88,28,60,1,4
404921,88,28,60,2,1
404921,88,28,60,3,1
404921,88,28,60,5,1
404921,88,28,60,20,1
404921,88,28,60,21,4
404921,88,28,60,22,1
404921,88,28,60,23,1
404921,88,28,60,25,1
404921,88,28,60,40,1
404994,4706,1549,3157,1,4
404994,4706,1549,3157,2,1
404994,4652,1523,3129,3,1
404994,1378,450,928,4,1
404994,3274,1073,2201,5,1
404994,54,26,28,11,1
404994,100,28,72,19,1
404994,3174,1045,2129,20,1
404994,4368,1433,2935,21,4
404994,4368,1433,2935,22,1
404994,4349,1419,2930,23,1
404994,1357,437,920,24,1
404994,2992,982,2010,25,1
404994,19,14,5,31,1
404994,98,28,70,39,1
404994,2894,954,1940,40,1
404994,338,116,222,41,4
404994,338,116,222,42,1
404994,303,104,199,43,1
404994,21,13,8,44,1
404994,282,91,191,45,1
404994,35,12,23,51,1
404994,2,0,2,59,1
404994,280,91,189,60,1
405012,79,3,76,1,4
405012,79,3,76,2,1
405012,79,3,76,3,1
405012,60,2,58,4,1
405012,19,1,18,5,1
405012,19,1,18,20,1
405012,79,3,76,21,4
405012,79,3,76,22,1
405012,79,3,76,23,1
405012,60,2,58,24,1
405012,19,1,18,25,1
405012,19,1,18,40,1
405021,57,3,54,1,4
405021,57,3,54,2,1
405021,57,3,54,3,1
405021,19,1,18,4,1
405021,38,2,36,5,1
405021,38,2,36,20,1
405021,57,3,54,21,4
405021,57,3,54,22,1
405021,57,3,54,23,1
405021,19,1,18,24,1
405021,38,2,36,25,1
405021,38,2,36,40,1
405058,118,118,0,1,4
405058,118,118,0,2,1
405058,118,118,0,3,1
405058,42,42,0,4,1
405058,76,76,0,5,1
405058,76,76,0,20,1
405058,118,118,0,21,4
405058,118,118,0,22,1
405058,118,118,0,23,1
405058,42,42,0,24,1
405058,76,76,0,25,1
405058,76,76,0,40,1
405076,320,51,269,1,4
405076,320,51,269,2,1
405076,320,51,269,3,1
405076,271,45,226,4,1
405076,49,6,43,5,1
405076,49,6,43,20,1
405076,320,51,269,21,4
405076,320,51,269,22,1
405076,320,51,269,23,1
405076,271,45,226,24,1
405076,49,6,43,25,1
405076,49,6,43,40,1
405748,16,10,6,1,4
405748,16,10,6,2,1
405748,16,10,6,3,1
405748,12,7,5,4,1
405748,4,3,1,5,1
405748,4,3,1,20,1
405748,9,7,2,21,4
405748,9,7,2,22,1
405748,9,7,2,23,1
405748,7,5,2,24,1
405748,2,2,0,25,1
405748,2,2,0,40,1
405748,7,3,4,41,4
405748,7,3,4,42,1
405748,7,3,4,43,1
405748,5,2,3,44,1
405748,2,1,1,45,1
405748,2,1,1,60,1
405854,155,155,0,1,4
405854,155,155,0,2,1
405854,155,155,0,3,1
405854,27,27,0,4,1
405854,128,128,0,5,1
405854,128,128,0,20,1
405854,155,155,0,21,4
405854,155,155,0,22,1
405854,155,155,0,23,1
405854,27,27,0,24,1
405854,128,128,0,25,1
405854,128,128,0,40,1
405872,3785,1493,2292,1,4
405872,3785,1493,2292,2,1
405872,3583,1417,2166,3,1
405872,733,361,372,4,1
405872,2850,1056,1794,5,1
405872,202,76,126,11,1
405872,251,91,160,19,1
405872,2599,965,1634,20,1
405872,1437,708,729,21,4
405872,1437,708,729,22,1
405872,1427,700,727,23,1
405872,513,258,255,24,1
405872,914,442,472,25,1
405872,10,8,2,31,1
405872,77,30,47,39,1
405872,837,412,425,40,1
405872,2348,785,1563,41,4
405872,2348,785,1563,42,1
405872,2156,717,1439,43,1
405872,220,103,117,44,1
405872,1936,614,1322,45,1
405872,192,68,124,51,1
405872,174,61,113,59,1
405872,1762,553,1209,60,1
405979,1849,735,1114,1,4
405979,1414,608,806,2,1
405979,1414,608,806,3,1
405979,29,8,21,4,1
405979,1385,600,785,5,1
405979,435,127,308,12,3
405979,106,49,57,19,1
405979,1279,551,728,20,1
405979,1849,735,1114,21,4
405979,1414,608,806,22,1
405979,1414,608,806,23,1
405979,29,8,21,24,1
405979,1385,600,785,25,1
405979,435,127,308,32,3
405979,106,49,57,39,1
405979,1279,551,728,40,1
405988,2106,920,1186,1,4
405988,1662,761,901,2,1
405988,1661,761,900,3,1
405988,19,10,9,4,1
405988,1642,751,891,5,1
405988,1,0,1,11,1
405988,444,159,285,12,3
405988,129,55,74,19,1
405988,1513,696,817,20,1
405988,2106,920,1186,21,4
405988,1662,761,901,22,1
405988,1661,761,900,23,1
405988,19,10,9,24,1
405988,1642,751,891,25,1
405988,1,0,1,31,1
405988,444,159,285,32,3
405988,129,55,74,39,1
405988,1513,696,817,40,1
405997,2462,1008,1454,1,4
405997,2098,851,1247,2,1
405997,2097,850,1247,3,1
405997,63,28,35,4,1
405997,2034,822,1212,5,1
405997,1,1,0,11,1
405997,364,157,207,12,3
405997,143,68,75,19,1
405997,1891,754,1137,20,1
405997,2462,1008,1454,21,4
405997,2098,851,1247,22,1
405997,2097,850,1247,23,1
405997,63,28,35,24,1
405997,2034,822,1212,25,1
405997,1,1,0,31,1
405997,364,157,207,32,3
405997,143,68,75,39,1
405997,1891,754,1137,40,1
406006,1655,724,931,1,4
406006,1374,610,764,2,1
406006,1374,610,764,3,1
406006,18,5,13,4,1
406006,1356,605,751,5,1
406006,281,114,167,12,3
406006,117,57,60,19,1
406006,1239,548,691,20,1
406006,1655,724,931,21,4
406006,1374,610,764,22,1
406006,1374,610,764,23,1
406006,18,5,13,24,1
406006,1356,605,751,25,1
406006,281,114,167,32,3
406006,117,57,60,39,1
406006,1239,548,691,40,1
406015,9954,4389,5565,1,4
406015,8309,3859,4450,2,1
406015,8302,3855,4447,3,1
406015,127,32,95,4,1
406015,8175,3823,4352,5,1
406015,7,4,3,11,1
406015,1645,530,1115,12,3
406015,772,379,393,19,1
406015,7403,3444,3959,20,1
406015,9954,4389,5565,21,4
406015,8309,3859,4450,22,1
406015,8302,3855,4447,23,1
406015,127,32,95,24,1
406015,8175,3823,4352,25,1
406015,7,4,3,31,1
406015,1645,530,1115,32,3
406015,772,379,393,39,1
406015,7403,3444,3959,40,1
406024,790,110,680,1,4
406024,790,110,680,2,1
406024,790,110,680,3,1
406024,38,3,35,4,1
406024,752,107,645,5,1
406024,167,23,144,19,1
406024,585,84,501,20,1
406024,427,63,364,21,4
406024,427,63,364,22,1
406024,427,63,364,23,1
406024,37,3,34,24,1
406024,390,60,330,25,1
406024,46,6,40,39,1
406024,344,54,290,40,1
406024,363,47,316,41,4
406024,363,47,316,42,1
406024,363,47,316,43,1
406024,1,0,1,44,1
406024,362,47,315,45,1
406024,121,17,104,59,1
406024,241,30,211,60,1
406033,1119,166,953,1,4
406033,1119,166,953,2,1
406033,1119,166,953,3,1
406033,96,21,75,4,1
406033,1023,145,878,5,1
406033,215,33,182,19,1
406033,808,112,696,20,1
406033,715,115,600,21,4
406033,715,115,600,22,1
406033,715,115,600,23,1
406033,95,21,74,24,1
406033,620,94,526,25,1
406033,93,14,79,39,1
406033,527,80,447,40,1
406033,404,51,353,41,4
406033,404,51,353,42,1
406033,404,51,353,43,1
406033,1,0,1,44,1
406033,403,51,352,45,1
406033,122,19,103,59,1
406033,281,32,249,60,1
406051,78,6,72,1,4
406051,78,6,72,2,1
406051,78,6,72,3,1
406051,12,2,10,4,1
406051,66,4,62,5,1
406051,66,4,62,20,1
406051,78,6,72,21,4
406051,78,6,72,22,1
406051,78,6,72,23,1
406051,12,2,10,24,1
406051,66,4,62,25,1
406051,66,4,62,40,1
406149,77,25,52,1,4
406149,77,25,52,2,1
406149,77,25,52,3,1
406149,34,13,21,4,1
406149,43,12,31,5,1
406149,43,12,31,20,1
406149,77,25,52,21,4
406149,77,25,52,22,1
406149,77,25,52,23,1
406149,34,13,21,24,1
406149,43,12,31,25,1
406149,43,12,31,40,1
406194,186,90,96,1,4
406194,186,90,96,2,1
406194,186,90,96,3,1
406194,16,4,12,4,1
406194,170,86,84,5,1
406194,2,1,1,19,1
406194,168,85,83,20,1
406194,127,58,69,21,4
406194,127,58,69,22,1
406194,127,58,69,23,1
406194,14,3,11,24,1
406194,113,55,58,25,1
406194,1,1,0,39,1
406194,112,54,58,40,1
406194,59,32,27,41,4
406194,59,32,27,42,1
406194,59,32,27,43,1
406194,2,1,1,44,1
406194,57,31,26,45,1
406194,1,0,1,59,1
406194,56,31,25,60,1
406200,1763,387,1376,1,4
406200,1763,387,1376,2,1
406200,1763,387,1376,3,1
406200,741,136,605,4,1
406200,1022,251,771,5,1
406200,1022,251,771,20,1
406200,1763,387,1376,21,4
406200,1763,387,1376,22,1
406200,1763,387,1376,23,1
406200,741,136,605,24,1
406200,1022,251,771,25,1
406200,1022,251,771,40,1
406219,189,41,148,1,4
406219,189,41,148,2,1
406219,189,41,148,3,1
406219,15,4,11,4,1
406219,174,37,137,5,1
406219,28,11,17,19,1
406219,146,26,120,20,1
406219,126,27,99,21,4
406219,126,27,99,22,1
406219,126,27,99,23,1
406219,12,4,8,24,1
406219,114,23,91,25,1
406219,24,10,14,39,1
406219,90,13,77,40,1
406219,63,14,49,41,4
406219,63,14,49,42,1
406219,63,14,49,43,1
406219,3,0,3,44,1
406219,60,14,46,45,1
406219,4,1,3,59,1
406219,56,13,43,60,1
406325,96,4,92,1,4
406325,96,4,92,2,1
406325,96,4,92,3,1
406325,16,0,16,4,1
406325,80,4,76,5,1
406325,80,4,76,20,1
406325,76,3,73,21,4
406325,76,3,73,22,1
406325,76,3,73,23,1
406325,16,0,16,24,1
406325,60,3,57,25,1
406325,60,3,57,40,1
406325,20,1,19,41,4
406325,20,1,19,42,1
406325,20,1,19,43,1
406325,20,1,19,45,1
406325,20,1,19,60,1
406361,37,5,32,1,4
406361,37,5,32,2,1
406361,37,5,32,3,1
406361,4,1,3,4,1
406361,33,4,29,5,1
406361,33,4,29,20,1
406361,37,5,32,21,4
406361,37,5,32,22,1
406361,37,5,32,23,1
406361,4,1,3,24,1
406361,33,4,29,25,1
406361,33,4,29,40,1
406413,107,19,88,1,4
406413,107,19,88,2,1
406413,107,19,88,3,1
406413,57,8,49,4,1
406413,50,11,39,5,1
406413,50,11,39,20,1
406413,107,19,88,21,4
406413,107,19,88,22,1
406413,107,19,88,23,1
406413,57,8,49,24,1
406413,50,11,39,25,1
406413,50,11,39,40,1
406422,92,4,88,1,4
406422,92,4,88,2,1
406422,92,4,88,3,1
406422,30,1,29,4,1
406422,62,3,59,5,1
406422,62,3,59,20,1
406422,59,2,57,21,4
406422,59,2,57,22,1
406422,59,2,57,23,1
406422,30,1,29,24,1
406422,29,1,28,25,1
406422,29,1,28,40,1
406422,33,2,31,41,4
406422,33,2,31,42,1
406422,33,2,31,43,1
406422,33,2,31,45,1
406422,33,2,31,60,1
406486,63,12,51,1,4
406486,63,12,51,2,1
406486,63,12,51,3,1
406486,36,7,29,4,1
406486,27,5,22,5,1
406486,27,5,22,20,1
406486,25,5,20,21,4
406486,25,5,20,22,1
406486,25,5,20,23,1
406486,19,4,15,24,1
406486,6,1,5,25,1
406486,6,1,5,40,1
406486,38,7,31,41,4
406486,38,7,31,42,1
406486,38,7,31,43,1
406486,17,3,14,44,1
406486,21,4,17,45,1
406486,21,4,17,60,1
406495,160,10,150,1,4
406495,160,10,150,2,1
406495,160,10,150,3,1
406495,142,9,133,4,1
406495,18,1,17,5,1
406495,18,1,17,20,1
406495,125,9,116,21,4
406495,125,9,116,22,1
406495,125,9,116,23,1
406495,114,8,106,24,1
406495,11,1,10,25,1
406495,11,1,10,40,1
406495,35,1,34,41,4
406495,35,1,34,42,1
406495,35,1,34,43,1
406495,28,1,27,44,1
406495,7,0,7,45,1
406495,7,0,7,60,1
406547,444,107,337,1,4
406547,444,107,337,2,1
406547,444,107,337,3,1
406547,55,13,42,4,1
406547,389,94,295,5,1
406547,31,5,26,19,1
406547,358,89,269,20,1
406547,341,77,264,21,4
406547,341,77,264,22,1
406547,341,77,264,23,1
406547,53,12,41,24,1
406547,288,65,223,25,1
406547,30,4,26,39,1
406547,258,61,197,40,1
406547,103,30,73,41,4
406547,103,30,73,42,1
406547,103,30,73,43,1
406547,2,1,1,44,1
406547,101,29,72,45,1
406547,1,1,0,59,1
406547,100,28,72,60,1
407009,3661,1311,2350,1,4
407009,3249,1189,2060,2,1
407009,3243,1184,2059,3,1
407009,271,98,173,4,1
407009,2972,1086,1886,5,1
407009,6,5,1,11,1
407009,412,122,290,12,3
407009,637,236,401,19,1
407009,2335,850,1485,20,1
407009,2911,1046,1865,21,4
407009,2694,977,1717,22,1
407009,2694,977,1717,23,1
407009,267,95,172,24,1
407009,2427,882,1545,25,1
407009,217,69,148,32,3
407009,526,191,335,39,1
407009,1901,691,1210,40,1
407009,750,265,485,41,4
407009,555,212,343,42,1
407009,549,207,342,43,1
407009,4,3,1,44,1
407009,545,204,341,45,1
407009,6,5,1,51,1
407009,195,53,142,52,3
407009,111,45,66,59,1
407009,434,159,275,60,1
407054,158,38,120,1,4
407054,158,38,120,2,1
407054,158,38,120,3,1
407054,52,13,39,4,1
407054,106,25,81,5,1
407054,106,25,81,20,1
407054,19,6,13,21,4
407054,19,6,13,22,1
407054,19,6,13,23,1
407054,9,4,5,24,1
407054,10,2,8,25,1
407054,10,2,8,40,1
407054,139,32,107,41,4
407054,139,32,107,42,1
407054,139,32,107,43,1
407054,43,9,34,44,1
407054,96,23,73,45,1
407054,96,23,73,60,1
407063,591,418,173,1,4
407063,591,418,173,2,1
407063,591,418,173,3,1
407063,69,57,12,4,1
407063,522,361,161,5,1
407063,6,2,4,19,1
407063,516,359,157,20,1
407063,441,331,110,21,4
407063,441,331,110,22,1
407063,441,331,110,23,1
407063,61,52,9,24,1
407063,380,279,101,25,1
407063,5,2,3,39,1
407063,375,277,98,40,1
407063,150,87,63,41,4
407063,150,87,63,42,1
407063,150,87,63,43,1
407063,8,5,3,44,1
407063,142,82,60,45,1
407063,1,0,1,59,1
407063,141,82,59,60,1
407090,286,5,281,1,4
407090,286,5,281,2,1
407090,286,5,281,3,1
407090,2,0,2,4,1
407090,284,5,279,5,1
407090,284,5,279,20,1
407090,103,2,101,21,4
407090,103,2,101,22,1
407090,103,2,101,23,1
407090,103,2,101,25,1
407090,103,2,101,40,1
407090,183,3,180,41,4
407090,183,3,180,42,1
407090,183,3,180,43,1
407090,2,0,2,44,1
407090,181,3,178,45,1
407090,181,3,178,60,1
407142,109,2,107,1,4
407142,109,2,107,2,1
407142,109,2,107,3,1
407142,11,0,11,4,1
407142,98,2,96,5,1
407142,98,2,96,20,1
407142,109,2,107,21,4
407142,109,2,107,22,1
407142,109,2,107,23,1
407142,11,0,11,24,1
407142,98,2,96,25,1
407142,98,2,96,40,1
407151,99,3,96,1,4
407151,99,3,96,2,1
407151,99,3,96,3,1
407151,23,1,22,4,1
407151,76,2,74,5,1
407151,76,2,74,20,1
407151,99,3,96,21,4
407151,99,3,96,22,1
407151,99,3,96,23,1
407151,23,1,22,24,1
407151,76,2,74,25,1
407151,76,2,74,40,1
407179,155,6,149,1,4
407179,155,6,149,2,1
407179,155,6,149,3,1
407179,63,1,62,4,1
407179,92,5,87,5,1
407179,92,5,87,20,1
407179,125,5,120,21,4
407179,125,5,120,22,1
407179,125,5,120,23,1
407179,55,1,54,24,1
407179,70,4,66,25,1
407179,70,4,66,40,1
407179,30,1,29,41,4
407179,30,1,29,42,1
407179,30,1,29,43,1
407179,8,0,8,44,1
407179,22,1,21,45,1
407179,22,1,21,60,1
407285,169,58,111,1,4
407285,169,58,111,2,1
407285,162,55,107,3,1
407285,12,6,6,4,1
407285,150,49,101,5,1
407285,7,3,4,11,1
407285,31,9,22,19,1
407285,119,40,79,20,1
407285,100,37,63,21,4
407285,100,37,63,22,1
407285,97,36,61,23,1
407285,8,6,2,24,1
407285,89,30,59,25,1
407285,3,1,2,31,1
407285,20,5,15,39,1
407285,69,25,44,40,1
407285,69,21,48,41,4
407285,69,21,48,42,1
407285,65,19,46,43,1
407285,4,0,4,44,1
407285,61,19,42,45,1
407285,4,2,2,51,1
407285,11,4,7,59,1
407285,50,15,35,60,1
407319,505,330,175,1,4
407319,505,330,175,2,1
407319,505,330,175,3,1
407319,79,46,33,4,1
407319,426,284,142,5,1
407319,22,11,11,19,1
407319,404,273,131,20,1
407319,344,237,107,21,4
407319,344,237,107,22,1
407319,344,237,107,23,1
407319,63,38,25,24,1
407319,281,199,82,25,1
407319,18,9,9,39,1
407319,263,190,73,40,1
407319,161,93,68,41,4
407319,161,93,68,42,1
407319,161,93,68,43,1
407319,16,8,8,44,1
407319,145,85,60,45,1
407319,4,2,2,59,1
407319,141,83,58,60,1
407328,121,23,98,1,4
407328,121,23,98,2,1
407328,120,23,97,3,1
407328,40,7,33,4,1
407328,80,16,64,5,1
407328,1,0,1,11,1
407328,80,16,64,20,1
407328,110,22,88,21,4
407328,110,22,88,22,1
407328,110,22,88,23,1
407328,38,7,31,24,1
407328,72,15,57,25,1
407328,72,15,57,40,1
407328,11,1,10,41,4
407328,11,1,10,42,1
407328,10,1,9,43,1
407328,2,0,2,44,1
407328,8,1,7,45,1
407328,1,0,1,51,1
407328,8,1,7,60,1
407355,237,12,225,1,4
407355,237,12,225,2,1
407355,237,12,225,3,1
407355,28,1,27,4,1
407355,209,11,198,5,1
407355,209,11,198,20,1
407355,236,12,224,21,4
407355,236,12,224,22,1
407355,236,12,224,23,1
407355,28,1,27,24,1
407355,208,11,197,25,1
407355,208,11,197,40,1
407355,1,0,1,41,4
407355,1,0,1,42,1
407355,1,0,1,43,1
407355,1,0,1,45,1
407355,1,0,1,60,1
407391,172,18,154,1,4
407391,172,18,154,2,1
407391,172,18,154,3,1
407391,12,1,11,4,1
407391,160,17,143,5,1
407391,160,17,143,20,1
407391,123,14,109,21,4
407391,123,14,109,22,1
407391,123,14,109,23,1
407391,9,1,8,24,1
407391,114,13,101,25,1
407391,114,13,101,40,1
407391,49,4,45,41,4
407391,49,4,45,42,1
407391,49,4,45,43,1
407391,3,0,3,44,1
407391,46,4,42,45,1
407391,46,4,42,60,1
407407,153,19,134,1,4
407407,153,19,134,2,1
407407,153,19,134,3,1
407407,40,4,36,4,1
407407,113,15,98,5,1
407407,113,15,98,20,1
407407,110,14,96,21,4
407407,110,14,96,22,1
407407,110,14,96,23,1
407407,32,3,29,24,1
407407,78,11,67,25,1
407407,78,11,67,40,1
407407,43,5,38,41,4
407407,43,5,38,42,1
407407,43,5,38,43,1
407407,8,1,7,44,1
407407,35,4,31,45,1
407407,35,4,31,60,1
407425,197,10,187,1,4
407425,197,10,187,2,1
407425,197,10,187,3,1
407425,27,0,27,4,1
407425,170,10,160,5,1
407425,170,10,160,20,1
407425,108,3,105,21,4
407425,108,3,105,22,1
407425,108,3,105,23,1
407425,21,0,21,24,1
407425,87,3,84,25,1
407425,87,3,84,40,1
407425,89,7,82,41,4
407425,89,7,82,42,1
407425,89,7,82,43,1
407425,6,0,6,44,1
407425,83,7,76,45,1
407425,83,7,76,60,1
407434,99,2,97,1,4
407434,99,2,97,2,1
407434,99,2,97,3,1
407434,41,0,41,4,1
407434,58,2,56,5,1
407434,58,2,56,20,1
407434,71,1,70,21,4
407434,71,1,70,22,1
407434,71,1,70,23,1
407434,37,0,37,24,1
407434,34,1,33,25,1
407434,34,1,33,40,1
407434,28,1,27,41,4
407434,28,1,27,42,1
407434,28,1,27,43,1
407434,4,0,4,44,1
407434,24,1,23,45,1
407434,24,1,23,60,1
407452,68,52,16,1,4
407452,68,52,16,2,1
407452,64,49,15,3,1
407452,52,38,14,4,1
407452,12,11,1,5,1
407452,4,3,1,11,1
407452,12,11,1,20,1
407452,64,49,15,21,4
407452,64,49,15,22,1
407452,64,49,15,23,1
407452,52,38,14,24,1
407452,12,11,1,25,1
407452,12,11,1,40,1
407452,4,3,1,41,4
407452,4,3,1,42,1
407452,4,3,1,51,1
407461,188,130,58,1,4
407461,188,130,58,2,1
407461,188,130,58,3,1
407461,91,68,23,4,1
407461,97,62,35,5,1
407461,97,62,35,20,1
407461,188,130,58,21,4
407461,188,130,58,22,1
407461,188,130,58,23,1
407461,91,68,23,24,1
407461,97,62,35,25,1
407461,97,62,35,40,1
407470,186,5,181,1,4
407470,186,5,181,2,1
407470,186,5,181,3,1
407470,99,3,96,4,1
407470,87,2,85,5,1
407470,87,2,85,20,1
407470,123,3,120,21,4
407470,123,3,120,22,1
407470,123,3,120,23,1
407470,71,2,69,24,1
407470,52,1,51,25,1
407470,52,1,51,40,1
407470,63,2,61,41,4
407470,63,2,61,42,1
407470,63,2,61,43,1
407470,28,1,27,44,1
407470,35,1,34,45,1
407470,35,1,34,60,1
407489,96,54,42,1,4
407489,96,54,42,2,1
407489,96,54,42,3,1
407489,28,15,13,4,1
407489,68,39,29,5,1
407489,68,39,29,20,1
407489,55,26,29,21,4
407489,55,26,29,22,1
407489,55,26,29,23,1
407489,17,8,9,24,1
407489,38,18,20,25,1
407489,38,18,20,40,1
407489,41,28,13,41,4
407489,41,28,13,42,1
407489,41,28,13,43,1
407489,11,7,4,44,1
407489,30,21,9,45,1
407489,30,21,9,60,1
407504,32,5,27,1,4
407504,32,5,27,2,1
407504,32,5,27,3,1
407504,11,1,10,4,1
407504,21,4,17,5,1
407504,21,4,17,20,1
407504,32,5,27,21,4
407504,32,5,27,22,1
407504,32,5,27,23,1
407504,11,1,10,24,1
407504,21,4,17,25,1
407504,21,4,17,40,1
407513,374,152,222,1,4
407513,374,152,222,2,1
407513,374,152,222,3,1
407513,177,75,102,4,1
407513,197,77,120,5,1
407513,197,77,120,20,1
407513,236,98,138,21,4
407513,236,98,138,22,1
407513,236,98,138,23,1
407513,113,49,64,24,1
407513,123,49,74,25,1
407513,123,49,74,40,1
407513,138,54,84,41,4
407513,138,54,84,42,1
407513,138,54,84,43,1
407513,64,26,38,44,1
407513,74,28,46,45,1
407513,74,28,46,60,1
407522,35,13,22,1,4
407522,35,13,22,2,1
407522,35,13,22,3,1
407522,27,11,16,4,1
407522,8,2,6,5,1
407522,8,2,6,20,1
407522,33,11,22,21,4
407522,33,11,22,22,1
407522,33,11,22,23,1
407522,26,10,16,24,1
407522,7,1,6,25,1
407522,7,1,6,40,1
407522,2,2,0,41,4
407522,2,2,0,42,1
407522,2,2,0,43,1
407522,1,1,0,44,1
407522,1,1,0,45,1
407522,1,1,0,60,1
407568,124,5,119,1,4
407568,124,5,119,2,1
407568,124,5,119,3,1
407568,14,0,14,4,1
407568,110,5,105,5,1
407568,110,5,105,20,1
407568,50,0,50,21,4
407568,50,0,50,22,1
407568,50,0,50,23,1
407568,10,0,10,24,1
407568,40,0,40,25,1
407568,40,0,40,40,1
407568,74,5,69,41,4
407568,74,5,69,42,1
407568,74,5,69,43,1
407568,4,0,4,44,1
407568,70,5,65,45,1
407568,70,5,65,60,1
407577,321,146,175,1,4
407577,321,146,175,2,1
407577,321,146,175,3,1
407577,273,119,154,4,1
407577,48,27,21,5,1
407577,48,27,21,20,1
407577,281,128,153,21,4
407577,281,128,153,22,1
407577,281,128,153,23,1
407577,244,108,136,24,1
407577,37,20,17,25,1
407577,37,20,17,40,1
407577,40,18,22,41,4
407577,40,18,22,42,1
407577,40,18,22,43,1
407577,29,11,18,44,1
407577,11,7,4,45,1
407577,11,7,4,60,1
407595,230,92,138,1,4
407595,230,92,138,2,1
407595,115,46,69,3,1
407595,115,46,69,4,1
407595,115,46,69,11,1
407595,230,92,138,21,4
407595,230,92,138,22,1
407595,115,46,69,23,1
407595,115,46,69,24,1
407595,115,46,69,31,1
407601,97,50,47,1,4
407601,97,50,47,2,1
407601,12,3,9,3,1
407601,6,2,4,4,1
407601,6,1,5,5,1
407601,85,47,38,11,1
407601,6,1,5,20,1
407601,3,1,2,21,4
407601,3,1,2,22,1
407601,3,1,2,23,1
407601,2,1,1,24,1
407601,1,0,1,25,1
407601,1,0,1,40,1
407601,94,49,45,41,4
407601,94,49,45,42,1
407601,9,2,7,43,1
407601,4,1,3,44,1
407601,5,1,4,45,1
407601,85,47,38,51,1
407601,5,1,4,60,1
407629,3594,1947,1647,1,4
407629,3594,1947,1647,12,3
407629,3594,1947,1647,21,4
407629,3594,1947,1647,32,3
407683,137,10,127,1,4
407683,137,10,127,2,1
407683,137,10,127,3,1
407683,30,4,26,4,1
407683,107,6,101,5,1
407683,107,6,101,20,1
407683,67,6,61,21,4
407683,67,6,61,22,1
407683,67,6,61,23,1
407683,14,2,12,24,1
407683,53,4,49,25,1
407683,53,4,49,40,1
407683,70,4,66,41,4
407683,70,4,66,42,1
407683,70,4,66,43,1
407683,16,2,14,44,1
407683,54,2,52,45,1
407683,54,2,52,60,1
407708,360,12,348,1,4
407708,360,12,348,2,1
407708,360,12,348,3,1
407708,42,1,41,4,1
407708,318,11,307,5,1
407708,318,11,307,20,1
407708,360,12,348,21,4
407708,360,12,348,22,1
407708,360,12,348,23,1
407708,42,1,41,24,1
407708,318,11,307,25,1
407708,318,11,307,40,1
407726,67,1,66,1,4
407726,67,1,66,2,1
407726,67,1,66,3,1
407726,21,0,21,4,1
407726,46,1,45,5,1
407726,46,1,45,20,1
407726,49,1,48,21,4
407726,49,1,48,22,1
407726,49,1,48,23,1
407726,18,0,18,24,1
407726,31,1,30,25,1
407726,31,1,30,40,1
407726,18,0,18,41,4
407726,18,0,18,42,1
407726,18,0,18,43,1
407726,3,0,3,44,1
407726,15,0,15,45,1
407726,15,0,15,60,1
407735,102,6,96,1,4
407735,102,6,96,2,1
407735,102,6,96,3,1
407735,45,4,41,4,1
407735,57,2,55,5,1
407735,57,2,55,20,1
407735,102,6,96,21,4
407735,102,6,96,22,1
407735,102,6,96,23,1
407735,45,4,41,24,1
407735,57,2,55,25,1
407735,57,2,55,40,1
407832,392,260,132,1,4
407832,392,260,132,2,1
407832,392,260,132,3,1
407832,208,146,62,4,1
407832,184,114,70,5,1
407832,184,114,70,20,1
407832,287,191,96,21,4
407832,287,191,96,22,1
407832,287,191,96,23,1
407832,177,128,49,24,1
407832,110,63,47,25,1
407832,110,63,47,40,1
407832,105,69,36,41,4
407832,105,69,36,42,1
407832,105,69,36,43,1
407832,31,18,13,44,1
407832,74,51,23,45,1
407832,74,51,23,60,1
408039,659,147,512,1,4
408039,659,147,512,2,1
408039,659,147,512,3,1
408039,76,21,55,4,1
408039,583,126,457,5,1
408039,101,26,75,19,1
408039,482,100,382,20,1
408039,659,147,512,21,4
408039,659,147,512,22,1
408039,659,147,512,23,1
408039,76,21,55,24,1
408039,583,126,457,25,1
408039,101,26,75,39,1
408039,482,100,382,40,1
408066,121,9,112,1,4
408066,121,9,112,2,1
408066,121,9,112,3,1
408066,26,2,24,4,1
408066,95,7,88,5,1
408066,95,7,88,20,1
408066,73,7,66,21,4
408066,73,7,66,22,1
408066,73,7,66,23,1
408066,18,2,16,24,1
408066,55,5,50,25,1
408066,55,5,50,40,1
408066,48,2,46,41,4
408066,48,2,46,42,1
408066,48,2,46,43,1
408066,8,0,8,44,1
408066,40,2,38,45,1
408066,40,2,38,60,1
408163,78,0,78,1,4
408163,78,0,78,2,1
408163,78,0,78,3,1
408163,13,0,13,4,1
408163,65,0,65,5,1
408163,65,0,65,20,1
408163,78,0,78,21,4
408163,78,0,78,22,1
408163,78,0,78,23,1
408163,13,0,13,24,1
408163,65,0,65,25,1
408163,65,0,65,40,1
408312,112,11,101,1,4
408312,112,11,101,2,1
408312,112,11,101,3,1
408312,16,2,14,4,1
408312,96,9,87,5,1
408312,18,2,16,19,1
408312,78,7,71,20,1
408312,112,11,101,21,4
408312,112,11,101,22,1
408312,112,11,101,23,1
408312,16,2,14,24,1
408312,96,9,87,25,1
408312,18,2,16,39,1
408312,78,7,71,40,1
408385,358,86,272,1,4
408385,358,86,272,2,1
408385,358,86,272,3,1
408385,306,77,229,4,1
408385,52,9,43,5,1
408385,52,9,43,20,1
408385,358,86,272,21,4
408385,358,86,272,22,1
408385,358,86,272,23,1
408385,306,77,229,24,1
408385,52,9,43,25,1
408385,52,9,43,40,1
408394,755,537,218,1,4
408394,755,537,218,2,1
408394,428,348,80,3,1
408394,105,97,8,4,1
408394,323,251,72,5,1
408394,327,189,138,11,1
408394,61,47,14,19,1
408394,262,204,58,20,1
408394,392,315,77,21,4
408394,392,315,77,22,1
408394,303,251,52,23,1
408394,87,79,8,24,1
408394,216,172,44,25,1
408394,89,64,25,31,1
408394,48,39,9,39,1
408394,168,133,35,40,1
408394,363,222,141,41,4
408394,363,222,141,42,1
408394,125,97,28,43,1
408394,18,18,0,44,1
408394,107,79,28,45,1
408394,238,125,113,51,1
408394,13,8,5,59,1
408394,94,71,23,60,1
408844,2448,685,1763,1,4
408844,2420,671,1749,2,1
408844,1803,484,1319,3,1
408844,332,94,238,4,1
408844,1471,390,1081,5,1
408844,617,187,430,11,1
408844,28,14,14,12,3
408844,1471,390,1081,20,1
408844,1773,502,1271,21,4
408844,1754,493,1261,22,1
408844,1312,346,966,23,1
408844,283,82,201,24,1
408844,1029,264,765,25,1
408844,442,147,295,31,1
408844,19,9,10,32,3
408844,1029,264,765,40,1
408844,675,183,492,41,4
408844,666,178,488,42,1
408844,491,138,353,43,1
408844,49,12,37,44,1
408844,442,126,316,45,1
408844,175,40,135,51,1
408844,9,5,4,52,3
408844,442,126,316,60,1
408862,302,17,285,1,4
408862,302,17,285,2,1
408862,302,17,285,3,1
408862,126,10,116,4,1
408862,176,7,169,5,1
408862,176,7,169,20,1
408862,109,7,102,21,4
408862,109,7,102,22,1
408862,109,7,102,23,1
408862,45,4,41,24,1
408862,64,3,61,25,1
408862,64,3,61,40,1
408862,193,10,183,41,4
408862,193,10,183,42,1
408862,193,10,183,43,1
408862,81,6,75,44,1
408862,112,4,108,45,1
408862,112,4,108,60,1
409032,116,7,109,1,4
409032,116,7,109,2,1
409032,116,7,109,3,1
409032,108,7,101,4,1
409032,8,0,8,5,1
409032,8,0,8,20,1
409032,116,7,109,21,4
409032,116,7,109,22,1
409032,116,7,109,23,1
409032,108,7,101,24,1
409032,8,0,8,25,1
409032,8,0,8,40,1
409069,531,406,125,1,4
409069,531,406,125,2,1
409069,531,406,125,3,1
409069,76,63,13,4,1
409069,455,343,112,5,1
409069,10,5,5,19,1
409069,445,338,107,20,1
409069,386,300,86,21,4
409069,386,300,86,22,1
409069,386,300,86,23,1
409069,67,54,13,24,1
409069,319,246,73,25,1
409069,4,4,0,39,1
409069,315,242,73,40,1
409069,145,106,39,41,4
409069,145,106,39,42,1
409069,145,106,39,43,1
409069,9,9,0,44,1
409069,136,97,39,45,1
409069,6,1,5,59,1
409069,130,96,34,60,1
409120,189,65,124,1,4
409120,189,65,124,2,1
409120,189,65,124,3,1
409120,74,35,39,4,1
409120,115,30,85,5,1
409120,115,30,85,20,1
409120,189,65,124,21,4
409120,189,65,124,22,1
409120,189,65,124,23,1
409120,74,35,39,24,1
409120,115,30,85,25,1
409120,115,30,85,40,1
409166,93,4,89,1,4
409166,93,4,89,2,1
409166,93,4,89,3,1
409166,30,2,28,4,1
409166,63,2,61,5,1
409166,63,2,61,20,1
409166,92,4,88,21,4
409166,92,4,88,22,1
409166,92,4,88,23,1
409166,30,2,28,24,1
409166,62,2,60,25,1
409166,62,2,60,40,1
409166,1,0,1,41,4
409166,1,0,1,42,1
409166,1,0,1,43,1
409166,1,0,1,45,1
409166,1,0,1,60,1
409193,231,229,2,1,4
409193,231,229,2,2,1
409193,231,229,2,3,1
409193,25,25,0,4,1
409193,206,204,2,5,1
409193,206,204,2,20,1
409193,231,229,2,21,4
409193,231,229,2,22,1
409193,231,229,2,23,1
409193,25,25,0,24,1
409193,206,204,2,25,1
409193,206,204,2,40,1
409254,253,10,243,1,4
409254,253,10,243,12,3
409254,42,0,42,21,4
409254,42,0,42,32,3
409254,211,10,201,41,4
409254,211,10,201,52,3
409315,31232,13554,17678,1,4
409315,31232,13554,17678,2,1
409315,18034,7624,10410,3,1
409315,3863,1850,2013,4,1
409315,14171,5774,8397,5,1
409315,13198,5930,7268,11,1
409315,1044,475,569,19,1
409315,13127,5299,7828,20,1
409315,10349,4538,5811,21,4
409315,10349,4538,5811,22,1
409315,8972,3971,5001,23,1
409315,2688,1302,1386,24,1
409315,6284,2669,3615,25,1
409315,1377,567,810,31,1
409315,543,247,296,39,1
409315,5741,2422,3319,40,1
409315,20883,9016,11867,41,4
409315,20883,9016,11867,42,1
409315,9062,3653,5409,43,1
409315,1175,548,627,44,1
409315,7887,3105,4782,45,1
409315,11821,5363,6458,51,1
409315,501,228,273,59,1
409315,7386,2877,4509,60,1
409537,83,22,61,1,4
409537,83,22,61,2,1
409537,83,22,61,3,1
409537,39,15,24,4,1
409537,44,7,37,5,1
409537,44,7,37,20,1
409537,58,9,49,21,4
409537,58,9,49,22,1
409537,58,9,49,23,1
409537,26,6,20,24,1
409537,32,3,29,25,1
409537,32,3,29,40,1
409537,25,13,12,41,4
409537,25,13,12,42,1
409537,25,13,12,43,1
409537,13,9,4,44,1
409537,12,4,8,45,1
409537,12,4,8,60,1
409591,106,48,58,1,4
409591,106,48,58,2,1
409591,106,48,58,3,1
409591,56,35,21,4,1
409591,50,13,37,5,1
409591,50,13,37,20,1
409591,68,31,37,21,4
409591,68,31,37,22,1
409591,68,31,37,23,1
409591,33,21,12,24,1
409591,35,10,25,25,1
409591,35,10,25,40,1
409591,38,17,21,41,4
409591,38,17,21,42,1
409591,38,17,21,43,1
409591,23,14,9,44,1
409591,15,3,12,45,1
409591,15,3,12,60,1
409616,420,206,214,1,4
409616,420,206,214,12,3
409616,420,206,214,21,4
409616,420,206,214,32,3
409670,461,126,335,1,4
409670,461,126,335,2,1
409670,461,126,335,3,1
409670,19,6,13,4,1
409670,442,120,322,5,1
409670,53,13,40,19,1
409670,389,107,282,20,1
409670,385,99,286,21,4
409670,385,99,286,22,1
409670,385,99,286,23,1
409670,19,6,13,24,1
409670,366,93,273,25,1
409670,47,9,38,39,1
409670,319,84,235,40,1
409670,76,27,49,41,4
409670,76,27,49,42,1
409670,76,27,49,43,1
409670,76,27,49,45,1
409670,6,4,2,59,1
409670,70,23,47,60,1
409698,5732,2157,3575,1,4
409698,5306,2033,3273,2,1
409698,5153,1965,3188,3,1
409698,866,305,561,4,1
409698,4287,1660,2627,5,1
409698,153,68,85,11,1
409698,426,124,302,12,3
409698,744,308,436,19,1
409698,3543,1352,2191,20,1
409698,5205,1965,3240,21,4
409698,4954,1893,3061,22,1
409698,4848,1851,2997,23,1
409698,862,305,557,24,1
409698,3986,1546,2440,25,1
409698,106,42,64,31,1
409698,251,72,179,32,3
409698,675,286,389,39,1
409698,3311,1260,2051,40,1
409698,527,192,335,41,4
409698,352,140,212,42,1
409698,305,114,191,43,1
409698,4,0,4,44,1
409698,301,114,187,45,1
409698,47,26,21,51,1
409698,175,52,123,52,3
409698,69,22,47,59,1
409698,232,92,140,60,1
409829,81,1,80,1,4
409829,81,1,80,2,1
409829,81,1,80,3,1
409829,81,1,80,5,1
409829,81,1,80,20,1
409829,78,1,77,21,4
409829,78,1,77,22,1
409829,78,1,77,23,1
409829,78,1,77,25,1
409829,78,1,77,40,1
409829,3,0,3,41,4
409829,3,0,3,42,1
409829,3,0,3,43,1
409829,3,0,3,45,1
409829,3,0,3,60,1
409838,45,18,27,1,4
409838,45,18,27,2,1
409838,45,18,27,3,1
409838,45,18,27,5,1
409838,45,18,27,20,1
409838,31,12,19,21,4
409838,31,12,19,22,1
409838,31,12,19,23,1
409838,31,12,19,25,1
409838,31,12,19,40,1
409838,14,6,8,41,4
409838,14,6,8,42,1
409838,14,6,8,43,1
409838,14,6,8,45,1
409838,14,6,8,60,1
409874,1076,293,783,1,4
409874,1076,293,783,2,1
409874,1076,293,783,3,1
409874,103,24,79,4,1
409874,973,269,704,5,1
409874,90,32,58,19,1
409874,883,237,646,20,1
409874,758,201,557,21,4
409874,758,201,557,22,1
409874,758,201,557,23,1
409874,72,15,57,24,1
409874,686,186,500,25,1
409874,44,15,29,39,1
409874,642,171,471,40,1
409874,318,92,226,41,4
409874,318,92,226,42,1
409874,318,92,226,43,1
409874,31,9,22,44,1
409874,287,83,204,45,1
409874,46,17,29,59,1
409874,241,66,175,60,1
410070,722,138,584,1,4
410070,722,138,584,2,1
410070,722,138,584,3,1
410070,179,45,134,4,1
410070,543,93,450,5,1
410070,106,12,94,19,1
410070,437,81,356,20,1
410070,722,138,584,21,4
410070,722,138,584,22,1
410070,722,138,584,23,1
410070,179,45,134,24,1
410070,543,93,450,25,1
410070,106,12,94,39,1
410070,437,81,356,40,1
410256,80,13,67,1,4
410256,80,13,67,2,1
410256,80,13,67,3,1
410256,19,3,16,4,1
410256,61,10,51,5,1
410256,61,10,51,20,1
410256,80,13,67,21,4
410256,80,13,67,22,1
410256,80,13,67,23,1
410256,19,3,16,24,1
410256,61,10,51,25,1
410256,61,10,51,40,1
410283,1033,267,766,1,4
410283,1033,267,766,2,1
410283,1033,267,766,3,1
410283,382,101,281,4,1
410283,651,166,485,5,1
410283,651,166,485,20,1
410283,1033,267,766,21,4
410283,1033,267,766,22,1
410283,1033,267,766,23,1
410283,382,101,281,24,1
410283,651,166,485,25,1
410283,651,166,485,40,1
410496,412,118,294,1,4
410496,412,118,294,2,1
410496,368,89,279,3,1
410496,42,8,34,4,1
410496,326,81,245,5,1
410496,44,29,15,11,1
410496,82,16,66,19,1
410496,244,65,179,20,1
410496,293,75,218,21,4
410496,293,75,218,22,1
410496,293,75,218,23,1
410496,40,8,32,24,1
410496,253,67,186,25,1
410496,78,15,63,39,1
410496,175,52,123,40,1
410496,119,43,76,41,4
410496,119,43,76,42,1
410496,75,14,61,43,1
410496,2,0,2,44,1
410496,73,14,59,45,1
410496,44,29,15,51,1
410496,4,1,3,59,1
410496,69,13,56,60,1
410502,1906,918,988,1,4
410502,1906,918,988,2,1
410502,1906,918,988,3,1
410502,325,146,179,4,1
410502,1581,772,809,5,1
410502,229,107,122,19,1
410502,1352,665,687,20,1
410502,1157,552,605,21,4
410502,1157,552,605,22,1
410502,1157,552,605,23,1
410502,234,103,131,24,1
410502,923,449,474,25,1
410502,148,73,75,39,1
410502,775,376,399,40,1
410502,749,366,383,41,4
410502,749,366,383,42,1
410502,749,366,383,43,1
410502,91,43,48,44,1
410502,658,323,335,45,1
410502,81,34,47,59,1
410502,577,289,288,60,1
410520,447,34,413,1,4
410520,447,34,413,2,1
410520,447,34,413,3,1
410520,5,1,4,4,1
410520,442,33,409,5,1
410520,442,33,409,20,1
410520,183,18,165,21,4
410520,183,18,165,22,1
410520,183,18,165,23,1
410520,4,0,4,24,1
410520,179,18,161,25,1
410520,179,18,161,40,1
410520,264,16,248,41,4
410520,264,16,248,42,1
410520,264,16,248,43,1
410520,1,1,0,44,1
410520,263,15,248,45,1
410520,263,15,248,60,1
410539,207,41,166,1,4
410539,207,41,166,2,1
410539,207,41,166,3,1
410539,58,9,49,4,1
410539,149,32,117,5,1
410539,149,32,117,20,1
410539,207,41,166,21,4
410539,207,41,166,22,1
410539,207,41,166,23,1
410539,58,9,49,24,1
410539,149,32,117,25,1
410539,149,32,117,40,1
410788,575,305,270,1,4
410788,575,305,270,2,1
410788,575,305,270,3,1
410788,81,45,36,4,1
410788,494,260,234,5,1
410788,494,260,234,20,1
410788,287,151,136,21,4
410788,287,151,136,22,1
410788,287,151,136,23,1
410788,32,18,14,24,1
410788,255,133,122,25,1
410788,255,133,122,40,1
410788,288,154,134,41,4
410788,288,154,134,42,1
410788,288,154,134,43,1
410788,49,27,22,44,1
410788,239,127,112,45,1
410788,239,127,112,60,1
410797,172,121,51,1,4
410797,172,121,51,2,1
410797,172,121,51,3,1
410797,48,37,11,4,1
410797,124,84,40,5,1
410797,124,84,40,20,1
410797,172,121,51,21,4
410797,172,121,51,22,1
410797,172,121,51,23,1
410797,48,37,11,24,1
410797,124,84,40,25,1
410797,124,84,40,40,1
410964,35,1,34,1,4
410964,35,1,34,2,1
410964,35,1,34,3,1
410964,3,0,3,4,1
410964,32,1,31,5,1
410964,32,1,31,20,1
410964,19,1,18,21,4
410964,19,1,18,22,1
410964,19,1,18,23,1
410964,3,0,3,24,1
410964,16,1,15,25,1
410964,16,1,15,40,1
410964,16,0,16,41,4
410964,16,0,16,42,1
410964,16,0,16,43,1
410964,16,0,16,45,1
410964,16,0,16,60,1
411055,477,362,115,1,4
411055,477,362,115,2,1
411055,477,362,115,3,1
411055,229,192,37,4,1
411055,248,170,78,5,1
411055,248,170,78,20,1
411055,477,362,115,21,4
411055,477,362,115,22,1
411055,477,362,115,23,1
411055,229,192,37,24,1
411055,248,170,78,25,1
411055,248,170,78,40,1
411374,612,52,560,1,4
411374,612,52,560,2,1
411374,612,52,560,3,1
411374,485,35,450,4,1
411374,127,17,110,5,1
411374,127,17,110,20,1
411374,612,52,560,21,4
411374,612,52,560,22,1
411374,612,52,560,23,1
411374,485,35,450,24,1
411374,127,17,110,25,1
411374,127,17,110,40,1
411684,108,37,71,1,4
411684,108,37,71,2,1
411684,108,37,71,3,1
411684,20,5,15,4,1
411684,88,32,56,5,1
411684,88,32,56,20,1
411684,108,37,71,21,4
411684,108,37,71,22,1
411684,108,37,71,23,1
411684,20,5,15,24,1
411684,88,32,56,25,1
411684,88,32,56,40,1
411754,44,19,25,1,4
411754,44,19,25,2,1
411754,44,19,25,3,1
411754,44,19,25,5,1
411754,44,19,25,20,1
411754,44,19,25,21,4
411754,44,19,25,22,1
411754,44,19,25,23,1
411754,44,19,25,25,1
411754,44,19,25,40,1
412003,56,9,47,1,4
412003,56,9,47,2,1
412003,54,8,46,3,1
412003,14,6,8,4,1
412003,40,2,38,5,1
412003,2,1,1,11,1
412003,9,2,7,19,1
412003,31,0,31,20,1
412003,48,5,43,21,4
412003,48,5,43,22,1
412003,48,5,43,23,1
412003,8,3,5,24,1
412003,40,2,38,25,1
412003,9,2,7,39,1
412003,31,0,31,40,1
412003,8,4,4,41,4
412003,8,4,4,42,1
412003,6,3,3,43,1
412003,6,3,3,44,1
412003,2,1,1,51,1
412173,694,68,626,1,4
412173,694,68,626,2,1
412173,693,68,625,3,1
412173,42,3,39,4,1
412173,651,65,586,5,1
412173,1,0,1,11,1
412173,182,13,169,19,1
412173,469,52,417,20,1
412173,694,68,626,21,4
412173,694,68,626,22,1
412173,693,68,625,23,1
412173,42,3,39,24,1
412173,651,65,586,25,1
412173,1,0,1,31,1
412173,182,13,169,39,1
412173,469,52,417,40,1
412535,47,3,44,1,4
412535,47,3,44,2,1
412535,47,3,44,3,1
412535,12,1,11,4,1
412535,35,2,33,5,1
412535,35,2,33,20,1
412535,46,3,43,21,4
412535,46,3,43,22,1
412535,46,3,43,23,1
412535,12,1,11,24,1
412535,34,2,32,25,1
412535,34,2,32,40,1
412535,1,0,1,41,4
412535,1,0,1,42,1
412535,1,0,1,43,1
412535,1,0,1,45,1
412535,1,0,1,60,1
412544,73,11,62,1,4
412544,73,11,62,2,1
412544,73,11,62,3,1
412544,7,0,7,4,1
412544,66,11,55,5,1
412544,66,11,55,20,1
412544,62,10,52,21,4
412544,62,10,52,22,1
412544,62,10,52,23,1
412544,7,0,7,24,1
412544,55,10,45,25,1
412544,55,10,45,40,1
412544,11,1,10,41,4
412544,11,1,10,42,1
412544,11,1,10,43,1
412544,11,1,10,45,1
412544,11,1,10,60,1
412599,814,242,572,1,4
412599,814,242,572,2,1
412599,814,242,572,3,1
412599,264,68,196,4,1
412599,550,174,376,5,1
412599,4,4,0,19,1
412599,546,170,376,20,1
412599,814,242,572,21,4
412599,814,242,572,22,1
412599,814,242,572,23,1
412599,264,68,196,24,1
412599,550,174,376,25,1
412599,4,4,0,39,1
412599,546,170,376,40,1
412650,83,77,6,1,4
412650,83,77,6,2,1
412650,83,77,6,3,1
412650,71,66,5,4,1
412650,12,11,1,5,1
412650,12,11,1,20,1
412650,72,66,6,21,4
412650,72,66,6,22,1
412650,72,66,6,23,1
412650,62,57,5,24,1
412650,10,9,1,25,1
412650,10,9,1,40,1
412650,11,11,0,41,4
412650,11,11,0,42,1
412650,11,11,0,43,1
412650,9,9,0,44,1
412650,2,2,0,45,1
412650,2,2,0,60,1
413176,43,13,30,1,4
413176,43,13,30,2,1
413176,43,13,30,3,1
413176,35,13,22,4,1
413176,8,0,8,5,1
413176,8,0,8,20,1
413176,43,13,30,21,4
413176,43,13,30,22,1
413176,43,13,30,23,1
413176,35,13,22,24,1
413176,8,0,8,25,1
413176,8,0,8,40,1
413343,22,1,21,1,4
413343,22,1,21,2,1
413343,22,1,21,3,1
413343,4,0,4,4,1
413343,18,1,17,5,1
413343,18,1,17,20,1
413343,22,1,21,21,4
413343,22,1,21,22,1
413343,22,1,21,23,1
413343,4,0,4,24,1
413343,18,1,17,25,1
413343,18,1,17,40,1
413413,34007,8527,25480,1,4
413413,7947,2586,5361,2,1
413413,7935,2582,5353,3,1
413413,142,57,85,4,1
413413,7793,2525,5268,5,1
413413,12,4,8,11,1
413413,26060,5941,20119,12,3
413413,512,133,379,19,1
413413,7281,2392,4889,20,1
413413,2108,683,1425,21,4
413413,1291,488,803,22,1
413413,1290,487,803,23,1
413413,2,2,0,24,1
413413,1288,485,803,25,1
413413,1,1,0,31,1
413413,817,195,622,32,3
413413,23,13,10,39,1
413413,1265,472,793,40,1
413413,31899,7844,24055,41,4
413413,6656,2098,4558,42,1
413413,6645,2095,4550,43,1
413413,140,55,85,44,1
413413,6505,2040,4465,45,1
413413,11,3,8,51,1
413413,25243,5746,19497,52,3
413413,489,120,369,59,1
413413,6016,1920,4096,60,1
413617,661,182,479,1,4
413617,661,182,479,2,1
413617,511,154,357,3,1
413617,89,38,51,4,1
413617,422,116,306,5,1
413617,150,28,122,11,1
413617,41,9,32,19,1
413617,381,107,274,20,1
413617,217,89,128,21,4
413617,217,89,128,22,1
413617,217,89,128,23,1
413617,63,30,33,24,1
413617,154,59,95,25,1
413617,16,5,11,39,1
413617,138,54,84,40,1
413617,444,93,351,41,4
413617,444,93,351,42,1
413617,294,65,229,43,1
413617,26,8,18,44,1
413617,268,57,211,45,1
413617,150,28,122,51,1
413617,25,4,21,59,1
413617,243,53,190,60,1
413626,348,144,204,1,4
413626,348,144,204,2,1
413626,340,142,198,3,1
413626,119,54,65,4,1
413626,221,88,133,5,1
413626,8,2,6,11,1
413626,221,88,133,20,1
413626,275,121,154,21,4
413626,275,121,154,22,1
413626,275,121,154,23,1
413626,108,50,58,24,1
413626,167,71,96,25,1
413626,167,71,96,40,1
413626,73,23,50,41,4
413626,73,23,50,42,1
413626,65,21,44,43,1
413626,11,4,7,44,1
413626,54,17,37,45,1
413626,8,2,6,51,1
413626,54,17,37,60,1
413635,257,58,199,1,4
413635,257,58,199,2,1
413635,257,58,199,3,1
413635,108,29,79,4,1
413635,149,29,120,5,1
413635,149,29,120,20,1
413635,257,58,199,21,4
413635,257,58,199,22,1
413635,257,58,199,23,1
413635,108,29,79,24,1
413635,149,29,120,25,1
413635,149,29,120,40,1
413644,62,18,44,1,4
413644,62,18,44,12,3
413644,53,17,36,21,4
413644,53,17,36,32,3
413644,9,1,8,41,4
413644,9,1,8,52,3
413680,458,440,18,1,4
413680,458,440,18,2,1
413680,458,440,18,3,1
413680,199,193,6,4,1
413680,259,247,12,5,1
413680,259,247,12,20,1
413680,458,440,18,21,4
413680,458,440,18,22,1
413680,458,440,18,23,1
413680,199,193,6,24,1
413680,259,247,12,25,1
413680,259,247,12,40,1
413778,212,26,186,1,4
413778,212,26,186,2,1
413778,212,26,186,3,1
413778,157,20,137,4,1
413778,55,6,49,5,1
413778,55,6,49,20,1
413778,212,26,186,21,4
413778,212,26,186,22,1
413778,212,26,186,23,1
413778,157,20,137,24,1
413778,55,6,49,25,1
413778,55,6,49,40,1
413802,983,445,538,1,4
413802,983,445,538,2,1
413802,983,445,538,3,1
413802,68,34,34,4,1
413802,915,411,504,5,1
413802,915,411,504,20,1
413802,331,30,301,21,4
413802,331,30,301,22,1
413802,331,30,301,23,1
413802,24,2,22,24,1
413802,307,28,279,25,1
413802,307,28,279,40,1
413802,652,415,237,41,4
413802,652,415,237,42,1
413802,652,415,237,43,1
413802,44,32,12,44,1
413802,608,383,225,45,1
413802,608,383,225,60,1
413820,17,0,17,1,4
413820,17,0,17,2,1
413820,17,0,17,3,1
413820,4,0,4,4,1
413820,13,0,13,5,1
413820,13,0,13,20,1
413820,17,0,17,21,4
413820,17,0,17,22,1
413820,17,0,17,23,1
413820,4,0,4,24,1
413820,13,0,13,25,1
413820,13,0,13,40,1
413839,289,238,51,1,4
413839,289,238,51,2,1
413839,289,238,51,3,1
413839,66,50,16,4,1
413839,223,188,35,5,1
413839,5,5,0,19,1
413839,218,183,35,20,1
413839,236,194,42,21,4
413839,236,194,42,22,1
413839,236,194,42,23,1
413839,59,45,14,24,1
413839,177,149,28,25,1
413839,5,5,0,39,1
413839,172,144,28,40,1
413839,53,44,9,41,4
413839,53,44,9,42,1
413839,53,44,9,43,1
413839,7,5,2,44,1
413839,46,39,7,45,1
413839,46,39,7,60,1
413848,312,257,55,1,4
413848,312,257,55,2,1
413848,312,257,55,3,1
413848,40,38,2,4,1
413848,272,219,53,5,1
413848,5,4,1,19,1
413848,267,215,52,20,1
413848,261,215,46,21,4
413848,261,215,46,22,1
413848,261,215,46,23,1
413848,40,38,2,24,1
413848,221,177,44,25,1
413848,3,2,1,39,1
413848,218,175,43,40,1
413848,51,42,9,41,4
413848,51,42,9,42,1
413848,51,42,9,43,1
413848,51,42,9,45,1
413848,2,2,0,59,1
413848,49,40,9,60,1
413857,547,388,159,1,4
413857,547,388,159,2,1
413857,547,388,159,3,1
413857,62,46,16,4,1
413857,485,342,143,5,1
413857,16,8,8,19,1
413857,469,334,135,20,1
413857,376,274,102,21,4
413857,376,274,102,22,1
413857,376,274,102,23,1
413857,57,42,15,24,1
413857,319,232,87,25,1
413857,10,6,4,39,1
413857,309,226,83,40,1
413857,171,114,57,41,4
413857,171,114,57,42,1
413857,171,114,57,43,1
413857,5,4,1,44,1
413857,166,110,56,45,1
413857,6,2,4,59,1
413857,160,108,52,60,1
413866,353,286,67,1,4
413866,353,286,67,2,1
413866,353,286,67,3,1
413866,60,49,11,4,1
413866,293,237,56,5,1
413866,293,237,56,20,1
413866,285,232,53,21,4
413866,285,232,53,22,1
413866,285,232,53,23,1
413866,56,46,10,24,1
413866,229,186,43,25,1
413866,229,186,43,40,1
413866,68,54,14,41,4
413866,68,54,14,42,1
413866,68,54,14,43,1
413866,4,3,1,44,1
413866,64,51,13,45,1
413866,64,51,13,60,1
413884,552,411,141,1,4
413884,552,411,141,2,1
413884,552,411,141,3,1
413884,107,79,28,4,1
413884,445,332,113,5,1
413884,4,3,1,19,1
413884,441,329,112,20,1
413884,402,299,103,21,4
413884,402,299,103,22,1
413884,402,299,103,23,1
413884,82,58,24,24,1
413884,320,241,79,25,1
413884,4,3,1,39,1
413884,316,238,78,40,1
413884,150,112,38,41,4
413884,150,112,38,42,1
413884,150,112,38,43,1
413884,25,21,4,44,1
413884,125,91,34,45,1
413884,125,91,34,60,1
413945,78,4,74,1,4
413945,78,4,74,2,1
413945,78,4,74,3,1
413945,21,0,21,4,1
413945,57,4,53,5,1
413945,57,4,53,20,1
413945,78,4,74,21,4
413945,78,4,74,22,1
413945,78,4,74,23,1
413945,21,0,21,24,1
413945,57,4,53,25,1
413945,57,4,53,40,1
413972,76,5,71,1,4
413972,76,5,71,2,1
413972,76,5,71,3,1
413972,53,3,50,4,1
413972,23,2,21,5,1
413972,23,2,21,20,1
413972,58,5,53,21,4
413972,58,5,53,22,1
413972,58,5,53,23,1
413972,45,3,42,24,1
413972,13,2,11,25,1
413972,13,2,11,40,1
413972,18,0,18,41,4
413972,18,0,18,42,1
413972,18,0,18,43,1
413972,8,0,8,44,1
413972,10,0,10,45,1
413972,10,0,10,60,1
414054,48,0,48,1,4
414054,48,0,48,2,1
414054,48,0,48,3,1
414054,23,0,23,4,1
414054,25,0,25,5,1
414054,25,0,25,20,1
414054,46,0,46,21,4
414054,46,0,46,22,1
414054,46,0,46,23,1
414054,22,0,22,24,1
414054,24,0,24,25,1
414054,24,0,24,40,1
414054,2,0,2,41,4
414054,2,0,2,42,1
414054,2,0,2,43,1
414054,1,0,1,44,1
414054,1,0,1,45,1
414054,1,0,1,60,1
414063,179,9,170,1,4
414063,179,9,170,2,1
414063,179,9,170,3,1
414063,56,1,55,4,1
414063,123,8,115,5,1
414063,123,8,115,20,1
414063,149,6,143,21,4
414063,149,6,143,22,1
414063,149,6,143,23,1
414063,53,0,53,24,1
414063,96,6,90,25,1
414063,96,6,90,40,1
414063,30,3,27,41,4
414063,30,3,27,42,1
414063,30,3,27,43,1
414063,3,1,2,44,1
414063,27,2,25,45,1
414063,27,2,25,60,1
414124,298,218,80,1,4
414124,298,218,80,2,1
414124,298,218,80,3,1
414124,222,168,54,4,1
414124,76,50,26,5,1
414124,76,50,26,20,1
414124,271,200,71,21,4
414124,271,200,71,22,1
414124,271,200,71,23,1
414124,200,154,46,24,1
414124,71,46,25,25,1
414124,71,46,25,40,1
414124,27,18,9,41,4
414124,27,18,9,42,1
414124,27,18,9,43,1
414124,22,14,8,44,1
414124,5,4,1,45,1
414124,5,4,1,60,1
414160,2257,597,1660,1,4
414160,2239,592,1647,2,1
414160,2202,581,1621,3,1
414160,286,105,181,4,1
414160,1916,476,1440,5,1
414160,37,11,26,11,1
414160,18,5,13,12,3
414160,230,73,157,19,1
414160,1686,403,1283,20,1
414160,1077,303,774,21,4
414160,1070,301,769,22,1
414160,1070,301,769,23,1
414160,198,74,124,24,1
414160,872,227,645,25,1
414160,7,2,5,32,3
414160,111,37,74,39,1
414160,761,190,571,40,1
414160,1180,294,886,41,4
414160,1169,291,878,42,1
414160,1132,280,852,43,1
414160,88,31,57,44,1
414160,1044,249,795,45,1
414160,37,11,26,51,1
414160,11,3,8,52,3
414160,119,36,83,59,1
414160,925,213,712,60,1
414452,25,0,25,1,4
414452,25,0,25,2,1
414452,25,0,25,3,1
414452,16,0,16,4,1
414452,9,0,9,5,1
414452,9,0,9,20,1
414452,25,0,25,21,4
414452,25,0,25,22,1
414452,25,0,25,23,1
414452,16,0,16,24,1
414452,9,0,9,25,1
414452,9,0,9,40,1
414461,3262,3093,169,1,4
414461,3262,3093,169,2,1
414461,3262,3093,169,3,1
414461,1046,996,50,4,1
414461,2216,2097,119,5,1
414461,441,402,39,19,1
414461,1775,1695,80,20,1
414461,2780,2646,134,21,4
414461,2780,2646,134,22,1
414461,2780,2646,134,23,1
414461,1046,996,50,24,1
414461,1734,1650,84,25,1
414461,291,269,22,39,1
414461,1443,1381,62,40,1
414461,482,447,35,41,4
414461,482,447,35,42,1
414461,482,447,35,43,1
414461,482,447,35,45,1
414461,150,133,17,59,1
414461,332,314,18,60,1
414489,79,2,77,1,4
414489,79,2,77,2,1
414489,79,2,77,3,1
414489,77,2,75,4,1
414489,2,0,2,5,1
414489,2,0,2,20,1
414489,79,2,77,21,4
414489,79,2,77,22,1
414489,79,2,77,23,1
414489,77,2,75,24,1
414489,2,0,2,25,1
414489,2,0,2,40,1
414531,271,235,36,1,4
414531,271,235,36,2,1
414531,271,235,36,3,1
414531,53,42,11,4,1
414531,218,193,25,5,1
414531,4,4,0,19,1
414531,214,189,25,20,1
414531,201,175,26,21,4
414531,201,175,26,22,1
414531,201,175,26,23,1
414531,41,35,6,24,1
414531,160,140,20,25,1
414531,3,3,0,39,1
414531,157,137,20,40,1
414531,70,60,10,41,4
414531,70,60,10,42,1
414531,70,60,10,43,1
414531,12,7,5,44,1
414531,58,53,5,45,1
414531,1,1,0,59,1
414531,57,52,5,60,1
414540,278,17,261,1,4
414540,278,17,261,2,1
414540,278,17,261,3,1
414540,69,4,65,4,1
414540,209,13,196,5,1
414540,209,13,196,20,1
414540,233,14,219,21,4
414540,233,14,219,22,1
414540,233,14,219,23,1
414540,60,2,58,24,1
414540,173,12,161,25,1
414540,173,12,161,40,1
414540,45,3,42,41,4
414540,45,3,42,42,1
414540,45,3,42,43,1
414540,9,2,7,44,1
414540,36,1,35,45,1
414540,36,1,35,60,1
414559,18,3,15,1,4
414559,18,3,15,2,1
414559,18,3,15,3,1
414559,10,3,7,4,1
414559,8,0,8,5,1
414559,8,0,8,20,1
414559,18,3,15,21,4
414559,18,3,15,22,1
414559,18,3,15,23,1
414559,10,3,7,24,1
414559,8,0,8,25,1
414559,8,0,8,40,1
414568,538,358,180,1,4
414568,538,358,180,2,1
414568,538,358,180,3,1
414568,98,68,30,4,1
414568,440,290,150,5,1
414568,8,4,4,19,1
414568,432,286,146,20,1
414568,386,260,126,21,4
414568,386,260,126,22,1
414568,386,260,126,23,1
414568,80,57,23,24,1
414568,306,203,103,25,1
414568,7,4,3,39,1
414568,299,199,100,40,1
414568,152,98,54,41,4
414568,152,98,54,42,1
414568,152,98,54,43,1
414568,18,11,7,44,1
414568,134,87,47,45,1
414568,1,0,1,59,1
414568,133,87,46,60,1
414586,527,282,245,1,4
414586,527,282,245,2,1
414586,527,282,245,3,1
414586,60,37,23,4,1
414586,467,245,222,5,1
414586,19,3,16,19,1
414586,448,242,206,20,1
414586,306,185,121,21,4
414586,306,185,121,22,1
414586,306,185,121,23,1
414586,52,29,23,24,1
414586,254,156,98,25,1
414586,9,1,8,39,1
414586,245,155,90,40,1
414586,221,97,124,41,4
414586,221,97,124,42,1
414586,221,97,124,43,1
414586,8,8,0,44,1
414586,213,89,124,45,1
414586,10,2,8,59,1
414586,203,87,116,60,1
414595,602,160,442,1,4
414595,145,39,106,2,1
414595,139,38,101,3,1
414595,15,5,10,4,1
414595,124,33,91,5,1
414595,6,1,5,11,1
414595,457,121,336,12,3
414595,11,3,8,19,1
414595,113,30,83,20,1
414595,422,116,306,21,4
414595,45,14,31,22,1
414595,43,13,30,23,1
414595,9,4,5,24,1
414595,34,9,25,25,1
414595,2,1,1,31,1
414595,377,102,275,32,3
414595,8,2,6,39,1
414595,26,7,19,40,1
414595,180,44,136,41,4
414595,100,25,75,42,1
414595,96,25,71,43,1
414595,6,1,5,44,1
414595,90,24,66,45,1
414595,4,0,4,51,1
414595,80,19,61,52,3
414595,3,1,2,59,1
414595,87,23,64,60,1
414708,5270,1815,3455,1,4
414708,4513,1560,2953,2,1
414708,4449,1537,2912,3,1
414708,195,78,117,4,1
414708,4254,1459,2795,5,1
414708,64,23,41,11,1
414708,757,255,502,12,3
414708,357,116,241,19,1
414708,3897,1343,2554,20,1
414708,1619,573,1046,21,4
414708,1283,457,826,22,1
414708,1283,457,826,23,1
414708,46,25,21,24,1
414708,1237,432,805,25,1
414708,336,116,220,32,3
414708,5,3,2,39,1
414708,1232,429,803,40,1
414708,3651,1242,2409,41,4
414708,3230,1103,2127,42,1
414708,3166,1080,2086,43,1
414708,149,53,96,44,1
414708,3017,1027,1990,45,1
414708,64,23,41,51,1
414708,421,139,282,52,3
414708,352,113,239,59,1
414708,2665,914,1751,60,1
414823,1952,745,1207,1,4
414823,1952,745,1207,2,1
414823,1937,736,1201,3,1
414823,491,191,300,4,1
414823,1446,545,901,5,1
414823,15,9,6,11,1
414823,160,45,115,19,1
414823,1286,500,786,20,1
414823,1900,724,1176,21,4
414823,1900,724,1176,22,1
414823,1885,715,1170,23,1
414823,486,188,298,24,1
414823,1399,527,872,25,1
414823,15,9,6,31,1
414823,158,45,113,39,1
414823,1241,482,759,40,1
414823,52,21,31,41,4
414823,52,21,31,42,1
414823,52,21,31,43,1
414823,5,3,2,44,1
414823,47,18,29,45,1
414823,2,0,2,59,1
414823,45,18,27,60,1
414841,224,181,43,1,4
414841,224,181,43,2,1
414841,224,181,43,3,1
414841,20,15,5,4,1
414841,204,166,38,5,1
414841,3,3,0,19,1
414841,201,163,38,20,1
414841,168,133,35,21,4
414841,168,133,35,22,1
414841,168,133,35,23,1
414841,20,15,5,24,1
414841,148,118,30,25,1
414841,3,3,0,39,1
414841,145,115,30,40,1
414841,56,48,8,41,4
414841,56,48,8,42,1
414841,56,48,8,43,1
414841,56,48,8,45,1
414841,56,48,8,60,1
414869,111,3,108,1,4
414869,111,3,108,2,1
414869,111,3,108,3,1
414869,24,2,22,4,1
414869,87,1,86,5,1
414869,87,1,86,20,1
414869,63,2,61,21,4
414869,63,2,61,22,1
414869,63,2,61,23,1
414869,18,2,16,24,1
414869,45,0,45,25,1
414869,45,0,45,40,1
414869,48,1,47,41,4
414869,48,1,47,42,1
414869,48,1,47,43,1
414869,6,0,6,44,1
414869,42,1,41,45,1
414869,42,1,41,60,1
414878,541,159,382,1,4
414878,438,135,303,2,1
414878,435,134,301,3,1
414878,4,1,3,4,1
414878,431,133,298,5,1
414878,3,1,2,11,1
414878,103,24,79,12,3
414878,59,21,38,19,1
414878,372,112,260,20,1
414878,353,92,261,21,4
414878,297,84,213,22,1
414878,297,84,213,23,1
414878,2,1,1,24,1
414878,295,83,212,25,1
414878,56,8,48,32,3
414878,36,11,25,39,1
414878,259,72,187,40,1
414878,188,67,121,41,4
414878,141,51,90,42,1
414878,138,50,88,43,1
414878,2,0,2,44,1
414878,136,50,86,45,1
414878,3,1,2,51,1
414878,47,16,31,52,3
414878,23,10,13,59,1
414878,113,40,73,60,1
414911,2506,1049,1457,1,4
414911,2506,1049,1457,2,1
414911,1336,571,765,3,1
414911,177,84,93,4,1
414911,1159,487,672,5,1
414911,1170,478,692,11,1
414911,49,18,31,19,1
414911,1110,469,641,20,1
414911,984,418,566,21,4
414911,984,418,566,22,1
414911,909,392,517,23,1
414911,130,61,69,24,1
414911,779,331,448,25,1
414911,75,26,49,31,1
414911,36,14,22,39,1
414911,743,317,426,40,1
414911,1522,631,891,41,4
414911,1522,631,891,42,1
414911,427,179,248,43,1
414911,47,23,24,44,1
414911,380,156,224,45,1
414911,1095,452,643,51,1
414911,13,4,9,59,1
414911,367,152,215,60,1
414939,272,50,222,1,4
414939,272,50,222,2,1
414939,272,50,222,3,1
414939,75,12,63,4,1
414939,197,38,159,5,1
414939,197,38,159,20,1
414939,272,50,222,21,4
414939,272,50,222,22,1
414939,272,50,222,23,1
414939,75,12,63,24,1
414939,197,38,159,25,1
414939,197,38,159,40,1
414966,126,69,57,1,4
414966,126,69,57,12,3
414966,42,23,19,21,4
414966,42,23,19,32,3
414966,84,46,38,41,4
414966,84,46,38,52,3
415039,96,3,93,1,4
415039,96,3,93,2,1
415039,96,3,93,3,1
415039,54,2,52,4,1
415039,42,1,41,5,1
415039,42,1,41,20,1
415039,73,3,70,21,4
415039,73,3,70,22,1
415039,73,3,70,23,1
415039,43,2,41,24,1
415039,30,1,29,25,1
415039,30,1,29,40,1
415039,23,0,23,41,4
415039,23,0,23,42,1
415039,23,0,23,43,1
415039,11,0,11,44,1
415039,12,0,12,45,1
415039,12,0,12,60,1
415057,117,115,2,1,4
415057,117,115,2,2,1
415057,117,115,2,3,1
415057,69,69,0,4,1
415057,48,46,2,5,1
415057,48,46,2,20,1
415057,117,115,2,21,4
415057,117,115,2,22,1
415057,117,115,2,23,1
415057,69,69,0,24,1
415057,48,46,2,25,1
415057,48,46,2,40,1
415729,19,9,10,1,4
415729,19,9,10,2,1
415729,19,9,10,3,1
415729,2,1,1,4,1
415729,17,8,9,5,1
415729,17,8,9,20,1
415729,11,4,7,21,4
415729,11,4,7,22,1
415729,11,4,7,23,1
415729,2,1,1,24,1
415729,9,3,6,25,1
415729,9,3,6,40,1
415729,8,5,3,41,4
415729,8,5,3,42,1
415729,8,5,3,43,1
415729,8,5,3,45,1
415729,8,5,3,60,1
415774,641,84,557,1,4
415774,641,84,557,2,1
415774,641,84,557,3,1
415774,198,22,176,4,1
415774,443,62,381,5,1
415774,443,62,381,20,1
415774,437,65,372,21,4
415774,437,65,372,22,1
415774,437,65,372,23,1
415774,139,18,121,24,1
415774,298,47,251,25,1
415774,298,47,251,40,1
415774,204,19,185,41,4
415774,204,19,185,42,1
415774,204,19,185,43,1
415774,59,4,55,44,1
415774,145,15,130,45,1
415774,145,15,130,60,1
415987,486,57,429,1,4
415987,486,57,429,2,1
415987,486,57,429,3,1
415987,171,28,143,4,1
415987,315,29,286,5,1
415987,315,29,286,20,1
415987,333,31,302,21,4
415987,333,31,302,22,1
415987,333,31,302,23,1
415987,87,15,72,24,1
415987,246,16,230,25,1
415987,246,16,230,40,1
415987,153,26,127,41,4
415987,153,26,127,42,1
415987,153,26,127,43,1
415987,84,13,71,44,1
415987,69,13,56,45,1
415987,69,13,56,60,1
416458,557,155,402,1,4
416458,557,155,402,2,1
416458,557,155,402,3,1
416458,117,32,85,4,1
416458,440,123,317,5,1
416458,440,123,317,20,1
416458,557,155,402,21,4
416458,557,155,402,22,1
416458,557,155,402,23,1
416458,117,32,85,24,1
416458,440,123,317,25,1
416458,440,123,317,40,1
416670,135,5,130,1,4
416670,135,5,130,2,1
416670,135,5,130,3,1
416670,80,3,77,4,1
416670,55,2,53,5,1
416670,55,2,53,20,1
416670,56,2,54,21,4
416670,56,2,54,22,1
416670,56,2,54,23,1
416670,34,1,33,24,1
416670,22,1,21,25,1
416670,22,1,21,40,1
416670,79,3,76,41,4
416670,79,3,76,42,1
416670,79,3,76,43,1
416670,46,2,44,44,1
416670,33,1,32,45,1
416670,33,1,32,60,1
416801,317,113,204,1,4
416801,313,112,201,2,1
416801,313,112,201,3,1
416801,313,112,201,5,1
416801,4,1,3,12,3
416801,166,63,103,19,1
416801,147,49,98,20,1
416801,283,103,180,21,4
416801,279,102,177,22,1
416801,279,102,177,23,1
416801,279,102,177,25,1
416801,4,1,3,32,3
416801,164,63,101,39,1
416801,115,39,76,40,1
416801,34,10,24,41,4
416801,34,10,24,42,1
416801,34,10,24,43,1
416801,34,10,24,45,1
416801,2,0,2,59,1
416801,32,10,22,60,1
416962,2180,871,1309,1,4
416962,1754,738,1016,2,1
416962,1753,738,1015,3,1
416962,43,20,23,4,1
416962,1710,718,992,5,1
416962,1,0,1,11,1
416962,426,133,293,12,3
416962,126,59,67,19,1
416962,1584,659,925,20,1
416962,2180,871,1309,21,4
416962,1754,738,1016,22,1
416962,1753,738,1015,23,1
416962,43,20,23,24,1
416962,1710,718,992,25,1
416962,1,0,1,31,1
416962,426,133,293,32,3
416962,126,59,67,39,1
416962,1584,659,925,40,1
416971,57,0,57,1,4
416971,57,0,57,2,1
416971,57,0,57,3,1
416971,22,0,22,4,1
416971,35,0,35,5,1
416971,35,0,35,20,1
416971,29,0,29,21,4
416971,29,0,29,22,1
416971,29,0,29,23,1
416971,13,0,13,24,1
416971,16,0,16,25,1
416971,16,0,16,40,1
416971,28,0,28,41,4
416971,28,0,28,42,1
416971,28,0,28,43,1
416971,9,0,9,44,1
416971,19,0,19,45,1
416971,19,0,19,60,1
416980,61,0,61,1,4
416980,61,0,61,2,1
416980,61,0,61,3,1
416980,24,0,24,4,1
416980,37,0,37,5,1
416980,37,0,37,20,1
416980,38,0,38,21,4
416980,38,0,38,22,1
416980,38,0,38,23,1
416980,18,0,18,24,1
416980,20,0,20,25,1
416980,20,0,20,40,1
416980,23,0,23,41,4
416980,23,0,23,42,1
416980,23,0,23,43,1
416980,6,0,6,44,1
416980,17,0,17,45,1
416980,17,0,17,60,1
417008,148,4,144,1,4
417008,148,4,144,2,1
417008,148,4,144,3,1
417008,55,2,53,4,1
417008,93,2,91,5,1
417008,93,2,91,20,1
417008,148,4,144,21,4
417008,148,4,144,22,1
417008,148,4,144,23,1
417008,55,2,53,24,1
417008,93,2,91,25,1
417008,93,2,91,40,1
417062,89,1,88,1,4
417062,89,1,88,2,1
417062,89,1,88,3,1
417062,22,0,22,4,1
417062,67,1,66,5,1
417062,67,1,66,20,1
417062,89,1,88,21,4
417062,89,1,88,22,1
417062,89,1,88,23,1
417062,22,0,22,24,1
417062,67,1,66,25,1
417062,67,1,66,40,1
417105,495,207,288,1,4
417105,495,207,288,2,1
417105,495,207,288,3,1
417105,132,60,72,4,1
417105,363,147,216,5,1
417105,363,147,216,20,1
417105,378,160,218,21,4
417105,378,160,218,22,1
417105,378,160,218,23,1
417105,115,54,61,24,1
417105,263,106,157,25,1
417105,263,106,157,40,1
417105,117,47,70,41,4
417105,117,47,70,42,1
417105,117,47,70,43,1
417105,17,6,11,44,1
417105,100,41,59,45,1
417105,100,41,59,60,1
417123,142,69,73,1,4
417123,142,69,73,2,1
417123,142,69,73,3,1
417123,48,25,23,4,1
417123,94,44,50,5,1
417123,94,44,50,20,1
417123,118,52,66,21,4
417123,118,52,66,22,1
417123,118,52,66,23,1
417123,41,19,22,24,1
417123,77,33,44,25,1
417123,77,33,44,40,1
417123,24,17,7,41,4
417123,24,17,7,42,1
417123,24,17,7,43,1
417123,7,6,1,44,1
417123,17,11,6,45,1
417123,17,11,6,60,1
417132,561,16,545,1,4
417132,561,16,545,2,1
417132,561,16,545,3,1
417132,193,3,190,4,1
417132,368,13,355,5,1
417132,368,13,355,20,1
417132,464,12,452,21,4
417132,464,12,452,22,1
417132,464,12,452,23,1
417132,153,1,152,24,1
417132,311,11,300,25,1
417132,311,11,300,40,1
417132,97,4,93,41,4
417132,97,4,93,42,1
417132,97,4,93,43,1
417132,40,2,38,44,1
417132,57,2,55,45,1
417132,57,2,55,60,1
417178,55,5,50,1,4
417178,55,5,50,2,1
417178,55,5,50,3,1
417178,7,0,7,4,1
417178,48,5,43,5,1
417178,48,5,43,20,1
417178,55,5,50,21,4
417178,55,5,50,22,1
417178,55,5,50,23,1
417178,7,0,7,24,1
417178,48,5,43,25,1
417178,48,5,43,40,1
417187,21,1,20,1,4
417187,21,1,20,2,1
417187,21,1,20,3,1
417187,1,1,0,4,1
417187,20,0,20,5,1
417187,20,0,20,20,1
417187,21,1,20,21,4
417187,21,1,20,22,1
417187,21,1,20,23,1
417187,1,1,0,24,1
417187,20,0,20,25,1
417187,20,0,20,40,1
417248,41,39,2,1,4
417248,41,39,2,2,1
417248,41,39,2,3,1
417248,38,37,1,4,1
417248,3,2,1,5,1
417248,3,2,1,20,1
417248,41,39,2,21,4
417248,41,39,2,22,1
417248,41,39,2,23,1
417248,38,37,1,24,1
417248,3,2,1,25,1
417248,3,2,1,40,1
417257,39,7,32,1,4
417257,39,7,32,2,1
417257,39,7,32,3,1
417257,9,0,9,4,1
417257,30,7,23,5,1
417257,30,7,23,20,1
417257,39,7,32,21,4
417257,39,7,32,22,1
417257,39,7,32,23,1
417257,9,0,9,24,1
417257,30,7,23,25,1
417257,30,7,23,40,1
417275,13,2,11,1,4
417275,13,2,11,2,1
417275,13,2,11,3,1
417275,3,1,2,4,1
417275,10,1,9,5,1
417275,10,1,9,20,1
417275,13,2,11,21,4
417275,13,2,11,22,1
417275,13,2,11,23,1
417275,3,1,2,24,1
417275,10,1,9,25,1
417275,10,1,9,40,1
417318,127,73,54,1,4
417318,127,73,54,2,1
417318,126,72,54,3,1
417318,19,7,12,4,1
417318,107,65,42,5,1
417318,1,1,0,11,1
417318,7,3,4,19,1
417318,100,62,38,20,1
417318,127,73,54,21,4
417318,127,73,54,22,1
417318,126,72,54,23,1
417318,19,7,12,24,1
417318,107,65,42,25,1
417318,1,1,0,31,1
417318,7,3,4,39,1
417318,100,62,38,40,1
417327,425,131,294,1,4
417327,425,131,294,2,1
417327,425,131,294,3,1
417327,33,13,20,4,1
417327,392,118,274,5,1
417327,50,14,36,19,1
417327,342,104,238,20,1
417327,300,94,206,21,4
417327,300,94,206,22,1
417327,300,94,206,23,1
417327,25,10,15,24,1
417327,275,84,191,25,1
417327,39,10,29,39,1
417327,236,74,162,40,1
417327,125,37,88,41,4
417327,125,37,88,42,1
417327,125,37,88,43,1
417327,8,3,5,44,1
417327,117,34,83,45,1
417327,11,4,7,59,1
417327,106,30,76,60,1
417345,12,0,12,1,4
417345,12,0,12,12,3
417345,12,0,12,21,4
417345,12,0,12,32,3
417381,168,16,152,1,4
417381,168,16,152,2,1
417381,168,16,152,3,1
417381,53,7,46,4,1
417381,115,9,106,5,1
417381,115,9,106,20,1
417381,138,11,127,21,4
417381,138,11,127,22,1
417381,138,11,127,23,1
417381,45,4,41,24,1
417381,93,7,86,25,1
417381,93,7,86,40,1
417381,30,5,25,41,4
417381,30,5,25,42,1
417381,30,5,25,43,1
417381,8,3,5,44,1
417381,22,2,20,45,1
417381,22,2,20,60,1
417406,58,0,58,1,4
417406,58,0,58,2,1
417406,58,0,58,3,1
417406,17,0,17,4,1
417406,41,0,41,5,1
417406,41,0,41,20,1
417406,58,0,58,21,4
417406,58,0,58,22,1
417406,58,0,58,23,1
417406,17,0,17,24,1
417406,41,0,41,25,1
417406,41,0,41,40,1
417442,90,5,85,1,4
417442,90,5,85,2,1
417442,90,5,85,3,1
417442,11,3,8,4,1
417442,79,2,77,5,1
417442,79,2,77,20,1
417442,90,5,85,21,4
417442,90,5,85,22,1
417442,90,5,85,23,1
417442,11,3,8,24,1
417442,79,2,77,25,1
417442,79,2,77,40,1
417503,286,3,283,1,4
417503,286,3,283,2,1
417503,286,3,283,3,1
417503,56,1,55,4,1
417503,230,2,228,5,1
417503,230,2,228,20,1
417503,240,1,239,21,4
417503,240,1,239,22,1
417503,240,1,239,23,1
417503,49,1,48,24,1
417503,191,0,191,25,1
417503,191,0,191,40,1
417503,46,2,44,41,4
417503,46,2,44,42,1
417503,46,2,44,43,1
417503,7,0,7,44,1
417503,39,2,37,45,1
417503,39,2,37,60,1
417549,267,1,266,1,4
417549,267,1,266,2,1
417549,267,1,266,3,1
417549,150,1,149,4,1
417549,117,0,117,5,1
417549,117,0,117,20,1
417549,267,1,266,21,4
417549,267,1,266,22,1
417549,267,1,266,23,1
417549,150,1,149,24,1
417549,117,0,117,25,1
417549,117,0,117,40,1
417576,132,6,126,1,4
417576,132,6,126,2,1
417576,132,6,126,3,1
417576,130,6,124,4,1
417576,2,0,2,5,1
417576,2,0,2,20,1
417576,121,6,115,21,4
417576,121,6,115,22,1
417576,121,6,115,23,1
417576,120,6,114,24,1
417576,1,0,1,25,1
417576,1,0,1,40,1
417576,11,0,11,41,4
417576,11,0,11,42,1
417576,11,0,11,43,1
417576,10,0,10,44,1
417576,1,0,1,45,1
417576,1,0,1,60,1
417600,39,0,39,1,4
417600,39,0,39,2,1
417600,39,0,39,3,1
417600,19,0,19,4,1
417600,20,0,20,5,1
417600,20,0,20,20,1
417600,39,0,39,21,4
417600,39,0,39,22,1
417600,39,0,39,23,1
417600,19,0,19,24,1
417600,20,0,20,25,1
417600,20,0,20,40,1
417628,27,6,21,1,4
417628,27,6,21,2,1
417628,27,6,21,3,1
417628,4,2,2,4,1
417628,23,4,19,5,1
417628,23,4,19,20,1
417628,26,5,21,21,4
417628,26,5,21,22,1
417628,26,5,21,23,1
417628,4,2,2,24,1
417628,22,3,19,25,1
417628,22,3,19,40,1
417628,1,1,0,41,4
417628,1,1,0,42,1
417628,1,1,0,43,1
417628,1,1,0,45,1
417628,1,1,0,60,1
417637,135,43,92,1,4
417637,135,43,92,2,1
417637,135,43,92,3,1
417637,45,27,18,4,1
417637,90,16,74,5,1
417637,90,16,74,20,1
417637,135,43,92,21,4
417637,135,43,92,22,1
417637,135,43,92,23,1
417637,45,27,18,24,1
417637,90,16,74,25,1
417637,90,16,74,40,1
417646,23,1,22,1,4
417646,23,1,22,2,1
417646,23,1,22,3,1
417646,11,0,11,4,1
417646,12,1,11,5,1
417646,12,1,11,20,1
417646,23,1,22,21,4
417646,23,1,22,22,1
417646,23,1,22,23,1
417646,11,0,11,24,1
417646,12,1,11,25,1
417646,12,1,11,40,1
417655,40,3,37,1,4
417655,40,3,37,2,1
417655,40,3,37,3,1
417655,19,1,18,4,1
417655,21,2,19,5,1
417655,21,2,19,20,1
417655,40,3,37,21,4
417655,40,3,37,22,1
417655,40,3,37,23,1
417655,19,1,18,24,1
417655,21,2,19,25,1
417655,21,2,19,40,1
417673,19,2,17,1,4
417673,19,2,17,2,1
417673,19,2,17,3,1
417673,11,2,9,4,1
417673,8,0,8,5,1
417673,8,0,8,20,1
417673,18,1,17,21,4
417673,18,1,17,22,1
417673,18,1,17,23,1
417673,10,1,9,24,1
417673,8,0,8,25,1
417673,8,0,8,40,1
417673,1,1,0,41,4
417673,1,1,0,42,1
417673,1,1,0,43,1
417673,1,1,0,44,1
417682,28,2,26,1,4
417682,28,2,26,2,1
417682,28,2,26,3,1
417682,3,0,3,4,1
417682,25,2,23,5,1
417682,25,2,23,20,1
417682,28,2,26,21,4
417682,28,2,26,22,1
417682,28,2,26,23,1
417682,3,0,3,24,1
417682,25,2,23,25,1
417682,25,2,23,40,1
417716,166,6,160,1,4
417716,166,6,160,2,1
417716,166,6,160,3,1
417716,11,1,10,4,1
417716,155,5,150,5,1
417716,155,5,150,20,1
417716,166,6,160,21,4
417716,166,6,160,22,1
417716,166,6,160,23,1
417716,11,1,10,24,1
417716,155,5,150,25,1
417716,155,5,150,40,1
417725,105,8,97,1,4
417725,105,8,97,2,1
417725,105,8,97,3,1
417725,10,2,8,4,1
417725,95,6,89,5,1
417725,95,6,89,20,1
417725,105,8,97,21,4
417725,105,8,97,22,1
417725,105,8,97,23,1
417725,10,2,8,24,1
417725,95,6,89,25,1
417725,95,6,89,40,1
417734,222,53,169,1,4
417734,222,53,169,2,1
417734,222,53,169,3,1
417734,5,2,3,4,1
417734,217,51,166,5,1
417734,42,11,31,19,1
417734,175,40,135,20,1
417734,61,16,45,21,4
417734,61,16,45,22,1
417734,61,16,45,23,1
417734,3,2,1,24,1
417734,58,14,44,25,1
417734,18,4,14,39,1
417734,40,10,30,40,1
417734,161,37,124,41,4
417734,161,37,124,42,1
417734,161,37,124,43,1
417734,2,0,2,44,1
417734,159,37,122,45,1
417734,24,7,17,59,1
417734,135,30,105,60,1
417743,4,4,0,1,4
417743,4,4,0,2,1
417743,4,4,0,3,1
417743,3,3,0,4,1
417743,1,1,0,5,1
417743,1,1,0,20,1
417743,4,4,0,21,4
417743,4,4,0,22,1
417743,4,4,0,23,1
417743,3,3,0,24,1
417743,1,1,0,25,1
417743,1,1,0,40,1
417752,47,22,25,1,4
417752,47,22,25,2,1
417752,47,22,25,3,1
417752,13,5,8,4,1
417752,34,17,17,5,1
417752,4,2,2,19,1
417752,30,15,15,20,1
417752,38,15,23,21,4
417752,38,15,23,22,1
417752,38,15,23,23,1
417752,12,4,8,24,1
417752,26,11,15,25,1
417752,4,2,2,39,1
417752,22,9,13,40,1
417752,9,7,2,41,4
417752,9,7,2,42,1
417752,9,7,2,43,1
417752,1,1,0,44,1
417752,8,6,2,45,1
417752,8,6,2,60,1
417789,125,6,119,1,4
417789,125,6,119,2,1
417789,125,6,119,3,1
417789,81,4,77,4,1
417789,44,2,42,5,1
417789,44,2,42,20,1
417789,62,4,58,21,4
417789,62,4,58,22,1
417789,62,4,58,23,1
417789,33,3,30,24,1
417789,29,1,28,25,1
417789,29,1,28,40,1
417789,63,2,61,41,4
417789,63,2,61,42,1
417789,63,2,61,43,1
417789,48,1,47,44,1
417789,15,1,14,45,1
417789,15,1,14,60,1
417798,34,5,29,1,4
417798,34,5,29,2,1
417798,34,5,29,3,1
417798,10,1,9,4,1
417798,24,4,20,5,1
417798,24,4,20,20,1
417798,34,5,29,21,4
417798,34,5,29,22,1
417798,34,5,29,23,1
417798,10,1,9,24,1
417798,24,4,20,25,1
417798,24,4,20,40,1
417804,70,8,62,1,4
417804,70,8,62,2,1
417804,70,8,62,3,1
417804,4,2,2,4,1
417804,66,6,60,5,1
417804,66,6,60,20,1
417804,70,8,62,21,4
417804,70,8,62,22,1
417804,70,8,62,23,1
417804,4,2,2,24,1
417804,66,6,60,25,1
417804,66,6,60,40,1
417831,137,103,34,1,4
417831,137,103,34,2,1
417831,137,103,34,3,1
417831,66,52,14,4,1
417831,71,51,20,5,1
417831,71,51,20,20,1
417831,137,103,34,21,4
417831,137,103,34,22,1
417831,137,103,34,23,1
417831,66,52,14,24,1
417831,71,51,20,25,1
417831,71,51,20,40,1
417840,280,29,251,1,4
417840,280,29,251,2,1
417840,280,29,251,3,1
417840,190,26,164,4,1
417840,90,3,87,5,1
417840,90,3,87,20,1
417840,280,29,251,21,4
417840,280,29,251,22,1
417840,280,29,251,23,1
417840,190,26,164,24,1
417840,90,3,87,25,1
417840,90,3,87,40,1
417868,22,4,18,1,4
417868,22,4,18,2,1
417868,22,4,18,3,1
417868,22,4,18,4,1
417868,22,4,18,21,4
417868,22,4,18,22,1
417868,22,4,18,23,1
417868,22,4,18,24,1
417886,84,7,77,1,4
417886,84,7,77,2,1
417886,84,7,77,3,1
417886,10,1,9,4,1
417886,74,6,68,5,1
417886,74,6,68,20,1
417886,84,7,77,21,4
417886,84,7,77,22,1
417886,84,7,77,23,1
417886,10,1,9,24,1
417886,74,6,68,25,1
417886,74,6,68,40,1
417901,24,7,17,1,4
417901,24,7,17,2,1
417901,24,7,17,3,1
417901,24,7,17,5,1
417901,24,7,17,20,1
417901,24,7,17,21,4
417901,24,7,17,22,1
417901,24,7,17,23,1
417901,24,7,17,25,1
417901,24,7,17,40,1
417910,158,30,128,1,4
417910,158,30,128,2,1
417910,158,30,128,3,1
417910,118,19,99,4,1
417910,40,11,29,5,1
417910,40,11,29,20,1
417910,158,30,128,21,4
417910,158,30,128,22,1
417910,158,30,128,23,1
417910,118,19,99,24,1
417910,40,11,29,25,1
417910,40,11,29,40,1
417947,26,2,24,1,4
417947,26,2,24,2,1
417947,26,2,24,3,1
417947,3,0,3,4,1
417947,23,2,21,5,1
417947,23,2,21,20,1
417947,26,2,24,21,4
417947,26,2,24,22,1
417947,26,2,24,23,1
417947,3,0,3,24,1
417947,23,2,21,25,1
417947,23,2,21,40,1
417983,70,4,66,1,4
417983,70,4,66,2,1
417983,70,4,66,3,1
417983,44,2,42,4,1
417983,26,2,24,5,1
417983,26,2,24,20,1
417983,70,4,66,41,4
417983,70,4,66,42,1
417983,70,4,66,43,1
417983,44,2,42,44,1
417983,26,2,24,45,1
417983,26,2,24,60,1
417992,54,11,43,1,4
417992,54,11,43,2,1
417992,54,11,43,3,1
417992,10,4,6,4,1
417992,44,7,37,5,1
417992,44,7,37,20,1
417992,40,7,33,21,4
417992,40,7,33,22,1
417992,40,7,33,23,1
417992,10,4,6,24,1
417992,30,3,27,25,1
417992,30,3,27,40,1
417992,14,4,10,41,4
417992,14,4,10,42,1
417992,14,4,10,43,1
417992,14,4,10,45,1
417992,14,4,10,60,1
418001,283,16,267,1,4
418001,283,16,267,2,1
418001,283,16,267,3,1
418001,26,1,25,4,1
418001,257,15,242,5,1
418001,257,15,242,20,1
418001,283,16,267,21,4
418001,283,16,267,22,1
418001,283,16,267,23,1
418001,26,1,25,24,1
418001,257,15,242,25,1
418001,257,15,242,40,1
418010,61,4,57,1,4
418010,61,4,57,2,1
418010,61,4,57,3,1
418010,16,3,13,4,1
418010,45,1,44,5,1
418010,45,1,44,20,1
418010,20,3,17,21,4
418010,20,3,17,22,1
418010,20,3,17,23,1
418010,5,3,2,24,1
418010,15,0,15,25,1
418010,15,0,15,40,1
418010,41,1,40,41,4
418010,41,1,40,42,1
418010,41,1,40,43,1
418010,11,0,11,44,1
418010,30,1,29,45,1
418010,30,1,29,60,1
418029,46,4,42,1,4
418029,46,4,42,2,1
418029,46,4,42,3,1
418029,8,3,5,4,1
418029,38,1,37,5,1
418029,38,1,37,20,1
418029,36,4,32,21,4
418029,36,4,32,22,1
418029,36,4,32,23,1
418029,8,3,5,24,1
418029,28,1,27,25,1
418029,28,1,27,40,1
418029,10,0,10,41,4
418029,10,0,10,42,1
418029,10,0,10,43,1
418029,10,0,10,45,1
418029,10,0,10,60,1
418038,136,15,121,1,4
418038,136,15,121,2,1
418038,136,15,121,3,1
418038,24,2,22,4,1
418038,112,13,99,5,1
418038,112,13,99,20,1
418038,136,15,121,21,4
418038,136,15,121,22,1
418038,136,15,121,23,1
418038,24,2,22,24,1
418038,112,13,99,25,1
418038,112,13,99,40,1
418056,127,17,110,1,4
418056,127,17,110,2,1
418056,127,17,110,3,1
418056,58,5,53,4,1
418056,69,12,57,5,1
418056,69,12,57,20,1
418056,93,13,80,21,4
418056,93,13,80,22,1
418056,93,13,80,23,1
418056,49,4,45,24,1
418056,44,9,35,25,1
418056,44,9,35,40,1
418056,34,4,30,41,4
418056,34,4,30,42,1
418056,34,4,30,43,1
418056,9,1,8,44,1
418056,25,3,22,45,1
418056,25,3,22,60,1
418065,339,40,299,1,4
418065,339,40,299,2,1
418065,339,40,299,3,1
418065,110,20,90,4,1
418065,229,20,209,5,1
418065,229,20,209,20,1
418065,252,29,223,21,4
418065,252,29,223,22,1
418065,252,29,223,23,1
418065,80,14,66,24,1
418065,172,15,157,25,1
418065,172,15,157,40,1
418065,87,11,76,41,4
418065,87,11,76,42,1
418065,87,11,76,43,1
418065,30,6,24,44,1
418065,57,5,52,45,1
418065,57,5,52,60,1
418083,126,27,99,1,4
418083,126,27,99,2,1
418083,126,27,99,3,1
418083,56,12,44,4,1
418083,70,15,55,5,1
418083,70,15,55,20,1
418083,83,17,66,21,4
418083,83,17,66,22,1
418083,83,17,66,23,1
418083,32,6,26,24,1
418083,51,11,40,25,1
418083,51,11,40,40,1
418083,43,10,33,41,4
418083,43,10,33,42,1
418083,43,10,33,43,1
418083,24,6,18,44,1
418083,19,4,15,45,1
418083,19,4,15,60,1
418126,782,231,551,1,4
418126,537,159,378,2,1
418126,529,158,371,3,1
418126,64,14,50,4,1
418126,465,144,321,5,1
418126,8,1,7,11,1
418126,245,72,173,12,3
418126,82,25,57,19,1
418126,383,119,264,20,1
418126,462,139,323,21,4
418126,312,91,221,22,1
418126,311,91,220,23,1
418126,43,9,34,24,1
418126,268,82,186,25,1
418126,1,0,1,31,1
418126,150,48,102,32,3
418126,53,21,32,39,1
418126,215,61,154,40,1
418126,320,92,228,41,4
418126,225,68,157,42,1
418126,218,67,151,43,1
418126,21,5,16,44,1
418126,197,62,135,45,1
418126,7,1,6,51,1
418126,95,24,71,52,3
418126,29,4,25,59,1
418126,168,58,110,60,1
418171,37,37,0,1,4
418171,37,37,0,2,1
418171,37,37,0,3,1
418171,28,28,0,4,1
418171,9,9,0,5,1
418171,9,9,0,20,1
418171,37,37,0,21,4
418171,37,37,0,22,1
418171,37,37,0,23,1
418171,28,28,0,24,1
418171,9,9,0,25,1
418171,9,9,0,40,1
418199,55,54,1,1,4
418199,55,54,1,2,1
418199,55,54,1,3,1
418199,30,30,0,4,1
418199,25,24,1,5,1
418199,25,24,1,20,1
418199,55,54,1,21,4
418199,55,54,1,22,1
418199,55,54,1,23,1
418199,30,30,0,24,1
418199,25,24,1,25,1
418199,25,24,1,40,1
418205,348,199,149,1,4
418205,348,199,149,2,1
418205,277,165,112,3,1
418205,91,55,36,4,1
418205,186,110,76,5,1
418205,71,34,37,11,1
418205,186,110,76,20,1
418205,161,88,73,21,4
418205,161,88,73,22,1
418205,161,88,73,23,1
418205,54,36,18,24,1
418205,107,52,55,25,1
418205,107,52,55,40,1
418205,187,111,76,41,4
418205,187,111,76,42,1
418205,116,77,39,43,1
418205,37,19,18,44,1
418205,79,58,21,45,1
418205,71,34,37,51,1
418205,79,58,21,60,1
418223,67,3,64,1,4
418223,67,3,64,2,1
418223,67,3,64,3,1
418223,24,0,24,4,1
418223,43,3,40,5,1
418223,43,3,40,20,1
418223,67,3,64,21,4
418223,67,3,64,22,1
418223,67,3,64,23,1
418223,24,0,24,24,1
418223,43,3,40,25,1
418223,43,3,40,40,1
418250,261,156,105,1,4
418250,261,156,105,2,1
418250,261,156,105,3,1
418250,214,120,94,4,1
418250,47,36,11,5,1
418250,47,36,11,20,1
418250,184,105,79,21,4
418250,184,105,79,22,1
418250,184,105,79,23,1
418250,144,73,71,24,1
418250,40,32,8,25,1
418250,40,32,8,40,1
418250,77,51,26,41,4
418250,77,51,26,42,1
418250,77,51,26,43,1
418250,70,47,23,44,1
418250,7,4,3,45,1
418250,7,4,3,60,1
418269,19,13,6,1,4
418269,19,13,6,2,1
418269,19,13,6,3,1
418269,10,6,4,4,1
418269,9,7,2,5,1
418269,9,7,2,20,1
418269,19,13,6,21,4
418269,19,13,6,22,1
418269,19,13,6,23,1
418269,10,6,4,24,1
418269,9,7,2,25,1
418269,9,7,2,40,1
418278,62,26,36,1,4
418278,62,26,36,2,1
418278,62,26,36,3,1
418278,30,19,11,4,1
418278,32,7,25,5,1
418278,32,7,25,20,1
418278,29,3,26,21,4
418278,29,3,26,22,1
418278,29,3,26,23,1
418278,11,2,9,24,1
418278,18,1,17,25,1
418278,18,1,17,40,1
418278,33,23,10,41,4
418278,33,23,10,42,1
418278,33,23,10,43,1
418278,19,17,2,44,1
418278,14,6,8,45,1
418278,14,6,8,60,1
418287,539,283,256,1,4
418287,539,283,256,2,1
418287,539,283,256,3,1
418287,77,30,47,4,1
418287,462,253,209,5,1
418287,462,253,209,20,1
418287,116,34,82,21,4
418287,116,34,82,22,1
418287,116,34,82,23,1
418287,60,23,37,24,1
418287,56,11,45,25,1
418287,56,11,45,40,1
418287,423,249,174,41,4
418287,423,249,174,42,1
418287,423,249,174,43,1
418287,17,7,10,44,1
418287,406,242,164,45,1
418287,406,242,164,60,1
418296,759,427,332,1,4
418296,759,427,332,2,1
418296,759,427,332,3,1
418296,665,385,280,4,1
418296,94,42,52,5,1
418296,94,42,52,20,1
418296,172,92,80,21,4
418296,172,92,80,22,1
418296,172,92,80,23,1
418296,96,59,37,24,1
418296,76,33,43,25,1
418296,76,33,43,40,1
418296,587,335,252,41,4
418296,587,335,252,42,1
418296,587,335,252,43,1
418296,569,326,243,44,1
418296,18,9,9,45,1
418296,18,9,9,60,1
418302,459,205,254,1,4
418302,459,205,254,2,1
418302,140,54,86,3,1
418302,101,30,71,4,1
418302,39,24,15,5,1
418302,319,151,168,11,1
418302,39,24,15,20,1
418302,116,39,77,21,4
418302,116,39,77,22,1
418302,116,39,77,23,1
418302,84,19,65,24,1
418302,32,20,12,25,1
418302,32,20,12,40,1
418302,343,166,177,41,4
418302,343,166,177,42,1
418302,24,15,9,43,1
418302,17,11,6,44,1
418302,7,4,3,45,1
418302,319,151,168,51,1
418302,7,4,3,60,1
418320,762,431,331,1,4
418320,762,431,331,2,1
418320,762,431,331,3,1
418320,99,40,59,4,1
418320,663,391,272,5,1
418320,663,391,272,20,1
418320,66,26,40,21,4
418320,66,26,40,22,1
418320,66,26,40,23,1
418320,48,19,29,24,1
418320,18,7,11,25,1
418320,18,7,11,40,1
418320,696,405,291,41,4
418320,696,405,291,42,1
418320,696,405,291,43,1
418320,51,21,30,44,1
418320,645,384,261,45,1
418320,645,384,261,60,1
418339,384,209,175,1,4
418339,384,209,175,2,1
418339,100,53,47,3,1
418339,55,32,23,4,1
418339,45,21,24,5,1
418339,284,156,128,11,1
418339,45,21,24,20,1
418339,55,29,26,21,4
418339,55,29,26,22,1
418339,54,28,26,23,1
418339,21,18,3,24,1
418339,33,10,23,25,1
418339,1,1,0,31,1
418339,33,10,23,40,1
418339,329,180,149,41,4
418339,329,180,149,42,1
418339,46,25,21,43,1
418339,34,14,20,44,1
418339,12,11,1,45,1
418339,283,155,128,51,1
418339,12,11,1,60,1
418348,500,343,157,1,4
418348,500,343,157,2,1
418348,142,112,30,3,1
418348,89,71,18,4,1
418348,53,41,12,5,1
418348,358,231,127,11,1
418348,53,41,12,20,1
418348,81,64,17,21,4
418348,81,64,17,22,1
418348,81,64,17,23,1
418348,48,37,11,24,1
418348,33,27,6,25,1
418348,33,27,6,40,1
418348,419,279,140,41,4
418348,419,279,140,42,1
418348,61,48,13,43,1
418348,41,34,7,44,1
418348,20,14,6,45,1
418348,358,231,127,51,1
418348,20,14,6,60,1
418357,198,86,112,1,4
418357,198,86,112,2,1
418357,108,43,65,3,1
418357,47,18,29,4,1
418357,61,25,36,5,1
418357,90,43,47,11,1
418357,61,25,36,20,1
418357,103,43,60,21,4
418357,103,43,60,22,1
418357,103,43,60,23,1
418357,42,18,24,24,1
418357,61,25,36,25,1
418357,61,25,36,40,1
418357,95,43,52,41,4
418357,95,43,52,42,1
418357,5,0,5,43,1
418357,5,0,5,44,1
418357,90,43,47,51,1
418384,48,3,45,1,4
418384,48,3,45,2,1
418384,48,3,45,3,1
418384,26,2,24,4,1
418384,22,1,21,5,1
418384,22,1,21,20,1
418384,48,3,45,21,4
418384,48,3,45,22,1
418384,48,3,45,23,1
418384,26,2,24,24,1
418384,22,1,21,25,1
418384,22,1,21,40,1
418409,174,73,101,1,4
418409,174,73,101,2,1
418409,174,73,101,3,1
418409,89,46,43,4,1
418409,85,27,58,5,1
418409,85,27,58,20,1
418409,53,6,47,21,4
418409,53,6,47,22,1
418409,53,6,47,23,1
418409,22,6,16,24,1
418409,31,0,31,25,1
418409,31,0,31,40,1
418409,121,67,54,41,4
418409,121,67,54,42,1
418409,121,67,54,43,1
418409,67,40,27,44,1
418409,54,27,27,45,1
418409,54,27,27,60,1
418427,156,15,141,1,4
418427,156,15,141,2,1
418427,156,15,141,3,1
418427,20,1,19,4,1
418427,136,14,122,5,1
418427,136,14,122,20,1
418427,135,15,120,21,4
418427,135,15,120,22,1
418427,135,15,120,23,1
418427,20,1,19,24,1
418427,115,14,101,25,1
418427,115,14,101,40,1
418427,21,0,21,41,4
418427,21,0,21,42,1
418427,21,0,21,43,1
418427,21,0,21,45,1
418427,21,0,21,60,1
418445,34,0,34,1,4
418445,34,0,34,2,1
418445,34,0,34,3,1
418445,18,0,18,4,1
418445,16,0,16,5,1
418445,16,0,16,20,1
418445,34,0,34,21,4
418445,34,0,34,22,1
418445,34,0,34,23,1
418445,18,0,18,24,1
418445,16,0,16,25,1
418445,16,0,16,40,1
418454,228,108,120,1,4
418454,228,108,120,2,1
418454,228,108,120,3,1
418454,204,107,97,4,1
418454,24,1,23,5,1
418454,24,1,23,20,1
418454,193,93,100,21,4
418454,193,93,100,22,1
418454,193,93,100,23,1
418454,182,92,90,24,1
418454,11,1,10,25,1
418454,11,1,10,40,1
418454,35,15,20,41,4
418454,35,15,20,42,1
418454,35,15,20,43,1
418454,22,15,7,44,1
418454,13,0,13,45,1
418454,13,0,13,60,1
418481,53,7,46,1,4
418481,53,7,46,2,1
418481,53,7,46,3,1
418481,25,2,23,4,1
418481,28,5,23,5,1
418481,28,5,23,20,1
418481,53,7,46,21,4
418481,53,7,46,22,1
418481,53,7,46,23,1
418481,25,2,23,24,1
418481,28,5,23,25,1
418481,28,5,23,40,1
418506,36,1,35,1,4
418506,36,1,35,2,1
418506,36,1,35,3,1
418506,35,0,35,4,1
418506,1,1,0,5,1
418506,1,1,0,20,1
418506,36,1,35,21,4
418506,36,1,35,22,1
418506,36,1,35,23,1
418506,35,0,35,24,1
418506,1,1,0,25,1
418506,1,1,0,40,1
418515,79,8,71,1,4
418515,79,8,71,2,1
418515,79,8,71,3,1
418515,62,7,55,4,1
418515,17,1,16,5,1
418515,17,1,16,20,1
418515,51,8,43,21,4
418515,51,8,43,22,1
418515,51,8,43,23,1
418515,42,7,35,24,1
418515,9,1,8,25,1
418515,9,1,8,40,1
418515,28,0,28,41,4
418515,28,0,28,42,1
418515,28,0,28,43,1
418515,20,0,20,44,1
418515,8,0,8,45,1
418515,8,0,8,60,1
418524,65,9,56,1,4
418524,65,9,56,2,1
418524,65,9,56,3,1
418524,27,4,23,4,1
418524,38,5,33,5,1
418524,38,5,33,20,1
418524,65,9,56,21,4
418524,65,9,56,22,1
418524,65,9,56,23,1
418524,27,4,23,24,1
418524,38,5,33,25,1
418524,38,5,33,40,1
418533,407,99,308,1,4
418533,407,99,308,2,1
418533,407,99,308,3,1
418533,264,71,193,4,1
418533,143,28,115,5,1
418533,143,28,115,20,1
418533,225,42,183,21,4
418533,225,42,183,22,1
418533,225,42,183,23,1
418533,140,30,110,24,1
418533,85,12,73,25,1
418533,85,12,73,40,1
418533,182,57,125,41,4
418533,182,57,125,42,1
418533,182,57,125,43,1
418533,124,41,83,44,1
418533,58,16,42,45,1
418533,58,16,42,60,1
418542,159,22,137,1,4
418542,159,22,137,2,1
418542,159,22,137,3,1
418542,82,20,62,4,1
418542,77,2,75,5,1
418542,77,2,75,20,1
418542,91,17,74,21,4
418542,91,17,74,22,1
418542,91,17,74,23,1
418542,44,17,27,24,1
418542,47,0,47,25,1
418542,47,0,47,40,1
418542,68,5,63,41,4
418542,68,5,63,42,1
418542,68,5,63,43,1
418542,38,3,35,44,1
418542,30,2,28,45,1
418542,30,2,28,60,1
418560,105,23,82,1,4
418560,105,23,82,2,1
418560,105,23,82,3,1
418560,41,13,28,4,1
418560,64,10,54,5,1
418560,64,10,54,20,1
418560,39,3,36,21,4
418560,39,3,36,22,1
418560,39,3,36,23,1
418560,13,1,12,24,1
418560,26,2,24,25,1
418560,26,2,24,40,1
418560,66,20,46,41,4
418560,66,20,46,42,1
418560,66,20,46,43,1
418560,28,12,16,44,1
418560,38,8,30,45,1
418560,38,8,30,60,1
418588,39,2,37,1,4
418588,39,2,37,2,1
418588,39,2,37,3,1
418588,15,0,15,4,1
418588,24,2,22,5,1
418588,24,2,22,20,1
418588,39,2,37,21,4
418588,39,2,37,22,1
418588,39,2,37,23,1
418588,15,0,15,24,1
418588,24,2,22,25,1
418588,24,2,22,40,1
418603,35,1,34,1,4
418603,35,1,34,2,1
418603,35,1,34,3,1
418603,17,0,17,4,1
418603,18,1,17,5,1
418603,18,1,17,20,1
418603,13,0,13,21,4
418603,13,0,13,22,1
418603,13,0,13,23,1
418603,4,0,4,24,1
418603,9,0,9,25,1
418603,9,0,9,40,1
418603,22,1,21,41,4
418603,22,1,21,42,1
418603,22,1,21,43,1
418603,13,0,13,44,1
418603,9,1,8,45,1
418603,9,1,8,60,1
418612,26,4,22,1,4
418612,26,4,22,2,1
418612,26,4,22,3,1
418612,4,1,3,4,1
418612,22,3,19,5,1
418612,22,3,19,20,1
418612,26,4,22,21,4
418612,26,4,22,22,1
418612,26,4,22,23,1
418612,4,1,3,24,1
418612,22,3,19,25,1
418612,22,3,19,40,1
418658,364,342,22,1,4
418658,364,342,22,2,1
418658,364,342,22,3,1
418658,102,98,4,4,1
418658,262,244,18,5,1
418658,262,244,18,20,1
418658,364,342,22,21,4
418658,364,342,22,22,1
418658,364,342,22,23,1
418658,102,98,4,24,1
418658,262,244,18,25,1
418658,262,244,18,40,1
418700,275,129,146,1,4
418700,275,129,146,2,1
418700,275,129,146,3,1
418700,117,32,85,4,1
418700,158,97,61,5,1
418700,158,97,61,20,1
418700,275,129,146,21,4
418700,275,129,146,22,1
418700,275,129,146,23,1
418700,117,32,85,24,1
418700,158,97,61,25,1
418700,158,97,61,40,1
418755,118,36,82,1,4
418755,118,36,82,2,1
418755,118,36,82,3,1
418755,23,7,16,4,1
418755,95,29,66,5,1
418755,95,29,66,20,1
418755,118,36,82,21,4
418755,118,36,82,22,1
418755,118,36,82,23,1
418755,23,7,16,24,1
418755,95,29,66,25,1
418755,95,29,66,40,1
418764,94,18,76,1,4
418764,94,18,76,2,1
418764,94,18,76,3,1
418764,41,9,32,4,1
418764,53,9,44,5,1
418764,53,9,44,20,1
418764,94,18,76,21,4
418764,94,18,76,22,1
418764,94,18,76,23,1
418764,41,9,32,24,1
418764,53,9,44,25,1
418764,53,9,44,40,1
418773,1550,618,932,1,4
418773,1550,618,932,2,1
418773,1550,618,932,3,1
418773,748,286,462,4,1
418773,802,332,470,5,1
418773,802,332,470,20,1
418773,1289,544,745,21,4
418773,1289,544,745,22,1
418773,1289,544,745,23,1
418773,562,235,327,24,1
418773,727,309,418,25,1
418773,727,309,418,40,1
418773,261,74,187,41,4
418773,261,74,187,42,1
418773,261,74,187,43,1
418773,186,51,135,44,1
418773,75,23,52,45,1
418773,75,23,52,60,1
418782,211,210,1,1,4
418782,211,210,1,2,1
418782,211,210,1,3,1
418782,132,131,1,4,1
418782,79,79,0,5,1
418782,79,79,0,20,1
418782,211,210,1,21,4
418782,211,210,1,22,1
418782,211,210,1,23,1
418782,132,131,1,24,1
418782,79,79,0,25,1
418782,79,79,0,40,1
418870,247,69,178,1,4
418870,247,69,178,2,1
418870,247,69,178,3,1
418870,39,18,21,4,1
418870,208,51,157,5,1
418870,24,3,21,19,1
418870,184,48,136,20,1
418870,247,69,178,21,4
418870,247,69,178,22,1
418870,247,69,178,23,1
418870,39,18,21,24,1
418870,208,51,157,25,1
418870,24,3,21,39,1
418870,184,48,136,40,1
418889,134,128,6,1,4
418889,134,128,6,2,1
418889,134,128,6,3,1
418889,55,54,1,4,1
418889,79,74,5,5,1
418889,55,51,4,19,1
418889,24,23,1,20,1
418889,89,84,5,21,4
418889,89,84,5,22,1
418889,89,84,5,23,1
418889,33,32,1,24,1
418889,56,52,4,25,1
418889,50,46,4,39,1
418889,6,6,0,40,1
418889,45,44,1,41,4
418889,45,44,1,42,1
418889,45,44,1,43,1
418889,22,22,0,44,1
418889,23,22,1,45,1
418889,5,5,0,59,1
418889,18,17,1,60,1
418913,11,3,8,1,4
418913,11,3,8,2,1
418913,11,3,8,3,1
418913,11,3,8,5,1
418913,11,3,8,20,1
418913,11,3,8,21,4
418913,11,3,8,22,1
418913,11,3,8,23,1
418913,11,3,8,25,1
418913,11,3,8,40,1
418968,69,4,65,1,4
418968,69,4,65,2,1
418968,69,4,65,3,1
418968,64,3,61,4,1
418968,5,1,4,5,1
418968,5,1,4,20,1
418968,69,4,65,21,4
418968,69,4,65,22,1
418968,69,4,65,23,1
418968,64,3,61,24,1
418968,5,1,4,25,1
418968,5,1,4,40,1
419031,22,2,20,1,4
419031,22,2,20,2,1
419031,22,2,20,3,1
419031,10,1,9,4,1
419031,12,1,11,5,1
419031,12,1,11,20,1
419031,22,2,20,21,4
419031,22,2,20,22,1
419031,22,2,20,23,1
419031,10,1,9,24,1
419031,12,1,11,25,1
419031,12,1,11,40,1
419095,49,1,48,1,4
419095,49,1,48,2,1
419095,49,1,48,3,1
419095,16,0,16,4,1
419095,33,1,32,5,1
419095,33,1,32,20,1
419095,49,1,48,21,4
419095,49,1,48,22,1
419095,49,1,48,23,1
419095,16,0,16,24,1
419095,33,1,32,25,1
419095,33,1,32,40,1
419147,36,0,36,1,4
419147,36,0,36,2,1
419147,36,0,36,3,1
419147,31,0,31,4,1
419147,5,0,5,5,1
419147,5,0,5,20,1
419147,26,0,26,21,4
419147,26,0,26,22,1
419147,26,0,26,23,1
419147,23,0,23,24,1
419147,3,0,3,25,1
419147,3,0,3,40,1
419147,10,0,10,41,4
419147,10,0,10,42,1
419147,10,0,10,43,1
419147,8,0,8,44,1
419147,2,0,2,45,1
419147,2,0,2,60,1
419156,41,3,38,1,4
419156,41,3,38,2,1
419156,41,3,38,3,1
419156,19,0,19,4,1
419156,22,3,19,5,1
419156,22,3,19,20,1
419156,41,3,38,21,4
419156,41,3,38,22,1
419156,41,3,38,23,1
419156,19,0,19,24,1
419156,22,3,19,25,1
419156,22,3,19,40,1
419183,412,80,332,1,4
419183,412,80,332,2,1
419183,412,80,332,3,1
419183,183,36,147,4,1
419183,229,44,185,5,1
419183,229,44,185,20,1
419183,412,80,332,21,4
419183,412,80,332,22,1
419183,412,80,332,23,1
419183,183,36,147,24,1
419183,229,44,185,25,1
419183,229,44,185,40,1
419217,138,28,110,1,4
419217,138,28,110,2,1
419217,138,28,110,3,1
419217,6,3,3,4,1
419217,132,25,107,5,1
419217,132,25,107,20,1
419217,138,28,110,21,4
419217,138,28,110,22,1
419217,138,28,110,23,1
419217,6,3,3,24,1
419217,132,25,107,25,1
419217,132,25,107,40,1
419226,427,196,231,1,4
419226,427,196,231,2,1
419226,427,196,231,3,1
419226,149,62,87,4,1
419226,278,134,144,5,1
419226,278,134,144,20,1
419226,427,196,231,21,4
419226,427,196,231,22,1
419226,427,196,231,23,1
419226,149,62,87,24,1
419226,278,134,144,25,1
419226,278,134,144,40,1
419235,207,55,152,1,4
419235,207,55,152,2,1
419235,207,55,152,3,1
419235,55,12,43,4,1
419235,152,43,109,5,1
419235,152,43,109,20,1
419235,207,55,152,21,4
419235,207,55,152,22,1
419235,207,55,152,23,1
419235,55,12,43,24,1
419235,152,43,109,25,1
419235,152,43,109,40,1
419244,193,181,12,1,4
419244,193,181,12,2,1
419244,193,181,12,3,1
419244,93,88,5,4,1
419244,100,93,7,5,1
419244,100,93,7,20,1
419244,124,118,6,21,4
419244,124,118,6,22,1
419244,124,118,6,23,1
419244,49,48,1,24,1
419244,75,70,5,25,1
419244,75,70,5,40,1
419244,69,63,6,41,4
419244,69,63,6,42,1
419244,69,63,6,43,1
419244,44,40,4,44,1
419244,25,23,2,45,1
419244,25,23,2,60,1
419253,170,132,38,1,4
419253,170,132,38,2,1
419253,170,132,38,3,1
419253,46,38,8,4,1
419253,124,94,30,5,1
419253,124,94,30,20,1
419253,170,132,38,21,4
419253,170,132,38,22,1
419253,170,132,38,23,1
419253,46,38,8,24,1
419253,124,94,30,25,1
419253,124,94,30,40,1
419262,6,0,6,1,4
419262,6,0,6,2,1
419262,6,0,6,3,1
419262,6,0,6,5,1
419262,6,0,6,20,1
419262,6,0,6,21,4
419262,6,0,6,22,1
419262,6,0,6,23,1
419262,6,0,6,25,1
419262,6,0,6,40,1
419271,12,0,12,1,4
419271,12,0,12,2,1
419271,12,0,12,3,1
419271,7,0,7,4,1
419271,5,0,5,5,1
419271,5,0,5,20,1
419271,7,0,7,21,4
419271,7,0,7,22,1
419271,7,0,7,23,1
419271,5,0,5,24,1
419271,2,0,2,25,1
419271,2,0,2,40,1
419271,5,0,5,41,4
419271,5,0,5,42,1
419271,5,0,5,43,1
419271,2,0,2,44,1
419271,3,0,3,45,1
419271,3,0,3,60,1
419280,51,4,47,1,4
419280,51,4,47,2,1
419280,51,4,47,3,1
419280,14,1,13,4,1
419280,37,3,34,5,1
419280,37,3,34,20,1
419280,22,4,18,21,4
419280,22,4,18,22,1
419280,22,4,18,23,1
419280,4,1,3,24,1
419280,18,3,15,25,1
419280,18,3,15,40,1
419280,29,0,29,41,4
419280,29,0,29,42,1
419280,29,0,29,43,1
419280,10,0,10,44,1
419280,19,0,19,45,1
419280,19,0,19,60,1
419314,24,2,22,1,4
419314,24,2,22,2,1
419314,24,2,22,3,1
419314,11,2,9,4,1
419314,13,0,13,5,1
419314,13,0,13,20,1
419314,24,2,22,21,4
419314,24,2,22,22,1
419314,24,2,22,23,1
419314,11,2,9,24,1
419314,13,0,13,25,1
419314,13,0,13,40,1
419332,28,25,3,1,4
419332,28,25,3,2,1
419332,28,25,3,3,1
419332,14,12,2,4,1
419332,14,13,1,5,1
419332,14,13,1,20,1
419332,17,14,3,21,4
419332,17,14,3,22,1
419332,17,14,3,23,1
419332,9,7,2,24,1
419332,8,7,1,25,1
419332,8,7,1,40,1
419332,11,11,0,41,4
419332,11,11,0,42,1
419332,11,11,0,43,1
419332,5,5,0,44,1
419332,6,6,0,45,1
419332,6,6,0,60,1
419341,65,34,31,1,4
419341,65,34,31,2,1
419341,65,34,31,3,1
419341,35,20,15,4,1
419341,30,14,16,5,1
419341,30,14,16,20,1
419341,65,34,31,21,4
419341,65,34,31,22,1
419341,65,34,31,23,1
419341,35,20,15,24,1
419341,30,14,16,25,1
419341,30,14,16,40,1
419411,219,57,162,1,4
419411,219,57,162,2,1
419411,219,57,162,3,1
419411,85,22,63,4,1
419411,134,35,99,5,1
419411,134,35,99,20,1
419411,129,29,100,21,4
419411,129,29,100,22,1
419411,129,29,100,23,1
419411,49,10,39,24,1
419411,80,19,61,25,1
419411,80,19,61,40,1
419411,90,28,62,41,4
419411,90,28,62,42,1
419411,90,28,62,43,1
419411,36,12,24,44,1
419411,54,16,38,45,1
419411,54,16,38,60,1
419420,126,67,59,1,4
419420,126,67,59,2,1
419420,126,67,59,3,1
419420,103,53,50,4,1
419420,23,14,9,5,1
419420,23,14,9,20,1
419420,57,19,38,21,4
419420,57,19,38,22,1
419420,57,19,38,23,1
419420,51,13,38,24,1
419420,6,6,0,25,1
419420,6,6,0,40,1
419420,69,48,21,41,4
419420,69,48,21,42,1
419420,69,48,21,43,1
419420,52,40,12,44,1
419420,17,8,9,45,1
419420,17,8,9,60,1
419457,925,220,705,1,4
419457,134,47,87,2,1
419457,126,45,81,3,1
419457,19,5,14,4,1
419457,107,40,67,5,1
419457,8,2,6,11,1
419457,791,173,618,12,3
419457,18,7,11,19,1
419457,89,33,56,20,1
419457,244,44,200,21,4
419457,18,8,10,22,1
419457,17,8,9,23,1
419457,1,1,0,24,1
419457,16,7,9,25,1
419457,1,0,1,31,1
419457,226,36,190,32,3
419457,1,1,0,39,1
419457,15,6,9,40,1
419457,681,176,505,41,4
419457,116,39,77,42,1
419457,109,37,72,43,1
419457,18,4,14,44,1
419457,91,33,58,45,1
419457,7,2,5,51,1
419457,565,137,428,52,3
419457,17,6,11,59,1
419457,74,27,47,60,1
419484,31,1,30,1,4
419484,31,1,30,2,1
419484,31,1,30,3,1
419484,23,1,22,4,1
419484,8,0,8,5,1
419484,8,0,8,20,1
419484,31,1,30,21,4
419484,31,1,30,22,1
419484,31,1,30,23,1
419484,23,1,22,24,1
419484,8,0,8,25,1
419484,8,0,8,40,1
419509,3421,1258,2163,1,4
419509,2796,1065,1731,2,1
419509,2791,1060,1731,3,1
419509,56,21,35,4,1
419509,2735,1039,1696,5,1
419509,5,5,0,11,1
419509,625,193,432,12,3
419509,190,74,116,19,1
419509,2545,965,1580,20,1
419509,3421,1258,2163,21,4
419509,2796,1065,1731,22,1
419509,2791,1060,1731,23,1
419509,56,21,35,24,1
419509,2735,1039,1696,25,1
419509,5,5,0,31,1
419509,625,193,432,32,3
419509,190,74,116,39,1
419509,2545,965,1580,40,1
419633,93,5,88,1,4
419633,93,5,88,2,1
419633,93,5,88,3,1
419633,26,0,26,4,1
419633,67,5,62,5,1
419633,67,5,62,20,1
419633,93,5,88,21,4
419633,93,5,88,22,1
419633,93,5,88,23,1
419633,26,0,26,24,1
419633,67,5,62,25,1
419633,67,5,62,40,1
419660,777,145,632,1,4
419660,777,145,632,2,1
419660,777,145,632,3,1
419660,199,39,160,4,1
419660,578,106,472,5,1
419660,578,106,472,20,1
419660,777,145,632,21,4
419660,777,145,632,22,1
419660,777,145,632,23,1
419660,199,39,160,24,1
419660,578,106,472,25,1
419660,578,106,472,40,1
419703,579,561,18,1,4
419703,579,561,18,2,1
419703,579,561,18,3,1
419703,312,302,10,4,1
419703,267,259,8,5,1
419703,267,259,8,20,1
419703,579,561,18,21,4
419703,579,561,18,22,1
419703,579,561,18,23,1
419703,312,302,10,24,1
419703,267,259,8,25,1
419703,267,259,8,40,1
419712,244,235,9,1,4
419712,244,235,9,2,1
419712,244,235,9,3,1
419712,147,140,7,4,1
419712,97,95,2,5,1
419712,97,95,2,20,1
419712,244,235,9,21,4
419712,244,235,9,22,1
419712,244,235,9,23,1
419712,147,140,7,24,1
419712,97,95,2,25,1
419712,97,95,2,40,1
419721,217,207,10,1,4
419721,217,207,10,2,1
419721,217,207,10,3,1
419721,126,118,8,4,1
419721,91,89,2,5,1
419721,91,89,2,20,1
419721,217,207,10,21,4
419721,217,207,10,22,1
419721,217,207,10,23,1
419721,126,118,8,24,1
419721,91,89,2,25,1
419721,91,89,2,40,1
420006,522,133,389,1,4
420006,492,122,370,2,1
420006,492,122,370,3,1
420006,59,14,45,4,1
420006,433,108,325,5,1
420006,30,11,19,12,3
420006,21,6,15,19,1
420006,412,102,310,20,1
420006,378,89,289,21,4
420006,367,84,283,22,1
420006,367,84,283,23,1
420006,58,13,45,24,1
420006,309,71,238,25,1
420006,11,5,6,32,3
420006,10,3,7,39,1
420006,299,68,231,40,1
420006,144,44,100,41,4
420006,125,38,87,42,1
420006,125,38,87,43,1
420006,1,1,0,44,1
420006,124,37,87,45,1
420006,19,6,13,52,3
420006,11,3,8,59,1
420006,113,34,79,60,1
420024,166,33,133,1,4
420024,166,33,133,2,1
420024,166,33,133,3,1
420024,32,6,26,4,1
420024,134,27,107,5,1
420024,134,27,107,20,1
420024,122,25,97,21,4
420024,122,25,97,22,1
420024,122,25,97,23,1
420024,24,4,20,24,1
420024,98,21,77,25,1
420024,98,21,77,40,1
420024,44,8,36,41,4
420024,44,8,36,42,1
420024,44,8,36,43,1
420024,8,2,6,44,1
420024,36,6,30,45,1
420024,36,6,30,60,1
420042,1454,828,626,1,4
420042,1281,730,551,2,1
420042,1281,730,551,3,1
420042,19,5,14,4,1
420042,1262,725,537,5,1
420042,173,98,75,12,3
420042,121,75,46,19,1
420042,1141,650,491,20,1
420042,1454,828,626,21,4
420042,1281,730,551,22,1
420042,1281,730,551,23,1
420042,19,5,14,24,1
420042,1262,725,537,25,1
420042,173,98,75,32,3
420042,121,75,46,39,1
420042,1141,650,491,40,1
420103,201,38,163,1,4
420103,201,38,163,2,1
420103,201,38,163,3,1
420103,77,18,59,4,1
420103,124,20,104,5,1
420103,2,1,1,19,1
420103,122,19,103,20,1
420103,201,38,163,21,4
420103,201,38,163,22,1
420103,201,38,163,23,1
420103,77,18,59,24,1
420103,124,20,104,25,1
420103,2,1,1,39,1
420103,122,19,103,40,1
420130,179,22,157,1,4
420130,179,22,157,2,1
420130,179,22,157,3,1
420130,172,20,152,4,1
420130,7,2,5,5,1
420130,7,2,5,20,1
420130,179,22,157,21,4
420130,179,22,157,22,1
420130,179,22,157,23,1
420130,172,20,152,24,1
420130,7,2,5,25,1
420130,7,2,5,40,1
420194,115,7,108,1,4
420194,115,7,108,2,1
420194,115,7,108,3,1
420194,99,7,92,4,1
420194,16,0,16,5,1
420194,16,0,16,20,1
420194,115,7,108,21,4
420194,115,7,108,22,1
420194,115,7,108,23,1
420194,99,7,92,24,1
420194,16,0,16,25,1
420194,16,0,16,40,1
420200,92,4,88,1,4
420200,92,4,88,2,1
420200,92,4,88,3,1
420200,47,4,43,4,1
420200,45,0,45,5,1
420200,45,0,45,20,1
420200,23,1,22,21,4
420200,23,1,22,22,1
420200,23,1,22,23,1
420200,11,1,10,24,1
420200,12,0,12,25,1
420200,12,0,12,40,1
420200,69,3,66,41,4
420200,69,3,66,42,1
420200,69,3,66,43,1
420200,36,3,33,44,1
420200,33,0,33,45,1
420200,33,0,33,60,1
420246,427,115,312,1,4
420246,427,115,312,12,3
420246,404,103,301,21,4
420246,404,103,301,32,3
420246,23,12,11,41,4
420246,23,12,11,52,3
420255,61,61,0,1,4
420255,61,61,0,2,1
420255,61,61,0,3,1
420255,42,42,0,4,1
420255,19,19,0,5,1
420255,19,19,0,20,1
420255,61,61,0,21,4
420255,61,61,0,22,1
420255,61,61,0,23,1
420255,42,42,0,24,1
420255,19,19,0,25,1
420255,19,19,0,40,1
420307,3877,729,3148,1,4
420307,3741,698,3043,2,1
420307,3741,698,3043,3,1
420307,1398,280,1118,4,1
420307,2343,418,1925,5,1
420307,136,31,105,12,3
420307,2343,418,1925,20,1
420307,2453,500,1953,21,4
420307,2380,484,1896,22,1
420307,2380,484,1896,23,1
420307,1041,205,836,24,1
420307,1339,279,1060,25,1
420307,73,16,57,32,3
420307,1339,279,1060,40,1
420307,1424,229,1195,41,4
420307,1361,214,1147,42,1
420307,1361,214,1147,43,1
420307,357,75,282,44,1
420307,1004,139,865,45,1
420307,63,15,48,52,3
420307,1004,139,865,60,1
420316,567,136,431,1,4
420316,567,136,431,2,1
420316,567,136,431,3,1
420316,257,51,206,4,1
420316,310,85,225,5,1
420316,310,85,225,20,1
420316,398,100,298,21,4
420316,398,100,298,22,1
420316,398,100,298,23,1
420316,205,42,163,24,1
420316,193,58,135,25,1
420316,193,58,135,40,1
420316,169,36,133,41,4
420316,169,36,133,42,1
420316,169,36,133,43,1
420316,52,9,43,44,1
420316,117,27,90,45,1
420316,117,27,90,60,1
420325,53,53,0,1,4
420325,48,48,0,2,1
420325,48,48,0,3,1
420325,8,8,0,4,1
420325,40,40,0,5,1
420325,5,5,0,12,3
420325,2,2,0,19,1
420325,38,38,0,20,1
420325,53,53,0,21,4
420325,48,48,0,22,1
420325,48,48,0,23,1
420325,8,8,0,24,1
420325,40,40,0,25,1
420325,5,5,0,32,3
420325,2,2,0,39,1
420325,38,38,0,40,1
420343,665,653,12,1,4
420343,665,653,12,2,1
420343,665,653,12,3,1
420343,201,196,5,4,1
420343,464,457,7,5,1
420343,464,457,7,20,1
420343,453,445,8,21,4
420343,453,445,8,22,1
420343,453,445,8,23,1
420343,86,84,2,24,1
420343,367,361,6,25,1
420343,367,361,6,40,1
420343,212,208,4,41,4
420343,212,208,4,42,1
420343,212,208,4,43,1
420343,115,112,3,44,1
420343,97,96,1,45,1
420343,97,96,1,60,1
420370,670,273,397,1,4
420370,670,273,397,2,1
420370,670,273,397,3,1
420370,470,203,267,4,1
420370,200,70,130,5,1
420370,200,70,130,20,1
420370,670,273,397,21,4
420370,670,273,397,22,1
420370,670,273,397,23,1
420370,470,203,267,24,1
420370,200,70,130,25,1
420370,200,70,130,40,1
420398,15965,7125,8840,1,4
420398,15965,7125,8840,2,1
420398,12686,5844,6842,3,1
420398,2387,1187,1200,4,1
420398,10299,4657,5642,5,1
420398,3279,1281,1998,11,1
420398,973,440,533,19,1
420398,9326,4217,5109,20,1
420398,3902,1919,1983,21,4
420398,3902,1919,1983,22,1
420398,3832,1885,1947,23,1
420398,930,464,466,24,1
420398,2902,1421,1481,25,1
420398,70,34,36,31,1
420398,256,135,121,39,1
420398,2646,1286,1360,40,1
420398,12063,5206,6857,41,4
420398,12063,5206,6857,42,1
420398,8854,3959,4895,43,1
420398,1457,723,734,44,1
420398,7397,3236,4161,45,1
420398,3209,1247,1962,51,1
420398,717,305,412,59,1
420398,6680,2931,3749,60,1
420404,381,303,78,1,4
420404,381,303,78,2,1
420404,381,303,78,3,1
420404,70,57,13,4,1
420404,311,246,65,5,1
420404,3,3,0,19,1
420404,308,243,65,20,1
420404,298,241,57,21,4
420404,298,241,57,22,1
420404,298,241,57,23,1
420404,55,46,9,24,1
420404,243,195,48,25,1
420404,2,2,0,39,1
420404,241,193,48,40,1
420404,83,62,21,41,4
420404,83,62,21,42,1
420404,83,62,21,43,1
420404,15,11,4,44,1
420404,68,51,17,45,1
420404,1,1,0,59,1
420404,67,50,17,60,1
420431,1869,826,1043,1,4
420431,1869,826,1043,2,1
420431,1483,515,968,3,1
420431,336,158,178,4,1
420431,1147,357,790,5,1
420431,386,311,75,11,1
420431,166,60,106,19,1
420431,981,297,684,20,1
420431,554,194,360,21,4
420431,554,194,360,22,1
420431,543,183,360,23,1
420431,127,53,74,24,1
420431,416,130,286,25,1
420431,11,11,0,31,1
420431,63,23,40,39,1
420431,353,107,246,40,1
420431,1315,632,683,41,4
420431,1315,632,683,42,1
420431,940,332,608,43,1
420431,209,105,104,44,1
420431,731,227,504,45,1
420431,375,300,75,51,1
420431,103,37,66,59,1
420431,628,190,438,60,1
420440,1583,546,1037,1,4
420440,1583,546,1037,2,1
420440,1313,452,861,3,1
420440,286,121,165,4,1
420440,1027,331,696,5,1
420440,270,94,176,11,1
420440,150,53,97,19,1
420440,877,278,599,20,1
420440,634,253,381,21,4
420440,634,253,381,22,1
420440,625,250,375,23,1
420440,174,80,94,24,1
420440,451,170,281,25,1
420440,9,3,6,31,1
420440,76,36,40,39,1
420440,375,134,241,40,1
420440,949,293,656,41,4
420440,949,293,656,42,1
420440,688,202,486,43,1
420440,112,41,71,44,1
420440,576,161,415,45,1
420440,261,91,170,51,1
420440,74,17,57,59,1
420440,502,144,358,60,1
420459,397,224,173,1,4
420459,397,224,173,2,1
420459,122,70,52,3,1
420459,54,40,14,4,1
420459,68,30,38,5,1
420459,275,154,121,11,1
420459,68,30,38,20,1
420459,80,43,37,21,4
420459,80,43,37,22,1
420459,80,43,37,23,1
420459,38,28,10,24,1
420459,42,15,27,25,1
420459,42,15,27,40,1
420459,317,181,136,41,4
420459,317,181,136,42,1
420459,42,27,15,43,1
420459,16,12,4,44,1
420459,26,15,11,45,1
420459,275,154,121,51,1
420459,26,15,11,60,1
420468,366,99,267,1,4
420468,366,99,267,2,1
420468,366,99,267,3,1
420468,315,90,225,4,1
420468,51,9,42,5,1
420468,51,9,42,20,1
420468,236,91,145,21,4
420468,236,91,145,22,1
420468,236,91,145,23,1
420468,199,82,117,24,1
420468,37,9,28,25,1
420468,37,9,28,40,1
420468,130,8,122,41,4
420468,130,8,122,42,1
420468,130,8,122,43,1
420468,116,8,108,44,1
420468,14,0,14,45,1
420468,14,0,14,60,1
420495,360,35,325,1,4
420495,360,35,325,2,1
420495,360,35,325,3,1
420495,43,2,41,4,1
420495,317,33,284,5,1
420495,42,2,40,19,1
420495,275,31,244,20,1
420495,355,34,321,21,4
420495,355,34,321,22,1
420495,355,34,321,23,1
420495,43,2,41,24,1
420495,312,32,280,25,1
420495,42,2,40,39,1
420495,270,30,240,40,1
420495,5,1,4,41,4
420495,5,1,4,42,1
420495,5,1,4,43,1
420495,5,1,4,45,1
420495,5,1,4,60,1
420501,495,62,433,1,4
420501,495,62,433,2,1
420501,495,62,433,3,1
420501,59,8,51,4,1
420501,436,54,382,5,1
420501,64,10,54,19,1
420501,372,44,328,20,1
420501,478,59,419,21,4
420501,478,59,419,22,1
420501,478,59,419,23,1
420501,59,8,51,24,1
420501,419,51,368,25,1
420501,64,10,54,39,1
420501,355,41,314,40,1
420501,17,3,14,41,4
420501,17,3,14,42,1
420501,17,3,14,43,1
420501,17,3,14,45,1
420501,17,3,14,60,1
420538,1238,421,817,1,4
420538,1238,421,817,2,1
420538,1166,411,755,3,1
420538,285,135,150,4,1
420538,881,276,605,5,1
420538,72,10,62,11,1
420538,119,42,77,19,1
420538,762,234,528,20,1
420538,889,333,556,21,4
420538,889,333,556,22,1
420538,861,325,536,23,1
420538,226,105,121,24,1
420538,635,220,415,25,1
420538,28,8,20,31,1
420538,71,29,42,39,1
420538,564,191,373,40,1
420538,349,88,261,41,4
420538,349,88,261,42,1
420538,305,86,219,43,1
420538,59,30,29,44,1
420538,246,56,190,45,1
420538,44,2,42,51,1
420538,48,13,35,59,1
420538,198,43,155,60,1
420556,974,338,636,1,4
420556,974,338,636,2,1
420556,841,284,557,3,1
420556,180,68,112,4,1
420556,661,216,445,5,1
420556,133,54,79,11,1
420556,2,0,2,19,1
420556,659,216,443,20,1
420556,332,131,201,21,4
420556,332,131,201,22,1
420556,317,123,194,23,1
420556,62,22,40,24,1
420556,255,101,154,25,1
420556,15,8,7,31,1
420556,255,101,154,40,1
420556,642,207,435,41,4
420556,642,207,435,42,1
420556,524,161,363,43,1
420556,118,46,72,44,1
420556,406,115,291,45,1
420556,118,46,72,51,1
420556,2,0,2,59,1
420556,404,115,289,60,1
420574,3697,2719,978,1,4
420574,3312,2507,805,2,1
420574,3305,2501,804,3,1
420574,409,316,93,4,1
420574,2896,2185,711,5,1
420574,7,6,1,11,1
420574,385,212,173,12,3
420574,514,398,116,19,1
420574,2382,1787,595,20,1
420574,2964,2198,766,21,4
420574,2789,2101,688,22,1
420574,2785,2097,688,23,1
420574,395,304,91,24,1
420574,2390,1793,597,25,1
420574,4,4,0,31,1
420574,175,97,78,32,3
420574,411,317,94,39,1
420574,1979,1476,503,40,1
420574,733,521,212,41,4
420574,523,406,117,42,1
420574,520,404,116,43,1
420574,14,12,2,44,1
420574,506,392,114,45,1
420574,3,2,1,51,1
420574,210,115,95,52,3
420574,103,81,22,59,1
420574,403,311,92,60,1
420608,155,3,152,1,4
420608,155,3,152,2,1
420608,155,3,152,3,1
420608,29,0,29,4,1
420608,126,3,123,5,1
420608,126,3,123,20,1
420608,145,3,142,21,4
420608,145,3,142,22,1
420608,145,3,142,23,1
420608,28,0,28,24,1
420608,117,3,114,25,1
420608,117,3,114,40,1
420608,10,0,10,41,4
420608,10,0,10,42,1
420608,10,0,10,43,1
420608,1,0,1,44,1
420608,9,0,9,45,1
420608,9,0,9,60,1
420705,126,70,56,1,4
420705,126,70,56,12,3
420705,4,2,2,21,4
420705,4,2,2,32,3
420705,122,68,54,41,4
420705,122,68,54,52,3
420723,514,220,294,1,4
420723,514,220,294,2,1
420723,514,220,294,3,1
420723,212,95,117,4,1
420723,302,125,177,5,1
420723,35,14,21,19,1
420723,267,111,156,20,1
420723,227,85,142,21,4
420723,227,85,142,22,1
420723,227,85,142,23,1
420723,102,38,64,24,1
420723,125,47,78,25,1
420723,11,5,6,39,1
420723,114,42,72,40,1
420723,287,135,152,41,4
420723,287,135,152,42,1
420723,287,135,152,43,1
420723,110,57,53,44,1
420723,177,78,99,45,1
420723,24,9,15,59,1
420723,153,69,84,60,1
420866,493,121,372,1,4
420866,141,45,96,2,1
420866,139,44,95,3,1
420866,2,1,1,4,1
420866,137,43,94,5,1
420866,2,1,1,11,1
420866,352,76,276,12,3
420866,22,5,17,19,1
420866,115,38,77,20,1
420866,153,41,112,21,4
420866,63,20,43,22,1
420866,63,20,43,23,1
420866,63,20,43,25,1
420866,90,21,69,32,3
420866,7,2,5,39,1
420866,56,18,38,40,1
420866,340,80,260,41,4
420866,78,25,53,42,1
420866,76,24,52,43,1
420866,2,1,1,44,1
420866,74,23,51,45,1
420866,2,1,1,51,1
420866,262,55,207,52,3
420866,15,3,12,59,1
420866,59,20,39,60,1
420981,448,149,299,1,4
420981,448,149,299,2,1
420981,448,149,299,3,1
420981,213,68,145,4,1
420981,235,81,154,5,1
420981,235,81,154,20,1
420981,448,149,299,21,4
420981,448,149,299,22,1
420981,448,149,299,23,1
420981,213,68,145,24,1
420981,235,81,154,25,1
420981,235,81,154,40,1
421018,1249,345,904,1,4
421018,980,273,707,2,1
421018,980,273,707,3,1
421018,70,20,50,4,1
421018,910,253,657,5,1
421018,269,72,197,12,3
421018,87,19,68,19,1
421018,823,234,589,20,1
421018,1249,345,904,21,4
421018,980,273,707,22,1
421018,980,273,707,23,1
421018,70,20,50,24,1
421018,910,253,657,25,1
421018,269,72,197,32,3
421018,87,19,68,39,1
421018,823,234,589,40,1
421513,284,63,221,1,4
421513,284,63,221,2,1
421513,284,63,221,3,1
421513,43,9,34,4,1
421513,241,54,187,5,1
421513,46,12,34,19,1
421513,195,42,153,20,1
421513,284,63,221,21,4
421513,284,63,221,22,1
421513,284,63,221,23,1
421513,43,9,34,24,1
421513,241,54,187,25,1
421513,46,12,34,39,1
421513,195,42,153,40,1
421540,218,118,100,1,4
421540,218,118,100,2,1
421540,218,118,100,3,1
421540,182,108,74,4,1
421540,36,10,26,5,1
421540,36,10,26,20,1
421540,62,26,36,21,4
421540,62,26,36,22,1
421540,62,26,36,23,1
421540,31,20,11,24,1
421540,31,6,25,25,1
421540,31,6,25,40,1
421540,156,92,64,41,4
421540,156,92,64,42,1
421540,156,92,64,43,1
421540,151,88,63,44,1
421540,5,4,1,45,1
421540,5,4,1,60,1
421559,145,65,80,1,4
421559,145,65,80,2,1
421559,145,65,80,3,1
421559,119,61,58,4,1
421559,26,4,22,5,1
421559,26,4,22,20,1
421559,58,9,49,21,4
421559,58,9,49,22,1
421559,58,9,49,23,1
421559,33,6,27,24,1
421559,25,3,22,25,1
421559,25,3,22,40,1
421559,87,56,31,41,4
421559,87,56,31,42,1
421559,87,56,31,43,1
421559,86,55,31,44,1
421559,1,1,0,45,1
421559,1,1,0,60,1
421586,96,45,51,1,4
421586,96,45,51,2,1
421586,96,45,51,3,1
421586,69,33,36,4,1
421586,27,12,15,5,1
421586,27,12,15,20,1
421586,96,45,51,21,4
421586,96,45,51,22,1
421586,96,45,51,23,1
421586,69,33,36,24,1
421586,27,12,15,25,1
421586,27,12,15,40,1
421610,53,1,52,1,4
421610,53,1,52,2,1
421610,53,1,52,3,1
421610,17,1,16,4,1
421610,36,0,36,5,1
421610,36,0,36,20,1
421610,35,1,34,21,4
421610,35,1,34,22,1
421610,35,1,34,23,1
421610,13,1,12,24,1
421610,22,0,22,25,1
421610,22,0,22,40,1
421610,18,0,18,41,4
421610,18,0,18,42,1
421610,18,0,18,43,1
421610,4,0,4,44,1
421610,14,0,14,45,1
421610,14,0,14,60,1
421665,14,0,14,1,4
421665,14,0,14,2,1
421665,14,0,14,3,1
421665,5,0,5,4,1
421665,9,0,9,5,1
421665,9,0,9,20,1
421665,6,0,6,21,4
421665,6,0,6,22,1
421665,6,0,6,23,1
421665,2,0,2,24,1
421665,4,0,4,25,1
421665,4,0,4,40,1
421665,8,0,8,41,4
421665,8,0,8,42,1
421665,8,0,8,43,1
421665,3,0,3,44,1
421665,5,0,5,45,1
421665,5,0,5,60,1
421708,937,149,788,1,4
421708,937,149,788,2,1
421708,937,149,788,3,1
421708,421,66,355,4,1
421708,516,83,433,5,1
421708,516,83,433,20,1
421708,937,149,788,21,4
421708,937,149,788,22,1
421708,937,149,788,23,1
421708,421,66,355,24,1
421708,516,83,433,25,1
421708,516,83,433,40,1
421717,54,23,31,1,4
421717,54,23,31,2,1
421717,54,23,31,3,1
421717,18,9,9,4,1
421717,36,14,22,5,1
421717,36,14,22,20,1
421717,54,23,31,21,4
421717,54,23,31,22,1
421717,54,23,31,23,1
421717,18,9,9,24,1
421717,36,14,22,25,1
421717,36,14,22,40,1
421771,51,4,47,1,4
421771,51,4,47,2,1
421771,51,4,47,3,1
421771,9,2,7,4,1
421771,42,2,40,5,1
421771,42,2,40,20,1
421771,51,4,47,21,4
421771,51,4,47,22,1
421771,51,4,47,23,1
421771,9,2,7,24,1
421771,42,2,40,25,1
421771,42,2,40,40,1
421832,513,200,313,1,4
421832,513,200,313,2,1
421832,513,200,313,3,1
421832,95,37,58,4,1
421832,418,163,255,5,1
421832,13,0,13,19,1
421832,405,163,242,20,1
421832,513,200,313,21,4
421832,513,200,313,22,1
421832,513,200,313,23,1
421832,95,37,58,24,1
421832,418,163,255,25,1
421832,13,0,13,39,1
421832,405,163,242,40,1
421841,273,117,156,1,4
421841,273,117,156,2,1
421841,273,117,156,3,1
421841,90,32,58,4,1
421841,183,85,98,5,1
421841,39,20,19,19,1
421841,144,65,79,20,1
421841,273,117,156,21,4
421841,273,117,156,22,1
421841,273,117,156,23,1
421841,90,32,58,24,1
421841,183,85,98,25,1
421841,39,20,19,39,1
421841,144,65,79,40,1
421878,222,14,208,1,4
421878,222,14,208,2,1
421878,222,14,208,3,1
421878,80,5,75,4,1
421878,142,9,133,5,1
421878,142,9,133,20,1
421878,173,9,164,21,4
421878,173,9,164,22,1
421878,173,9,164,23,1
421878,69,3,66,24,1
421878,104,6,98,25,1
421878,104,6,98,40,1
421878,49,5,44,41,4
421878,49,5,44,42,1
421878,49,5,44,43,1
421878,11,2,9,44,1
421878,38,3,35,45,1
421878,38,3,35,60,1
421896,390,181,209,1,4
421896,390,181,209,2,1
421896,390,181,209,3,1
421896,90,48,42,4,1
421896,300,133,167,5,1
421896,300,133,167,20,1
421896,390,181,209,21,4
421896,390,181,209,22,1
421896,390,181,209,23,1
421896,90,48,42,24,1
421896,300,133,167,25,1
421896,300,133,167,40,1
422020,87,84,3,1,4
422020,87,84,3,2,1
422020,87,84,3,3,1
422020,3,2,1,4,1
422020,84,82,2,5,1
422020,9,9,0,19,1
422020,75,73,2,20,1
422020,87,84,3,21,4
422020,87,84,3,22,1
422020,87,84,3,23,1
422020,3,2,1,24,1
422020,84,82,2,25,1
422020,9,9,0,39,1
422020,75,73,2,40,1
422190,74,5,69,1,4
422190,74,5,69,2,1
422190,74,5,69,3,1
422190,19,3,16,4,1
422190,55,2,53,5,1
422190,55,2,53,20,1
422190,9,0,9,21,4
422190,9,0,9,22,1
422190,9,0,9,23,1
422190,1,0,1,24,1
422190,8,0,8,25,1
422190,8,0,8,40,1
422190,65,5,60,41,4
422190,65,5,60,42,1
422190,65,5,60,43,1
422190,18,3,15,44,1
422190,47,2,45,45,1
422190,47,2,45,60,1
422695,277,37,240,1,4
422695,277,37,240,2,1
422695,277,37,240,3,1
422695,21,10,11,4,1
422695,256,27,229,5,1
422695,256,27,229,20,1
422695,277,37,240,21,4
422695,277,37,240,22,1
422695,277,37,240,23,1
422695,21,10,11,24,1
422695,256,27,229,25,1
422695,256,27,229,40,1
422835,290,74,216,1,4
422835,290,74,216,2,1
422835,290,74,216,3,1
422835,99,25,74,4,1
422835,191,49,142,5,1
422835,191,49,142,20,1
422835,290,74,216,21,4
422835,290,74,216,22,1
422835,290,74,216,23,1
422835,99,25,74,24,1
422835,191,49,142,25,1
422835,191,49,142,40,1
423120,920,36,884,1,4
423120,920,36,884,2,1
423120,920,36,884,3,1
423120,545,21,524,4,1
423120,375,15,360,5,1
423120,375,15,360,20,1
423120,920,36,884,21,4
423120,920,36,884,22,1
423120,920,36,884,23,1
423120,545,21,524,24,1
423120,375,15,360,25,1
423120,375,15,360,40,1
423397,40,40,0,1,4
423397,40,40,0,2,1
423397,40,40,0,3,1
423397,13,13,0,4,1
423397,27,27,0,5,1
423397,27,27,0,20,1
423397,40,40,0,21,4
423397,40,40,0,22,1
423397,40,40,0,23,1
423397,13,13,0,24,1
423397,27,27,0,25,1
423397,27,27,0,40,1
423582,120,18,102,1,4
423582,120,18,102,2,1
423582,120,18,102,3,1
423582,59,15,44,4,1
423582,61,3,58,5,1
423582,61,3,58,20,1
423582,93,16,77,21,4
423582,93,16,77,22,1
423582,93,16,77,23,1
423582,45,13,32,24,1
423582,48,3,45,25,1
423582,48,3,45,40,1
423582,27,2,25,41,4
423582,27,2,25,42,1
423582,27,2,25,43,1
423582,14,2,12,44,1
423582,13,0,13,45,1
423582,13,0,13,60,1
423643,2984,1657,1327,1,4
423643,2984,1657,1327,12,3
423643,2950,1640,1310,21,4
423643,2950,1640,1310,32,3
423643,34,17,17,41,4
423643,34,17,17,52,3
423652,580,239,341,1,4
423652,580,239,341,2,1
423652,505,202,303,3,1
423652,148,62,86,4,1
423652,357,140,217,5,1
423652,75,37,38,11,1
423652,57,24,33,19,1
423652,300,116,184,20,1
423652,184,67,117,21,4
423652,184,67,117,22,1
423652,183,67,116,23,1
423652,49,19,30,24,1
423652,134,48,86,25,1
423652,1,0,1,31,1
423652,31,12,19,39,1
423652,103,36,67,40,1
423652,396,172,224,41,4
423652,396,172,224,42,1
423652,322,135,187,43,1
423652,99,43,56,44,1
423652,223,92,131,45,1
423652,74,37,37,51,1
423652,26,12,14,59,1
423652,197,80,117,60,1
423980,1739,854,885,1,4
423980,1739,854,885,2,1
423980,1739,854,885,3,1
423980,265,128,137,4,1
423980,1474,726,748,5,1
423980,81,39,42,19,1
423980,1393,687,706,20,1
423980,1739,854,885,21,4
423980,1739,854,885,22,1
423980,1739,854,885,23,1
423980,265,128,137,24,1
423980,1474,726,748,25,1
423980,81,39,42,39,1
423980,1393,687,706,40,1
425250,108,28,80,1,4
425250,108,28,80,2,1
425250,108,28,80,3,1
425250,32,7,25,4,1
425250,76,21,55,5,1
425250,76,21,55,20,1
425250,43,11,32,21,4
425250,43,11,32,22,1
425250,43,11,32,23,1
425250,13,3,10,24,1
425250,30,8,22,25,1
425250,30,8,22,40,1
425250,65,17,48,41,4
425250,65,17,48,42,1
425250,65,17,48,43,1
425250,19,4,15,44,1
425250,46,13,33,45,1
425250,46,13,33,60,1
425870,18,0,18,1,4
425870,18,0,18,2,1
425870,18,0,18,3,1
425870,6,0,6,4,1
425870,12,0,12,5,1
425870,12,0,12,20,1
425870,4,0,4,21,4
425870,4,0,4,22,1
425870,4,0,4,23,1
425870,1,0,1,24,1
425870,3,0,3,25,1
425870,3,0,3,40,1
425870,14,0,14,41,4
425870,14,0,14,42,1
425870,14,0,14,43,1
425870,5,0,5,44,1
425870,9,0,9,45,1
425870,9,0,9,60,1
425889,378,53,325,1,4
425889,378,53,325,2,1
425889,378,53,325,3,1
425889,133,23,110,4,1
425889,245,30,215,5,1
425889,245,30,215,20,1
425889,303,50,253,21,4
425889,303,50,253,22,1
425889,303,50,253,23,1
425889,109,23,86,24,1
425889,194,27,167,25,1
425889,194,27,167,40,1
425889,75,3,72,41,4
425889,75,3,72,42,1
425889,75,3,72,43,1
425889,24,0,24,44,1
425889,51,3,48,45,1
425889,51,3,48,60,1
425986,196,27,169,1,4
425986,196,27,169,2,1
425986,196,27,169,3,1
425986,68,15,53,4,1
425986,128,12,116,5,1
425986,128,12,116,20,1
425986,196,27,169,21,4
425986,196,27,169,22,1
425986,196,27,169,23,1
425986,68,15,53,24,1
425986,128,12,116,25,1
425986,128,12,116,40,1
426314,14564,12582,1982,1,4
426314,9789,8630,1159,2,1
426314,9689,8553,1136,3,1
426314,387,355,32,4,1
426314,9302,8198,1104,5,1
426314,100,77,23,11,1
426314,4775,3952,823,12,3
426314,934,790,144,19,1
426314,8368,7408,960,20,1
426314,5356,4552,804,21,4
426314,2898,2569,329,22,1
426314,2895,2567,328,23,1
426314,74,70,4,24,1
426314,2821,2497,324,25,1
426314,3,2,1,31,1
426314,2458,1983,475,32,3
426314,204,172,32,39,1
426314,2617,2325,292,40,1
426314,9208,8030,1178,41,4
426314,6891,6061,830,42,1
426314,6794,5986,808,43,1
426314,313,285,28,44,1
426314,6481,5701,780,45,1
426314,97,75,22,51,1
426314,2317,1969,348,52,3
426314,730,618,112,59,1
426314,5751,5083,668,60,1
427025,2154,674,1480,1,4
427025,2154,674,1480,2,1
427025,2154,674,1480,3,1
427025,592,196,396,4,1
427025,1562,478,1084,5,1
427025,1562,478,1084,20,1
427025,2154,674,1480,21,4
427025,2154,674,1480,22,1
427025,2154,674,1480,23,1
427025,592,196,396,24,1
427025,1562,478,1084,25,1
427025,1562,478,1084,40,1
427308,150,8,142,1,4
427308,150,8,142,2,1
427308,150,8,142,3,1
427308,121,6,115,4,1
427308,29,2,27,5,1
427308,29,2,27,20,1
427308,150,8,142,21,4
427308,150,8,142,22,1
427308,150,8,142,23,1
427308,121,6,115,24,1
427308,29,2,27,25,1
427308,29,2,27,40,1
427335,60,0,60,1,4
427335,60,0,60,2,1
427335,60,0,60,3,1
427335,56,0,56,4,1
427335,4,0,4,5,1
427335,4,0,4,20,1
427335,28,0,28,21,4
427335,28,0,28,22,1
427335,28,0,28,23,1
427335,26,0,26,24,1
427335,2,0,2,25,1
427335,2,0,2,40,1
427335,32,0,32,41,4
427335,32,0,32,42,1
427335,32,0,32,43,1
427335,30,0,30,44,1
427335,2,0,2,45,1
427335,2,0,2,60,1
427663,303,247,56,1,4
427663,303,247,56,2,1
427663,303,247,56,3,1
427663,59,50,9,4,1
427663,244,197,47,5,1
427663,5,4,1,19,1
427663,239,193,46,20,1
427663,264,219,45,21,4
427663,264,219,45,22,1
427663,264,219,45,23,1
427663,58,50,8,24,1
427663,206,169,37,25,1
427663,4,3,1,39,1
427663,202,166,36,40,1
427663,39,28,11,41,4
427663,39,28,11,42,1
427663,39,28,11,43,1
427663,1,0,1,44,1
427663,38,28,10,45,1
427663,1,1,0,59,1
427663,37,27,10,60,1
427894,169,166,3,1,4
427894,169,166,3,2,1
427894,169,166,3,3,1
427894,48,48,0,4,1
427894,121,118,3,5,1
427894,121,118,3,20,1
427894,36,35,1,21,4
427894,36,35,1,22,1
427894,36,35,1,23,1
427894,8,8,0,24,1
427894,28,27,1,25,1
427894,28,27,1,40,1
427894,133,131,2,41,4
427894,133,131,2,42,1
427894,133,131,2,43,1
427894,40,40,0,44,1
427894,93,91,2,45,1
427894,93,91,2,60,1
427919,134,50,84,1,4
427919,134,50,84,2,1
427919,134,50,84,3,1
427919,42,15,27,4,1
427919,92,35,57,5,1
427919,92,35,57,20,1
427919,81,36,45,21,4
427919,81,36,45,22,1
427919,81,36,45,23,1
427919,23,11,12,24,1
427919,58,25,33,25,1
427919,58,25,33,40,1
427919,53,14,39,41,4
427919,53,14,39,42,1
427919,53,14,39,43,1
427919,19,4,15,44,1
427919,34,10,24,45,1
427919,34,10,24,60,1
427973,235,215,20,1,4
427973,235,215,20,2,1
427973,235,215,20,3,1
427973,53,48,5,4,1
427973,182,167,15,5,1
427973,182,167,15,20,1
427973,223,204,19,21,4
427973,223,204,19,22,1
427973,223,204,19,23,1
427973,52,47,5,24,1
427973,171,157,14,25,1
427973,171,157,14,40,1
427973,12,11,1,41,4
427973,12,11,1,42,1
427973,12,11,1,43,1
427973,1,1,0,44,1
427973,11,10,1,45,1
427973,11,10,1,60,1
427982,229,27,202,1,4
427982,229,27,202,2,1
427982,229,27,202,3,1
427982,46,6,40,4,1
427982,183,21,162,5,1
427982,183,21,162,20,1
427982,142,20,122,21,4
427982,142,20,122,22,1
427982,142,20,122,23,1
427982,28,2,26,24,1
427982,114,18,96,25,1
427982,114,18,96,40,1
427982,87,7,80,41,4
427982,87,7,80,42,1
427982,87,7,80,43,1
427982,18,4,14,44,1
427982,69,3,66,45,1
427982,69,3,66,60,1
427991,478,258,220,1,4
427991,478,258,220,2,1
427991,478,258,220,3,1
427991,290,132,158,4,1
427991,188,126,62,5,1
427991,188,126,62,20,1
427991,351,185,166,21,4
427991,351,185,166,22,1
427991,351,185,166,23,1
427991,228,105,123,24,1
427991,123,80,43,25,1
427991,123,80,43,40,1
427991,127,73,54,41,4
427991,127,73,54,42,1
427991,127,73,54,43,1
427991,62,27,35,44,1
427991,65,46,19,45,1
427991,65,46,19,60,1
428000,173,87,86,1,4
428000,173,87,86,2,1
428000,173,87,86,3,1
428000,173,87,86,5,1
428000,173,87,86,20,1
428000,173,87,86,21,4
428000,173,87,86,22,1
428000,173,87,86,23,1
428000,173,87,86,25,1
428000,173,87,86,40,1
428019,310,155,155,1,4
428019,310,155,155,2,1
428019,310,155,155,3,1
428019,46,22,24,4,1
428019,264,133,131,5,1
428019,264,133,131,20,1
428019,63,24,39,21,4
428019,63,24,39,22,1
428019,63,24,39,23,1
428019,46,22,24,24,1
428019,17,2,15,25,1
428019,17,2,15,40,1
428019,247,131,116,41,4
428019,247,131,116,42,1
428019,247,131,116,43,1
428019,247,131,116,45,1
428019,247,131,116,60,1
428055,195,38,157,1,4
428055,195,38,157,2,1
428055,195,38,157,3,1
428055,40,10,30,4,1
428055,155,28,127,5,1
428055,155,28,127,20,1
428055,195,38,157,21,4
428055,195,38,157,22,1
428055,195,38,157,23,1
428055,40,10,30,24,1
428055,155,28,127,25,1
428055,155,28,127,40,1
428073,25,1,24,1,4
428073,25,1,24,2,1
428073,25,1,24,3,1
428073,18,0,18,4,1
428073,7,1,6,5,1
428073,7,1,6,20,1
428073,25,1,24,21,4
428073,25,1,24,22,1
428073,25,1,24,23,1
428073,18,0,18,24,1
428073,7,1,6,25,1
428073,7,1,6,40,1
428125,89,55,34,1,4
428125,89,55,34,2,1
428125,89,55,34,3,1
428125,22,18,4,4,1
428125,67,37,30,5,1
428125,67,37,30,20,1
428125,87,53,34,21,4
428125,87,53,34,22,1
428125,87,53,34,23,1
428125,22,18,4,24,1
428125,65,35,30,25,1
428125,65,35,30,40,1
428125,2,2,0,41,4
428125,2,2,0,42,1
428125,2,2,0,43,1
428125,2,2,0,45,1
428125,2,2,0,60,1
428143,185,13,172,1,4
428143,185,13,172,2,1
428143,185,13,172,3,1
428143,64,2,62,4,1
428143,121,11,110,5,1
428143,121,11,110,20,1
428143,185,13,172,21,4
428143,185,13,172,22,1
428143,185,13,172,23,1
428143,64,2,62,24,1
428143,121,11,110,25,1
428143,121,11,110,40,1
428170,1157,257,900,1,4
428170,1157,257,900,2,1
428170,1153,256,897,3,1
428170,573,128,445,4,1
428170,580,128,452,5,1
428170,4,1,3,11,1
428170,63,17,46,19,1
428170,517,111,406,20,1
428170,721,149,572,21,4
428170,721,149,572,22,1
428170,721,149,572,23,1
428170,392,90,302,24,1
428170,329,59,270,25,1
428170,34,10,24,39,1
428170,295,49,246,40,1
428170,436,108,328,41,4
428170,436,108,328,42,1
428170,432,107,325,43,1
428170,181,38,143,44,1
428170,251,69,182,45,1
428170,4,1,3,51,1
428170,29,7,22,59,1
428170,222,62,160,60,1
428259,341,85,256,1,4
428259,289,69,220,2,1
428259,289,69,220,3,1
428259,289,69,220,5,1
428259,52,16,36,12,3
428259,45,11,34,19,1
428259,244,58,186,20,1
428259,3,0,3,21,4
428259,3,0,3,22,1
428259,3,0,3,23,1
428259,3,0,3,25,1
428259,3,0,3,40,1
428259,338,85,253,41,4
428259,286,69,217,42,1
428259,286,69,217,43,1
428259,286,69,217,45,1
428259,52,16,36,52,3
428259,45,11,34,59,1
428259,241,58,183,60,1
428268,533,137,396,1,4
428268,123,45,78,2,1
428268,123,45,78,3,1
428268,16,4,12,4,1
428268,107,41,66,5,1
428268,410,92,318,12,3
428268,28,14,14,19,1
428268,79,27,52,20,1
428268,121,34,87,21,4
428268,27,12,15,22,1
428268,27,12,15,23,1
428268,2,1,1,24,1
428268,25,11,14,25,1
428268,94,22,72,32,3
428268,6,5,1,39,1
428268,19,6,13,40,1
428268,412,103,309,41,4
428268,96,33,63,42,1
428268,96,33,63,43,1
428268,14,3,11,44,1
428268,82,30,52,45,1
428268,316,70,246,52,3
428268,22,9,13,59,1
428268,60,21,39,60,1
428286,1066,584,482,1,4
428286,1066,584,482,2,1
428286,1066,584,482,3,1
428286,176,101,75,4,1
428286,890,483,407,5,1
428286,156,92,64,19,1
428286,734,391,343,20,1
428286,804,440,364,21,4
428286,804,440,364,22,1
428286,804,440,364,23,1
428286,142,76,66,24,1
428286,662,364,298,25,1
428286,93,55,38,39,1
428286,569,309,260,40,1
428286,262,144,118,41,4
428286,262,144,118,42,1
428286,262,144,118,43,1
428286,34,25,9,44,1
428286,228,119,109,45,1
428286,63,37,26,59,1
428286,165,82,83,60,1
428295,63,62,1,1,4
428295,63,62,1,2,1
428295,63,62,1,3,1
428295,55,54,1,4,1
428295,8,8,0,5,1
428295,8,8,0,20,1
428295,45,45,0,21,4
428295,45,45,0,22,1
428295,45,45,0,23,1
428295,40,40,0,24,1
428295,5,5,0,25,1
428295,5,5,0,40,1
428295,18,17,1,41,4
428295,18,17,1,42,1
428295,18,17,1,43,1
428295,15,14,1,44,1
428295,3,3,0,45,1
428295,3,3,0,60,1
428329,105,23,82,1,4
428329,105,23,82,2,1
428329,105,23,82,3,1
428329,28,6,22,4,1
428329,77,17,60,5,1
428329,10,1,9,19,1
428329,67,16,51,20,1
428329,105,23,82,21,4
428329,105,23,82,22,1
428329,105,23,82,23,1
428329,28,6,22,24,1
428329,77,17,60,25,1
428329,10,1,9,39,1
428329,67,16,51,40,1
428392,1304,561,743,1,4
428392,1304,561,743,2,1
428392,979,420,559,3,1
428392,272,127,145,4,1
428392,707,293,414,5,1
428392,325,141,184,11,1
428392,200,83,117,19,1
428392,507,210,297,20,1
428392,544,233,311,21,4
428392,544,233,311,22,1
428392,486,220,266,23,1
428392,183,84,99,24,1
428392,303,136,167,25,1
428392,58,13,45,31,1
428392,98,43,55,39,1
428392,205,93,112,40,1
428392,760,328,432,41,4
428392,760,328,432,42,1
428392,493,200,293,43,1
428392,89,43,46,44,1
428392,404,157,247,45,1
428392,267,128,139,51,1
428392,102,40,62,59,1
428392,302,117,185,60,1
428444,1045,546,499,1,4
428444,1045,546,499,2,1
428444,1045,546,499,3,1
428444,229,119,110,4,1
428444,816,427,389,5,1
428444,185,93,92,19,1
428444,631,334,297,20,1
428444,833,427,406,21,4
428444,833,427,406,22,1
428444,833,427,406,23,1
428444,191,96,95,24,1
428444,642,331,311,25,1
428444,143,74,69,39,1
428444,499,257,242,40,1
428444,212,119,93,41,4
428444,212,119,93,42,1
428444,212,119,93,43,1
428444,38,23,15,44,1
428444,174,96,78,45,1
428444,42,19,23,59,1
428444,132,77,55,60,1
429012,74,68,6,1,4
429012,74,68,6,2,1
429012,74,68,6,3,1
429012,26,23,3,4,1
429012,48,45,3,5,1
429012,48,45,3,20,1
429012,74,68,6,21,4
429012,74,68,6,22,1
429012,74,68,6,23,1
429012,26,23,3,24,1
429012,48,45,3,25,1
429012,48,45,3,40,1
429085,130,39,91,1,4
429085,130,39,91,12,3
429085,80,27,53,21,4
429085,80,27,53,32,3
429085,50,12,38,41,4
429085,50,12,38,52,3
429094,189,40,149,1,4
429094,189,40,149,12,3
429094,142,30,112,21,4
429094,142,30,112,32,3
429094,47,10,37,41,4
429094,47,10,37,52,3
429100,54,3,51,1,4
429100,54,3,51,2,1
429100,54,3,51,3,1
429100,39,1,38,4,1
429100,15,2,13,5,1
429100,15,2,13,20,1
429100,54,3,51,21,4
429100,54,3,51,22,1
429100,54,3,51,23,1
429100,39,1,38,24,1
429100,15,2,13,25,1
429100,15,2,13,40,1
429128,762,33,729,1,4
429128,762,33,729,2,1
429128,623,25,598,3,1
429128,245,12,233,4,1
429128,378,13,365,5,1
429128,139,8,131,11,1
429128,10,0,10,19,1
429128,368,13,355,20,1
429128,29,0,29,21,4
429128,29,0,29,22,1
429128,29,0,29,23,1
429128,5,0,5,24,1
429128,24,0,24,25,1
429128,8,0,8,39,1
429128,16,0,16,40,1
429128,733,33,700,41,4
429128,733,33,700,42,1
429128,594,25,569,43,1
429128,240,12,228,44,1
429128,354,13,341,45,1
429128,139,8,131,51,1
429128,2,0,2,59,1
429128,352,13,339,60,1
429599,469,368,101,1,4
429599,469,368,101,2,1
429599,469,368,101,3,1
429599,83,60,23,4,1
429599,386,308,78,5,1
429599,4,4,0,19,1
429599,382,304,78,20,1
429599,359,286,73,21,4
429599,359,286,73,22,1
429599,359,286,73,23,1
429599,76,56,20,24,1
429599,283,230,53,25,1
429599,4,4,0,39,1
429599,279,226,53,40,1
429599,110,82,28,41,4
429599,110,82,28,42,1
429599,110,82,28,43,1
429599,7,4,3,44,1
429599,103,78,25,45,1
429599,103,78,25,60,1
430050,132,28,104,1,4
430050,132,28,104,2,1
430050,132,28,104,3,1
430050,13,5,8,4,1
430050,119,23,96,5,1
430050,119,23,96,20,1
430050,132,28,104,21,4
430050,132,28,104,22,1
430050,132,28,104,23,1
430050,13,5,8,24,1
430050,119,23,96,25,1
430050,119,23,96,40,1
430087,869,460,409,1,4
430087,645,343,302,2,1
430087,644,342,302,3,1
430087,34,5,29,4,1
430087,610,337,273,5,1
430087,1,1,0,11,1
430087,224,117,107,12,3
430087,69,7,62,19,1
430087,541,330,211,20,1
430087,451,246,205,21,4
430087,308,170,138,22,1
430087,307,169,138,23,1
430087,11,1,10,24,1
430087,296,168,128,25,1
430087,1,1,0,31,1
430087,143,76,67,32,3
430087,37,2,35,39,1
430087,259,166,93,40,1
430087,418,214,204,41,4
430087,337,173,164,42,1
430087,337,173,164,43,1
430087,23,4,19,44,1
430087,314,169,145,45,1
430087,81,41,40,52,3
430087,32,5,27,59,1
430087,282,164,118,60,1
430096,449,134,315,1,4
430096,449,134,315,2,1
430096,449,134,315,3,1
430096,308,90,218,4,1
430096,141,44,97,5,1
430096,141,44,97,20,1
430096,326,100,226,21,4
430096,326,100,226,22,1
430096,326,100,226,23,1
430096,229,69,160,24,1
430096,97,31,66,25,1
430096,97,31,66,40,1
430096,123,34,89,41,4
430096,123,34,89,42,1
430096,123,34,89,43,1
430096,79,21,58,44,1
430096,44,13,31,45,1
430096,44,13,31,60,1
430148,682,218,464,1,4
430148,682,218,464,2,1
430148,682,218,464,3,1
430148,80,38,42,4,1
430148,602,180,422,5,1
430148,70,17,53,19,1
430148,532,163,369,20,1
430148,525,163,362,21,4
430148,525,163,362,22,1
430148,525,163,362,23,1
430148,44,23,21,24,1
430148,481,140,341,25,1
430148,44,11,33,39,1
430148,437,129,308,40,1
430148,157,55,102,41,4
430148,157,55,102,42,1
430148,157,55,102,43,1
430148,36,15,21,44,1
430148,121,40,81,45,1
430148,26,6,20,59,1
430148,95,34,61,60,1
430157,255,246,9,1,4
430157,255,246,9,2,1
430157,255,246,9,3,1
430157,62,62,0,4,1
430157,193,184,9,5,1
430157,193,184,9,20,1
430157,238,230,8,21,4
430157,238,230,8,22,1
430157,238,230,8,23,1
430157,55,55,0,24,1
430157,183,175,8,25,1
430157,183,175,8,40,1
430157,17,16,1,41,4
430157,17,16,1,42,1
430157,17,16,1,43,1
430157,7,7,0,44,1
430157,10,9,1,45,1
430157,10,9,1,60,1
430166,171,167,4,1,4
430166,171,167,4,2,1
430166,171,167,4,3,1
430166,55,53,2,4,1
430166,116,114,2,5,1
430166,116,114,2,20,1
430166,159,155,4,21,4
430166,159,155,4,22,1
430166,159,155,4,23,1
430166,49,47,2,24,1
430166,110,108,2,25,1
430166,110,108,2,40,1
430166,12,12,0,41,4
430166,12,12,0,42,1
430166,12,12,0,43,1
430166,6,6,0,44,1
430166,6,6,0,45,1
430166,6,6,0,60,1
430175,645,120,525,1,4
430175,645,120,525,2,1
430175,645,120,525,3,1
430175,76,16,60,4,1
430175,569,104,465,5,1
430175,569,104,465,20,1
430175,645,120,525,21,4
430175,645,120,525,22,1
430175,645,120,525,23,1
430175,76,16,60,24,1
430175,569,104,465,25,1
430175,569,104,465,40,1
430184,3074,1098,1976,1,4
430184,2062,732,1330,2,1
430184,2038,724,1314,3,1
430184,214,66,148,4,1
430184,1824,658,1166,5,1
430184,24,8,16,11,1
430184,1012,366,646,12,3
430184,145,64,81,19,1
430184,1679,594,1085,20,1
430184,497,267,230,21,4
430184,282,177,105,22,1
430184,281,177,104,23,1
430184,25,15,10,24,1
430184,256,162,94,25,1
430184,1,0,1,31,1
430184,215,90,125,32,3
430184,32,23,9,39,1
430184,224,139,85,40,1
430184,2577,831,1746,41,4
430184,1780,555,1225,42,1
430184,1757,547,1210,43,1
430184,189,51,138,44,1
430184,1568,496,1072,45,1
430184,23,8,15,51,1
430184,797,276,521,52,3
430184,113,41,72,59,1
430184,1455,455,1000,60,1
430218,114,20,94,1,4
430218,114,20,94,2,1
430218,114,20,94,3,1
430218,53,7,46,4,1
430218,61,13,48,5,1
430218,61,13,48,20,1
430218,82,15,67,21,4
430218,82,15,67,22,1
430218,82,15,67,23,1
430218,41,7,34,24,1
430218,41,8,33,25,1
430218,41,8,33,40,1
430218,32,5,27,41,4
430218,32,5,27,42,1
430218,32,5,27,43,1
430218,12,0,12,44,1
430218,20,5,15,45,1
430218,20,5,15,60,1
430227,130,1,129,1,4
430227,130,1,129,2,1
430227,130,1,129,3,1
430227,46,0,46,4,1
430227,84,1,83,5,1
430227,84,1,83,20,1
430227,96,1,95,21,4
430227,96,1,95,22,1
430227,96,1,95,23,1
430227,32,0,32,24,1
430227,64,1,63,25,1
430227,64,1,63,40,1
430227,34,0,34,41,4
430227,34,0,34,42,1
430227,34,0,34,43,1
430227,14,0,14,44,1
430227,20,0,20,45,1
430227,20,0,20,60,1
430245,612,106,506,1,4
430245,612,106,506,2,1
430245,612,106,506,3,1
430245,494,91,403,4,1
430245,118,15,103,5,1
430245,118,15,103,20,1
430245,612,106,506,21,4
430245,612,106,506,22,1
430245,612,106,506,23,1
430245,494,91,403,24,1
430245,118,15,103,25,1
430245,118,15,103,40,1
430254,56,12,44,1,4
430254,56,12,44,2,1
430254,56,12,44,3,1
430254,20,4,16,4,1
430254,36,8,28,5,1
430254,36,8,28,20,1
430254,40,10,30,21,4
430254,40,10,30,22,1
430254,40,10,30,23,1
430254,15,4,11,24,1
430254,25,6,19,25,1
430254,25,6,19,40,1
430254,16,2,14,41,4
430254,16,2,14,42,1
430254,16,2,14,43,1
430254,5,0,5,44,1
430254,11,2,9,45,1
430254,11,2,9,60,1
430263,417,328,89,1,4
430263,417,328,89,2,1
430263,417,328,89,3,1
430263,82,63,19,4,1
430263,335,265,70,5,1
430263,3,2,1,19,1
430263,332,263,69,20,1
430263,295,240,55,21,4
430263,295,240,55,22,1
430263,295,240,55,23,1
430263,70,55,15,24,1
430263,225,185,40,25,1
430263,2,2,0,39,1
430263,223,183,40,40,1
430263,122,88,34,41,4
430263,122,88,34,42,1
430263,122,88,34,43,1
430263,12,8,4,44,1
430263,110,80,30,45,1
430263,1,0,1,59,1
430263,109,80,29,60,1
430306,30,4,26,1,4
430306,30,4,26,2,1
430306,30,4,26,3,1
430306,5,0,5,4,1
430306,25,4,21,5,1
430306,25,4,21,20,1
430306,20,2,18,21,4
430306,20,2,18,22,1
430306,20,2,18,23,1
430306,3,0,3,24,1
430306,17,2,15,25,1
430306,17,2,15,40,1
430306,10,2,8,41,4
430306,10,2,8,42,1
430306,10,2,8,43,1
430306,2,0,2,44,1
430306,8,2,6,45,1
430306,8,2,6,60,1
430342,145,46,99,1,4
430342,145,46,99,2,1
430342,145,46,99,3,1
430342,39,11,28,4,1
430342,106,35,71,5,1
430342,106,35,71,20,1
430342,145,46,99,21,4
430342,145,46,99,22,1
430342,145,46,99,23,1
430342,39,11,28,24,1
430342,106,35,71,25,1
430342,106,35,71,40,1
430351,239,195,44,1,4
430351,239,195,44,2,1
430351,239,195,44,3,1
430351,45,38,7,4,1
430351,194,157,37,5,1
430351,7,7,0,19,1
430351,187,150,37,20,1
430351,186,150,36,21,4
430351,186,150,36,22,1
430351,186,150,36,23,1
430351,36,30,6,24,1
430351,150,120,30,25,1
430351,5,5,0,39,1
430351,145,115,30,40,1
430351,53,45,8,41,4
430351,53,45,8,42,1
430351,53,45,8,43,1
430351,9,8,1,44,1
430351,44,37,7,45,1
430351,2,2,0,59,1
430351,42,35,7,60,1
430360,255,214,41,1,4
430360,255,214,41,2,1
430360,255,214,41,3,1
430360,38,31,7,4,1
430360,217,183,34,5,1
430360,11,7,4,19,1
430360,206,176,30,20,1
430360,199,169,30,21,4
430360,199,169,30,22,1
430360,199,169,30,23,1
430360,31,28,3,24,1
430360,168,141,27,25,1
430360,10,6,4,39,1
430360,158,135,23,40,1
430360,56,45,11,41,4
430360,56,45,11,42,1
430360,56,45,11,43,1
430360,7,3,4,44,1
430360,49,42,7,45,1
430360,1,1,0,59,1
430360,48,41,7,60,1
430379,419,277,142,1,4
430379,419,277,142,2,1
430379,419,277,142,3,1
430379,60,42,18,4,1
430379,359,235,124,5,1
430379,8,5,3,19,1
430379,351,230,121,20,1
430379,307,206,101,21,4
430379,307,206,101,22,1
430379,307,206,101,23,1
430379,49,36,13,24,1
430379,258,170,88,25,1
430379,5,4,1,39,1
430379,253,166,87,40,1
430379,112,71,41,41,4
430379,112,71,41,42,1
430379,112,71,41,43,1
430379,11,6,5,44,1
430379,101,65,36,45,1
430379,3,1,2,59,1
430379,98,64,34,60,1
430388,391,249,142,1,4
430388,391,249,142,2,1
430388,391,249,142,3,1
430388,52,32,20,4,1
430388,339,217,122,5,1
430388,16,6,10,19,1
430388,323,211,112,20,1
430388,291,188,103,21,4
430388,291,188,103,22,1
430388,291,188,103,23,1
430388,49,30,19,24,1
430388,242,158,84,25,1
430388,10,5,5,39,1
430388,232,153,79,40,1
430388,100,61,39,41,4
430388,100,61,39,42,1
430388,100,61,39,43,1
430388,3,2,1,44,1
430388,97,59,38,45,1
430388,6,1,5,59,1
430388,91,58,33,60,1
430403,42,4,38,1,4
430403,42,4,38,2,1
430403,42,4,38,3,1
430403,13,2,11,4,1
430403,29,2,27,5,1
430403,29,2,27,20,1
430403,42,4,38,21,4
430403,42,4,38,22,1
430403,42,4,38,23,1
430403,13,2,11,24,1
430403,29,2,27,25,1
430403,29,2,27,40,1
430421,329,39,290,1,4
430421,329,39,290,2,1
430421,329,39,290,3,1
430421,42,3,39,4,1
430421,287,36,251,5,1
430421,287,36,251,20,1
430421,329,39,290,21,4
430421,329,39,290,22,1
430421,329,39,290,23,1
430421,42,3,39,24,1
430421,287,36,251,25,1
430421,287,36,251,40,1
430485,86,31,55,1,4
430485,86,31,55,2,1
430485,86,31,55,3,1
430485,23,8,15,4,1
430485,63,23,40,5,1
430485,6,3,3,19,1
430485,57,20,37,20,1
430485,86,31,55,21,4
430485,86,31,55,22,1
430485,86,31,55,23,1
430485,23,8,15,24,1
430485,63,23,40,25,1
430485,6,3,3,39,1
430485,57,20,37,40,1
430564,61,12,49,1,4
430564,61,12,49,2,1
430564,61,12,49,3,1
430564,21,7,14,4,1
430564,40,5,35,5,1
430564,40,5,35,20,1
430564,25,4,21,21,4
430564,25,4,21,22,1
430564,25,4,21,23,1
430564,8,2,6,24,1
430564,17,2,15,25,1
430564,17,2,15,40,1
430564,36,8,28,41,4
430564,36,8,28,42,1
430564,36,8,28,43,1
430564,13,5,8,44,1
430564,23,3,20,45,1
430564,23,3,20,60,1
430582,388,174,214,1,4
430582,388,174,214,2,1
430582,388,174,214,3,1
430582,227,112,115,4,1
430582,161,62,99,5,1
430582,161,62,99,20,1
430582,388,174,214,21,4
430582,388,174,214,22,1
430582,388,174,214,23,1
430582,227,112,115,24,1
430582,161,62,99,25,1
430582,161,62,99,40,1
430591,268,65,203,1,4
430591,268,65,203,12,3
430591,193,51,142,21,4
430591,193,51,142,32,3
430591,75,14,61,41,4
430591,75,14,61,52,3
430643,6,6,0,1,4
430643,6,6,0,2,1
430643,6,6,0,3,1
430643,5,5,0,4,1
430643,1,1,0,5,1
430643,1,1,0,20,1
430643,6,6,0,41,4
430643,6,6,0,42,1
430643,6,6,0,43,1
430643,5,5,0,44,1
430643,1,1,0,45,1
430643,1,1,0,60,1
430670,295,141,154,1,4
430670,27,12,15,2,1
430670,27,12,15,3,1
430670,6,4,2,4,1
430670,21,8,13,5,1
430670,268,129,139,12,3
430670,7,3,4,19,1
430670,14,5,9,20,1
430670,295,141,154,21,4
430670,27,12,15,22,1
430670,27,12,15,23,1
430670,6,4,2,24,1
430670,21,8,13,25,1
430670,268,129,139,32,3
430670,7,3,4,39,1
430670,14,5,9,40,1
430704,88,31,57,1,4
430704,6,3,3,2,1
430704,6,3,3,3,1
430704,6,3,3,5,1
430704,82,28,54,12,3
430704,5,2,3,19,1
430704,1,1,0,20,1
430704,75,26,49,21,4
430704,6,3,3,22,1
430704,6,3,3,23,1
430704,6,3,3,25,1
430704,69,23,46,32,3
430704,5,2,3,39,1
430704,1,1,0,40,1
430704,13,5,8,41,4
430704,13,5,8,52,3
430795,278,89,189,1,4
430795,278,89,189,2,1
430795,278,89,189,3,1
430795,145,59,86,4,1
430795,133,30,103,5,1
430795,2,0,2,19,1
430795,131,30,101,20,1
430795,261,75,186,21,4
430795,261,75,186,22,1
430795,261,75,186,23,1
430795,129,45,84,24,1
430795,132,30,102,25,1
430795,1,0,1,39,1
430795,131,30,101,40,1
430795,17,14,3,41,4
430795,17,14,3,42,1
430795,17,14,3,43,1
430795,16,14,2,44,1
430795,1,0,1,45,1
430795,1,0,1,59,1
430810,506,149,357,1,4
430810,470,131,339,2,1
430810,470,131,339,3,1
430810,107,30,77,4,1
430810,363,101,262,5,1
430810,36,18,18,12,3
430810,25,10,15,19,1
430810,338,91,247,20,1
430810,449,133,316,21,4
430810,413,115,298,22,1
430810,413,115,298,23,1
430810,95,29,66,24,1
430810,318,86,232,25,1
430810,36,18,18,32,3
430810,23,9,14,39,1
430810,295,77,218,40,1
430810,57,16,41,41,4
430810,57,16,41,42,1
430810,57,16,41,43,1
430810,12,1,11,44,1
430810,45,15,30,45,1
430810,2,1,1,59,1
430810,43,14,29,60,1
430847,11,1,10,1,4
430847,11,1,10,2,1
430847,11,1,10,3,1
430847,11,1,10,5,1
430847,11,1,10,20,1
430847,10,1,9,21,4
430847,10,1,9,22,1
430847,10,1,9,23,1
430847,10,1,9,25,1
430847,10,1,9,40,1
430847,1,0,1,41,4
430847,1,0,1,42,1
430847,1,0,1,43,1
430847,1,0,1,45,1
430847,1,0,1,60,1
430883,34,4,30,1,4
430883,34,4,30,2,1
430883,34,4,30,3,1
430883,21,2,19,4,1
430883,13,2,11,5,1
430883,13,2,11,20,1
430883,34,4,30,21,4
430883,34,4,30,22,1
430883,34,4,30,23,1
430883,21,2,19,24,1
430883,13,2,11,25,1
430883,13,2,11,40,1
430908,67,10,57,1,4
430908,67,10,57,2,1
430908,67,10,57,3,1
430908,37,9,28,4,1
430908,30,1,29,5,1
430908,30,1,29,20,1
430908,50,10,40,21,4
430908,50,10,40,22,1
430908,50,10,40,23,1
430908,31,9,22,24,1
430908,19,1,18,25,1
430908,19,1,18,40,1
430908,17,0,17,41,4
430908,17,0,17,42,1
430908,17,0,17,43,1
430908,6,0,6,44,1
430908,11,0,11,45,1
430908,11,0,11,60,1
430935,867,713,154,1,4
430935,867,713,154,2,1
430935,867,713,154,3,1
430935,254,211,43,4,1
430935,613,502,111,5,1
430935,107,88,19,19,1
430935,506,414,92,20,1
430935,651,535,116,21,4
430935,651,535,116,22,1
430935,651,535,116,23,1
430935,244,203,41,24,1
430935,407,332,75,25,1
430935,102,83,19,39,1
430935,305,249,56,40,1
430935,216,178,38,41,4
430935,216,178,38,42,1
430935,216,178,38,43,1
430935,10,8,2,44,1
430935,206,170,36,45,1
430935,5,5,0,59,1
430935,201,165,36,60,1
430971,56,8,48,1,4
430971,56,8,48,2,1
430971,56,8,48,3,1
430971,25,3,22,4,1
430971,31,5,26,5,1
430971,31,5,26,20,1
430971,56,8,48,21,4
430971,56,8,48,22,1
430971,56,8,48,23,1
430971,25,3,22,24,1
430971,31,5,26,25,1
430971,31,5,26,40,1
430980,167,36,131,1,4
430980,167,36,131,2,1
430980,167,36,131,3,1
430980,20,2,18,4,1
430980,147,34,113,5,1
430980,147,34,113,20,1
430980,167,36,131,21,4
430980,167,36,131,22,1
430980,167,36,131,23,1
430980,20,2,18,24,1
430980,147,34,113,25,1
430980,147,34,113,40,1
430999,98,10,88,1,4
430999,98,10,88,2,1
430999,98,10,88,3,1
430999,62,7,55,4,1
430999,36,3,33,5,1
430999,36,3,33,20,1
430999,98,10,88,21,4
430999,98,10,88,22,1
430999,98,10,88,23,1
430999,62,7,55,24,1
430999,36,3,33,25,1
430999,36,3,33,40,1
431017,114,51,63,1,4
431017,114,51,63,2,1
431017,114,51,63,3,1
431017,91,38,53,4,1
431017,23,13,10,5,1
431017,23,13,10,20,1
431017,82,31,51,21,4
431017,82,31,51,22,1
431017,82,31,51,23,1
431017,69,25,44,24,1
431017,13,6,7,25,1
431017,13,6,7,40,1
431017,32,20,12,41,4
431017,32,20,12,42,1
431017,32,20,12,43,1
431017,22,13,9,44,1
431017,10,7,3,45,1
431017,10,7,3,60,1
431026,1114,312,802,1,4
431026,1114,312,802,2,1
431026,1114,312,802,3,1
431026,1089,300,789,4,1
431026,25,12,13,5,1
431026,25,12,13,20,1
431026,1079,301,778,21,4
431026,1079,301,778,22,1
431026,1079,301,778,23,1
431026,1056,291,765,24,1
431026,23,10,13,25,1
431026,23,10,13,40,1
431026,35,11,24,41,4
431026,35,11,24,42,1
431026,35,11,24,43,1
431026,33,9,24,44,1
431026,2,2,0,45,1
431026,2,2,0,60,1
431071,103,24,79,1,4
431071,103,24,79,2,1
431071,103,24,79,3,1
431071,35,10,25,4,1
431071,68,14,54,5,1
431071,68,14,54,20,1
431071,58,13,45,21,4
431071,58,13,45,22,1
431071,58,13,45,23,1
431071,23,5,18,24,1
431071,35,8,27,25,1
431071,35,8,27,40,1
431071,45,11,34,41,4
431071,45,11,34,42,1
431071,45,11,34,43,1
431071,12,5,7,44,1
431071,33,6,27,45,1
431071,33,6,27,60,1
431099,102,3,99,1,4
431099,102,3,99,2,1
431099,102,3,99,3,1
431099,81,3,78,4,1
431099,21,0,21,5,1
431099,21,0,21,20,1
431099,65,3,62,21,4
431099,65,3,62,22,1
431099,65,3,62,23,1
431099,56,3,53,24,1
431099,9,0,9,25,1
431099,9,0,9,40,1
431099,37,0,37,41,4
431099,37,0,37,42,1
431099,37,0,37,43,1
431099,25,0,25,44,1
431099,12,0,12,45,1
431099,12,0,12,60,1
431105,151,23,128,1,4
431105,151,23,128,2,1
431105,151,23,128,3,1
431105,77,13,64,4,1
431105,74,10,64,5,1
431105,74,10,64,20,1
431105,29,6,23,21,4
431105,29,6,23,22,1
431105,29,6,23,23,1
431105,8,1,7,24,1
431105,21,5,16,25,1
431105,21,5,16,40,1
431105,122,17,105,41,4
431105,122,17,105,42,1
431105,122,17,105,43,1
431105,69,12,57,44,1
431105,53,5,48,45,1
431105,53,5,48,60,1
431123,356,353,3,1,4
431123,356,353,3,2,1
431123,356,353,3,3,1
431123,65,64,1,4,1
431123,291,289,2,5,1
431123,291,289,2,20,1
431123,356,353,3,21,4
431123,356,353,3,22,1
431123,356,353,3,23,1
431123,65,64,1,24,1
431123,291,289,2,25,1
431123,291,289,2,40,1
431141,1989,967,1022,1,4
431141,1989,967,1022,2,1
431141,1989,967,1022,3,1
431141,491,253,238,4,1
431141,1498,714,784,5,1
431141,57,32,25,19,1
431141,1441,682,759,20,1
431141,1962,963,999,21,4
431141,1962,963,999,22,1
431141,1962,963,999,23,1
431141,491,253,238,24,1
431141,1471,710,761,25,1
431141,57,32,25,39,1
431141,1414,678,736,40,1
431141,27,4,23,41,4
431141,27,4,23,42,1
431141,27,4,23,43,1
431141,27,4,23,45,1
431141,27,4,23,60,1
431169,117,36,81,1,4
431169,117,36,81,2,1
431169,117,36,81,3,1
431169,30,11,19,4,1
431169,87,25,62,5,1
431169,87,25,62,20,1
431169,117,36,81,21,4
431169,117,36,81,22,1
431169,117,36,81,23,1
431169,30,11,19,24,1
431169,87,25,62,25,1
431169,87,25,62,40,1
431187,45,39,6,1,4
431187,45,39,6,2,1
431187,45,39,6,3,1
431187,45,39,6,4,1
431187,45,39,6,21,4
431187,45,39,6,22,1
431187,45,39,6,23,1
431187,45,39,6,24,1
431196,143,17,126,1,4
431196,143,17,126,2,1
431196,143,17,126,3,1
431196,29,5,24,4,1
431196,114,12,102,5,1
431196,114,12,102,20,1
431196,143,17,126,21,4
431196,143,17,126,22,1
431196,143,17,126,23,1
431196,29,5,24,24,1
431196,114,12,102,25,1
431196,114,12,102,40,1
431202,69,4,65,1,4
431202,69,4,65,2,1
431202,69,4,65,3,1
431202,10,1,9,4,1
431202,59,3,56,5,1
431202,59,3,56,20,1
431202,69,4,65,41,4
431202,69,4,65,42,1
431202,69,4,65,43,1
431202,10,1,9,44,1
431202,59,3,56,45,1
431202,59,3,56,60,1
431266,91,3,88,1,4
431266,91,3,88,2,1
431266,91,3,88,3,1
431266,15,1,14,4,1
431266,76,2,74,5,1
431266,76,2,74,20,1
431266,35,1,34,21,4
431266,35,1,34,22,1
431266,35,1,34,23,1
431266,35,1,34,25,1
431266,35,1,34,40,1
431266,56,2,54,41,4
431266,56,2,54,42,1
431266,56,2,54,43,1
431266,15,1,14,44,1
431266,41,1,40,45,1
431266,41,1,40,60,1
431275,123,6,117,1,4
431275,123,6,117,2,1
431275,123,6,117,3,1
431275,35,0,35,4,1
431275,88,6,82,5,1
431275,88,6,82,20,1
431275,31,1,30,21,4
431275,31,1,30,22,1
431275,31,1,30,23,1
431275,10,0,10,24,1
431275,21,1,20,25,1
431275,21,1,20,40,1
431275,92,5,87,41,4
431275,92,5,87,42,1
431275,92,5,87,43,1
431275,25,0,25,44,1
431275,67,5,62,45,1
431275,67,5,62,60,1
431284,55,7,48,1,4
431284,55,7,48,2,1
431284,55,7,48,3,1
431284,12,1,11,4,1
431284,43,6,37,5,1
431284,43,6,37,20,1
431284,12,2,10,21,4
431284,12,2,10,22,1
431284,12,2,10,23,1
431284,2,0,2,24,1
431284,10,2,8,25,1
431284,10,2,8,40,1
431284,43,5,38,41,4
431284,43,5,38,42,1
431284,43,5,38,43,1
431284,10,1,9,44,1
431284,33,4,29,45,1
431284,33,4,29,60,1
431309,96,29,67,1,4
431309,96,29,67,2,1
431309,96,29,67,3,1
431309,45,15,30,4,1
431309,51,14,37,5,1
431309,51,14,37,20,1
431309,96,29,67,21,4
431309,96,29,67,22,1
431309,96,29,67,23,1
431309,45,15,30,24,1
431309,51,14,37,25,1
431309,51,14,37,40,1
431558,330,141,189,1,4
431558,330,141,189,2,1
431558,323,138,185,3,1
431558,155,69,86,4,1
431558,168,69,99,5,1
431558,7,3,4,11,1
431558,168,69,99,20,1
431558,330,141,189,21,4
431558,330,141,189,22,1
431558,323,138,185,23,1
431558,155,69,86,24,1
431558,168,69,99,25,1
431558,7,3,4,31,1
431558,168,69,99,40,1
431594,20,0,20,1,4
431594,20,0,20,12,3
431594,20,0,20,21,4
431594,20,0,20,32,3
431600,168,32,136,1,4
431600,168,32,136,2,1
431600,168,32,136,3,1
431600,15,5,10,4,1
431600,153,27,126,5,1
431600,153,27,126,20,1
431600,163,30,133,21,4
431600,163,30,133,22,1
431600,163,30,133,23,1
431600,15,5,10,24,1
431600,148,25,123,25,1
431600,148,25,123,40,1
431600,5,2,3,41,4
431600,5,2,3,42,1
431600,5,2,3,43,1
431600,5,2,3,45,1
431600,5,2,3,60,1
431637,812,256,556,1,4
431637,812,256,556,2,1
431637,812,256,556,3,1
431637,206,52,154,4,1
431637,606,204,402,5,1
431637,606,204,402,20,1
431637,525,146,379,21,4
431637,525,146,379,22,1
431637,525,146,379,23,1
431637,141,28,113,24,1
431637,384,118,266,25,1
431637,384,118,266,40,1
431637,287,110,177,41,4
431637,287,110,177,42,1
431637,287,110,177,43,1
431637,65,24,41,44,1
431637,222,86,136,45,1
431637,222,86,136,60,1
431691,36,5,31,1,4
431691,36,5,31,2,1
431691,36,5,31,3,1
431691,16,4,12,4,1
431691,20,1,19,5,1
431691,20,1,19,20,1
431691,36,5,31,21,4
431691,36,5,31,22,1
431691,36,5,31,23,1
431691,16,4,12,24,1
431691,20,1,19,25,1
431691,20,1,19,40,1
431707,31,2,29,1,4
431707,31,2,29,2,1
431707,31,2,29,3,1
431707,31,2,29,5,1
431707,31,2,29,20,1
431707,31,2,29,21,4
431707,31,2,29,22,1
431707,31,2,29,23,1
431707,31,2,29,25,1
431707,31,2,29,40,1
431716,522,297,225,1,4
431716,522,297,225,2,1
431716,522,297,225,3,1
431716,356,184,172,4,1
431716,166,113,53,5,1
431716,166,113,53,20,1
431716,522,297,225,21,4
431716,522,297,225,22,1
431716,522,297,225,23,1
431716,356,184,172,24,1
431716,166,113,53,25,1
431716,166,113,53,40,1
431770,55,3,52,1,4
431770,55,3,52,2,1
431770,55,3,52,3,1
431770,36,3,33,4,1
431770,19,0,19,5,1
431770,19,0,19,20,1
431770,20,1,19,21,4
431770,20,1,19,22,1
431770,20,1,19,23,1
431770,20,1,19,24,1
431770,35,2,33,41,4
431770,35,2,33,42,1
431770,35,2,33,43,1
431770,16,2,14,44,1
431770,19,0,19,45,1
431770,19,0,19,60,1
431877,30,5,25,1,4
431877,30,5,25,2,1
431877,30,5,25,3,1
431877,21,3,18,4,1
431877,9,2,7,5,1
431877,9,2,7,20,1
431877,10,3,7,21,4
431877,10,3,7,22,1
431877,10,3,7,23,1
431877,10,3,7,24,1
431877,20,2,18,41,4
431877,20,2,18,42,1
431877,20,2,18,43,1
431877,11,0,11,44,1
431877,9,2,7,45,1
431877,9,2,7,60,1
431886,625,104,521,1,4
431886,625,104,521,2,1
431886,620,102,518,3,1
431886,137,17,120,4,1
431886,483,85,398,5,1
431886,5,2,3,11,1
431886,28,6,22,19,1
431886,455,79,376,20,1
431886,625,104,521,21,4
431886,625,104,521,22,1
431886,620,102,518,23,1
431886,137,17,120,24,1
431886,483,85,398,25,1
431886,5,2,3,31,1
431886,28,6,22,39,1
431886,455,79,376,40,1
431929,243,63,180,1,4
431929,243,63,180,2,1
431929,243,63,180,3,1
431929,62,19,43,4,1
431929,181,44,137,5,1
431929,181,44,137,20,1
431929,237,61,176,21,4
431929,237,61,176,22,1
431929,237,61,176,23,1
431929,62,19,43,24,1
431929,175,42,133,25,1
431929,175,42,133,40,1
431929,6,2,4,41,4
431929,6,2,4,42,1
431929,6,2,4,43,1
431929,6,2,4,45,1
431929,6,2,4,60,1
431956,66,15,51,1,4
431956,66,15,51,2,1
431956,66,15,51,3,1
431956,28,5,23,4,1
431956,38,10,28,5,1
431956,38,10,28,20,1
431956,66,15,51,21,4
431956,66,15,51,22,1
431956,66,15,51,23,1
431956,28,5,23,24,1
431956,38,10,28,25,1
431956,38,10,28,40,1
431965,144,45,99,1,4
431965,144,45,99,2,1
431965,144,45,99,3,1
431965,89,27,62,4,1
431965,55,18,37,5,1
431965,55,18,37,20,1
431965,144,45,99,21,4
431965,144,45,99,22,1
431965,144,45,99,23,1
431965,89,27,62,24,1
431965,55,18,37,25,1
431965,55,18,37,40,1
431983,126,126,0,1,4
431983,126,126,0,2,1
431983,126,126,0,3,1
431983,37,37,0,4,1
431983,89,89,0,5,1
431983,2,2,0,19,1
431983,87,87,0,20,1
431983,126,126,0,21,4
431983,126,126,0,22,1
431983,126,126,0,23,1
431983,37,37,0,24,1
431983,89,89,0,25,1
431983,2,2,0,39,1
431983,87,87,0,40,1
432074,200,80,120,1,4
432074,200,80,120,2,1
432074,200,80,120,3,1
432074,130,57,73,4,1
432074,70,23,47,5,1
432074,70,23,47,20,1
432074,66,17,49,21,4
432074,66,17,49,22,1
432074,66,17,49,23,1
432074,42,14,28,24,1
432074,24,3,21,25,1
432074,24,3,21,40,1
432074,134,63,71,41,4
432074,134,63,71,42,1
432074,134,63,71,43,1
432074,88,43,45,44,1
432074,46,20,26,45,1
432074,46,20,26,60,1
432117,110,8,102,1,4
432117,110,8,102,2,1
432117,110,8,102,3,1
432117,12,2,10,4,1
432117,98,6,92,5,1
432117,98,6,92,20,1
432117,69,7,62,21,4
432117,69,7,62,22,1
432117,69,7,62,23,1
432117,10,2,8,24,1
432117,59,5,54,25,1
432117,59,5,54,40,1
432117,41,1,40,41,4
432117,41,1,40,42,1
432117,41,1,40,43,1
432117,2,0,2,44,1
432117,39,1,38,45,1
432117,39,1,38,60,1
432223,642,290,352,1,4
432223,566,246,320,2,1
432223,566,246,320,3,1
432223,8,2,6,4,1
432223,558,244,314,5,1
432223,76,44,32,12,3
432223,48,30,18,19,1
432223,510,214,296,20,1
432223,642,290,352,21,4
432223,566,246,320,22,1
432223,566,246,320,23,1
432223,8,2,6,24,1
432223,558,244,314,25,1
432223,76,44,32,32,3
432223,48,30,18,39,1
432223,510,214,296,40,1
432232,1560,704,856,1,4
432232,1308,595,713,2,1
432232,1308,595,713,3,1
432232,43,13,30,4,1
432232,1265,582,683,5,1
432232,252,109,143,12,3
432232,88,41,47,19,1
432232,1177,541,636,20,1
432232,1560,704,856,21,4
432232,1308,595,713,22,1
432232,1308,595,713,23,1
432232,43,13,30,24,1
432232,1265,582,683,25,1
432232,252,109,143,32,3
432232,88,41,47,39,1
432232,1177,541,636,40,1
432241,694,262,432,1,4
432241,639,239,400,2,1
432241,639,239,400,3,1
432241,11,3,8,4,1
432241,628,236,392,5,1
432241,55,23,32,12,3
432241,20,12,8,19,1
432241,608,224,384,20,1
432241,694,262,432,21,4
432241,639,239,400,22,1
432241,639,239,400,23,1
432241,11,3,8,24,1
432241,628,236,392,25,1
432241,55,23,32,32,3
432241,20,12,8,39,1
432241,608,224,384,40,1
432269,99,85,14,1,4
432269,99,85,14,2,1
432269,99,85,14,3,1
432269,39,34,5,4,1
432269,60,51,9,5,1
432269,60,51,9,20,1
432269,99,85,14,21,4
432269,99,85,14,22,1
432269,99,85,14,23,1
432269,39,34,5,24,1
432269,60,51,9,25,1
432269,60,51,9,40,1
432302,234,54,180,1,4
432302,234,54,180,2,1
432302,233,54,179,3,1
432302,54,13,41,4,1
432302,179,41,138,5,1
432302,1,0,1,11,1
432302,8,2,6,19,1
432302,171,39,132,20,1
432302,234,54,180,21,4
432302,234,54,180,22,1
432302,233,54,179,23,1
432302,54,13,41,24,1
432302,179,41,138,25,1
432302,1,0,1,31,1
432302,8,2,6,39,1
432302,171,39,132,40,1
432348,219,133,86,1,4
432348,219,133,86,12,3
432348,216,132,84,21,4
432348,216,132,84,32,3
432348,3,1,2,41,4
432348,3,1,2,52,3
432357,205,34,171,1,4
432357,205,34,171,12,3
432357,63,8,55,21,4
432357,63,8,55,32,3
432357,142,26,116,41,4
432357,142,26,116,52,3
432384,467,124,343,1,4
432384,467,124,343,2,1
432384,467,124,343,3,1
432384,40,12,28,4,1
432384,427,112,315,5,1
432384,38,9,29,19,1
432384,389,103,286,20,1
432384,467,124,343,21,4
432384,467,124,343,22,1
432384,467,124,343,23,1
432384,40,12,28,24,1
432384,427,112,315,25,1
432384,38,9,29,39,1
432384,389,103,286,40,1
432524,196,72,124,1,4
432524,196,72,124,2,1
432524,194,72,122,3,1
432524,91,28,63,4,1
432524,103,44,59,5,1
432524,2,0,2,11,1
432524,20,15,5,19,1
432524,83,29,54,20,1
432524,183,65,118,21,4
432524,183,65,118,22,1
432524,181,65,116,23,1
432524,87,25,62,24,1
432524,94,40,54,25,1
432524,2,0,2,31,1
432524,20,15,5,39,1
432524,74,25,49,40,1
432524,13,7,6,41,4
432524,13,7,6,42,1
432524,13,7,6,43,1
432524,4,3,1,44,1
432524,9,4,5,45,1
432524,9,4,5,60,1
432533,1808,1049,759,1,4
432533,1808,1049,759,2,1
432533,1807,1048,759,3,1
432533,371,220,151,4,1
432533,1436,828,608,5,1
432533,1,1,0,11,1
432533,206,98,108,19,1
432533,1230,730,500,20,1
432533,1250,716,534,21,4
432533,1250,716,534,22,1
432533,1250,716,534,23,1
432533,299,181,118,24,1
432533,951,535,416,25,1
432533,158,73,85,39,1
432533,793,462,331,40,1
432533,558,333,225,41,4
432533,558,333,225,42,1
432533,557,332,225,43,1
432533,72,39,33,44,1
432533,485,293,192,45,1
432533,1,1,0,51,1
432533,48,25,23,59,1
432533,437,268,169,60,1
433004,287,90,197,1,4
433004,280,86,194,2,1
433004,280,86,194,3,1
433004,3,2,1,4,1
433004,277,84,193,5,1
433004,7,4,3,12,3
433004,25,8,17,19,1
433004,252,76,176,20,1
433004,287,90,197,21,4
433004,280,86,194,22,1
433004,280,86,194,23,1
433004,3,2,1,24,1
433004,277,84,193,25,1
433004,7,4,3,32,3
433004,25,8,17,39,1
433004,252,76,176,40,1
433013,561,151,410,1,4
433013,561,151,410,2,1
433013,561,151,410,3,1
433013,48,12,36,4,1
433013,513,139,374,5,1
433013,50,17,33,19,1
433013,463,122,341,20,1
433013,552,150,402,21,4
433013,552,150,402,22,1
433013,552,150,402,23,1
433013,47,11,36,24,1
433013,505,139,366,25,1
433013,50,17,33,39,1
433013,455,122,333,40,1
433013,9,1,8,41,4
433013,9,1,8,42,1
433013,9,1,8,43,1
433013,1,1,0,44,1
433013,8,0,8,45,1
433013,8,0,8,60,1
433040,40,4,36,1,4
433040,40,4,36,2,1
433040,40,4,36,3,1
433040,39,3,36,4,1
433040,1,1,0,5,1
433040,1,1,0,20,1
433040,40,4,36,21,4
433040,40,4,36,22,1
433040,40,4,36,23,1
433040,39,3,36,24,1
433040,1,1,0,25,1
433040,1,1,0,40,1
433068,349,180,169,1,4
433068,349,180,169,2,1
433068,349,180,169,3,1
433068,154,72,82,4,1
433068,195,108,87,5,1
433068,195,108,87,20,1
433068,282,136,146,21,4
433068,282,136,146,22,1
433068,282,136,146,23,1
433068,111,51,60,24,1
433068,171,85,86,25,1
433068,171,85,86,40,1
433068,67,44,23,41,4
433068,67,44,23,42,1
433068,67,44,23,43,1
433068,43,21,22,44,1
433068,24,23,1,45,1
433068,24,23,1,60,1
433101,607,103,504,1,4
433101,607,103,504,2,1
433101,607,103,504,3,1
433101,161,28,133,4,1
433101,446,75,371,5,1
433101,446,75,371,20,1
433101,470,89,381,21,4
433101,470,89,381,22,1
433101,470,89,381,23,1
433101,119,24,95,24,1
433101,351,65,286,25,1
433101,351,65,286,40,1
433101,137,14,123,41,4
433101,137,14,123,42,1
433101,137,14,123,43,1
433101,42,4,38,44,1
433101,95,10,85,45,1
433101,95,10,85,60,1
433138,360,146,214,1,4
433138,360,146,214,2,1
433138,352,143,209,3,1
433138,131,57,74,4,1
433138,221,86,135,5,1
433138,8,3,5,11,1
433138,221,86,135,20,1
433138,248,82,166,21,4
433138,248,82,166,22,1
433138,246,82,164,23,1
433138,71,22,49,24,1
433138,175,60,115,25,1
433138,2,0,2,31,1
433138,175,60,115,40,1
433138,112,64,48,41,4
433138,112,64,48,42,1
433138,106,61,45,43,1
433138,60,35,25,44,1
433138,46,26,20,45,1
433138,6,3,3,51,1
433138,46,26,20,60,1
433165,4,2,2,1,4
433165,4,2,2,2,1
433165,4,2,2,3,1
433165,4,2,2,5,1
433165,4,2,2,20,1
433165,4,2,2,21,4
433165,4,2,2,22,1
433165,4,2,2,23,1
433165,4,2,2,25,1
433165,4,2,2,40,1
433174,449,57,392,1,4
433174,449,57,392,2,1
433174,445,57,388,3,1
433174,24,5,19,4,1
433174,421,52,369,5,1
433174,4,0,4,11,1
433174,152,13,139,19,1
433174,269,39,230,20,1
433174,81,16,65,21,4
433174,81,16,65,22,1
433174,81,16,65,23,1
433174,3,1,2,24,1
433174,78,15,63,25,1
433174,27,3,24,39,1
433174,51,12,39,40,1
433174,368,41,327,41,4
433174,368,41,327,42,1
433174,364,41,323,43,1
433174,21,4,17,44,1
433174,343,37,306,45,1
433174,4,0,4,51,1
433174,125,10,115,59,1
433174,218,27,191,60,1
433217,7,3,4,1,4
433217,7,3,4,12,3
433217,7,3,4,21,4
433217,7,3,4,32,3
433387,46733,18984,27749,1,4
433387,35493,14729,20764,2,1
433387,35493,14729,20764,3,1
433387,52,34,18,4,1
433387,35441,14695,20746,5,1
433387,11240,4255,6985,12,3
433387,33554,13802,19752,19,1
433387,1887,893,994,20,1
433387,46733,18984,27749,21,4
433387,35493,14729,20764,22,1
433387,35493,14729,20764,23,1
433387,52,34,18,24,1
433387,35441,14695,20746,25,1
433387,11240,4255,6985,32,3
433387,33554,13802,19752,39,1
433387,1887,893,994,40,1
433420,349,54,295,1,4
433420,339,49,290,2,1
433420,339,49,290,3,1
433420,25,2,23,4,1
433420,314,47,267,5,1
433420,10,5,5,12,3
433420,211,28,183,19,1
433420,103,19,84,20,1
433420,349,54,295,21,4
433420,339,49,290,22,1
433420,339,49,290,23,1
433420,25,2,23,24,1
433420,314,47,267,25,1
433420,10,5,5,32,3
433420,211,28,183,39,1
433420,103,19,84,40,1
433466,943,163,780,1,4
433466,943,163,780,2,1
433466,943,163,780,3,1
433466,207,34,173,4,1
433466,736,129,607,5,1
433466,736,129,607,20,1
433466,859,132,727,21,4
433466,859,132,727,22,1
433466,859,132,727,23,1
433466,182,27,155,24,1
433466,677,105,572,25,1
433466,677,105,572,40,1
433466,84,31,53,41,4
433466,84,31,53,42,1
433466,84,31,53,43,1
433466,25,7,18,44,1
433466,59,24,35,45,1
433466,59,24,35,60,1
433536,329,47,282,1,4
433536,316,44,272,2,1
433536,305,44,261,3,1
433536,24,3,21,4,1
433536,281,41,240,5,1
433536,11,0,11,11,1
433536,13,3,10,12,3
433536,5,0,5,19,1
433536,276,41,235,20,1
433536,194,30,164,21,4
433536,189,30,159,22,1
433536,189,30,159,23,1
433536,18,2,16,24,1
433536,171,28,143,25,1
433536,5,0,5,32,3
433536,2,0,2,39,1
433536,169,28,141,40,1
433536,135,17,118,41,4
433536,127,14,113,42,1
433536,116,14,102,43,1
433536,6,1,5,44,1
433536,110,13,97,45,1
433536,11,0,11,51,1
433536,8,3,5,52,3
433536,3,0,3,59,1
433536,107,13,94,60,1
433563,159,80,79,1,4
433563,159,80,79,2,1
433563,156,80,76,3,1
433563,23,13,10,4,1
433563,133,67,66,5,1
433563,3,0,3,11,1
433563,24,7,17,19,1
433563,109,60,49,20,1
433563,120,66,54,21,4
433563,120,66,54,22,1
433563,120,66,54,23,1
433563,23,13,10,24,1
433563,97,53,44,25,1
433563,21,7,14,39,1
433563,76,46,30,40,1
433563,39,14,25,41,4
433563,39,14,25,42,1
433563,36,14,22,43,1
433563,36,14,22,45,1
433563,3,0,3,51,1
433563,3,0,3,59,1
433563,33,14,19,60,1
433660,14077,6111,7966,1,4
433660,12907,5735,7172,2,1
433660,12795,5693,7102,3,1
433660,2739,1155,1584,4,1
433660,10056,4538,5518,5,1
433660,112,42,70,11,1
433660,1170,376,794,12,3
433660,1160,524,636,19,1
433660,8896,4014,4882,20,1
433660,10539,4566,5973,21,4
433660,10151,4433,5718,22,1
433660,10132,4424,5708,23,1
433660,2668,1124,1544,24,1
433660,7464,3300,4164,25,1
433660,19,9,10,31,1
433660,388,133,255,32,3
433660,744,350,394,39,1
433660,6720,2950,3770,40,1
433660,3538,1545,1993,41,4
433660,2756,1302,1454,42,1
433660,2663,1269,1394,43,1
433660,71,31,40,44,1
433660,2592,1238,1354,45,1
433660,93,33,60,51,1
433660,782,243,539,52,3
433660,416,174,242,59,1
433660,2176,1064,1112,60,1
433970,254,24,230,1,4
433970,254,24,230,2,1
433970,254,24,230,3,1
433970,164,14,150,4,1
433970,90,10,80,5,1
433970,90,10,80,20,1
433970,193,20,173,21,4
433970,193,20,173,22,1
433970,193,20,173,23,1
433970,121,10,111,24,1
433970,72,10,62,25,1
433970,72,10,62,40,1
433970,61,4,57,41,4
433970,61,4,57,42,1
433970,61,4,57,43,1
433970,43,4,39,44,1
433970,18,0,18,45,1
433970,18,0,18,60,1
434016,144,49,95,1,4
434016,144,49,95,2,1
434016,132,43,89,3,1
434016,25,12,13,4,1
434016,107,31,76,5,1
434016,12,6,6,11,1
434016,5,2,3,19,1
434016,102,29,73,20,1
434016,73,29,44,21,4
434016,73,29,44,22,1
434016,73,29,44,23,1
434016,18,9,9,24,1
434016,55,20,35,25,1
434016,2,1,1,39,1
434016,53,19,34,40,1
434016,71,20,51,41,4
434016,71,20,51,42,1
434016,59,14,45,43,1
434016,7,3,4,44,1
434016,52,11,41,45,1
434016,12,6,6,51,1
434016,3,1,2,59,1
434016,49,10,39,60,1
434034,623,430,193,1,4
434034,623,430,193,2,1
434034,498,352,146,3,1
434034,10,6,4,4,1
434034,488,346,142,5,1
434034,125,78,47,11,1
434034,119,78,41,19,1
434034,369,268,101,20,1
434034,33,27,6,21,4
434034,33,27,6,22,1
434034,33,27,6,23,1
434034,1,0,1,24,1
434034,32,27,5,25,1
434034,8,7,1,39,1
434034,24,20,4,40,1
434034,590,403,187,41,4
434034,590,403,187,42,1
434034,465,325,140,43,1
434034,9,6,3,44,1
434034,456,319,137,45,1
434034,125,78,47,51,1
434034,111,71,40,59,1
434034,345,248,97,60,1
434052,652,451,201,1,4
434052,652,451,201,2,1
434052,652,451,201,3,1
434052,81,59,22,4,1
434052,571,392,179,5,1
434052,25,10,15,19,1
434052,546,382,164,20,1
434052,469,363,106,21,4
434052,469,363,106,22,1
434052,469,363,106,23,1
434052,71,55,16,24,1
434052,398,308,90,25,1
434052,12,7,5,39,1
434052,386,301,85,40,1
434052,183,88,95,41,4
434052,183,88,95,42,1
434052,183,88,95,43,1
434052,10,4,6,44,1
434052,173,84,89,45,1
434052,13,3,10,59,1
434052,160,81,79,60,1
434061,4593,1873,2720,1,4
434061,4593,1873,2720,2,1
434061,3277,1334,1943,3,1
434061,1027,417,610,4,1
434061,2250,917,1333,5,1
434061,1316,539,777,11,1
434061,469,185,284,19,1
434061,1781,732,1049,20,1
434061,2235,906,1329,21,4
434061,2235,906,1329,22,1
434061,2054,833,1221,23,1
434061,779,323,456,24,1
434061,1275,510,765,25,1
434061,181,73,108,31,1
434061,261,108,153,39,1
434061,1014,402,612,40,1
434061,2358,967,1391,41,4
434061,2358,967,1391,42,1
434061,1223,501,722,43,1
434061,248,94,154,44,1
434061,975,407,568,45,1
434061,1135,466,669,51,1
434061,208,77,131,59,1
434061,767,330,437,60,1
434140,927,258,669,1,4
434140,927,258,669,2,1
434140,900,246,654,3,1
434140,301,75,226,4,1
434140,599,171,428,5,1
434140,27,12,15,11,1
434140,599,171,428,20,1
434140,927,258,669,21,4
434140,927,258,669,22,1
434140,900,246,654,23,1
434140,301,75,226,24,1
434140,599,171,428,25,1
434140,27,12,15,31,1
434140,599,171,428,40,1
434159,267,180,87,1,4
434159,267,180,87,2,1
434159,267,180,87,3,1
434159,72,50,22,4,1
434159,195,130,65,5,1
434159,195,130,65,20,1
434159,267,180,87,21,4
434159,267,180,87,22,1
434159,267,180,87,23,1
434159,72,50,22,24,1
434159,195,130,65,25,1
434159,195,130,65,40,1
434274,99,33,66,1,4
434274,99,33,66,2,1
434274,99,33,66,3,1
434274,75,26,49,4,1
434274,24,7,17,5,1
434274,24,7,17,20,1
434274,57,20,37,21,4
434274,57,20,37,22,1
434274,57,20,37,23,1
434274,53,16,37,24,1
434274,4,4,0,25,1
434274,4,4,0,40,1
434274,42,13,29,41,4
434274,42,13,29,42,1
434274,42,13,29,43,1
434274,22,10,12,44,1
434274,20,3,17,45,1
434274,20,3,17,60,1
434283,86,5,81,1,4
434283,86,5,81,2,1
434283,86,5,81,3,1
434283,24,5,19,4,1
434283,62,0,62,5,1
434283,62,0,62,20,1
434283,86,5,81,21,4
434283,86,5,81,22,1
434283,86,5,81,23,1
434283,24,5,19,24,1
434283,62,0,62,25,1
434283,62,0,62,40,1
434308,312,64,248,1,4
434308,312,64,248,2,1
434308,312,64,248,3,1
434308,139,25,114,4,1
434308,173,39,134,5,1
434308,173,39,134,20,1
434308,183,35,148,21,4
434308,183,35,148,22,1
434308,183,35,148,23,1
434308,98,20,78,24,1
434308,85,15,70,25,1
434308,85,15,70,40,1
434308,129,29,100,41,4
434308,129,29,100,42,1
434308,129,29,100,43,1
434308,41,5,36,44,1
434308,88,24,64,45,1
434308,88,24,64,60,1
434317,1317,308,1009,1,4
434317,1317,308,1009,2,1
434317,1317,308,1009,3,1
434317,401,90,311,4,1
434317,916,218,698,5,1
434317,916,218,698,20,1
434317,1317,308,1009,21,4
434317,1317,308,1009,22,1
434317,1317,308,1009,23,1
434317,401,90,311,24,1
434317,916,218,698,25,1
434317,916,218,698,40,1
434344,58,4,54,1,4
434344,58,4,54,2,1
434344,58,4,54,3,1
434344,2,0,2,4,1
434344,56,4,52,5,1
434344,56,4,52,20,1
434344,58,4,54,21,4
434344,58,4,54,22,1
434344,58,4,54,23,1
434344,2,0,2,24,1
434344,56,4,52,25,1
434344,56,4,52,40,1
434362,43,43,0,1,4
434362,43,43,0,2,1
434362,43,43,0,3,1
434362,33,33,0,4,1
434362,10,10,0,5,1
434362,10,10,0,20,1
434362,43,43,0,21,4
434362,43,43,0,22,1
434362,43,43,0,23,1
434362,33,33,0,24,1
434362,10,10,0,25,1
434362,10,10,0,40,1
434380,51,4,47,1,4
434380,51,4,47,2,1
434380,51,4,47,3,1
434380,40,4,36,4,1
434380,11,0,11,5,1
434380,11,0,11,20,1
434380,51,4,47,21,4
434380,51,4,47,22,1
434380,51,4,47,23,1
434380,40,4,36,24,1
434380,11,0,11,25,1
434380,11,0,11,40,1
434414,1662,749,913,1,4
434414,1662,749,913,2,1
434414,1642,744,898,3,1
434414,661,244,417,4,1
434414,981,500,481,5,1
434414,20,5,15,11,1
434414,301,142,159,19,1
434414,680,358,322,20,1
434414,1262,555,707,21,4
434414,1262,555,707,22,1
434414,1262,555,707,23,1
434414,497,188,309,24,1
434414,765,367,398,25,1
434414,244,117,127,39,1
434414,521,250,271,40,1
434414,400,194,206,41,4
434414,400,194,206,42,1
434414,380,189,191,43,1
434414,164,56,108,44,1
434414,216,133,83,45,1
434414,20,5,15,51,1
434414,57,25,32,59,1
434414,159,108,51,60,1
434432,23,4,19,1,4
434432,23,4,19,2,1
434432,23,4,19,3,1
434432,10,1,9,4,1
434432,13,3,10,5,1
434432,13,3,10,19,1
434432,23,4,19,21,4
434432,23,4,19,22,1
434432,23,4,19,23,1
434432,10,1,9,24,1
434432,13,3,10,25,1
434432,13,3,10,39,1
434441,147,41,106,1,4
434441,147,41,106,12,3
434441,147,41,106,21,4
434441,147,41,106,32,3
434469,67,9,58,1,4
434469,67,9,58,2,1
434469,67,9,58,3,1
434469,34,8,26,4,1
434469,33,1,32,5,1
434469,33,1,32,20,1
434469,29,4,25,21,4
434469,29,4,25,22,1
434469,29,4,25,23,1
434469,14,4,10,24,1
434469,15,0,15,25,1
434469,15,0,15,40,1
434469,38,5,33,41,4
434469,38,5,33,42,1
434469,38,5,33,43,1
434469,20,4,16,44,1
434469,18,1,17,45,1
434469,18,1,17,60,1
434496,58,2,56,1,4
434496,58,2,56,2,1
434496,58,2,56,3,1
434496,55,2,53,4,1
434496,3,0,3,5,1
434496,3,0,3,20,1
434496,58,2,56,21,4
434496,58,2,56,22,1
434496,58,2,56,23,1
434496,55,2,53,24,1
434496,3,0,3,25,1
434496,3,0,3,40,1
434502,129,13,116,1,4
434502,129,13,116,2,1
434502,129,13,116,3,1
434502,13,2,11,4,1
434502,116,11,105,5,1
434502,116,11,105,20,1
434502,129,13,116,21,4
434502,129,13,116,22,1
434502,129,13,116,23,1
434502,13,2,11,24,1
434502,116,11,105,25,1
434502,116,11,105,40,1
434520,541,158,383,1,4
434520,541,158,383,2,1
434520,541,158,383,3,1
434520,430,128,302,4,1
434520,111,30,81,5,1
434520,111,30,81,20,1
434520,371,111,260,21,4
434520,371,111,260,22,1
434520,371,111,260,23,1
434520,295,92,203,24,1
434520,76,19,57,25,1
434520,76,19,57,40,1
434520,170,47,123,41,4
434520,170,47,123,42,1
434520,170,47,123,43,1
434520,135,36,99,44,1
434520,35,11,24,45,1
434520,35,11,24,60,1
434539,283,102,181,1,4
434539,283,102,181,2,1
434539,283,102,181,3,1
434539,22,10,12,4,1
434539,261,92,169,5,1
434539,17,8,9,19,1
434539,244,84,160,20,1
434539,207,76,131,21,4
434539,207,76,131,22,1
434539,207,76,131,23,1
434539,19,8,11,24,1
434539,188,68,120,25,1
434539,14,7,7,39,1
434539,174,61,113,40,1
434539,76,26,50,41,4
434539,76,26,50,42,1
434539,76,26,50,43,1
434539,3,2,1,44,1
434539,73,24,49,45,1
434539,3,1,2,59,1
434539,70,23,47,60,1
434548,291,259,32,1,4
434548,291,259,32,2,1
434548,291,259,32,3,1
434548,34,32,2,4,1
434548,257,227,30,5,1
434548,14,9,5,19,1
434548,243,218,25,20,1
434548,208,181,27,21,4
434548,208,181,27,22,1
434548,208,181,27,23,1
434548,29,28,1,24,1
434548,179,153,26,25,1
434548,12,7,5,39,1
434548,167,146,21,40,1
434548,83,78,5,41,4
434548,83,78,5,42,1
434548,83,78,5,43,1
434548,5,4,1,44,1
434548,78,74,4,45,1
434548,2,2,0,59,1
434548,76,72,4,60,1
434557,336,276,60,1,4
434557,336,276,60,2,1
434557,336,276,60,3,1
434557,47,43,4,4,1
434557,289,233,56,5,1
434557,9,6,3,19,1
434557,280,227,53,20,1
434557,255,209,46,21,4
434557,255,209,46,22,1
434557,255,209,46,23,1
434557,42,39,3,24,1
434557,213,170,43,25,1
434557,6,5,1,39,1
434557,207,165,42,40,1
434557,81,67,14,41,4
434557,81,67,14,42,1
434557,81,67,14,43,1
434557,5,4,1,44,1
434557,76,63,13,45,1
434557,3,1,2,59,1
434557,73,62,11,60,1
434566,253,224,29,1,4
434566,253,224,29,2,1
434566,253,224,29,3,1
434566,48,44,4,4,1
434566,205,180,25,5,1
434566,3,3,0,19,1
434566,202,177,25,20,1
434566,201,175,26,21,4
434566,201,175,26,22,1
434566,201,175,26,23,1
434566,42,38,4,24,1
434566,159,137,22,25,1
434566,3,3,0,39,1
434566,156,134,22,40,1
434566,52,49,3,41,4
434566,52,49,3,42,1
434566,52,49,3,43,1
434566,6,6,0,44,1
434566,46,43,3,45,1
434566,46,43,3,60,1
434575,278,229,49,1,4
434575,278,229,49,2,1
434575,278,229,49,3,1
434575,44,34,10,4,1
434575,234,195,39,5,1
434575,5,5,0,19,1
434575,229,190,39,20,1
434575,223,189,34,21,4
434575,223,189,34,22,1
434575,223,189,34,23,1
434575,41,33,8,24,1
434575,182,156,26,25,1
434575,4,4,0,39,1
434575,178,152,26,40,1
434575,55,40,15,41,4
434575,55,40,15,42,1
434575,55,40,15,43,1
434575,3,1,2,44,1
434575,52,39,13,45,1
434575,1,1,0,59,1
434575,51,38,13,60,1
434584,257,96,161,1,4
434584,257,96,161,2,1
434584,102,30,72,3,1
434584,30,11,19,4,1
434584,72,19,53,5,1
434584,155,66,89,11,1
434584,8,3,5,19,1
434584,64,16,48,20,1
434584,50,16,34,21,4
434584,50,16,34,22,1
434584,39,16,23,23,1
434584,21,9,12,24,1
434584,18,7,11,25,1
434584,11,0,11,31,1
434584,2,2,0,39,1
434584,16,5,11,40,1
434584,207,80,127,41,4
434584,207,80,127,42,1
434584,63,14,49,43,1
434584,9,2,7,44,1
434584,54,12,42,45,1
434584,144,66,78,51,1
434584,6,1,5,59,1
434584,48,11,37,60,1
434672,23981,9502,14479,1,4
434672,23981,9502,14479,2,1
434672,22657,9013,13644,3,1
434672,4940,2257,2683,4,1
434672,17717,6756,10961,5,1
434672,1324,489,835,11,1
434672,2008,873,1135,19,1
434672,15709,5883,9826,20,1
434672,7983,3753,4230,21,4
434672,7983,3753,4230,22,1
434672,7760,3661,4099,23,1
434672,2508,1228,1280,24,1
434672,5252,2433,2819,25,1
434672,223,92,131,31,1
434672,839,437,402,39,1
434672,4413,1996,2417,40,1
434672,15998,5749,10249,41,4
434672,15998,5749,10249,42,1
434672,14897,5352,9545,43,1
434672,2432,1029,1403,44,1
434672,12465,4323,8142,45,1
434672,1101,397,704,51,1
434672,1169,436,733,59,1
434672,11296,3887,7409,60,1
434690,299,296,3,1,4
434690,299,296,3,2,1
434690,299,296,3,3,1
434690,126,126,0,4,1
434690,173,170,3,5,1
434690,173,170,3,20,1
434690,283,280,3,21,4
434690,283,280,3,22,1
434690,283,280,3,23,1
434690,122,122,0,24,1
434690,161,158,3,25,1
434690,161,158,3,40,1
434690,16,16,0,41,4
434690,16,16,0,42,1
434690,16,16,0,43,1
434690,4,4,0,44,1
434690,12,12,0,45,1
434690,12,12,0,60,1
434715,1279,562,717,1,4
434715,1279,562,717,12,3
434715,1109,487,622,21,4
434715,1109,487,622,32,3
434715,170,75,95,41,4
434715,170,75,95,52,3
434751,60,14,46,1,4
434751,60,14,46,2,1
434751,58,14,44,3,1
434751,11,3,8,4,1
434751,47,11,36,5,1
434751,2,0,2,11,1
434751,4,1,3,19,1
434751,43,10,33,20,1
434751,36,13,23,21,4
434751,36,13,23,22,1
434751,36,13,23,23,1
434751,7,3,4,24,1
434751,29,10,19,25,1
434751,2,1,1,39,1
434751,27,9,18,40,1
434751,24,1,23,41,4
434751,24,1,23,42,1
434751,22,1,21,43,1
434751,4,0,4,44,1
434751,18,1,17,45,1
434751,2,0,2,51,1
434751,2,0,2,59,1
434751,16,1,15,60,1
434812,43,4,39,1,4
434812,43,4,39,2,1
434812,43,4,39,3,1
434812,6,0,6,4,1
434812,37,4,33,5,1
434812,37,4,33,20,1
434812,9,2,7,21,4
434812,9,2,7,22,1
434812,9,2,7,23,1
434812,9,2,7,25,1
434812,9,2,7,40,1
434812,34,2,32,41,4
434812,34,2,32,42,1
434812,34,2,32,43,1
434812,6,0,6,44,1
434812,28,2,26,45,1
434812,28,2,26,60,1
434821,603,61,542,1,4
434821,603,61,542,2,1
434821,603,61,542,3,1
434821,147,9,138,4,1
434821,456,52,404,5,1
434821,456,52,404,20,1
434821,388,35,353,21,4
434821,388,35,353,22,1
434821,388,35,353,23,1
434821,109,7,102,24,1
434821,279,28,251,25,1
434821,279,28,251,40,1
434821,215,26,189,41,4
434821,215,26,189,42,1
434821,215,26,189,43,1
434821,38,2,36,44,1
434821,177,24,153,45,1
434821,177,24,153,60,1
434830,181,6,175,1,4
434830,181,6,175,2,1
434830,181,6,175,3,1
434830,87,4,83,4,1
434830,94,2,92,5,1
434830,94,2,92,20,1
434830,113,3,110,21,4
434830,113,3,110,22,1
434830,113,3,110,23,1
434830,54,2,52,24,1
434830,59,1,58,25,1
434830,59,1,58,40,1
434830,68,3,65,41,4
434830,68,3,65,42,1
434830,68,3,65,43,1
434830,33,2,31,44,1
434830,35,1,34,45,1
434830,35,1,34,60,1
434900,1031,344,687,1,4
434900,1031,344,687,2,1
434900,1031,344,687,3,1
434900,505,210,295,4,1
434900,526,134,392,5,1
434900,526,134,392,20,1
434900,1031,344,687,21,4
434900,1031,344,687,22,1
434900,1031,344,687,23,1
434900,505,210,295,24,1
434900,526,134,392,25,1
434900,526,134,392,40,1
434937,45,45,0,1,4
434937,45,45,0,2,1
434937,23,23,0,3,1
434937,1,1,0,4,1
434937,22,22,0,5,1
434937,22,22,0,11,1
434937,8,8,0,19,1
434937,14,14,0,20,1
434937,45,45,0,21,4
434937,45,45,0,22,1
434937,23,23,0,23,1
434937,1,1,0,24,1
434937,22,22,0,25,1
434937,22,22,0,31,1
434937,8,8,0,39,1
434937,14,14,0,40,1
434946,1364,496,868,1,4
434946,1080,404,676,2,1
434946,1080,404,676,3,1
434946,33,11,22,4,1
434946,1047,393,654,5,1
434946,284,92,192,12,3
434946,93,44,49,19,1
434946,954,349,605,20,1
434946,1364,496,868,21,4
434946,1080,404,676,22,1
434946,1080,404,676,23,1
434946,33,11,22,24,1
434946,1047,393,654,25,1
434946,284,92,192,32,3
434946,93,44,49,39,1
434946,954,349,605,40,1
434955,1238,673,565,1,4
434955,1028,572,456,2,1
434955,1028,572,456,3,1
434955,29,13,16,4,1
434955,999,559,440,5,1
434955,210,101,109,12,3
434955,112,73,39,19,1
434955,887,486,401,20,1
434955,1238,673,565,21,4
434955,1028,572,456,22,1
434955,1028,572,456,23,1
434955,29,13,16,24,1
434955,999,559,440,25,1
434955,210,101,109,32,3
434955,112,73,39,39,1
434955,887,486,401,40,1
434973,560,326,234,1,4
434973,479,284,195,2,1
434973,479,284,195,3,1
434973,7,4,3,4,1
434973,472,280,192,5,1
434973,81,42,39,12,3
434973,38,25,13,19,1
434973,434,255,179,20,1
434973,560,326,234,21,4
434973,479,284,195,22,1
434973,479,284,195,23,1
434973,7,4,3,24,1
434973,472,280,192,25,1
434973,81,42,39,32,3
434973,38,25,13,39,1
434973,434,255,179,40,1
434982,868,302,566,1,4
434982,794,264,530,2,1
434982,794,264,530,3,1
434982,25,2,23,4,1
434982,769,262,507,5,1
434982,74,38,36,12,3
434982,41,14,27,19,1
434982,728,248,480,20,1
434982,868,302,566,21,4
434982,794,264,530,22,1
434982,794,264,530,23,1
434982,25,2,23,24,1
434982,769,262,507,25,1
434982,74,38,36,32,3
434982,41,14,27,39,1
434982,728,248,480,40,1
435000,856,357,499,1,4
435000,44,12,32,2,1
435000,44,12,32,3,1
435000,44,12,32,5,1
435000,812,345,467,12,3
435000,7,2,5,19,1
435000,37,10,27,20,1
435000,816,348,468,21,4
435000,43,12,31,22,1
435000,43,12,31,23,1
435000,43,12,31,25,1
435000,773,336,437,32,3
435000,6,2,4,39,1
435000,37,10,27,40,1
435000,40,9,31,41,4
435000,1,0,1,42,1
435000,1,0,1,43,1
435000,1,0,1,45,1
435000,39,9,30,52,3
435000,1,0,1,59,1
436003,161,18,143,1,4
436003,161,18,143,2,1
436003,161,18,143,3,1
436003,66,5,61,4,1
436003,95,13,82,5,1
436003,95,13,82,20,1
436003,111,14,97,21,4
436003,111,14,97,22,1
436003,111,14,97,23,1
436003,39,4,35,24,1
436003,72,10,62,25,1
436003,72,10,62,40,1
436003,50,4,46,41,4
436003,50,4,46,42,1
436003,50,4,46,43,1
436003,27,1,26,44,1
436003,23,3,20,45,1
436003,23,3,20,60,1
436012,711,46,665,1,4
436012,711,46,665,2,1
436012,711,46,665,3,1
436012,109,6,103,4,1
436012,602,40,562,5,1
436012,602,40,562,20,1
436012,711,46,665,21,4
436012,711,46,665,22,1
436012,711,46,665,23,1
436012,109,6,103,24,1
436012,602,40,562,25,1
436012,602,40,562,40,1
436021,23,1,22,1,4
436021,23,1,22,12,3
436021,23,1,22,21,4
436021,23,1,22,32,3
436030,39,0,39,1,4
436030,39,0,39,2,1
436030,39,0,39,3,1
436030,26,0,26,4,1
436030,13,0,13,5,1
436030,13,0,13,20,1
436030,13,0,13,21,4
436030,13,0,13,22,1
436030,13,0,13,23,1
436030,10,0,10,24,1
436030,3,0,3,25,1
436030,3,0,3,40,1
436030,26,0,26,41,4
436030,26,0,26,42,1
436030,26,0,26,43,1
436030,16,0,16,44,1
436030,10,0,10,45,1
436030,10,0,10,60,1
436067,47,2,45,1,4
436067,47,2,45,2,1
436067,47,2,45,3,1
436067,12,0,12,4,1
436067,35,2,33,5,1
436067,35,2,33,20,1
436067,47,2,45,21,4
436067,47,2,45,22,1
436067,47,2,45,23,1
436067,12,0,12,24,1
436067,35,2,33,25,1
436067,35,2,33,40,1
436094,743,219,524,1,4
436094,223,76,147,2,1
436094,219,76,143,3,1
436094,20,8,12,4,1
436094,199,68,131,5,1
436094,4,0,4,11,1
436094,520,143,377,12,3
436094,44,18,26,19,1
436094,155,50,105,20,1
436094,251,70,181,21,4
436094,100,36,64,22,1
436094,97,36,61,23,1
436094,9,3,6,24,1
436094,88,33,55,25,1
436094,3,0,3,31,1
436094,151,34,117,32,3
436094,17,9,8,39,1
436094,71,24,47,40,1
436094,492,149,343,41,4
436094,123,40,83,42,1
436094,122,40,82,43,1
436094,11,5,6,44,1
436094,111,35,76,45,1
436094,1,0,1,51,1
436094,369,109,260,52,3
436094,27,9,18,59,1
436094,84,26,58,60,1
436100,34,2,32,1,4
436100,34,2,32,2,1
436100,34,2,32,3,1
436100,27,1,26,4,1
436100,7,1,6,5,1
436100,7,1,6,20,1
436100,34,2,32,21,4
436100,34,2,32,22,1
436100,34,2,32,23,1
436100,27,1,26,24,1
436100,7,1,6,25,1
436100,7,1,6,40,1
436182,231,54,177,1,4
436182,231,54,177,2,1
436182,231,54,177,3,1
436182,31,11,20,4,1
436182,200,43,157,5,1
436182,18,5,13,19,1
436182,182,38,144,20,1
436182,231,54,177,21,4
436182,231,54,177,22,1
436182,231,54,177,23,1
436182,31,11,20,24,1
436182,200,43,157,25,1
436182,18,5,13,39,1
436182,182,38,144,40,1
436191,624,337,287,1,4
436191,624,337,287,2,1
436191,624,337,287,3,1
436191,60,31,29,4,1
436191,564,306,258,5,1
436191,64,26,38,19,1
436191,500,280,220,20,1
436191,624,337,287,21,4
436191,624,337,287,22,1
436191,624,337,287,23,1
436191,60,31,29,24,1
436191,564,306,258,25,1
436191,64,26,38,39,1
436191,500,280,220,40,1
436225,491,132,359,1,4
436225,491,132,359,2,1
436225,491,132,359,3,1
436225,231,56,175,4,1
436225,260,76,184,5,1
436225,260,76,184,20,1
436225,491,132,359,21,4
436225,491,132,359,22,1
436225,491,132,359,23,1
436225,231,56,175,24,1
436225,260,76,184,25,1
436225,260,76,184,40,1
436261,138,42,96,1,4
436261,138,42,96,12,3
436261,113,33,80,21,4
436261,113,33,80,32,3
436261,25,9,16,41,4
436261,25,9,16,52,3
436270,158,41,117,1,4
436270,158,41,117,2,1
436270,158,41,117,3,1
436270,62,9,53,4,1
436270,96,32,64,5,1
436270,96,32,64,20,1
436270,83,22,61,21,4
436270,83,22,61,22,1
436270,83,22,61,23,1
436270,32,3,29,24,1
436270,51,19,32,25,1
436270,51,19,32,40,1
436270,75,19,56,41,4
436270,75,19,56,42,1
436270,75,19,56,43,1
436270,30,6,24,44,1
436270,45,13,32,45,1
436270,45,13,32,60,1
436304,3146,1313,1833,1,4
436304,3146,1313,1833,2,1
436304,1602,717,885,3,1
436304,333,161,172,4,1
436304,1269,556,713,5,1
436304,1544,596,948,11,1
436304,215,85,130,19,1
436304,1054,471,583,20,1
436304,853,387,466,21,4
436304,853,387,466,22,1
436304,809,360,449,23,1
436304,229,110,119,24,1
436304,580,250,330,25,1
436304,44,27,17,31,1
436304,104,46,58,39,1
436304,476,204,272,40,1
436304,2293,926,1367,41,4
436304,2293,926,1367,42,1
436304,793,357,436,43,1
436304,104,51,53,44,1
436304,689,306,383,45,1
436304,1500,569,931,51,1
436304,111,39,72,59,1
436304,578,267,311,60,1
436429,2218,1891,327,1,4
436429,2218,1891,327,2,1
436429,2218,1891,327,3,1
436429,467,385,82,4,1
436429,1751,1506,245,5,1
436429,1751,1506,245,20,1
436429,2218,1891,327,21,4
436429,2218,1891,327,22,1
436429,2218,1891,327,23,1
436429,467,385,82,24,1
436429,1751,1506,245,25,1
436429,1751,1506,245,40,1
436438,673,226,447,1,4
436438,251,107,144,2,1
436438,250,107,143,3,1
436438,17,8,9,4,1
436438,233,99,134,5,1
436438,1,0,1,11,1
436438,422,119,303,12,3
436438,33,13,20,19,1
436438,200,86,114,20,1
436438,244,75,169,21,4
436438,101,42,59,22,1
436438,101,42,59,23,1
436438,6,1,5,24,1
436438,95,41,54,25,1
436438,143,33,110,32,3
436438,14,5,9,39,1
436438,81,36,45,40,1
436438,429,151,278,41,4
436438,150,65,85,42,1
436438,149,65,84,43,1
436438,11,7,4,44,1
436438,138,58,80,45,1
436438,1,0,1,51,1
436438,279,86,193,52,3
436438,19,8,11,59,1
436438,119,50,69,60,1
436465,307,64,243,1,4
436465,307,64,243,2,1
436465,307,64,243,3,1
436465,129,27,102,4,1
436465,178,37,141,5,1
436465,178,37,141,20,1
436465,307,64,243,21,4
436465,307,64,243,22,1
436465,307,64,243,23,1
436465,129,27,102,24,1
436465,178,37,141,25,1
436465,178,37,141,40,1
436483,509,160,349,1,4
436483,509,160,349,2,1
436483,509,160,349,3,1
436483,30,11,19,4,1
436483,479,149,330,5,1
436483,109,38,71,19,1
436483,370,111,259,20,1
436483,88,22,66,21,4
436483,88,22,66,22,1
436483,88,22,66,23,1
436483,1,0,1,24,1
436483,87,22,65,25,1
436483,9,3,6,39,1
436483,78,19,59,40,1
436483,421,138,283,41,4
436483,421,138,283,42,1
436483,421,138,283,43,1
436483,29,11,18,44,1
436483,392,127,265,45,1
436483,100,35,65,59,1
436483,292,92,200,60,1
436553,225,60,165,1,4
436553,225,60,165,2,1
436553,225,60,165,3,1
436553,13,3,10,4,1
436553,212,57,155,5,1
436553,212,57,155,20,1
436553,225,60,165,21,4
436553,225,60,165,22,1
436553,225,60,165,23,1
436553,13,3,10,24,1
436553,212,57,155,25,1
436553,212,57,155,40,1
436599,76,31,45,1,4
436599,76,31,45,2,1
436599,76,31,45,3,1
436599,19,5,14,4,1
436599,57,26,31,5,1
436599,57,26,31,20,1
436599,10,5,5,21,4
436599,10,5,5,22,1
436599,10,5,5,23,1
436599,2,0,2,24,1
436599,8,5,3,25,1
436599,8,5,3,40,1
436599,66,26,40,41,4
436599,66,26,40,42,1
436599,66,26,40,43,1
436599,17,5,12,44,1
436599,49,21,28,45,1
436599,49,21,28,60,1
436614,61,41,20,1,4
436614,46,26,20,2,1
436614,43,26,17,3,1
436614,10,7,3,4,1
436614,33,19,14,5,1
436614,3,0,3,11,1
436614,15,15,0,12,3
436614,4,3,1,19,1
436614,29,16,13,20,1
436614,32,23,9,21,4
436614,29,20,9,22,1
436614,29,20,9,23,1
436614,10,7,3,24,1
436614,19,13,6,25,1
436614,3,3,0,32,3
436614,3,2,1,39,1
436614,16,11,5,40,1
436614,29,18,11,41,4
436614,17,6,11,42,1
436614,14,6,8,43,1
436614,14,6,8,45,1
436614,3,0,3,51,1
436614,12,12,0,52,3
436614,1,1,0,59,1
436614,13,5,8,60,1
436632,163,15,148,1,4
436632,163,15,148,2,1
436632,163,15,148,3,1
436632,50,6,44,4,1
436632,113,9,104,5,1
436632,113,9,104,20,1
436632,99,10,89,21,4
436632,99,10,89,22,1
436632,99,10,89,23,1
436632,31,4,27,24,1
436632,68,6,62,25,1
436632,68,6,62,40,1
436632,64,5,59,41,4
436632,64,5,59,42,1
436632,64,5,59,43,1
436632,19,2,17,44,1
436632,45,3,42,45,1
436632,45,3,42,60,1
436641,175,36,139,1,4
436641,175,36,139,2,1
436641,175,36,139,3,1
436641,44,6,38,4,1
436641,131,30,101,5,1
436641,131,30,101,20,1
436641,148,34,114,21,4
436641,148,34,114,22,1
436641,148,34,114,23,1
436641,38,6,32,24,1
436641,110,28,82,25,1
436641,110,28,82,40,1
436641,27,2,25,41,4
436641,27,2,25,42,1
436641,27,2,25,43,1
436641,6,0,6,44,1
436641,21,2,19,45,1
436641,21,2,19,60,1
436650,98,7,91,1,4
436650,98,7,91,2,1
436650,98,7,91,3,1
436650,21,2,19,4,1
436650,77,5,72,5,1
436650,77,5,72,20,1
436650,98,7,91,21,4
436650,98,7,91,22,1
436650,98,7,91,23,1
436650,21,2,19,24,1
436650,77,5,72,25,1
436650,77,5,72,40,1
436702,801,138,663,1,4
436702,801,138,663,2,1
436702,801,138,663,3,1
436702,237,41,196,4,1
436702,564,97,467,5,1
436702,30,2,28,19,1
436702,534,95,439,20,1
436702,239,31,208,21,4
436702,239,31,208,22,1
436702,239,31,208,23,1
436702,103,9,94,24,1
436702,136,22,114,25,1
436702,8,1,7,39,1
436702,128,21,107,40,1
436702,562,107,455,41,4
436702,562,107,455,42,1
436702,562,107,455,43,1
436702,134,32,102,44,1
436702,428,75,353,45,1
436702,22,1,21,59,1
436702,406,74,332,60,1
436775,192,11,181,1,4
436775,192,11,181,2,1
436775,192,11,181,3,1
436775,55,1,54,4,1
436775,137,10,127,5,1
436775,137,10,127,20,1
436775,192,11,181,21,4
436775,192,11,181,22,1
436775,192,11,181,23,1
436775,55,1,54,24,1
436775,137,10,127,25,1
436775,137,10,127,40,1
436818,2518,1176,1342,1,4
436818,2518,1176,1342,2,1
436818,2382,1097,1285,3,1
436818,661,333,328,4,1
436818,1721,764,957,5,1
436818,136,79,57,11,1
436818,165,70,95,19,1
436818,1556,694,862,20,1
436818,1966,911,1055,21,4
436818,1966,911,1055,22,1
436818,1960,908,1052,23,1
436818,639,323,316,24,1
436818,1321,585,736,25,1
436818,6,3,3,31,1
436818,119,53,66,39,1
436818,1202,532,670,40,1
436818,552,265,287,41,4
436818,552,265,287,42,1
436818,422,189,233,43,1
436818,22,10,12,44,1
436818,400,179,221,45,1
436818,130,76,54,51,1
436818,46,17,29,59,1
436818,354,162,192,60,1
436827,682,342,340,1,4
436827,682,342,340,2,1
436827,645,320,325,3,1
436827,212,122,90,4,1
436827,433,198,235,5,1
436827,37,22,15,11,1
436827,57,30,27,19,1
436827,376,168,208,20,1
436827,539,274,265,21,4
436827,539,274,265,22,1
436827,533,269,264,23,1
436827,209,121,88,24,1
436827,324,148,176,25,1
436827,6,5,1,31,1
436827,41,23,18,39,1
436827,283,125,158,40,1
436827,143,68,75,41,4
436827,143,68,75,42,1
436827,112,51,61,43,1
436827,3,1,2,44,1
436827,109,50,59,45,1
436827,31,17,14,51,1
436827,16,7,9,59,1
436827,93,43,50,60,1
436836,1363,635,728,1,4
436836,1363,635,728,2,1
436836,1224,548,676,3,1
436836,231,113,118,4,1
436836,993,435,558,5,1
436836,139,87,52,11,1
436836,119,40,79,19,1
436836,874,395,479,20,1
436836,924,425,499,21,4
436836,924,425,499,22,1
436836,923,425,498,23,1
436836,222,111,111,24,1
436836,701,314,387,25,1
436836,1,0,1,31,1
436836,81,29,52,39,1
436836,620,285,335,40,1
436836,439,210,229,41,4
436836,439,210,229,42,1
436836,301,123,178,43,1
436836,9,2,7,44,1
436836,292,121,171,45,1
436836,138,87,51,51,1
436836,38,11,27,59,1
436836,254,110,144,60,1
437042,470,371,99,1,4
437042,470,371,99,2,1
437042,470,371,99,3,1
437042,104,84,20,4,1
437042,366,287,79,5,1
437042,1,1,0,19,1
437042,365,286,79,20,1
437042,397,310,87,21,4
437042,397,310,87,22,1
437042,397,310,87,23,1
437042,96,76,20,24,1
437042,301,234,67,25,1
437042,1,1,0,39,1
437042,300,233,67,40,1
437042,73,61,12,41,4
437042,73,61,12,42,1
437042,73,61,12,43,1
437042,8,8,0,44,1
437042,65,53,12,45,1
437042,65,53,12,60,1
437051,573,434,139,1,4
437051,573,434,139,2,1
437051,573,434,139,3,1
437051,96,69,27,4,1
437051,477,365,112,5,1
437051,11,9,2,19,1
437051,466,356,110,20,1
437051,477,359,118,21,4
437051,477,359,118,22,1
437051,477,359,118,23,1
437051,88,65,23,24,1
437051,389,294,95,25,1
437051,10,8,2,39,1
437051,379,286,93,40,1
437051,96,75,21,41,4
437051,96,75,21,42,1
437051,96,75,21,43,1
437051,8,4,4,44,1
437051,88,71,17,45,1
437051,1,1,0,59,1
437051,87,70,17,60,1
437060,280,161,119,1,4
437060,280,161,119,2,1
437060,280,161,119,3,1
437060,37,22,15,4,1
437060,243,139,104,5,1
437060,24,11,13,19,1
437060,219,128,91,20,1
437060,280,161,119,21,4
437060,280,161,119,22,1
437060,280,161,119,23,1
437060,37,22,15,24,1
437060,243,139,104,25,1
437060,24,11,13,39,1
437060,219,128,91,40,1
437097,1044,768,276,1,4
437097,785,567,218,2,1
437097,781,563,218,3,1
437097,5,2,3,4,1
437097,776,561,215,5,1
437097,4,4,0,11,1
437097,259,201,58,12,3
437097,160,118,42,19,1
437097,616,443,173,20,1
437097,963,717,246,21,4
437097,741,537,204,22,1
437097,737,533,204,23,1
437097,5,2,3,24,1
437097,732,531,201,25,1
437097,4,4,0,31,1
437097,222,180,42,32,3
437097,159,118,41,39,1
437097,573,413,160,40,1
437097,81,51,30,41,4
437097,44,30,14,42,1
437097,44,30,14,43,1
437097,44,30,14,45,1
437097,37,21,16,52,3
437097,1,0,1,59,1
437097,43,30,13,60,1
437103,8043,3425,4618,1,4
437103,8043,3425,4618,2,1
437103,7263,3123,4140,3,1
437103,1790,865,925,4,1
437103,5473,2258,3215,5,1
437103,780,302,478,11,1
437103,974,390,584,19,1
437103,4499,1868,2631,20,1
437103,4216,1973,2243,21,4
437103,4216,1973,2243,22,1
437103,4139,1943,2196,23,1
437103,1385,690,695,24,1
437103,2754,1253,1501,25,1
437103,77,30,47,31,1
437103,604,272,332,39,1
437103,2150,981,1169,40,1
437103,3827,1452,2375,41,4
437103,3827,1452,2375,42,1
437103,3124,1180,1944,43,1
437103,405,175,230,44,1
437103,2719,1005,1714,45,1
437103,703,272,431,51,1
437103,370,118,252,59,1
437103,2349,887,1462,60,1
437219,492,416,76,1,4
437219,492,416,76,2,1
437219,492,416,76,3,1
437219,70,54,16,4,1
437219,422,362,60,5,1
437219,12,11,1,19,1
437219,410,351,59,20,1
437219,415,351,64,21,4
437219,415,351,64,22,1
437219,415,351,64,23,1
437219,64,49,15,24,1
437219,351,302,49,25,1
437219,8,7,1,39,1
437219,343,295,48,40,1
437219,77,65,12,41,4
437219,77,65,12,42,1
437219,77,65,12,43,1
437219,6,5,1,44,1
437219,71,60,11,45,1
437219,4,4,0,59,1
437219,67,56,11,60,1
437237,71,68,3,1,4
437237,71,68,3,2,1
437237,71,68,3,3,1
437237,53,51,2,4,1
437237,18,17,1,5,1
437237,18,17,1,20,1
437237,71,68,3,21,4
437237,71,68,3,22,1
437237,71,68,3,23,1
437237,53,51,2,24,1
437237,18,17,1,25,1
437237,18,17,1,40,1
437316,344,64,280,1,4
437316,344,64,280,2,1
437316,344,64,280,3,1
437316,344,64,280,5,1
437316,76,7,69,19,1
437316,268,57,211,20,1
437316,332,62,270,21,4
437316,332,62,270,22,1
437316,332,62,270,23,1
437316,332,62,270,25,1
437316,76,7,69,39,1
437316,256,55,201,40,1
437316,12,2,10,41,4
437316,12,2,10,42,1
437316,12,2,10,43,1
437316,12,2,10,45,1
437316,12,2,10,60,1
437325,515,95,420,1,4
437325,466,81,385,2,1
437325,446,78,368,3,1
437325,446,78,368,5,1
437325,20,3,17,11,1
437325,49,14,35,12,3
437325,84,13,71,19,1
437325,362,65,297,20,1
437325,66,18,48,21,4
437325,65,18,47,22,1
437325,64,18,46,23,1
437325,64,18,46,25,1
437325,1,0,1,31,1
437325,1,0,1,32,3
437325,15,4,11,39,1
437325,49,14,35,40,1
437325,449,77,372,41,4
437325,401,63,338,42,1
437325,382,60,322,43,1
437325,382,60,322,45,1
437325,19,3,16,51,1
437325,48,14,34,52,3
437325,69,9,60,59,1
437325,313,51,262,60,1
437501,75,24,51,1,4
437501,75,24,51,2,1
437501,75,24,51,3,1
437501,25,8,17,4,1
437501,50,16,34,5,1
437501,50,16,34,20,1
437501,75,24,51,21,4
437501,75,24,51,22,1
437501,75,24,51,23,1
437501,25,8,17,24,1
437501,50,16,34,25,1
437501,50,16,34,40,1
437529,355,124,231,1,4
437529,355,124,231,2,1
437529,355,124,231,3,1
437529,273,102,171,4,1
437529,82,22,60,5,1
437529,82,22,60,20,1
437529,232,80,152,21,4
437529,232,80,152,22,1
437529,232,80,152,23,1
437529,177,66,111,24,1
437529,55,14,41,25,1
437529,55,14,41,40,1
437529,123,44,79,41,4
437529,123,44,79,42,1
437529,123,44,79,43,1
437529,96,36,60,44,1
437529,27,8,19,45,1
437529,27,8,19,60,1
437556,464,189,275,1,4
437556,464,189,275,2,1
437556,464,189,275,3,1
437556,155,53,102,4,1
437556,309,136,173,5,1
437556,309,136,173,20,1
437556,464,189,275,21,4
437556,464,189,275,22,1
437556,464,189,275,23,1
437556,155,53,102,24,1
437556,309,136,173,25,1
437556,309,136,173,40,1
437608,164,78,86,1,4
437608,164,78,86,2,1
437608,164,78,86,3,1
437608,121,55,66,4,1
437608,43,23,20,5,1
437608,43,23,20,20,1
437608,164,78,86,21,4
437608,164,78,86,22,1
437608,164,78,86,23,1
437608,121,55,66,24,1
437608,43,23,20,25,1
437608,43,23,20,40,1
437635,223,59,164,1,4
437635,223,59,164,2,1
437635,223,59,164,3,1
437635,221,59,162,4,1
437635,2,0,2,5,1
437635,1,0,1,19,1
437635,1,0,1,20,1
437635,223,59,164,21,4
437635,223,59,164,22,1
437635,223,59,164,23,1
437635,221,59,162,24,1
437635,2,0,2,25,1
437635,1,0,1,39,1
437635,1,0,1,40,1
437653,79,30,49,1,4
437653,79,30,49,2,1
437653,79,30,49,3,1
437653,56,23,33,4,1
437653,23,7,16,5,1
437653,23,7,16,20,1
437653,78,29,49,21,4
437653,78,29,49,22,1
437653,78,29,49,23,1
437653,56,23,33,24,1
437653,22,6,16,25,1
437653,22,6,16,40,1
437653,1,1,0,41,4
437653,1,1,0,42,1
437653,1,1,0,43,1
437653,1,1,0,45,1
437653,1,1,0,60,1
437662,3265,988,2277,1,4
437662,3265,988,2277,2,1
437662,3265,988,2277,3,1
437662,558,138,420,4,1
437662,2707,850,1857,5,1
437662,4,1,3,19,1
437662,2703,849,1854,20,1
437662,3002,933,2069,21,4
437662,3002,933,2069,22,1
437662,3002,933,2069,23,1
437662,438,112,326,24,1
437662,2564,821,1743,25,1
437662,1,0,1,39,1
437662,2563,821,1742,40,1
437662,263,55,208,41,4
437662,263,55,208,42,1
437662,263,55,208,43,1
437662,120,26,94,44,1
437662,143,29,114,45,1
437662,3,1,2,59,1
437662,140,28,112,60,1
437705,11,0,11,1,4
437705,11,0,11,2,1
437705,11,0,11,3,1
437705,5,0,5,4,1
437705,6,0,6,5,1
437705,6,0,6,20,1
437705,9,0,9,21,4
437705,9,0,9,22,1
437705,9,0,9,23,1
437705,5,0,5,24,1
437705,4,0,4,25,1
437705,4,0,4,40,1
437705,2,0,2,41,4
437705,2,0,2,42,1
437705,2,0,2,43,1
437705,2,0,2,45,1
437705,2,0,2,60,1
437732,169,28,141,1,4
437732,169,28,141,2,1
437732,169,28,141,3,1
437732,61,8,53,4,1
437732,108,20,88,5,1
437732,108,20,88,20,1
437732,84,11,73,21,4
437732,84,11,73,22,1
437732,84,11,73,23,1
437732,61,8,53,24,1
437732,23,3,20,25,1
437732,23,3,20,40,1
437732,85,17,68,41,4
437732,85,17,68,42,1
437732,85,17,68,43,1
437732,85,17,68,45,1
437732,85,17,68,60,1
437750,265,244,21,1,4
437750,265,244,21,2,1
437750,265,244,21,3,1
437750,70,64,6,4,1
437750,195,180,15,5,1
437750,195,180,15,20,1
437750,265,244,21,21,4
437750,265,244,21,22,1
437750,265,244,21,23,1
437750,70,64,6,24,1
437750,195,180,15,25,1
437750,195,180,15,40,1
437769,172,11,161,1,4
437769,172,11,161,2,1
437769,172,11,161,3,1
437769,16,2,14,4,1
437769,156,9,147,5,1
437769,156,9,147,20,1
437769,172,11,161,21,4
437769,172,11,161,22,1
437769,172,11,161,23,1
437769,16,2,14,24,1
437769,156,9,147,25,1
437769,156,9,147,40,1
437778,314,24,290,1,4
437778,314,24,290,2,1
437778,314,24,290,3,1
437778,119,8,111,4,1
437778,195,16,179,5,1
437778,195,16,179,20,1
437778,314,24,290,21,4
437778,314,24,290,22,1
437778,314,24,290,23,1
437778,119,8,111,24,1
437778,195,16,179,25,1
437778,195,16,179,40,1
437848,772,403,369,1,4
437848,772,403,369,2,1
437848,772,403,369,3,1
437848,71,33,38,4,1
437848,701,370,331,5,1
437848,701,370,331,20,1
437848,564,289,275,21,4
437848,564,289,275,22,1
437848,564,289,275,23,1
437848,69,32,37,24,1
437848,495,257,238,25,1
437848,495,257,238,40,1
437848,208,114,94,41,4
437848,208,114,94,42,1
437848,208,114,94,43,1
437848,2,1,1,44,1
437848,206,113,93,45,1
437848,206,113,93,60,1
437857,138,2,136,1,4
437857,138,2,136,2,1
437857,138,2,136,3,1
437857,49,2,47,4,1
437857,89,0,89,5,1
437857,89,0,89,20,1
437857,112,2,110,21,4
437857,112,2,110,22,1
437857,112,2,110,23,1
437857,46,2,44,24,1
437857,66,0,66,25,1
437857,66,0,66,40,1
437857,26,0,26,41,4
437857,26,0,26,42,1
437857,26,0,26,43,1
437857,3,0,3,44,1
437857,23,0,23,45,1
437857,23,0,23,60,1
437884,30,25,5,1,4
437884,30,25,5,2,1
437884,30,25,5,3,1
437884,10,8,2,4,1
437884,20,17,3,5,1
437884,20,17,3,20,1
437884,30,25,5,21,4
437884,30,25,5,22,1
437884,30,25,5,23,1
437884,10,8,2,24,1
437884,20,17,3,25,1
437884,20,17,3,40,1
437927,49,8,41,1,4
437927,49,8,41,2,1
437927,49,8,41,3,1
437927,49,8,41,5,1
437927,49,8,41,20,1
437927,49,8,41,21,4
437927,49,8,41,22,1
437927,49,8,41,23,1
437927,49,8,41,25,1
437927,49,8,41,40,1
437936,693,96,597,1,4
437936,693,96,597,2,1
437936,693,96,597,3,1
437936,55,7,48,4,1
437936,638,89,549,5,1
437936,115,13,102,19,1
437936,523,76,447,20,1
437936,662,94,568,21,4
437936,662,94,568,22,1
437936,662,94,568,23,1
437936,55,7,48,24,1
437936,607,87,520,25,1
437936,113,13,100,39,1
437936,494,74,420,40,1
437936,31,2,29,41,4
437936,31,2,29,42,1
437936,31,2,29,43,1
437936,31,2,29,45,1
437936,2,0,2,59,1
437936,29,2,27,60,1
438151,2541,988,1553,1,4
438151,2382,919,1463,2,1
438151,2382,919,1463,3,1
438151,104,40,64,4,1
438151,2278,879,1399,5,1
438151,159,69,90,12,3
438151,88,35,53,19,1
438151,2190,844,1346,20,1
438151,2541,988,1553,21,4
438151,2382,919,1463,22,1
438151,2382,919,1463,23,1
438151,104,40,64,24,1
438151,2278,879,1399,25,1
438151,159,69,90,32,3
438151,88,35,53,39,1
438151,2190,844,1346,40,1
438179,420,128,292,1,4
438179,420,128,292,2,1
438179,420,128,292,3,1
438179,158,44,114,4,1
438179,262,84,178,5,1
438179,262,84,178,20,1
438179,420,128,292,21,4
438179,420,128,292,22,1
438179,420,128,292,23,1
438179,158,44,114,24,1
438179,262,84,178,25,1
438179,262,84,178,40,1
438197,406,63,343,1,4
438197,406,63,343,2,1
438197,406,63,343,3,1
438197,72,11,61,4,1
438197,334,52,282,5,1
438197,334,52,282,20,1
438197,406,63,343,21,4
438197,406,63,343,22,1
438197,406,63,343,23,1
438197,72,11,61,24,1
438197,334,52,282,25,1
438197,334,52,282,40,1
438212,3544,940,2604,1,4
438212,3544,940,2604,2,1
438212,3544,940,2604,3,1
438212,645,168,477,4,1
438212,2899,772,2127,5,1
438212,219,47,172,19,1
438212,2680,725,1955,20,1
438212,2272,593,1679,21,4
438212,2272,593,1679,22,1
438212,2272,593,1679,23,1
438212,453,120,333,24,1
438212,1819,473,1346,25,1
438212,151,30,121,39,1
438212,1668,443,1225,40,1
438212,1272,347,925,41,4
438212,1272,347,925,42,1
438212,1272,347,925,43,1
438212,192,48,144,44,1
438212,1080,299,781,45,1
438212,68,17,51,59,1
438212,1012,282,730,60,1
438258,589,123,466,1,4
438258,589,123,466,2,1
438258,589,123,466,3,1
438258,50,11,39,4,1
438258,539,112,427,5,1
438258,100,23,77,19,1
438258,439,89,350,20,1
438258,512,96,416,21,4
438258,512,96,416,22,1
438258,512,96,416,23,1
438258,42,8,34,24,1
438258,470,88,382,25,1
438258,64,6,58,39,1
438258,406,82,324,40,1
438258,77,27,50,41,4
438258,77,27,50,42,1
438258,77,27,50,43,1
438258,8,3,5,44,1
438258,69,24,45,45,1
438258,36,17,19,59,1
438258,33,7,26,60,1
438267,376,121,255,1,4
438267,376,121,255,2,1
438267,376,121,255,3,1
438267,249,98,151,4,1
438267,127,23,104,5,1
438267,127,23,104,20,1
438267,376,121,255,21,4
438267,376,121,255,22,1
438267,376,121,255,23,1
438267,249,98,151,24,1
438267,127,23,104,25,1
438267,127,23,104,40,1
438285,380,48,332,1,4
438285,380,48,332,2,1
438285,380,48,332,3,1
438285,127,14,113,4,1
438285,253,34,219,5,1
438285,1,1,0,19,1
438285,252,33,219,20,1
438285,380,48,332,21,4
438285,380,48,332,22,1
438285,380,48,332,23,1
438285,127,14,113,24,1
438285,253,34,219,25,1
438285,1,1,0,39,1
438285,252,33,219,40,1
438294,127,21,106,1,4
438294,127,21,106,2,1
438294,127,21,106,3,1
438294,42,5,37,4,1
438294,85,16,69,5,1
438294,7,0,7,19,1
438294,78,16,62,20,1
438294,127,21,106,21,4
438294,127,21,106,22,1
438294,127,21,106,23,1
438294,42,5,37,24,1
438294,85,16,69,25,1
438294,7,0,7,39,1
438294,78,16,62,40,1
438337,188,45,143,1,4
438337,188,45,143,2,1
438337,188,45,143,3,1
438337,181,43,138,4,1
438337,7,2,5,5,1
438337,7,2,5,20,1
438337,153,38,115,21,4
438337,153,38,115,22,1
438337,153,38,115,23,1
438337,147,36,111,24,1
438337,6,2,4,25,1
438337,6,2,4,40,1
438337,35,7,28,41,4
438337,35,7,28,42,1
438337,35,7,28,43,1
438337,34,7,27,44,1
438337,1,0,1,45,1
438337,1,0,1,60,1
438416,306,88,218,1,4
438416,271,77,194,2,1
438416,271,77,194,3,1
438416,271,77,194,5,1
438416,35,11,24,12,3
438416,271,77,194,20,1
438416,306,88,218,21,4
438416,271,77,194,22,1
438416,271,77,194,23,1
438416,271,77,194,25,1
438416,35,11,24,32,3
438416,271,77,194,40,1
438498,2825,1037,1788,1,4
438498,2279,778,1501,2,1
438498,2271,774,1497,3,1
438498,211,81,130,4,1
438498,2060,693,1367,5,1
438498,8,4,4,11,1
438498,546,259,287,12,3
438498,137,34,103,19,1
438498,1923,659,1264,20,1
438498,810,397,413,21,4
438498,432,207,225,22,1
438498,432,207,225,23,1
438498,32,19,13,24,1
438498,400,188,212,25,1
438498,378,190,188,32,3
438498,33,14,19,39,1
438498,367,174,193,40,1
438498,2015,640,1375,41,4
438498,1847,571,1276,42,1
438498,1839,567,1272,43,1
438498,179,62,117,44,1
438498,1660,505,1155,45,1
438498,8,4,4,51,1
438498,168,69,99,52,3
438498,104,20,84,59,1
438498,1556,485,1071,60,1
438504,2466,2401,65,1,4
438504,2466,2401,65,2,1
438504,2466,2401,65,3,1
438504,466,455,11,4,1
438504,2000,1946,54,5,1
438504,2000,1946,54,20,1
438504,2466,2401,65,21,4
438504,2466,2401,65,22,1
438504,2466,2401,65,23,1
438504,466,455,11,24,1
438504,2000,1946,54,25,1
438504,2000,1946,54,40,1
438586,1103,439,664,1,4
438586,1003,409,594,2,1
438586,1002,408,594,3,1
438586,129,61,68,4,1
438586,873,347,526,5,1
438586,1,1,0,11,1
438586,100,30,70,12,3
438586,80,19,61,19,1
438586,793,328,465,20,1
438586,378,148,230,21,4
438586,340,138,202,22,1
438586,340,138,202,23,1
438586,38,20,18,24,1
438586,302,118,184,25,1
438586,38,10,28,32,3
438586,26,10,16,39,1
438586,276,108,168,40,1
438586,725,291,434,41,4
438586,663,271,392,42,1
438586,662,270,392,43,1
438586,91,41,50,44,1
438586,571,229,342,45,1
438586,1,1,0,51,1
438586,62,20,42,52,3
438586,54,9,45,59,1
438586,517,220,297,60,1
438601,164,88,76,1,4
438601,148,81,67,2,1
438601,148,81,67,3,1
438601,148,81,67,5,1
438601,16,7,9,12,3
438601,148,81,67,20,1
438601,104,58,46,21,4
438601,101,56,45,22,1
438601,101,56,45,23,1
438601,101,56,45,25,1
438601,3,2,1,32,3
438601,101,56,45,40,1
438601,60,30,30,41,4
438601,47,25,22,42,1
438601,47,25,22,43,1
438601,47,25,22,45,1
438601,13,5,8,52,3
438601,47,25,22,60,1
438610,739,237,502,1,4
438610,713,224,489,2,1
438610,713,224,489,3,1
438610,46,12,34,4,1
438610,667,212,455,5,1
438610,26,13,13,12,3
438610,40,13,27,19,1
438610,627,199,428,20,1
438610,739,237,502,21,4
438610,713,224,489,22,1
438610,713,224,489,23,1
438610,46,12,34,24,1
438610,667,212,455,25,1
438610,26,13,13,32,3
438610,40,13,27,39,1
438610,627,199,428,40,1
438629,43,18,25,1,4
438629,37,14,23,2,1
438629,37,14,23,3,1
438629,37,14,23,5,1
438629,6,4,2,12,3
438629,37,14,23,20,1
438629,43,18,25,21,4
438629,37,14,23,22,1
438629,37,14,23,23,1
438629,37,14,23,25,1
438629,6,4,2,32,3
438629,37,14,23,40,1
438647,840,267,573,1,4
438647,840,267,573,2,1
438647,840,267,573,3,1
438647,129,39,90,4,1
438647,711,228,483,5,1
438647,74,15,59,19,1
438647,637,213,424,20,1
438647,779,242,537,21,4
438647,779,242,537,22,1
438647,779,242,537,23,1
438647,128,38,90,24,1
438647,651,204,447,25,1
438647,69,14,55,39,1
438647,582,190,392,40,1
438647,61,25,36,41,4
438647,61,25,36,42,1
438647,61,25,36,43,1
438647,1,1,0,44,1
438647,60,24,36,45,1
438647,5,1,4,59,1
438647,55,23,32,60,1
438656,501,91,410,1,4
438656,501,91,410,2,1
438656,501,91,410,3,1
438656,123,29,94,4,1
438656,378,62,316,5,1
438656,378,62,316,20,1
438656,501,91,410,21,4
438656,501,91,410,22,1
438656,501,91,410,23,1
438656,123,29,94,24,1
438656,378,62,316,25,1
438656,378,62,316,40,1
438674,79,22,57,1,4
438674,79,22,57,2,1
438674,79,22,57,3,1
438674,9,3,6,4,1
438674,70,19,51,5,1
438674,70,19,51,20,1
438674,79,22,57,21,4
438674,79,22,57,22,1
438674,79,22,57,23,1
438674,9,3,6,24,1
438674,70,19,51,25,1
438674,70,19,51,40,1
438708,867,225,642,1,4
438708,867,225,642,2,1
438708,544,142,402,3,1
438708,85,35,50,4,1
438708,459,107,352,5,1
438708,323,83,240,11,1
438708,84,19,65,19,1
438708,375,88,287,20,1
438708,293,85,208,21,4
438708,293,85,208,22,1
438708,287,84,203,23,1
438708,55,24,31,24,1
438708,232,60,172,25,1
438708,6,1,5,31,1
438708,58,16,42,39,1
438708,174,44,130,40,1
438708,574,140,434,41,4
438708,574,140,434,42,1
438708,257,58,199,43,1
438708,30,11,19,44,1
438708,227,47,180,45,1
438708,317,82,235,51,1
438708,26,3,23,59,1
438708,201,44,157,60,1
438735,157,146,11,1,4
438735,157,146,11,2,1
438735,157,146,11,3,1
438735,36,35,1,4,1
438735,121,111,10,5,1
438735,121,111,10,20,1
438735,148,138,10,21,4
438735,148,138,10,22,1
438735,148,138,10,23,1
438735,34,34,0,24,1
438735,114,104,10,25,1
438735,114,104,10,40,1
438735,9,8,1,41,4
438735,9,8,1,42,1
438735,9,8,1,43,1
438735,2,1,1,44,1
438735,7,7,0,45,1
438735,7,7,0,60,1
438805,696,279,417,1,4
438805,696,279,417,2,1
438805,696,279,417,3,1
438805,668,260,408,4,1
438805,28,19,9,5,1
438805,28,19,9,20,1
438805,570,244,326,21,4
438805,570,244,326,22,1
438805,570,244,326,23,1
438805,543,226,317,24,1
438805,27,18,9,25,1
438805,27,18,9,40,1
438805,126,35,91,41,4
438805,126,35,91,42,1
438805,126,35,91,43,1
438805,125,34,91,44,1
438805,1,1,0,45,1
438805,1,1,0,60,1
438869,229,34,195,1,4
438869,229,34,195,2,1
438869,229,34,195,3,1
438869,85,12,73,4,1
438869,144,22,122,5,1
438869,2,1,1,19,1
438869,142,21,121,20,1
438869,229,34,195,21,4
438869,229,34,195,22,1
438869,229,34,195,23,1
438869,85,12,73,24,1
438869,144,22,122,25,1
438869,2,1,1,39,1
438869,142,21,121,40,1
438902,665,157,508,1,4
438902,604,138,466,2,1
438902,604,138,466,3,1
438902,60,4,56,4,1
438902,544,134,410,5,1
438902,61,19,42,12,3
438902,57,13,44,19,1
438902,487,121,366,20,1
438902,501,106,395,21,4
438902,496,104,392,22,1
438902,496,104,392,23,1
438902,60,4,56,24,1
438902,436,100,336,25,1
438902,5,2,3,32,3
438902,46,10,36,39,1
438902,390,90,300,40,1
438902,164,51,113,41,4
438902,108,34,74,42,1
438902,108,34,74,43,1
438902,108,34,74,45,1
438902,56,17,39,52,3
438902,11,3,8,59,1
438902,97,31,66,60,1
438984,161,73,88,1,4
438984,161,73,88,2,1
438984,161,73,88,3,1
438984,76,38,38,4,1
438984,85,35,50,5,1
438984,85,35,50,20,1
438984,157,72,85,21,4
438984,157,72,85,22,1
438984,157,72,85,23,1
438984,75,38,37,24,1
438984,82,34,48,25,1
438984,82,34,48,40,1
438984,4,1,3,41,4
438984,4,1,3,42,1
438984,4,1,3,43,1
438984,1,0,1,44,1
438984,3,1,2,45,1
438984,3,1,2,60,1
439020,107,23,84,1,4
439020,31,7,24,2,1
439020,31,7,24,3,1
439020,31,7,24,5,1
439020,76,16,60,12,3
439020,2,1,1,19,1
439020,29,6,23,20,1
439020,74,19,55,21,4
439020,14,5,9,22,1
439020,14,5,9,23,1
439020,14,5,9,25,1
439020,60,14,46,32,3
439020,2,1,1,39,1
439020,12,4,8,40,1
439020,33,4,29,41,4
439020,17,2,15,42,1
439020,17,2,15,43,1
439020,17,2,15,45,1
439020,16,2,14,52,3
439020,17,2,15,60,1
439039,205,72,133,1,4
439039,205,72,133,2,1
439039,205,72,133,3,1
439039,40,12,28,4,1
439039,165,60,105,5,1
439039,165,60,105,20,1
439039,134,39,95,21,4
439039,134,39,95,22,1
439039,134,39,95,23,1
439039,33,8,25,24,1
439039,101,31,70,25,1
439039,101,31,70,40,1
439039,71,33,38,41,4
439039,71,33,38,42,1
439039,71,33,38,43,1
439039,7,4,3,44,1
439039,64,29,35,45,1
439039,64,29,35,60,1
439057,365,153,212,1,4
439057,153,72,81,2,1
439057,153,72,81,3,1
439057,18,11,7,4,1
439057,135,61,74,5,1
439057,212,81,131,12,3
439057,42,14,28,19,1
439057,93,47,46,20,1
439057,73,27,46,21,4
439057,42,20,22,22,1
439057,42,20,22,23,1
439057,1,1,0,24,1
439057,41,19,22,25,1
439057,31,7,24,32,3
439057,11,6,5,39,1
439057,30,13,17,40,1
439057,292,126,166,41,4
439057,111,52,59,42,1
439057,111,52,59,43,1
439057,17,10,7,44,1
439057,94,42,52,45,1
439057,181,74,107,52,3
439057,31,8,23,59,1
439057,63,34,29,60,1
439118,538,90,448,1,4
439118,538,90,448,2,1
439118,538,90,448,3,1
439118,71,12,59,4,1
439118,467,78,389,5,1
439118,81,11,70,19,1
439118,386,67,319,20,1
439118,538,90,448,21,4
439118,538,90,448,22,1
439118,538,90,448,23,1
439118,71,12,59,24,1
439118,467,78,389,25,1
439118,81,11,70,39,1
439118,386,67,319,40,1
439127,262,17,245,1,4
439127,262,17,245,2,1
439127,262,17,245,3,1
439127,83,5,78,4,1
439127,179,12,167,5,1
439127,18,2,16,19,1
439127,161,10,151,20,1
439127,262,17,245,21,4
439127,262,17,245,22,1
439127,262,17,245,23,1
439127,83,5,78,24,1
439127,179,12,167,25,1
439127,18,2,16,39,1
439127,161,10,151,40,1
439136,403,368,35,1,4
439136,403,368,35,2,1
439136,403,368,35,3,1
439136,62,56,6,4,1
439136,341,312,29,5,1
439136,341,312,29,20,1
439136,313,286,27,21,4
439136,313,286,27,22,1
439136,313,286,27,23,1
439136,57,52,5,24,1
439136,256,234,22,25,1
439136,256,234,22,40,1
439136,90,82,8,41,4
439136,90,82,8,42,1
439136,90,82,8,43,1
439136,5,4,1,44,1
439136,85,78,7,45,1
439136,85,78,7,60,1
439145,3396,1344,2052,1,4
439145,3396,1344,2052,2,1
439145,2731,1071,1660,3,1
439145,448,218,230,4,1
439145,2283,853,1430,5,1
439145,665,273,392,11,1
439145,599,196,403,19,1
439145,1684,657,1027,20,1
439145,1518,647,871,21,4
439145,1518,647,871,22,1
439145,1278,547,731,23,1
439145,253,125,128,24,1
439145,1025,422,603,25,1
439145,240,100,140,31,1
439145,215,86,129,39,1
439145,810,336,474,40,1
439145,1878,697,1181,41,4
439145,1878,697,1181,42,1
439145,1453,524,929,43,1
439145,195,93,102,44,1
439145,1258,431,827,45,1
439145,425,173,252,51,1
439145,384,110,274,59,1
439145,874,321,553,60,1
439190,2821,1460,1361,1,4
439190,2821,1460,1361,2,1
439190,2177,1126,1051,3,1
439190,381,213,168,4,1
439190,1796,913,883,5,1
439190,644,334,310,11,1
439190,620,340,280,19,1
439190,1176,573,603,20,1
439190,1539,823,716,21,4
439190,1539,823,716,22,1
439190,1239,657,582,23,1
439190,275,158,117,24,1
439190,964,499,465,25,1
439190,300,166,134,31,1
439190,307,173,134,39,1
439190,657,326,331,40,1
439190,1282,637,645,41,4
439190,1282,637,645,42,1
439190,938,469,469,43,1
439190,106,55,51,44,1
439190,832,414,418,45,1
439190,344,168,176,51,1
439190,313,167,146,59,1
439190,519,247,272,60,1
439279,575,182,393,1,4
439279,542,168,374,2,1
439279,542,168,374,3,1
439279,41,14,27,4,1
439279,501,154,347,5,1
439279,33,14,19,12,3
439279,46,9,37,19,1
439279,455,145,310,20,1
439279,575,182,393,21,4
439279,542,168,374,22,1
439279,542,168,374,23,1
439279,41,14,27,24,1
439279,501,154,347,25,1
439279,33,14,19,32,3
439279,46,9,37,39,1
439279,455,145,310,40,1
439288,1529,621,908,1,4
439288,1506,617,889,2,1
439288,1506,617,889,3,1
439288,337,124,213,4,1
439288,1169,493,676,5,1
439288,23,4,19,12,3
439288,132,59,73,19,1
439288,1037,434,603,20,1
439288,1393,565,828,21,4
439288,1373,563,810,22,1
439288,1373,563,810,23,1
439288,327,121,206,24,1
439288,1046,442,604,25,1
439288,20,2,18,32,3
439288,113,51,62,39,1
439288,933,391,542,40,1
439288,136,56,80,41,4
439288,133,54,79,42,1
439288,133,54,79,43,1
439288,10,3,7,44,1
439288,123,51,72,45,1
439288,3,2,1,52,3
439288,19,8,11,59,1
439288,104,43,61,60,1
439297,385,102,283,1,4
439297,333,88,245,2,1
439297,333,88,245,3,1
439297,18,6,12,4,1
439297,315,82,233,5,1
439297,52,14,38,12,3
439297,31,3,28,19,1
439297,284,79,205,20,1
439297,385,102,283,21,4
439297,333,88,245,22,1
439297,333,88,245,23,1
439297,18,6,12,24,1
439297,315,82,233,25,1
439297,52,14,38,32,3
439297,31,3,28,39,1
439297,284,79,205,40,1
439303,88,7,81,1,4
439303,88,7,81,2,1
439303,88,7,81,3,1
439303,13,1,12,4,1
439303,75,6,69,5,1
439303,6,0,6,19,1
439303,69,6,63,20,1
439303,75,5,70,21,4
439303,75,5,70,22,1
439303,75,5,70,23,1
439303,13,1,12,24,1
439303,62,4,58,25,1
439303,6,0,6,39,1
439303,56,4,52,40,1
439303,13,2,11,41,4
439303,13,2,11,42,1
439303,13,2,11,43,1
439303,13,2,11,45,1
439303,13,2,11,60,1
439312,40,12,28,1,4
439312,40,12,28,2,1
439312,40,12,28,3,1
439312,5,2,3,4,1
439312,35,10,25,5,1
439312,3,0,3,19,1
439312,32,10,22,20,1
439312,29,8,21,21,4
439312,29,8,21,22,1
439312,29,8,21,23,1
439312,5,2,3,24,1
439312,24,6,18,25,1
439312,3,0,3,39,1
439312,21,6,15,40,1
439312,11,4,7,41,4
439312,11,4,7,42,1
439312,11,4,7,43,1
439312,11,4,7,45,1
439312,11,4,7,60,1
439367,230,85,145,1,4
439367,230,85,145,2,1
439367,230,85,145,3,1
439367,67,27,40,4,1
439367,163,58,105,5,1
439367,1,1,0,19,1
439367,162,57,105,20,1
439367,230,85,145,21,4
439367,230,85,145,22,1
439367,230,85,145,23,1
439367,67,27,40,24,1
439367,163,58,105,25,1
439367,1,1,0,39,1
439367,162,57,105,40,1
439394,125,23,102,1,4
439394,2,1,1,2,1
439394,2,1,1,11,1
439394,123,22,101,12,3
439394,125,23,102,21,4
439394,2,1,1,22,1
439394,2,1,1,31,1
439394,123,22,101,32,3
439400,66,45,21,1,4
439400,66,45,21,2,1
439400,66,45,21,3,1
439400,26,16,10,4,1
439400,40,29,11,5,1
439400,40,29,11,20,1
439400,38,24,14,21,4
439400,38,24,14,22,1
439400,38,24,14,23,1
439400,16,9,7,24,1
439400,22,15,7,25,1
439400,22,15,7,40,1
439400,28,21,7,41,4
439400,28,21,7,42,1
439400,28,21,7,43,1
439400,10,7,3,44,1
439400,18,14,4,45,1
439400,18,14,4,60,1
439437,231,32,199,1,4
439437,231,32,199,2,1
439437,231,32,199,3,1
439437,55,8,47,4,1
439437,176,24,152,5,1
439437,176,24,152,20,1
439437,231,32,199,21,4
439437,231,32,199,22,1
439437,231,32,199,23,1
439437,55,8,47,24,1
439437,176,24,152,25,1
439437,176,24,152,40,1
439446,142,32,110,1,4
439446,27,12,15,2,1
439446,27,12,15,3,1
439446,27,12,15,5,1
439446,115,20,95,12,3
439446,27,12,15,20,1
439446,142,32,110,21,4
439446,27,12,15,22,1
439446,27,12,15,23,1
439446,27,12,15,25,1
439446,115,20,95,32,3
439446,27,12,15,40,1
439455,504,41,463,1,4
439455,504,41,463,2,1
439455,504,41,463,3,1
439455,167,20,147,4,1
439455,337,21,316,5,1
439455,337,21,316,20,1
439455,388,26,362,21,4
439455,388,26,362,22,1
439455,388,26,362,23,1
439455,129,12,117,24,1
439455,259,14,245,25,1
439455,259,14,245,40,1
439455,116,15,101,41,4
439455,116,15,101,42,1
439455,116,15,101,43,1
439455,38,8,30,44,1
439455,78,7,71,45,1
439455,78,7,71,60,1
439473,294,109,185,1,4
439473,294,109,185,2,1
439473,294,109,185,3,1
439473,94,42,52,4,1
439473,200,67,133,5,1
439473,200,67,133,20,1
439473,162,62,100,21,4
439473,162,62,100,22,1
439473,162,62,100,23,1
439473,50,22,28,24,1
439473,112,40,72,25,1
439473,112,40,72,40,1
439473,132,47,85,41,4
439473,132,47,85,42,1
439473,132,47,85,43,1
439473,44,20,24,44,1
439473,88,27,61,45,1
439473,88,27,61,60,1
439482,320,17,303,1,4
439482,320,17,303,2,1
439482,320,17,303,3,1
439482,66,6,60,4,1
439482,254,11,243,5,1
439482,254,11,243,20,1
439482,186,10,176,21,4
439482,186,10,176,22,1
439482,186,10,176,23,1
439482,42,5,37,24,1
439482,144,5,139,25,1
439482,144,5,139,40,1
439482,134,7,127,41,4
439482,134,7,127,42,1
439482,134,7,127,43,1
439482,24,1,23,44,1
439482,110,6,104,45,1
439482,110,6,104,60,1
439491,291,36,255,1,4
439491,291,36,255,2,1
439491,291,36,255,3,1
439491,230,32,198,4,1
439491,61,4,57,5,1
439491,61,4,57,20,1
439491,291,36,255,21,4
439491,291,36,255,22,1
439491,291,36,255,23,1
439491,230,32,198,24,1
439491,61,4,57,25,1
439491,61,4,57,40,1
439507,355,44,311,1,4
439507,355,44,311,2,1
439507,355,44,311,3,1
439507,221,22,199,4,1
439507,134,22,112,5,1
439507,134,22,112,20,1
439507,355,44,311,21,4
439507,355,44,311,22,1
439507,355,44,311,23,1
439507,221,22,199,24,1
439507,134,22,112,25,1
439507,134,22,112,40,1
439525,285,55,230,1,4
439525,285,55,230,2,1
439525,285,55,230,3,1
439525,89,11,78,4,1
439525,196,44,152,5,1
439525,181,42,139,19,1
439525,15,2,13,20,1
439525,285,55,230,21,4
439525,285,55,230,22,1
439525,285,55,230,23,1
439525,89,11,78,24,1
439525,196,44,152,25,1
439525,181,42,139,39,1
439525,15,2,13,40,1
439570,587,57,530,1,4
439570,587,57,530,2,1
439570,587,57,530,3,1
439570,175,20,155,4,1
439570,412,37,375,5,1
439570,412,37,375,20,1
439570,587,57,530,21,4
439570,587,57,530,22,1
439570,587,57,530,23,1
439570,175,20,155,24,1
439570,412,37,375,25,1
439570,412,37,375,40,1
439589,302,11,291,1,4
439589,302,11,291,2,1
439589,302,11,291,3,1
439589,85,2,83,4,1
439589,217,9,208,5,1
439589,217,9,208,20,1
439589,215,8,207,21,4
439589,215,8,207,22,1
439589,215,8,207,23,1
439589,63,2,61,24,1
439589,152,6,146,25,1
439589,152,6,146,40,1
439589,87,3,84,41,4
439589,87,3,84,42,1
439589,87,3,84,43,1
439589,22,0,22,44,1
439589,65,3,62,45,1
439589,65,3,62,60,1
439613,257,136,121,1,4
439613,257,136,121,2,1
439613,219,119,100,3,1
439613,41,25,16,4,1
439613,178,94,84,5,1
439613,38,17,21,11,1
439613,64,28,36,19,1
439613,114,66,48,20,1
439613,139,83,56,21,4
439613,139,83,56,22,1
439613,126,74,52,23,1
439613,18,13,5,24,1
439613,108,61,47,25,1
439613,13,9,4,31,1
439613,42,17,25,39,1
439613,66,44,22,40,1
439613,118,53,65,41,4
439613,118,53,65,42,1
439613,93,45,48,43,1
439613,23,12,11,44,1
439613,70,33,37,45,1
439613,25,8,17,51,1
439613,22,11,11,59,1
439613,48,22,26,60,1
439622,155,22,133,1,4
439622,155,22,133,2,1
439622,155,22,133,3,1
439622,21,4,17,4,1
439622,134,18,116,5,1
439622,134,18,116,20,1
439622,155,22,133,21,4
439622,155,22,133,22,1
439622,155,22,133,23,1
439622,21,4,17,24,1
439622,134,18,116,25,1
439622,134,18,116,40,1
439631,34,3,31,1,4
439631,34,3,31,2,1
439631,34,3,31,3,1
439631,23,2,21,4,1
439631,11,1,10,5,1
439631,11,1,10,20,1
439631,34,3,31,21,4
439631,34,3,31,22,1
439631,34,3,31,23,1
439631,23,2,21,24,1
439631,11,1,10,25,1
439631,11,1,10,40,1
439668,120,107,13,1,4
439668,120,107,13,2,1
439668,120,107,13,3,1
439668,74,66,8,4,1
439668,46,41,5,5,1
439668,46,41,5,20,1
439668,120,107,13,21,4
439668,120,107,13,22,1
439668,120,107,13,23,1
439668,74,66,8,24,1
439668,46,41,5,25,1
439668,46,41,5,40,1
439686,280,31,249,1,4
439686,280,31,249,2,1
439686,280,31,249,3,1
439686,92,9,83,4,1
439686,188,22,166,5,1
439686,188,22,166,20,1
439686,222,25,197,21,4
439686,222,25,197,22,1
439686,222,25,197,23,1
439686,68,7,61,24,1
439686,154,18,136,25,1
439686,154,18,136,40,1
439686,58,6,52,41,4
439686,58,6,52,42,1
439686,58,6,52,43,1
439686,24,2,22,44,1
439686,34,4,30,45,1
439686,34,4,30,60,1
439701,598,338,260,1,4
439701,372,207,165,2,1
439701,372,207,165,3,1
439701,53,29,24,4,1
439701,319,178,141,5,1
439701,226,131,95,12,3
439701,70,37,33,19,1
439701,249,141,108,20,1
439701,212,128,84,21,4
439701,151,86,65,22,1
439701,151,86,65,23,1
439701,25,15,10,24,1
439701,126,71,55,25,1
439701,61,42,19,32,3
439701,31,17,14,39,1
439701,95,54,41,40,1
439701,386,210,176,41,4
439701,221,121,100,42,1
439701,221,121,100,43,1
439701,28,14,14,44,1
439701,193,107,86,45,1
439701,165,89,76,52,3
439701,39,20,19,59,1
439701,154,87,67,60,1
439729,17,2,15,1,4
439729,17,2,15,2,1
439729,17,2,15,3,1
439729,9,1,8,4,1
439729,8,1,7,5,1
439729,8,1,7,20,1
439729,10,1,9,21,4
439729,10,1,9,22,1
439729,10,1,9,23,1
439729,5,1,4,24,1
439729,5,0,5,25,1
439729,5,0,5,40,1
439729,7,1,6,41,4
439729,7,1,6,42,1
439729,7,1,6,43,1
439729,4,0,4,44,1
439729,3,1,2,45,1
439729,3,1,2,60,1
439738,381,55,326,1,4
439738,381,55,326,2,1
439738,381,55,326,3,1
439738,27,6,21,4,1
439738,354,49,305,5,1
439738,83,12,71,19,1
439738,271,37,234,20,1
439738,381,55,326,21,4
439738,381,55,326,22,1
439738,381,55,326,23,1
439738,27,6,21,24,1
439738,354,49,305,25,1
439738,83,12,71,39,1
439738,271,37,234,40,1
439747,33,4,29,1,4
439747,33,4,29,2,1
439747,33,4,29,3,1
439747,32,3,29,4,1
439747,1,1,0,5,1
439747,1,1,0,20,1
439747,26,3,23,21,4
439747,26,3,23,22,1
439747,26,3,23,23,1
439747,25,2,23,24,1
439747,1,1,0,25,1
439747,1,1,0,40,1
439747,7,1,6,41,4
439747,7,1,6,42,1
439747,7,1,6,43,1
439747,7,1,6,44,1
439774,39,13,26,1,4
439774,39,13,26,2,1
439774,39,13,26,3,1
439774,32,13,19,4,1
439774,7,0,7,5,1
439774,7,0,7,20,1
439774,28,8,20,21,4
439774,28,8,20,22,1
439774,28,8,20,23,1
439774,23,8,15,24,1
439774,5,0,5,25,1
439774,5,0,5,40,1
439774,11,5,6,41,4
439774,11,5,6,42,1
439774,11,5,6,43,1
439774,9,5,4,44,1
439774,2,0,2,45,1
439774,2,0,2,60,1
439783,150,75,75,1,4
439783,81,34,47,2,1
439783,64,27,37,3,1
439783,64,27,37,5,1
439783,17,7,10,11,1
439783,69,41,28,12,3
439783,25,10,15,19,1
439783,39,17,22,20,1
439783,80,44,36,21,4
439783,47,22,25,22,1
439783,47,22,25,23,1
439783,47,22,25,25,1
439783,33,22,11,32,3
439783,21,9,12,39,1
439783,26,13,13,40,1
439783,70,31,39,41,4
439783,34,12,22,42,1
439783,17,5,12,43,1
439783,17,5,12,45,1
439783,17,7,10,51,1
439783,36,19,17,52,3
439783,4,1,3,59,1
439783,13,4,9,60,1
439792,266,61,205,1,4
439792,266,61,205,2,1
439792,266,61,205,3,1
439792,40,9,31,4,1
439792,226,52,174,5,1
439792,17,2,15,19,1
439792,209,50,159,20,1
439792,266,61,205,21,4
439792,266,61,205,22,1
439792,266,61,205,23,1
439792,40,9,31,24,1
439792,226,52,174,25,1
439792,17,2,15,39,1
439792,209,50,159,40,1
439817,170,101,69,1,4
439817,170,101,69,12,3
439817,113,64,49,21,4
439817,113,64,49,32,3
439817,57,37,20,41,4
439817,57,37,20,52,3
439826,326,172,154,1,4
439826,326,172,154,2,1
439826,326,172,154,3,1
439826,71,42,29,4,1
439826,255,130,125,5,1
439826,255,130,125,20,1
439826,326,172,154,21,4
439826,326,172,154,22,1
439826,326,172,154,23,1
439826,71,42,29,24,1
439826,255,130,125,25,1
439826,255,130,125,40,1
439844,67,2,65,1,4
439844,67,2,65,2,1
439844,67,2,65,3,1
439844,16,0,16,4,1
439844,51,2,49,5,1
439844,51,2,49,20,1
439844,67,2,65,21,4
439844,67,2,65,22,1
439844,67,2,65,23,1
439844,16,0,16,24,1
439844,51,2,49,25,1
439844,51,2,49,40,1
439862,79,46,33,1,4
439862,75,43,32,2,1
439862,71,41,30,3,1
439862,17,10,7,4,1
439862,54,31,23,5,1
439862,4,2,2,11,1
439862,4,3,1,12,3
439862,7,3,4,19,1
439862,47,28,19,20,1
439862,57,32,25,21,4
439862,57,32,25,22,1
439862,57,32,25,23,1
439862,17,10,7,24,1
439862,40,22,18,25,1
439862,7,3,4,39,1
439862,33,19,14,40,1
439862,22,14,8,41,4
439862,18,11,7,42,1
439862,14,9,5,43,1
439862,14,9,5,45,1
439862,4,2,2,51,1
439862,4,3,1,52,3
439862,14,9,5,60,1
439871,104,12,92,1,4
439871,104,12,92,2,1
439871,104,12,92,3,1
439871,25,4,21,4,1
439871,79,8,71,5,1
439871,79,8,71,20,1
439871,104,12,92,21,4
439871,104,12,92,22,1
439871,104,12,92,23,1
439871,25,4,21,24,1
439871,79,8,71,25,1
439871,79,8,71,40,1
439899,45,25,20,1,4
439899,45,25,20,2,1
439899,42,24,18,3,1
439899,28,18,10,4,1
439899,14,6,8,5,1
439899,3,1,2,11,1
439899,5,3,2,19,1
439899,9,3,6,20,1
439899,40,24,16,21,4
439899,40,24,16,22,1
439899,40,24,16,23,1
439899,27,18,9,24,1
439899,13,6,7,25,1
439899,5,3,2,39,1
439899,8,3,5,40,1
439899,5,1,4,41,4
439899,5,1,4,42,1
439899,2,0,2,43,1
439899,1,0,1,44,1
439899,1,0,1,45,1
439899,3,1,2,51,1
439899,1,0,1,60,1
439905,47,6,41,1,4
439905,47,6,41,2,1
439905,47,6,41,3,1
439905,6,1,5,4,1
439905,41,5,36,5,1
439905,41,5,36,20,1
439905,47,6,41,21,4
439905,47,6,41,22,1
439905,47,6,41,23,1
439905,6,1,5,24,1
439905,41,5,36,25,1
439905,41,5,36,40,1
439914,50,12,38,1,4
439914,50,12,38,12,3
439914,50,12,38,21,4
439914,50,12,38,32,3
439932,26,1,25,1,4
439932,26,1,25,2,1
439932,26,1,25,3,1
439932,20,1,19,4,1
439932,6,0,6,5,1
439932,6,0,6,20,1
439932,26,1,25,21,4
439932,26,1,25,22,1
439932,26,1,25,23,1
439932,20,1,19,24,1
439932,6,0,6,25,1
439932,6,0,6,40,1
439969,173,58,115,1,4
439969,35,12,23,2,1
439969,35,12,23,3,1
439969,20,7,13,4,1
439969,15,5,10,5,1
439969,138,46,92,12,3
439969,15,5,10,20,1
439969,138,46,92,21,4
439969,138,46,92,32,3
439969,35,12,23,41,4
439969,35,12,23,42,1
439969,35,12,23,43,1
439969,20,7,13,44,1
439969,15,5,10,45,1
439969,15,5,10,60,1
439978,84,1,83,1,4
439978,84,1,83,2,1
439978,84,1,83,3,1
439978,31,0,31,4,1
439978,53,1,52,5,1
439978,53,1,52,20,1
439978,84,1,83,21,4
439978,84,1,83,22,1
439978,84,1,83,23,1
439978,31,0,31,24,1
439978,53,1,52,25,1
439978,53,1,52,40,1
439996,90,26,64,1,4
439996,90,26,64,2,1
439996,90,26,64,3,1
439996,78,21,57,4,1
439996,12,5,7,5,1
439996,12,5,7,20,1
439996,90,26,64,21,4
439996,90,26,64,22,1
439996,90,26,64,23,1
439996,78,21,57,24,1
439996,12,5,7,25,1
439996,12,5,7,40,1
440004,35,13,22,1,4
440004,35,13,22,12,3
440004,35,13,22,21,4
440004,35,13,22,32,3
440031,169,82,87,1,4
440031,169,82,87,12,3
440031,157,74,83,21,4
440031,157,74,83,32,3
440031,12,8,4,41,4
440031,12,8,4,52,3
440059,542,499,43,1,4
440059,542,499,43,2,1
440059,542,499,43,3,1
440059,93,87,6,4,1
440059,449,412,37,5,1
440059,449,412,37,20,1
440059,521,481,40,21,4
440059,521,481,40,22,1
440059,521,481,40,23,1
440059,89,83,6,24,1
440059,432,398,34,25,1
440059,432,398,34,40,1
440059,21,18,3,41,4
440059,21,18,3,42,1
440059,21,18,3,43,1
440059,4,4,0,44,1
440059,17,14,3,45,1
440059,17,14,3,60,1
440077,50,2,48,1,4
440077,50,2,48,2,1
440077,50,2,48,3,1
440077,30,2,28,4,1
440077,20,0,20,5,1
440077,20,0,20,20,1
440077,50,2,48,21,4
440077,50,2,48,22,1
440077,50,2,48,23,1
440077,30,2,28,24,1
440077,20,0,20,25,1
440077,20,0,20,40,1
440086,318,33,285,1,4
440086,318,33,285,2,1
440086,318,33,285,3,1
440086,251,26,225,4,1
440086,67,7,60,5,1
440086,67,7,60,20,1
440086,244,23,221,21,4
440086,244,23,221,22,1
440086,244,23,221,23,1
440086,196,17,179,24,1
440086,48,6,42,25,1
440086,48,6,42,40,1
440086,74,10,64,41,4
440086,74,10,64,42,1
440086,74,10,64,43,1
440086,55,9,46,44,1
440086,19,1,18,45,1
440086,19,1,18,60,1
440101,188,13,175,1,4
440101,188,13,175,2,1
440101,188,13,175,3,1
440101,32,3,29,4,1
440101,156,10,146,5,1
440101,156,10,146,20,1
440101,134,10,124,21,4
440101,134,10,124,22,1
440101,134,10,124,23,1
440101,28,3,25,24,1
440101,106,7,99,25,1
440101,106,7,99,40,1
440101,54,3,51,41,4
440101,54,3,51,42,1
440101,54,3,51,43,1
440101,4,0,4,44,1
440101,50,3,47,45,1
440101,50,3,47,60,1
440110,402,78,324,1,4
440110,402,78,324,2,1
440110,402,78,324,3,1
440110,164,32,132,4,1
440110,238,46,192,5,1
440110,238,46,192,20,1
440110,402,78,324,21,4
440110,402,78,324,22,1
440110,402,78,324,23,1
440110,164,32,132,24,1
440110,238,46,192,25,1
440110,238,46,192,40,1
440129,288,57,231,1,4
440129,288,57,231,2,1
440129,288,57,231,3,1
440129,123,27,96,4,1
440129,165,30,135,5,1
440129,165,30,135,20,1
440129,288,57,231,21,4
440129,288,57,231,22,1
440129,288,57,231,23,1
440129,123,27,96,24,1
440129,165,30,135,25,1
440129,165,30,135,40,1
440147,321,113,208,1,4
440147,321,113,208,2,1
440147,321,113,208,3,1
440147,38,14,24,4,1
440147,283,99,184,5,1
440147,2,1,1,19,1
440147,281,98,183,20,1
440147,275,93,182,21,4
440147,275,93,182,22,1
440147,275,93,182,23,1
440147,37,13,24,24,1
440147,238,80,158,25,1
440147,238,80,158,40,1
440147,46,20,26,41,4
440147,46,20,26,42,1
440147,46,20,26,43,1
440147,1,1,0,44,1
440147,45,19,26,45,1
440147,2,1,1,59,1
440147,43,18,25,60,1
440165,181,140,41,1,4
440165,181,140,41,2,1
440165,181,140,41,3,1
440165,23,14,9,4,1
440165,158,126,32,5,1
440165,6,4,2,19,1
440165,152,122,30,20,1
440165,126,95,31,21,4
440165,126,95,31,22,1
440165,126,95,31,23,1
440165,21,14,7,24,1
440165,105,81,24,25,1
440165,6,4,2,39,1
440165,99,77,22,40,1
440165,55,45,10,41,4
440165,55,45,10,42,1
440165,55,45,10,43,1
440165,2,0,2,44,1
440165,53,45,8,45,1
440165,53,45,8,60,1
440174,83,6,77,1,4
440174,83,6,77,2,1
440174,83,6,77,3,1
440174,6,0,6,4,1
440174,77,6,71,5,1
440174,3,0,3,19,1
440174,74,6,68,20,1
440174,83,6,77,21,4
440174,83,6,77,22,1
440174,83,6,77,23,1
440174,6,0,6,24,1
440174,77,6,71,25,1
440174,3,0,3,39,1
440174,74,6,68,40,1
440217,34,5,29,1,4
440217,34,5,29,2,1
440217,34,5,29,3,1
440217,13,2,11,4,1
440217,21,3,18,5,1
440217,21,3,18,20,1
440217,34,5,29,21,4
440217,34,5,29,22,1
440217,34,5,29,23,1
440217,13,2,11,24,1
440217,21,3,18,25,1
440217,21,3,18,40,1
440226,88,0,88,1,4
440226,88,0,88,2,1
440226,88,0,88,3,1
440226,29,0,29,4,1
440226,59,0,59,5,1
440226,59,0,59,20,1
440226,88,0,88,21,4
440226,88,0,88,22,1
440226,88,0,88,23,1
440226,29,0,29,24,1
440226,59,0,59,25,1
440226,59,0,59,40,1
440262,276,259,17,1,4
440262,276,259,17,2,1
440262,276,259,17,3,1
440262,141,135,6,4,1
440262,135,124,11,5,1
440262,135,124,11,20,1
440262,276,259,17,21,4
440262,276,259,17,22,1
440262,276,259,17,23,1
440262,141,135,6,24,1
440262,135,124,11,25,1
440262,135,124,11,40,1
440271,300,38,262,1,4
440271,300,38,262,2,1
440271,300,38,262,3,1
440271,125,21,104,4,1
440271,175,17,158,5,1
440271,5,4,1,19,1
440271,170,13,157,20,1
440271,300,38,262,21,4
440271,300,38,262,22,1
440271,300,38,262,23,1
440271,125,21,104,24,1
440271,175,17,158,25,1
440271,5,4,1,39,1
440271,170,13,157,40,1
440299,962,414,548,1,4
440299,962,414,548,2,1
440299,962,414,548,3,1
440299,5,2,3,4,1
440299,957,412,545,5,1
440299,82,41,41,19,1
440299,875,371,504,20,1
440299,643,299,344,21,4
440299,643,299,344,22,1
440299,643,299,344,23,1
440299,2,1,1,24,1
440299,641,298,343,25,1
440299,47,26,21,39,1
440299,594,272,322,40,1
440299,319,115,204,41,4
440299,319,115,204,42,1
440299,319,115,204,43,1
440299,3,1,2,44,1
440299,316,114,202,45,1
440299,35,15,20,59,1
440299,281,99,182,60,1
440323,273,36,237,1,4
440323,273,36,237,2,1
440323,268,35,233,3,1
440323,34,3,31,4,1
440323,234,32,202,5,1
440323,5,1,4,11,1
440323,45,6,39,19,1
440323,189,26,163,20,1
440323,273,36,237,21,4
440323,273,36,237,22,1
440323,268,35,233,23,1
440323,34,3,31,24,1
440323,234,32,202,25,1
440323,5,1,4,31,1
440323,45,6,39,39,1
440323,189,26,163,40,1
440332,329,66,263,1,4
440332,329,66,263,2,1
440332,329,66,263,3,1
440332,104,27,77,4,1
440332,225,39,186,5,1
440332,6,0,6,19,1
440332,219,39,180,20,1
440332,329,66,263,21,4
440332,329,66,263,22,1
440332,329,66,263,23,1
440332,104,27,77,24,1
440332,225,39,186,25,1
440332,6,0,6,39,1
440332,219,39,180,40,1
440341,1499,816,683,1,4
440341,1499,816,683,2,1
440341,1485,805,680,3,1
440341,405,223,182,4,1
440341,1080,582,498,5,1
440341,14,11,3,11,1
440341,211,103,108,19,1
440341,869,479,390,20,1
440341,1115,629,486,21,4
440341,1115,629,486,22,1
440341,1112,626,486,23,1
440341,330,177,153,24,1
440341,782,449,333,25,1
440341,3,3,0,31,1
440341,153,82,71,39,1
440341,629,367,262,40,1
440341,384,187,197,41,4
440341,384,187,197,42,1
440341,373,179,194,43,1
440341,75,46,29,44,1
440341,298,133,165,45,1
440341,11,8,3,51,1
440341,58,21,37,59,1
440341,240,112,128,60,1
440369,666,132,534,1,4
440369,666,132,534,2,1
440369,666,132,534,3,1
440369,53,10,43,4,1
440369,613,122,491,5,1
440369,613,122,491,20,1
440369,666,132,534,21,4
440369,666,132,534,22,1
440369,666,132,534,23,1
440369,53,10,43,24,1
440369,613,122,491,25,1
440369,613,122,491,40,1
440396,178,76,102,1,4
440396,154,61,93,2,1
440396,150,60,90,3,1
440396,44,20,24,4,1
440396,106,40,66,5,1
440396,4,1,3,11,1
440396,24,15,9,12,3
440396,4,0,4,19,1
440396,102,40,62,20,1
440396,159,67,92,21,4
440396,141,55,86,22,1
440396,139,55,84,23,1
440396,42,18,24,24,1
440396,97,37,60,25,1
440396,2,0,2,31,1
440396,18,12,6,32,3
440396,4,0,4,39,1
440396,93,37,56,40,1
440396,19,9,10,41,4
440396,13,6,7,42,1
440396,11,5,6,43,1
440396,2,2,0,44,1
440396,9,3,6,45,1
440396,2,1,1,51,1
440396,6,3,3,52,3
440396,9,3,6,60,1
440402,2057,846,1211,1,4
440402,2057,846,1211,2,1
440402,1311,500,811,3,1
440402,355,152,203,4,1
440402,956,348,608,5,1
440402,746,346,400,11,1
440402,437,144,293,19,1
440402,519,204,315,20,1
440402,963,395,568,21,4
440402,963,395,568,22,1
440402,896,359,537,23,1
440402,289,122,167,24,1
440402,607,237,370,25,1
440402,67,36,31,31,1
440402,217,76,141,39,1
440402,390,161,229,40,1
440402,1094,451,643,41,4
440402,1094,451,643,42,1
440402,415,141,274,43,1
440402,66,30,36,44,1
440402,349,111,238,45,1
440402,679,310,369,51,1
440402,220,68,152,59,1
440402,129,43,86,60,1
440411,114,38,76,1,4
440411,14,6,8,2,1
440411,14,6,8,3,1
440411,14,6,8,5,1
440411,100,32,68,12,3
440411,1,1,0,19,1
440411,13,5,8,20,1
440411,26,10,16,21,4
440411,1,1,0,22,1
440411,1,1,0,23,1
440411,1,1,0,25,1
440411,25,9,16,32,3
440411,1,1,0,39,1
440411,88,28,60,41,4
440411,13,5,8,42,1
440411,13,5,8,43,1
440411,13,5,8,45,1
440411,75,23,52,52,3
440411,13,5,8,60,1
440420,210,147,63,1,4
440420,181,132,49,2,1
440420,181,132,49,3,1
440420,3,1,2,4,1
440420,178,131,47,5,1
440420,29,15,14,12,3
440420,16,15,1,19,1
440420,162,116,46,20,1
440420,210,147,63,21,4
440420,181,132,49,22,1
440420,181,132,49,23,1
440420,3,1,2,24,1
440420,178,131,47,25,1
440420,29,15,14,32,3
440420,16,15,1,39,1
440420,162,116,46,40,1
440439,1499,658,841,1,4
440439,1338,581,757,2,1
440439,1337,581,756,3,1
440439,62,19,43,4,1
440439,1275,562,713,5,1
440439,1,0,1,11,1
440439,161,77,84,12,3
440439,136,70,66,19,1
440439,1139,492,647,20,1
440439,1499,658,841,21,4
440439,1338,581,757,22,1
440439,1337,581,756,23,1
440439,62,19,43,24,1
440439,1275,562,713,25,1
440439,1,0,1,31,1
440439,161,77,84,32,3
440439,136,70,66,39,1
440439,1139,492,647,40,1
440448,1841,667,1174,1,4
440448,1595,577,1018,2,1
440448,1595,577,1018,3,1
440448,62,16,46,4,1
440448,1533,561,972,5,1
440448,246,90,156,12,3
440448,127,53,74,19,1
440448,1406,508,898,20,1
440448,1841,667,1174,21,4
440448,1595,577,1018,22,1
440448,1595,577,1018,23,1
440448,62,16,46,24,1
440448,1533,561,972,25,1
440448,246,90,156,32,3
440448,127,53,74,39,1
440448,1406,508,898,40,1
440457,268,89,179,1,4
440457,256,84,172,2,1
440457,256,84,172,3,1
440457,8,3,5,4,1
440457,248,81,167,5,1
440457,12,5,7,12,3
440457,6,3,3,19,1
440457,242,78,164,20,1
440457,268,89,179,21,4
440457,256,84,172,22,1
440457,256,84,172,23,1
440457,8,3,5,24,1
440457,248,81,167,25,1
440457,12,5,7,32,3
440457,6,3,3,39,1
440457,242,78,164,40,1
440466,307,125,182,1,4
440466,283,108,175,2,1
440466,283,108,175,3,1
440466,13,4,9,4,1
440466,270,104,166,5,1
440466,24,17,7,12,3
440466,18,11,7,19,1
440466,252,93,159,20,1
440466,307,125,182,21,4
440466,283,108,175,22,1
440466,283,108,175,23,1
440466,13,4,9,24,1
440466,270,104,166,25,1
440466,24,17,7,32,3
440466,18,11,7,39,1
440466,252,93,159,40,1
440484,979,524,455,1,4
440484,979,524,455,2,1
440484,979,524,455,3,1
440484,124,65,59,4,1
440484,855,459,396,5,1
440484,855,459,396,20,1
440484,706,346,360,21,4
440484,706,346,360,22,1
440484,706,346,360,23,1
440484,120,63,57,24,1
440484,586,283,303,25,1
440484,586,283,303,40,1
440484,273,178,95,41,4
440484,273,178,95,42,1
440484,273,178,95,43,1
440484,4,2,2,44,1
440484,269,176,93,45,1
440484,269,176,93,60,1
440642,380,296,84,1,4
440642,380,296,84,2,1
440642,380,296,84,3,1
440642,58,47,11,4,1
440642,322,249,73,5,1
440642,2,2,0,19,1
440642,320,247,73,20,1
440642,311,245,66,21,4
440642,311,245,66,22,1
440642,311,245,66,23,1
440642,54,45,9,24,1
440642,257,200,57,25,1
440642,2,2,0,39,1
440642,255,198,57,40,1
440642,69,51,18,41,4
440642,69,51,18,42,1
440642,69,51,18,43,1
440642,4,2,2,44,1
440642,65,49,16,45,1
440642,65,49,16,60,1
440651,1269,321,948,1,4
440651,1269,321,948,2,1
440651,1269,321,948,3,1
440651,246,83,163,4,1
440651,1023,238,785,5,1
440651,310,79,231,19,1
440651,713,159,554,20,1
440651,1056,272,784,21,4
440651,1056,272,784,22,1
440651,1056,272,784,23,1
440651,243,83,160,24,1
440651,813,189,624,25,1
440651,294,76,218,39,1
440651,519,113,406,40,1
440651,213,49,164,41,4
440651,213,49,164,42,1
440651,213,49,164,43,1
440651,3,0,3,44,1
440651,210,49,161,45,1
440651,16,3,13,59,1
440651,194,46,148,60,1
440721,283,79,204,1,4
440721,283,79,204,2,1
440721,276,72,204,3,1
440721,112,21,91,4,1
440721,164,51,113,5,1
440721,7,7,0,11,1
440721,164,51,113,20,1
440721,171,29,142,21,4
440721,171,29,142,22,1
440721,171,29,142,23,1
440721,62,6,56,24,1
440721,109,23,86,25,1
440721,109,23,86,40,1
440721,112,50,62,41,4
440721,112,50,62,42,1
440721,105,43,62,43,1
440721,50,15,35,44,1
440721,55,28,27,45,1
440721,7,7,0,51,1
440721,55,28,27,60,1
440730,503,142,361,1,4
440730,503,142,361,2,1
440730,503,142,361,3,1
440730,322,115,207,4,1
440730,181,27,154,5,1
440730,181,27,154,20,1
440730,503,142,361,21,4
440730,503,142,361,22,1
440730,503,142,361,23,1
440730,322,115,207,24,1
440730,181,27,154,25,1
440730,181,27,154,40,1
440749,292,211,81,1,4
440749,292,211,81,2,1
440749,150,98,52,3,1
440749,10,7,3,4,1
440749,140,91,49,5,1
440749,142,113,29,11,1
440749,16,7,9,19,1
440749,124,84,40,20,1
440749,47,25,22,21,4
440749,47,25,22,22,1
440749,45,25,20,23,1
440749,1,0,1,24,1
440749,44,25,19,25,1
440749,2,0,2,31,1
440749,9,4,5,39,1
440749,35,21,14,40,1
440749,245,186,59,41,4
440749,245,186,59,42,1
440749,105,73,32,43,1
440749,9,7,2,44,1
440749,96,66,30,45,1
440749,140,113,27,51,1
440749,7,3,4,59,1
440749,89,63,26,60,1
440758,346,99,247,1,4
440758,346,99,247,2,1
440758,346,99,247,3,1
440758,14,3,11,4,1
440758,332,96,236,5,1
440758,83,24,59,19,1
440758,249,72,177,20,1
440758,29,15,14,21,4
440758,29,15,14,22,1
440758,29,15,14,23,1
440758,29,15,14,25,1
440758,3,3,0,39,1
440758,26,12,14,40,1
440758,317,84,233,41,4
440758,317,84,233,42,1
440758,317,84,233,43,1
440758,14,3,11,44,1
440758,303,81,222,45,1
440758,80,21,59,59,1
440758,223,60,163,60,1
440767,756,208,548,1,4
440767,756,208,548,2,1
440767,755,207,548,3,1
440767,66,27,39,4,1
440767,689,180,509,5,1
440767,1,1,0,11,1
440767,147,43,104,19,1
440767,542,137,405,20,1
440767,45,19,26,21,4
440767,45,19,26,22,1
440767,45,19,26,23,1
440767,45,19,26,25,1
440767,11,3,8,39,1
440767,34,16,18,40,1
440767,711,189,522,41,4
440767,711,189,522,42,1
440767,710,188,522,43,1
440767,66,27,39,44,1
440767,644,161,483,45,1
440767,1,1,0,51,1
440767,136,40,96,59,1
440767,508,121,387,60,1
440776,30,8,22,1,4
440776,30,8,22,2,1
440776,30,8,22,3,1
440776,12,3,9,4,1
440776,18,5,13,5,1
440776,18,5,13,20,1
440776,30,8,22,21,4
440776,30,8,22,22,1
440776,30,8,22,23,1
440776,12,3,9,24,1
440776,18,5,13,25,1
440776,18,5,13,40,1
440794,418,154,264,1,4
440794,418,154,264,2,1
440794,411,151,260,3,1
440794,61,26,35,4,1
440794,350,125,225,5,1
440794,7,3,4,11,1
440794,81,33,48,19,1
440794,269,92,177,20,1
440794,353,121,232,21,4
440794,353,121,232,22,1
440794,353,121,232,23,1
440794,53,21,32,24,1
440794,300,100,200,25,1
440794,73,27,46,39,1
440794,227,73,154,40,1
440794,65,33,32,41,4
440794,65,33,32,42,1
440794,58,30,28,43,1
440794,8,5,3,44,1
440794,50,25,25,45,1
440794,7,3,4,51,1
440794,8,6,2,59,1
440794,42,19,23,60,1
440800,18,13,5,1,4
440800,18,13,5,2,1
440800,18,13,5,3,1
440800,18,13,5,5,1
440800,18,13,5,20,1
440800,18,13,5,21,4
440800,18,13,5,22,1
440800,18,13,5,23,1
440800,18,13,5,25,1
440800,18,13,5,40,1
440819,131,69,62,1,4
440819,131,69,62,2,1
440819,131,69,62,3,1
440819,131,69,62,5,1
440819,131,69,62,20,1
440819,131,69,62,21,4
440819,131,69,62,22,1
440819,131,69,62,23,1
440819,131,69,62,25,1
440819,131,69,62,40,1
440828,934,360,574,1,4
440828,782,322,460,2,1
440828,765,317,448,3,1
440828,765,317,448,5,1
440828,17,5,12,11,1
440828,152,38,114,12,3
440828,220,87,133,19,1
440828,545,230,315,20,1
440828,291,109,182,21,4
440828,190,82,108,22,1
440828,190,82,108,23,1
440828,190,82,108,25,1
440828,101,27,74,32,3
440828,18,7,11,39,1
440828,172,75,97,40,1
440828,643,251,392,41,4
440828,592,240,352,42,1
440828,575,235,340,43,1
440828,575,235,340,45,1
440828,17,5,12,51,1
440828,51,11,40,52,3
440828,202,80,122,59,1
440828,373,155,218,60,1
440855,162,11,151,1,4
440855,162,11,151,2,1
440855,162,11,151,3,1
440855,57,5,52,4,1
440855,105,6,99,5,1
440855,105,6,99,20,1
440855,162,11,151,21,4
440855,162,11,151,22,1
440855,162,11,151,23,1
440855,57,5,52,24,1
440855,105,6,99,25,1
440855,105,6,99,40,1
440873,882,466,416,1,4
440873,882,466,416,2,1
440873,882,466,416,3,1
440873,74,45,29,4,1
440873,808,421,387,5,1
440873,54,25,29,19,1
440873,754,396,358,20,1
440873,882,466,416,21,4
440873,882,466,416,22,1
440873,882,466,416,23,1
440873,74,45,29,24,1
440873,808,421,387,25,1
440873,54,25,29,39,1
440873,754,396,358,40,1
440882,164,107,57,1,4
440882,164,107,57,2,1
440882,164,107,57,3,1
440882,12,4,8,4,1
440882,152,103,49,5,1
440882,15,10,5,19,1
440882,137,93,44,20,1
440882,164,107,57,21,4
440882,164,107,57,22,1
440882,164,107,57,23,1
440882,12,4,8,24,1
440882,152,103,49,25,1
440882,15,10,5,39,1
440882,137,93,44,40,1
440891,209,157,52,1,4
440891,209,157,52,2,1
440891,209,157,52,3,1
440891,31,23,8,4,1
440891,178,134,44,5,1
440891,20,14,6,19,1
440891,158,120,38,20,1
440891,209,157,52,21,4
440891,209,157,52,22,1
440891,209,157,52,23,1
440891,31,23,8,24,1
440891,178,134,44,25,1
440891,20,14,6,39,1
440891,158,120,38,40,1
440907,497,140,357,1,4
440907,497,140,357,2,1
440907,497,140,357,3,1
440907,492,140,352,4,1
440907,5,0,5,5,1
440907,5,0,5,20,1
440907,208,20,188,21,4
440907,208,20,188,22,1
440907,208,20,188,23,1
440907,205,20,185,24,1
440907,3,0,3,25,1
440907,3,0,3,40,1
440907,289,120,169,41,4
440907,289,120,169,42,1
440907,289,120,169,43,1
440907,287,120,167,44,1
440907,2,0,2,45,1
440907,2,0,2,60,1
440916,691,319,372,1,4
440916,691,319,372,12,3
440916,683,313,370,21,4
440916,683,313,370,32,3
440916,8,6,2,41,4
440916,8,6,2,52,3
440925,348,130,218,1,4
440925,348,130,218,2,1
440925,345,130,215,3,1
440925,28,13,15,4,1
440925,317,117,200,5,1
440925,3,0,3,11,1
440925,28,6,22,19,1
440925,289,111,178,20,1
440925,289,113,176,21,4
440925,289,113,176,22,1
440925,289,113,176,23,1
440925,16,7,9,24,1
440925,273,106,167,25,1
440925,22,4,18,39,1
440925,251,102,149,40,1
440925,59,17,42,41,4
440925,59,17,42,42,1
440925,56,17,39,43,1
440925,12,6,6,44,1
440925,44,11,33,45,1
440925,3,0,3,51,1
440925,6,2,4,59,1
440925,38,9,29,60,1
440952,388,87,301,1,4
440952,388,87,301,2,1
440952,388,87,301,3,1
440952,79,17,62,4,1
440952,309,70,239,5,1
440952,309,70,239,20,1
440952,295,63,232,21,4
440952,295,63,232,22,1
440952,295,63,232,23,1
440952,65,13,52,24,1
440952,230,50,180,25,1
440952,230,50,180,40,1
440952,93,24,69,41,4
440952,93,24,69,42,1
440952,93,24,69,43,1
440952,14,4,10,44,1
440952,79,20,59,45,1
440952,79,20,59,60,1
440989,907,666,241,1,4
440989,907,666,241,2,1
440989,907,666,241,3,1
440989,93,73,20,4,1
440989,814,593,221,5,1
440989,814,593,221,20,1
440989,907,666,241,21,4
440989,907,666,241,22,1
440989,907,666,241,23,1
440989,93,73,20,24,1
440989,814,593,221,25,1
440989,814,593,221,40,1
441016,557,69,488,1,4
441016,557,69,488,2,1
441016,557,69,488,3,1
441016,182,25,157,4,1
441016,375,44,331,5,1
441016,375,44,331,20,1
441016,557,69,488,21,4
441016,557,69,488,22,1
441016,557,69,488,23,1
441016,182,25,157,24,1
441016,375,44,331,25,1
441016,375,44,331,40,1
441025,704,110,594,1,4
441025,704,110,594,2,1
441025,704,110,594,3,1
441025,117,26,91,4,1
441025,587,84,503,5,1
441025,116,18,98,19,1
441025,471,66,405,20,1
441025,458,70,388,21,4
441025,458,70,388,22,1
441025,458,70,388,23,1
441025,78,16,62,24,1
441025,380,54,326,25,1
441025,80,14,66,39,1
441025,300,40,260,40,1
441025,246,40,206,41,4
441025,246,40,206,42,1
441025,246,40,206,43,1
441025,39,10,29,44,1
441025,207,30,177,45,1
441025,36,4,32,59,1
441025,171,26,145,60,1
441052,1565,392,1173,1,4
441052,1565,392,1173,2,1
441052,1565,392,1173,3,1
441052,181,42,139,4,1
441052,1384,350,1034,5,1
441052,252,72,180,19,1
441052,1132,278,854,20,1
441052,1565,392,1173,21,4
441052,1565,392,1173,22,1
441052,1565,392,1173,23,1
441052,181,42,139,24,1
441052,1384,350,1034,25,1
441052,252,72,180,39,1
441052,1132,278,854,40,1
441070,117,37,80,1,4
441070,117,37,80,2,1
441070,105,32,73,3,1
441070,21,5,16,4,1
441070,84,27,57,5,1
441070,12,5,7,11,1
441070,2,2,0,19,1
441070,82,25,57,20,1
441070,59,22,37,21,4
441070,59,22,37,22,1
441070,56,20,36,23,1
441070,10,2,8,24,1
441070,46,18,28,25,1
441070,3,2,1,31,1
441070,2,2,0,39,1
441070,44,16,28,40,1
441070,58,15,43,41,4
441070,58,15,43,42,1
441070,49,12,37,43,1
441070,11,3,8,44,1
441070,38,9,29,45,1
441070,9,3,6,51,1
441070,38,9,29,60,1
441089,1277,1231,46,1,4
441089,1277,1231,46,2,1
441089,1277,1231,46,3,1
441089,418,400,18,4,1
441089,859,831,28,5,1
441089,66,61,5,19,1
441089,793,770,23,20,1
441089,1277,1231,46,21,4
441089,1277,1231,46,22,1
441089,1277,1231,46,23,1
441089,418,400,18,24,1
441089,859,831,28,25,1
441089,66,61,5,39,1
441089,793,770,23,40,1
441104,279,77,202,1,4
441104,279,77,202,12,3
441104,188,53,135,21,4
441104,188,53,135,32,3
441104,91,24,67,41,4
441104,91,24,67,52,3
441131,284,96,188,1,4
441131,284,96,188,12,3
441131,62,21,41,21,4
441131,62,21,41,32,3
441131,222,75,147,41,4
441131,222,75,147,52,3
441168,85,6,79,1,4
441168,85,6,79,2,1
441168,85,6,79,3,1
441168,18,3,15,4,1
441168,67,3,64,5,1
441168,67,3,64,20,1
441168,85,6,79,21,4
441168,85,6,79,22,1
441168,85,6,79,23,1
441168,18,3,15,24,1
441168,67,3,64,25,1
441168,67,3,64,40,1
441186,883,254,629,1,4
441186,740,222,518,2,1
441186,693,205,488,3,1
441186,89,22,67,4,1
441186,604,183,421,5,1
441186,47,17,30,11,1
441186,143,32,111,12,3
441186,189,68,121,19,1
441186,415,115,300,20,1
441186,517,145,372,21,4
441186,410,127,283,22,1
441186,410,127,283,23,1
441186,410,127,283,25,1
441186,107,18,89,32,3
441186,155,55,100,39,1
441186,255,72,183,40,1
441186,366,109,257,41,4
441186,330,95,235,42,1
441186,283,78,205,43,1
441186,89,22,67,44,1
441186,194,56,138,45,1
441186,47,17,30,51,1
441186,36,14,22,52,3
441186,34,13,21,59,1
441186,160,43,117,60,1
441195,54,36,18,1,4
441195,54,36,18,2,1
441195,54,36,18,3,1
441195,20,16,4,4,1
441195,34,20,14,5,1
441195,34,20,14,20,1
441195,54,36,18,21,4
441195,54,36,18,22,1
441195,54,36,18,23,1
441195,20,16,4,24,1
441195,34,20,14,25,1
441195,34,20,14,40,1
441201,156,26,130,1,4
441201,156,26,130,2,1
441201,156,26,130,3,1
441201,28,1,27,4,1
441201,128,25,103,5,1
441201,16,0,16,19,1
441201,112,25,87,20,1
441201,94,14,80,21,4
441201,94,14,80,22,1
441201,94,14,80,23,1
441201,19,1,18,24,1
441201,75,13,62,25,1
441201,11,0,11,39,1
441201,64,13,51,40,1
441201,62,12,50,41,4
441201,62,12,50,42,1
441201,62,12,50,43,1
441201,9,0,9,44,1
441201,53,12,41,45,1
441201,5,0,5,59,1
441201,48,12,36,60,1
441210,343,132,211,1,4
441210,343,132,211,2,1
441210,343,132,211,3,1
441210,161,85,76,4,1
441210,182,47,135,5,1
441210,182,47,135,20,1
441210,160,10,150,21,4
441210,160,10,150,22,1
441210,160,10,150,23,1
441210,40,3,37,24,1
441210,120,7,113,25,1
441210,120,7,113,40,1
441210,183,122,61,41,4
441210,183,122,61,42,1
441210,183,122,61,43,1
441210,121,82,39,44,1
441210,62,40,22,45,1
441210,62,40,22,60,1
441229,796,218,578,1,4
441229,796,218,578,2,1
441229,683,179,504,3,1
441229,185,47,138,4,1
441229,498,132,366,5,1
441229,113,39,74,11,1
441229,498,132,366,20,1
441229,796,218,578,21,4
441229,796,218,578,22,1
441229,683,179,504,23,1
441229,185,47,138,24,1
441229,498,132,366,25,1
441229,113,39,74,31,1
441229,498,132,366,40,1
441238,82,42,40,1,4
441238,82,42,40,12,3
441238,82,42,40,21,4
441238,82,42,40,32,3
441256,61,3,58,1,4
441256,61,3,58,2,1
441256,61,3,58,3,1
441256,21,0,21,4,1
441256,40,3,37,5,1
441256,40,3,37,20,1
441256,61,3,58,21,4
441256,61,3,58,22,1
441256,61,3,58,23,1
441256,21,0,21,24,1
441256,40,3,37,25,1
441256,40,3,37,40,1
441274,127,12,115,1,4
441274,127,12,115,2,1
441274,127,12,115,3,1
441274,23,1,22,4,1
441274,104,11,93,5,1
441274,104,11,93,20,1
441274,88,9,79,21,4
441274,88,9,79,22,1
441274,88,9,79,23,1
441274,21,1,20,24,1
441274,67,8,59,25,1
441274,67,8,59,40,1
441274,39,3,36,41,4
441274,39,3,36,42,1
441274,39,3,36,43,1
441274,2,0,2,44,1
441274,37,3,34,45,1
441274,37,3,34,60,1
441308,1797,472,1325,1,4
441308,1797,472,1325,12,3
441308,1573,422,1151,21,4
441308,1573,422,1151,32,3
441308,224,50,174,41,4
441308,224,50,174,52,3
441317,41,10,31,1,4
441317,41,10,31,2,1
441317,41,10,31,3,1
441317,17,8,9,4,1
441317,24,2,22,5,1
441317,24,2,22,20,1
441317,41,10,31,21,4
441317,41,10,31,22,1
441317,41,10,31,23,1
441317,17,8,9,24,1
441317,24,2,22,25,1
441317,24,2,22,40,1
441335,29,6,23,1,4
441335,29,6,23,2,1
441335,29,6,23,3,1
441335,29,6,23,5,1
441335,29,6,23,20,1
441335,29,6,23,21,4
441335,29,6,23,22,1
441335,29,6,23,23,1
441335,29,6,23,25,1
441335,29,6,23,40,1
441353,16,1,15,1,4
441353,16,1,15,2,1
441353,16,1,15,3,1
441353,5,0,5,4,1
441353,11,1,10,5,1
441353,11,1,10,20,1
441353,16,1,15,21,4
441353,16,1,15,22,1
441353,16,1,15,23,1
441353,5,0,5,24,1
441353,11,1,10,25,1
441353,11,1,10,40,1
441362,480,56,424,1,4
441362,480,56,424,2,1
441362,480,56,424,3,1
441362,397,46,351,4,1
441362,83,10,73,5,1
441362,83,10,73,20,1
441362,351,41,310,21,4
441362,351,41,310,22,1
441362,351,41,310,23,1
441362,290,35,255,24,1
441362,61,6,55,25,1
441362,61,6,55,40,1
441362,129,15,114,41,4
441362,129,15,114,42,1
441362,129,15,114,43,1
441362,107,11,96,44,1
441362,22,4,18,45,1
441362,22,4,18,60,1
441371,359,67,292,1,4
441371,359,67,292,2,1
441371,359,67,292,3,1
441371,97,19,78,4,1
441371,262,48,214,5,1
441371,262,48,214,20,1
441371,357,67,290,21,4
441371,357,67,290,22,1
441371,357,67,290,23,1
441371,97,19,78,24,1
441371,260,48,212,25,1
441371,260,48,212,40,1
441371,2,0,2,41,4
441371,2,0,2,42,1
441371,2,0,2,43,1
441371,2,0,2,45,1
441371,2,0,2,60,1
441380,201,136,65,1,4
441380,201,136,65,2,1
441380,201,136,65,3,1
441380,63,43,20,4,1
441380,138,93,45,5,1
441380,138,93,45,20,1
441380,157,108,49,21,4
441380,157,108,49,22,1
441380,157,108,49,23,1
441380,58,41,17,24,1
441380,99,67,32,25,1
441380,99,67,32,40,1
441380,44,28,16,41,4
441380,44,28,16,42,1
441380,44,28,16,43,1
441380,5,2,3,44,1
441380,39,26,13,45,1
441380,39,26,13,60,1
441405,14,2,12,1,4
441405,14,2,12,2,1
441405,14,2,12,3,1
441405,12,2,10,4,1
441405,2,0,2,5,1
441405,2,0,2,20,1
441405,14,2,12,21,4
441405,14,2,12,22,1
441405,14,2,12,23,1
441405,12,2,10,24,1
441405,2,0,2,25,1
441405,2,0,2,40,1
441414,390,158,232,1,4
441414,390,158,232,2,1
441414,390,158,232,3,1
441414,154,55,99,4,1
441414,236,103,133,5,1
441414,236,103,133,20,1
441414,78,25,53,21,4
441414,78,25,53,22,1
441414,78,25,53,23,1
441414,25,12,13,24,1
441414,53,13,40,25,1
441414,53,13,40,40,1
441414,312,133,179,41,4
441414,312,133,179,42,1
441414,312,133,179,43,1
441414,129,43,86,44,1
441414,183,90,93,45,1
441414,183,90,93,60,1
441423,350,45,305,1,4
441423,350,45,305,2,1
441423,350,45,305,3,1
441423,145,19,126,4,1
441423,205,26,179,5,1
441423,205,26,179,20,1
441423,350,45,305,21,4
441423,350,45,305,22,1
441423,350,45,305,23,1
441423,145,19,126,24,1
441423,205,26,179,25,1
441423,205,26,179,40,1
441432,93,19,74,1,4
441432,93,19,74,2,1
441432,93,19,74,3,1
441432,41,8,33,4,1
441432,52,11,41,5,1
441432,52,11,41,20,1
441432,93,19,74,21,4
441432,93,19,74,22,1
441432,93,19,74,23,1
441432,41,8,33,24,1
441432,52,11,41,25,1
441432,52,11,41,40,1
441441,263,40,223,1,4
441441,263,40,223,2,1
441441,263,40,223,3,1
441441,191,29,162,4,1
441441,72,11,61,5,1
441441,72,11,61,20,1
441441,263,40,223,21,4
441441,263,40,223,22,1
441441,263,40,223,23,1
441441,191,29,162,24,1
441441,72,11,61,25,1
441441,72,11,61,40,1
441478,142,84,58,1,4
441478,33,20,13,2,1
441478,33,20,13,3,1
441478,33,20,13,5,1
441478,109,64,45,12,3
441478,33,20,13,19,1
441478,142,84,58,21,4
441478,33,20,13,22,1
441478,33,20,13,23,1
441478,33,20,13,25,1
441478,109,64,45,32,3
441478,33,20,13,39,1
441487,139,16,123,1,4
441487,139,16,123,2,1
441487,139,16,123,3,1
441487,54,7,47,4,1
441487,85,9,76,5,1
441487,47,5,42,19,1
441487,38,4,34,20,1
441487,94,11,83,21,4
441487,94,11,83,22,1
441487,94,11,83,23,1
441487,29,4,25,24,1
441487,65,7,58,25,1
441487,27,3,24,39,1
441487,38,4,34,40,1
441487,45,5,40,41,4
441487,45,5,40,42,1
441487,45,5,40,43,1
441487,25,3,22,44,1
441487,20,2,18,45,1
441487,20,2,18,59,1
441496,92,86,6,1,4
441496,92,86,6,2,1
441496,92,86,6,3,1
441496,92,86,6,5,1
441496,92,86,6,20,1
441496,89,83,6,21,4
441496,89,83,6,22,1
441496,89,83,6,23,1
441496,89,83,6,25,1
441496,89,83,6,40,1
441496,3,3,0,41,4
441496,3,3,0,42,1
441496,3,3,0,43,1
441496,3,3,0,45,1
441496,3,3,0,60,1
441502,274,27,247,1,4
441502,274,27,247,2,1
441502,274,27,247,3,1
441502,161,22,139,4,1
441502,113,5,108,5,1
441502,113,5,108,19,1
441502,199,15,184,21,4
441502,199,15,184,22,1
441502,199,15,184,23,1
441502,117,13,104,24,1
441502,82,2,80,25,1
441502,82,2,80,39,1
441502,75,12,63,41,4
441502,75,12,63,42,1
441502,75,12,63,43,1
441502,44,9,35,44,1
441502,31,3,28,45,1
441502,31,3,28,59,1
441511,767,266,501,1,4
441511,620,223,397,2,1
441511,620,223,397,3,1
441511,63,26,37,4,1
441511,557,197,360,5,1
441511,147,43,104,12,3
441511,23,8,15,19,1
441511,534,189,345,20,1
441511,636,220,416,21,4
441511,562,200,362,22,1
441511,562,200,362,23,1
441511,44,21,23,24,1
441511,518,179,339,25,1
441511,74,20,54,32,3
441511,23,8,15,39,1
441511,495,171,324,40,1
441511,131,46,85,41,4
441511,58,23,35,42,1
441511,58,23,35,43,1
441511,19,5,14,44,1
441511,39,18,21,45,1
441511,73,23,50,52,3
441511,39,18,21,60,1
441548,139,35,104,1,4
441548,139,35,104,2,1
441548,139,35,104,3,1
441548,129,33,96,4,1
441548,10,2,8,5,1
441548,10,2,8,20,1
441548,139,35,104,21,4
441548,139,35,104,22,1
441548,139,35,104,23,1
441548,129,33,96,24,1
441548,10,2,8,25,1
441548,10,2,8,40,1
441575,864,165,699,1,4
441575,864,165,699,2,1
441575,864,165,699,3,1
441575,234,35,199,4,1
441575,630,130,500,5,1
441575,630,130,500,20,1
441575,864,165,699,21,4
441575,864,165,699,22,1
441575,864,165,699,23,1
441575,234,35,199,24,1
441575,630,130,500,25,1
441575,630,130,500,40,1
441593,33,3,30,1,4
441593,33,3,30,2,1
441593,33,3,30,3,1
441593,10,1,9,4,1
441593,23,2,21,5,1
441593,23,2,21,20,1
441593,33,3,30,21,4
441593,33,3,30,22,1
441593,33,3,30,23,1
441593,10,1,9,24,1
441593,23,2,21,25,1
441593,23,2,21,40,1
441609,116,116,0,1,4
441609,116,116,0,2,1
441609,116,116,0,3,1
441609,5,5,0,4,1
441609,111,111,0,5,1
441609,111,111,0,20,1
441609,116,116,0,21,4
441609,116,116,0,22,1
441609,116,116,0,23,1
441609,5,5,0,24,1
441609,111,111,0,25,1
441609,111,111,0,40,1
441618,14,2,12,1,4
441618,14,2,12,2,1
441618,14,2,12,3,1
441618,8,2,6,4,1
441618,6,0,6,5,1
441618,6,0,6,20,1
441618,10,1,9,21,4
441618,10,1,9,22,1
441618,10,1,9,23,1
441618,6,1,5,24,1
441618,4,0,4,25,1
441618,4,0,4,40,1
441618,4,1,3,41,4
441618,4,1,3,42,1
441618,4,1,3,43,1
441618,2,1,1,44,1
441618,2,0,2,45,1
441618,2,0,2,60,1
441627,24,14,10,1,4
441627,24,14,10,2,1
441627,24,14,10,3,1
441627,24,14,10,5,1
441627,24,14,10,20,1
441627,24,14,10,21,4
441627,24,14,10,22,1
441627,24,14,10,23,1
441627,24,14,10,25,1
441627,24,14,10,40,1
441636,263,43,220,1,4
441636,263,43,220,2,1
441636,263,43,220,3,1
441636,9,2,7,4,1
441636,254,41,213,5,1
441636,100,13,87,19,1
441636,154,28,126,20,1
441636,220,36,184,21,4
441636,220,36,184,22,1
441636,220,36,184,23,1
441636,6,1,5,24,1
441636,214,35,179,25,1
441636,84,10,74,39,1
441636,130,25,105,40,1
441636,43,7,36,41,4
441636,43,7,36,42,1
441636,43,7,36,43,1
441636,3,1,2,44,1
441636,40,6,34,45,1
441636,16,3,13,59,1
441636,24,3,21,60,1
441645,149,7,142,1,4
441645,149,7,142,2,1
441645,149,7,142,3,1
441645,14,1,13,4,1
441645,135,6,129,5,1
441645,135,6,129,20,1
441645,145,7,138,21,4
441645,145,7,138,22,1
441645,145,7,138,23,1
441645,14,1,13,24,1
441645,131,6,125,25,1
441645,131,6,125,40,1
441645,4,0,4,41,4
441645,4,0,4,42,1
441645,4,0,4,43,1
441645,4,0,4,45,1
441645,4,0,4,60,1
441663,335,60,275,1,4
441663,335,60,275,2,1
441663,335,60,275,3,1
441663,121,27,94,4,1
441663,214,33,181,5,1
441663,214,33,181,20,1
441663,304,55,249,21,4
441663,304,55,249,22,1
441663,304,55,249,23,1
441663,114,26,88,24,1
441663,190,29,161,25,1
441663,190,29,161,40,1
441663,31,5,26,41,4
441663,31,5,26,42,1
441663,31,5,26,43,1
441663,7,1,6,44,1
441663,24,4,20,45,1
441663,24,4,20,60,1
441672,64,11,53,1,4
441672,64,11,53,2,1
441672,64,11,53,3,1
441672,57,9,48,4,1
441672,7,2,5,5,1
441672,7,2,5,20,1
441672,64,11,53,21,4
441672,64,11,53,22,1
441672,64,11,53,23,1
441672,57,9,48,24,1
441672,7,2,5,25,1
441672,7,2,5,40,1
441690,412,256,156,1,4
441690,375,234,141,2,1
441690,355,227,128,3,1
441690,31,23,8,4,1
441690,324,204,120,5,1
441690,20,7,13,11,1
441690,37,22,15,12,3
441690,59,36,23,19,1
441690,265,168,97,20,1
441690,160,104,56,21,4
441690,145,95,50,22,1
441690,145,95,50,23,1
441690,12,9,3,24,1
441690,133,86,47,25,1
441690,15,9,6,32,3
441690,27,19,8,39,1
441690,106,67,39,40,1
441690,252,152,100,41,4
441690,230,139,91,42,1
441690,210,132,78,43,1
441690,19,14,5,44,1
441690,191,118,73,45,1
441690,20,7,13,51,1
441690,22,13,9,52,3
441690,32,17,15,59,1
441690,159,101,58,60,1
441706,189,87,102,1,4
441706,189,87,102,2,1
441706,189,87,102,3,1
441706,141,65,76,4,1
441706,48,22,26,5,1
441706,48,22,26,20,1
441706,189,87,102,21,4
441706,189,87,102,22,1
441706,189,87,102,23,1
441706,141,65,76,24,1
441706,48,22,26,25,1
441706,48,22,26,40,1
441742,785,87,698,1,4
441742,785,87,698,2,1
441742,785,87,698,3,1
441742,174,20,154,4,1
441742,611,67,544,5,1
441742,611,67,544,20,1
441742,785,87,698,21,4
441742,785,87,698,22,1
441742,785,87,698,23,1
441742,174,20,154,24,1
441742,611,67,544,25,1
441742,611,67,544,40,1
441751,18,2,16,1,4
441751,18,2,16,2,1
441751,18,2,16,3,1
441751,1,0,1,4,1
441751,17,2,15,5,1
441751,17,2,15,20,1
441751,18,2,16,21,4
441751,18,2,16,22,1
441751,18,2,16,23,1
441751,1,0,1,24,1
441751,17,2,15,25,1
441751,17,2,15,40,1
441760,2995,1634,1361,1,4
441760,2995,1634,1361,2,1
441760,2569,1420,1149,3,1
441760,660,388,272,4,1
441760,1909,1032,877,5,1
441760,426,214,212,11,1
441760,321,166,155,19,1
441760,1588,866,722,20,1
441760,1366,838,528,21,4
441760,1366,838,528,22,1
441760,1330,814,516,23,1
441760,439,285,154,24,1
441760,891,529,362,25,1
441760,36,24,12,31,1
441760,177,95,82,39,1
441760,714,434,280,40,1
441760,1629,796,833,41,4
441760,1629,796,833,42,1
441760,1239,606,633,43,1
441760,221,103,118,44,1
441760,1018,503,515,45,1
441760,390,190,200,51,1
441760,144,71,73,59,1
441760,874,432,442,60,1
441779,68,1,67,1,4
441779,68,1,67,2,1
441779,68,1,67,3,1
441779,21,1,20,4,1
441779,47,0,47,5,1
441779,47,0,47,20,1
441779,68,1,67,21,4
441779,68,1,67,22,1
441779,68,1,67,23,1
441779,21,1,20,24,1
441779,47,0,47,25,1
441779,47,0,47,40,1
441788,341,328,13,1,4
441788,341,328,13,2,1
441788,341,328,13,3,1
441788,59,55,4,4,1
441788,282,273,9,5,1
441788,282,273,9,20,1
441788,313,301,12,21,4
441788,313,301,12,22,1
441788,313,301,12,23,1
441788,58,54,4,24,1
441788,255,247,8,25,1
441788,255,247,8,40,1
441788,28,27,1,41,4
441788,28,27,1,42,1
441788,28,27,1,43,1
441788,1,1,0,44,1
441788,27,26,1,45,1
441788,27,26,1,60,1
441830,67,14,53,1,4
441830,67,14,53,2,1
441830,67,14,53,3,1
441830,25,8,17,4,1
441830,42,6,36,5,1
441830,42,6,36,20,1
441830,23,4,19,21,4
441830,23,4,19,22,1
441830,23,4,19,23,1
441830,11,1,10,24,1
441830,12,3,9,25,1
441830,12,3,9,40,1
441830,44,10,34,41,4
441830,44,10,34,42,1
441830,44,10,34,43,1
441830,14,7,7,44,1
441830,30,3,27,45,1
441830,30,3,27,60,1
441858,280,20,260,1,4
441858,280,20,260,2,1
441858,280,20,260,3,1
441858,125,7,118,4,1
441858,155,13,142,5,1
441858,155,13,142,20,1
441858,197,16,181,21,4
441858,197,16,181,22,1
441858,197,16,181,23,1
441858,82,6,76,24,1
441858,115,10,105,25,1
441858,115,10,105,40,1
441858,83,4,79,41,4
441858,83,4,79,42,1
441858,83,4,79,43,1
441858,43,1,42,44,1
441858,40,3,37,45,1
441858,40,3,37,60,1
441876,228,12,216,1,4
441876,228,12,216,2,1
441876,228,12,216,3,1
441876,20,2,18,4,1
441876,208,10,198,5,1
441876,208,10,198,20,1
441876,167,9,158,21,4
441876,167,9,158,22,1
441876,167,9,158,23,1
441876,17,2,15,24,1
441876,150,7,143,25,1
441876,150,7,143,40,1
441876,61,3,58,41,4
441876,61,3,58,42,1
441876,61,3,58,43,1
441876,3,0,3,44,1
441876,58,3,55,45,1
441876,58,3,55,60,1
441894,5,5,0,1,4
441894,5,5,0,2,1
441894,5,5,0,3,1
441894,3,3,0,4,1
441894,2,2,0,5,1
441894,2,2,0,20,1
441894,5,5,0,21,4
441894,5,5,0,22,1
441894,5,5,0,23,1
441894,3,3,0,24,1
441894,2,2,0,25,1
441894,2,2,0,40,1
441900,3377,825,2552,1,4
441900,3377,825,2552,2,1
441900,3076,719,2357,3,1
441900,264,66,198,4,1
441900,2812,653,2159,5,1
441900,301,106,195,11,1
441900,507,111,396,19,1
441900,2305,542,1763,20,1
441900,1199,291,908,21,4
441900,1199,291,908,22,1
441900,1182,285,897,23,1
441900,163,38,125,24,1
441900,1019,247,772,25,1
441900,17,6,11,31,1
441900,155,32,123,39,1
441900,864,215,649,40,1
441900,2178,534,1644,41,4
441900,2178,534,1644,42,1
441900,1894,434,1460,43,1
441900,101,28,73,44,1
441900,1793,406,1387,45,1
441900,284,100,184,51,1
441900,352,79,273,59,1
441900,1441,327,1114,60,1
441919,376,51,325,1,4
441919,376,51,325,2,1
441919,376,51,325,3,1
441919,185,31,154,4,1
441919,191,20,171,5,1
441919,191,20,171,20,1
441919,279,37,242,21,4
441919,279,37,242,22,1
441919,279,37,242,23,1
441919,164,23,141,24,1
441919,115,14,101,25,1
441919,115,14,101,40,1
441919,97,14,83,41,4
441919,97,14,83,42,1
441919,97,14,83,43,1
441919,21,8,13,44,1
441919,76,6,70,45,1
441919,76,6,70,60,1
441928,642,112,530,1,4
441928,642,112,530,2,1
441928,642,112,530,3,1
441928,326,57,269,4,1
441928,316,55,261,5,1
441928,316,55,261,20,1
441928,315,61,254,21,4
441928,315,61,254,22,1
441928,315,61,254,23,1
441928,183,37,146,24,1
441928,132,24,108,25,1
441928,132,24,108,40,1
441928,327,51,276,41,4
441928,327,51,276,42,1
441928,327,51,276,43,1
441928,143,20,123,44,1
441928,184,31,153,45,1
441928,184,31,153,60,1
441937,5140,1823,3317,1,4
441937,4963,1772,3191,2,1
441937,4950,1768,3182,3,1
441937,832,278,554,4,1
441937,4118,1490,2628,5,1
441937,13,4,9,11,1
441937,177,51,126,12,3
441937,915,370,545,19,1
441937,3203,1120,2083,20,1
441937,4401,1555,2846,21,4
441937,4281,1518,2763,22,1
441937,4272,1514,2758,23,1
441937,823,273,550,24,1
441937,3449,1241,2208,25,1
441937,9,4,5,31,1
441937,120,37,83,32,3
441937,730,304,426,39,1
441937,2719,937,1782,40,1
441937,739,268,471,41,4
441937,682,254,428,42,1
441937,678,254,424,43,1
441937,9,5,4,44,1
441937,669,249,420,45,1
441937,4,0,4,51,1
441937,57,14,43,52,3
441937,185,66,119,59,1
441937,484,183,301,60,1
441955,678,572,106,1,4
441955,678,572,106,2,1
441955,678,572,106,3,1
441955,103,84,19,4,1
441955,575,488,87,5,1
441955,575,488,87,20,1
441955,495,427,68,21,4
441955,495,427,68,22,1
441955,495,427,68,23,1
441955,93,74,19,24,1
441955,402,353,49,25,1
441955,402,353,49,40,1
441955,183,145,38,41,4
441955,183,145,38,42,1
441955,183,145,38,43,1
441955,10,10,0,44,1
441955,173,135,38,45,1
441955,173,135,38,60,1
441964,573,481,92,1,4
441964,573,481,92,2,1
441964,573,481,92,3,1
441964,58,46,12,4,1
441964,515,435,80,5,1
441964,9,9,0,19,1
441964,506,426,80,20,1
441964,465,392,73,21,4
441964,465,392,73,22,1
441964,465,392,73,23,1
441964,54,43,11,24,1
441964,411,349,62,25,1
441964,9,9,0,39,1
441964,402,340,62,40,1
441964,108,89,19,41,4
441964,108,89,19,42,1
441964,108,89,19,43,1
441964,4,3,1,44,1
441964,104,86,18,45,1
441964,104,86,18,60,1
441973,1761,912,849,1,4
441973,1761,912,849,2,1
441973,1761,912,849,3,1
441973,357,194,163,4,1
441973,1404,718,686,5,1
441973,247,110,137,19,1
441973,1157,608,549,20,1
441973,951,515,436,21,4
441973,951,515,436,22,1
441973,951,515,436,23,1
441973,230,132,98,24,1
441973,721,383,338,25,1
441973,150,65,85,39,1
441973,571,318,253,40,1
441973,810,397,413,41,4
441973,810,397,413,42,1
441973,810,397,413,43,1
441973,127,62,65,44,1
441973,683,335,348,45,1
441973,97,45,52,59,1
441973,586,290,296,60,1
441982,355,177,178,1,4
441982,355,177,178,2,1
441982,343,171,172,3,1
441982,82,36,46,4,1
441982,261,135,126,5,1
441982,12,6,6,11,1
441982,4,3,1,19,1
441982,257,132,125,20,1
441982,355,177,178,21,4
441982,355,177,178,22,1
441982,343,171,172,23,1
441982,82,36,46,24,1
441982,261,135,126,25,1
441982,12,6,6,31,1
441982,4,3,1,39,1
441982,257,132,125,40,1
442037,311,80,231,1,4
442037,311,80,231,2,1
442037,311,80,231,3,1
442037,27,7,20,4,1
442037,284,73,211,5,1
442037,3,2,1,19,1
442037,281,71,210,20,1
442037,311,80,231,21,4
442037,311,80,231,22,1
442037,311,80,231,23,1
442037,27,7,20,24,1
442037,284,73,211,25,1
442037,3,2,1,39,1
442037,281,71,210,40,1
442046,478,54,424,1,4
442046,478,54,424,2,1
442046,478,54,424,3,1
442046,171,22,149,4,1
442046,307,32,275,5,1
442046,1,0,1,19,1
442046,306,32,274,20,1
442046,438,50,388,21,4
442046,438,50,388,22,1
442046,438,50,388,23,1
442046,159,20,139,24,1
442046,279,30,249,25,1
442046,1,0,1,39,1
442046,278,30,248,40,1
442046,40,4,36,41,4
442046,40,4,36,42,1
442046,40,4,36,43,1
442046,12,2,10,44,1
442046,28,2,26,45,1
442046,28,2,26,60,1
442064,86,27,59,1,4
442064,86,27,59,12,3
442064,76,25,51,21,4
442064,76,25,51,32,3
442064,10,2,8,41,4
442064,10,2,8,52,3
442073,645,178,467,1,4
442073,645,178,467,2,1
442073,645,178,467,3,1
442073,134,36,98,4,1
442073,511,142,369,5,1
442073,511,142,369,20,1
442073,371,103,268,21,4
442073,371,103,268,22,1
442073,371,103,268,23,1
442073,88,21,67,24,1
442073,283,82,201,25,1
442073,283,82,201,40,1
442073,274,75,199,41,4
442073,274,75,199,42,1
442073,274,75,199,43,1
442073,46,15,31,44,1
442073,228,60,168,45,1
442073,228,60,168,60,1
442134,547,67,480,1,4
442134,547,67,480,2,1
442134,543,67,476,3,1
442134,199,27,172,4,1
442134,344,40,304,5,1
442134,4,0,4,11,1
442134,344,40,304,20,1
442134,547,67,480,21,4
442134,547,67,480,22,1
442134,543,67,476,23,1
442134,199,27,172,24,1
442134,344,40,304,25,1
442134,4,0,4,31,1
442134,344,40,304,40,1
442143,567,190,377,1,4
442143,517,170,347,2,1
442143,517,170,347,3,1
442143,16,4,12,4,1
442143,501,166,335,5,1
442143,50,20,30,12,3
442143,35,16,19,19,1
442143,466,150,316,20,1
442143,567,190,377,21,4
442143,517,170,347,22,1
442143,517,170,347,23,1
442143,16,4,12,24,1
442143,501,166,335,25,1
442143,50,20,30,32,3
442143,35,16,19,39,1
442143,466,150,316,40,1
442152,1510,518,992,1,4
442152,1350,462,888,2,1
442152,1350,462,888,3,1
442152,48,18,30,4,1
442152,1302,444,858,5,1
442152,160,56,104,12,3
442152,89,42,47,19,1
442152,1213,402,811,20,1
442152,1510,518,992,21,4
442152,1350,462,888,22,1
442152,1350,462,888,23,1
442152,48,18,30,24,1
442152,1302,444,858,25,1
442152,160,56,104,32,3
442152,89,42,47,39,1
442152,1213,402,811,40,1
442161,882,337,545,1,4
442161,813,305,508,2,1
442161,813,305,508,3,1
442161,39,11,28,4,1
442161,774,294,480,5,1
442161,69,32,37,12,3
442161,48,21,27,19,1
442161,726,273,453,20,1
442161,882,337,545,21,4
442161,813,305,508,22,1
442161,813,305,508,23,1
442161,39,11,28,24,1
442161,774,294,480,25,1
442161,69,32,37,32,3
442161,48,21,27,39,1
442161,726,273,453,40,1
442170,1890,682,1208,1,4
442170,1737,621,1116,2,1
442170,1737,621,1116,3,1
442170,70,28,42,4,1
442170,1667,593,1074,5,1
442170,153,61,92,12,3
442170,86,37,49,19,1
442170,1581,556,1025,20,1
442170,1890,682,1208,21,4
442170,1737,621,1116,22,1
442170,1737,621,1116,23,1
442170,70,28,42,24,1
442170,1667,593,1074,25,1
442170,153,61,92,32,3
442170,86,37,49,39,1
442170,1581,556,1025,40,1
442189,865,539,326,1,4
442189,650,408,242,2,1
442189,650,408,242,3,1
442189,3,2,1,4,1
442189,647,406,241,5,1
442189,215,131,84,12,3
442189,45,29,16,19,1
442189,602,377,225,20,1
442189,865,539,326,21,4
442189,650,408,242,22,1
442189,650,408,242,23,1
442189,3,2,1,24,1
442189,647,406,241,25,1
442189,215,131,84,32,3
442189,45,29,16,39,1
442189,602,377,225,40,1
442204,199,51,148,1,4
442204,199,51,148,2,1
442204,199,51,148,3,1
442204,135,37,98,4,1
442204,64,14,50,5,1
442204,64,14,50,20,1
442204,187,51,136,21,4
442204,187,51,136,22,1
442204,187,51,136,23,1
442204,132,37,95,24,1
442204,55,14,41,25,1
442204,55,14,41,40,1
442204,12,0,12,41,4
442204,12,0,12,42,1
442204,12,0,12,43,1
442204,3,0,3,44,1
442204,9,0,9,45,1
442204,9,0,9,60,1
442213,58,1,57,1,4
442213,58,1,57,2,1
442213,58,1,57,3,1
442213,2,0,2,4,1
442213,56,1,55,5,1
442213,56,1,55,20,1
442213,19,0,19,21,4
442213,19,0,19,22,1
442213,19,0,19,23,1
442213,1,0,1,24,1
442213,18,0,18,25,1
442213,18,0,18,40,1
442213,39,1,38,41,4
442213,39,1,38,42,1
442213,39,1,38,43,1
442213,1,0,1,44,1
442213,38,1,37,45,1
442213,38,1,37,60,1
442222,495,125,370,1,4
442222,219,56,163,2,1
442222,218,55,163,3,1
442222,41,10,31,4,1
442222,177,45,132,5,1
442222,1,1,0,11,1
442222,276,69,207,12,3
442222,52,9,43,19,1
442222,125,36,89,20,1
442222,62,18,44,21,4
442222,19,8,11,22,1
442222,19,8,11,23,1
442222,19,8,11,25,1
442222,43,10,33,32,3
442222,3,0,3,39,1
442222,16,8,8,40,1
442222,433,107,326,41,4
442222,200,48,152,42,1
442222,199,47,152,43,1
442222,41,10,31,44,1
442222,158,37,121,45,1
442222,1,1,0,51,1
442222,233,59,174,52,3
442222,49,9,40,59,1
442222,109,28,81,60,1
442231,961,498,463,1,4
442231,961,498,463,2,1
442231,961,498,463,3,1
442231,129,75,54,4,1
442231,832,423,409,5,1
442231,55,23,32,19,1
442231,777,400,377,20,1
442231,961,498,463,21,4
442231,961,498,463,22,1
442231,961,498,463,23,1
442231,129,75,54,24,1
442231,832,423,409,25,1
442231,55,23,32,39,1
442231,777,400,377,40,1
442240,188,17,171,1,4
442240,188,17,171,2,1
442240,188,17,171,3,1
442240,44,1,43,4,1
442240,144,16,128,5,1
442240,144,16,128,20,1
442240,141,14,127,21,4
442240,141,14,127,22,1
442240,141,14,127,23,1
442240,36,1,35,24,1
442240,105,13,92,25,1
442240,105,13,92,40,1
442240,47,3,44,41,4
442240,47,3,44,42,1
442240,47,3,44,43,1
442240,8,0,8,44,1
442240,39,3,36,45,1
442240,39,3,36,60,1
442295,319,163,156,1,4
442295,319,163,156,12,3
442295,315,161,154,21,4
442295,315,161,154,32,3
442295,4,2,2,41,4
442295,4,2,2,52,3
442329,696,680,16,1,4
442329,696,680,16,2,1
442329,696,680,16,3,1
442329,336,328,8,4,1
442329,360,352,8,5,1
442329,360,352,8,20,1
442329,696,680,16,21,4
442329,696,680,16,22,1
442329,696,680,16,23,1
442329,336,328,8,24,1
442329,360,352,8,25,1
442329,360,352,8,40,1
442338,442,286,156,1,4
442338,442,286,156,2,1
442338,442,286,156,3,1
442338,52,37,15,4,1
442338,390,249,141,5,1
442338,25,6,19,19,1
442338,365,243,122,20,1
442338,303,207,96,21,4
442338,303,207,96,22,1
442338,303,207,96,23,1
442338,45,30,15,24,1
442338,258,177,81,25,1
442338,20,5,15,39,1
442338,238,172,66,40,1
442338,139,79,60,41,4
442338,139,79,60,42,1
442338,139,79,60,43,1
442338,7,7,0,44,1
442338,132,72,60,45,1
442338,5,1,4,59,1
442338,127,71,56,60,1
442347,310,231,79,1,4
442347,310,231,79,2,1
442347,310,231,79,3,1
442347,53,38,15,4,1
442347,257,193,64,5,1
442347,4,3,1,19,1
442347,253,190,63,20,1
442347,220,163,57,21,4
442347,220,163,57,22,1
442347,220,163,57,23,1
442347,41,30,11,24,1
442347,179,133,46,25,1
442347,4,3,1,39,1
442347,175,130,45,40,1
442347,90,68,22,41,4
442347,90,68,22,42,1
442347,90,68,22,43,1
442347,12,8,4,44,1
442347,78,60,18,45,1
442347,78,60,18,60,1
442356,1429,203,1226,1,4
442356,1429,203,1226,2,1
442356,1394,198,1196,3,1
442356,179,39,140,4,1
442356,1215,159,1056,5,1
442356,35,5,30,11,1
442356,278,41,237,19,1
442356,937,118,819,20,1
442356,520,72,448,21,4
442356,520,72,448,22,1
442356,519,72,447,23,1
442356,109,8,101,24,1
442356,410,64,346,25,1
442356,1,0,1,31,1
442356,80,17,63,39,1
442356,330,47,283,40,1
442356,909,131,778,41,4
442356,909,131,778,42,1
442356,875,126,749,43,1
442356,70,31,39,44,1
442356,805,95,710,45,1
442356,34,5,29,51,1
442356,198,24,174,59,1
442356,607,71,536,60,1
442383,210,33,177,1,4
442383,210,33,177,2,1
442383,210,33,177,3,1
442383,63,15,48,4,1
442383,147,18,129,5,1
442383,37,4,33,19,1
442383,110,14,96,20,1
442383,194,31,163,21,4
442383,194,31,163,22,1
442383,194,31,163,23,1
442383,62,15,47,24,1
442383,132,16,116,25,1
442383,37,4,33,39,1
442383,95,12,83,40,1
442383,16,2,14,41,4
442383,16,2,14,42,1
442383,16,2,14,43,1
442383,1,0,1,44,1
442383,15,2,13,45,1
442383,15,2,13,60,1
442392,152,56,96,1,4
442392,152,56,96,12,3
442392,152,56,96,21,4
442392,152,56,96,32,3
442408,229,211,18,1,4
442408,229,211,18,2,1
442408,229,211,18,3,1
442408,24,24,0,4,1
442408,205,187,18,5,1
442408,16,12,4,19,1
442408,189,175,14,20,1
442408,229,211,18,21,4
442408,229,211,18,22,1
442408,229,211,18,23,1
442408,24,24,0,24,1
442408,205,187,18,25,1
442408,16,12,4,39,1
442408,189,175,14,40,1
442426,301,38,263,1,4
442426,301,38,263,2,1
442426,301,38,263,3,1
442426,47,7,40,4,1
442426,254,31,223,5,1
442426,213,25,188,19,1
442426,41,6,35,20,1
442426,246,31,215,21,4
442426,246,31,215,22,1
442426,246,31,215,23,1
442426,37,5,32,24,1
442426,209,26,183,25,1
442426,172,21,151,39,1
442426,37,5,32,40,1
442426,55,7,48,41,4
442426,55,7,48,42,1
442426,55,7,48,43,1
442426,10,2,8,44,1
442426,45,5,40,45,1
442426,41,4,37,59,1
442426,4,1,3,60,1
442435,39,14,25,1,4
442435,39,14,25,2,1
442435,35,11,24,3,1
442435,14,4,10,4,1
442435,21,7,14,5,1
442435,4,3,1,11,1
442435,21,7,14,20,1
442435,39,14,25,21,4
442435,39,14,25,22,1
442435,35,11,24,23,1
442435,14,4,10,24,1
442435,21,7,14,25,1
442435,4,3,1,31,1
442435,21,7,14,40,1
442444,698,271,427,1,4
442444,698,271,427,2,1
442444,698,271,427,3,1
442444,63,35,28,4,1
442444,635,236,399,5,1
442444,75,22,53,19,1
442444,560,214,346,20,1
442444,698,271,427,21,4
442444,698,271,427,22,1
442444,698,271,427,23,1
442444,63,35,28,24,1
442444,635,236,399,25,1
442444,75,22,53,39,1
442444,560,214,346,40,1
442462,251,53,198,1,4
442462,251,53,198,2,1
442462,251,53,198,3,1
442462,100,24,76,4,1
442462,151,29,122,5,1
442462,151,29,122,20,1
442462,251,53,198,21,4
442462,251,53,198,22,1
442462,251,53,198,23,1
442462,100,24,76,24,1
442462,151,29,122,25,1
442462,151,29,122,40,1
442523,53,24,29,1,4
442523,53,24,29,2,1
442523,53,24,29,3,1
442523,20,11,9,4,1
442523,33,13,20,5,1
442523,5,3,2,19,1
442523,28,10,18,20,1
442523,49,22,27,21,4
442523,49,22,27,22,1
442523,49,22,27,23,1
442523,19,11,8,24,1
442523,30,11,19,25,1
442523,4,2,2,39,1
442523,26,9,17,40,1
442523,4,2,2,41,4
442523,4,2,2,42,1
442523,4,2,2,43,1
442523,1,0,1,44,1
442523,3,2,1,45,1
442523,1,1,0,59,1
442523,2,1,1,60,1
442569,11188,5981,5207,1,4
442569,9590,5054,4536,2,1
442569,9521,5011,4510,3,1
442569,1912,716,1196,4,1
442569,7609,4295,3314,5,1
442569,69,43,26,11,1
442569,1598,927,671,12,3
442569,486,207,279,19,1
442569,7123,4088,3035,20,1
442569,7841,3770,4071,21,4
442569,6545,3030,3515,22,1
442569,6537,3026,3511,23,1
442569,1773,614,1159,24,1
442569,4764,2412,2352,25,1
442569,8,4,4,31,1
442569,1296,740,556,32,3
442569,393,150,243,39,1
442569,4371,2262,2109,40,1
442569,3347,2211,1136,41,4
442569,3045,2024,1021,42,1
442569,2984,1985,999,43,1
442569,139,102,37,44,1
442569,2845,1883,962,45,1
442569,61,39,22,51,1
442569,302,187,115,52,3
442569,93,57,36,59,1
442569,2752,1826,926,60,1
442578,190,48,142,1,4
442578,190,48,142,2,1
442578,184,45,139,3,1
442578,17,1,16,4,1
442578,167,44,123,5,1
442578,6,3,3,11,1
442578,30,5,25,19,1
442578,137,39,98,20,1
442578,107,27,80,21,4
442578,107,27,80,22,1
442578,106,27,79,23,1
442578,12,1,11,24,1
442578,94,26,68,25,1
442578,1,0,1,31,1
442578,23,3,20,39,1
442578,71,23,48,40,1
442578,83,21,62,41,4
442578,83,21,62,42,1
442578,78,18,60,43,1
442578,5,0,5,44,1
442578,73,18,55,45,1
442578,5,3,2,51,1
442578,7,2,5,59,1
442578,66,16,50,60,1
442602,647,100,547,1,4
442602,647,100,547,2,1
442602,647,100,547,3,1
442602,50,9,41,4,1
442602,597,91,506,5,1
442602,105,18,87,19,1
442602,492,73,419,20,1
442602,545,74,471,21,4
442602,545,74,471,22,1
442602,545,74,471,23,1
442602,43,4,39,24,1
442602,502,70,432,25,1
442602,65,9,56,39,1
442602,437,61,376,40,1
442602,102,26,76,41,4
442602,102,26,76,42,1
442602,102,26,76,43,1
442602,7,5,2,44,1
442602,95,21,74,45,1
442602,40,9,31,59,1
442602,55,12,43,60,1
442611,1510,1465,45,1,4
442611,1510,1465,45,2,1
442611,1510,1465,45,3,1
442611,358,349,9,4,1
442611,1152,1116,36,5,1
442611,1152,1116,36,20,1
442611,1510,1465,45,21,4
442611,1510,1465,45,22,1
442611,1510,1465,45,23,1
442611,358,349,9,24,1
442611,1152,1116,36,25,1
442611,1152,1116,36,40,1
442620,314,46,268,1,4
442620,314,46,268,2,1
442620,314,46,268,3,1
442620,43,2,41,4,1
442620,271,44,227,5,1
442620,271,44,227,20,1
442620,314,46,268,21,4
442620,314,46,268,22,1
442620,314,46,268,23,1
442620,43,2,41,24,1
442620,271,44,227,25,1
442620,271,44,227,40,1
442639,35,21,14,1,4
442639,27,14,13,2,1
442639,26,13,13,3,1
442639,3,2,1,4,1
442639,23,11,12,5,1
442639,1,1,0,11,1
442639,8,7,1,12,3
442639,5,2,3,19,1
442639,18,9,9,20,1
442639,35,21,14,21,4
442639,27,14,13,22,1
442639,26,13,13,23,1
442639,3,2,1,24,1
442639,23,11,12,25,1
442639,1,1,0,31,1
442639,8,7,1,32,3
442639,5,2,3,39,1
442639,18,9,9,40,1
442648,289,58,231,1,4
442648,289,58,231,2,1
442648,289,58,231,3,1
442648,94,19,75,4,1
442648,195,39,156,5,1
442648,195,39,156,20,1
442648,289,58,231,21,4
442648,289,58,231,22,1
442648,289,58,231,23,1
442648,94,19,75,24,1
442648,195,39,156,25,1
442648,195,39,156,40,1
442657,272,48,224,1,4
442657,272,48,224,2,1
442657,272,48,224,3,1
442657,103,21,82,4,1
442657,169,27,142,5,1
442657,169,27,142,20,1
442657,272,48,224,21,4
442657,272,48,224,22,1
442657,272,48,224,23,1
442657,103,21,82,24,1
442657,169,27,142,25,1
442657,169,27,142,40,1
442718,470,73,397,1,4
442718,470,73,397,2,1
442718,470,73,397,3,1
442718,14,3,11,4,1
442718,456,70,386,5,1
442718,87,17,70,19,1
442718,369,53,316,20,1
442718,88,10,78,21,4
442718,88,10,78,22,1
442718,88,10,78,23,1
442718,88,10,78,25,1
442718,5,2,3,39,1
442718,83,8,75,40,1
442718,382,63,319,41,4
442718,382,63,319,42,1
442718,382,63,319,43,1
442718,14,3,11,44,1
442718,368,60,308,45,1
442718,82,15,67,59,1
442718,286,45,241,60,1
442727,880,314,566,1,4
442727,880,314,566,2,1
442727,880,314,566,3,1
442727,270,105,165,4,1
442727,610,209,401,5,1
442727,610,209,401,20,1
442727,880,314,566,21,4
442727,880,314,566,22,1
442727,880,314,566,23,1
442727,270,105,165,24,1
442727,610,209,401,25,1
442727,610,209,401,40,1
442736,288,40,248,1,4
442736,288,40,248,2,1
442736,288,40,248,3,1
442736,41,5,36,4,1
442736,247,35,212,5,1
442736,247,35,212,20,1
442736,288,40,248,21,4
442736,288,40,248,22,1
442736,288,40,248,23,1
442736,41,5,36,24,1
442736,247,35,212,25,1
442736,247,35,212,40,1
442745,365,76,289,1,4
442745,365,76,289,2,1
442745,365,76,289,3,1
442745,69,16,53,4,1
442745,296,60,236,5,1
442745,10,3,7,19,1
442745,286,57,229,20,1
442745,365,76,289,21,4
442745,365,76,289,22,1
442745,365,76,289,23,1
442745,69,16,53,24,1
442745,296,60,236,25,1
442745,10,3,7,39,1
442745,286,57,229,40,1
442781,243,78,165,1,4
442781,243,78,165,2,1
442781,184,54,130,3,1
442781,32,11,21,4,1
442781,152,43,109,5,1
442781,59,24,35,11,1
442781,20,5,15,19,1
442781,132,38,94,20,1
442781,73,27,46,21,4
442781,73,27,46,22,1
442781,73,27,46,23,1
442781,12,4,8,24,1
442781,61,23,38,25,1
442781,9,4,5,39,1
442781,52,19,33,40,1
442781,170,51,119,41,4
442781,170,51,119,42,1
442781,111,27,84,43,1
442781,20,7,13,44,1
442781,91,20,71,45,1
442781,59,24,35,51,1
442781,11,1,10,59,1
442781,80,19,61,60,1
442790,1071,291,780,1,4
442790,1071,291,780,2,1
442790,1071,291,780,3,1
442790,95,14,81,4,1
442790,976,277,699,5,1
442790,147,40,107,19,1
442790,829,237,592,20,1
442790,889,201,688,21,4
442790,889,201,688,22,1
442790,889,201,688,23,1
442790,92,12,80,24,1
442790,797,189,608,25,1
442790,108,16,92,39,1
442790,689,173,516,40,1
442790,182,90,92,41,4
442790,182,90,92,42,1
442790,182,90,92,43,1
442790,3,2,1,44,1
442790,179,88,91,45,1
442790,39,24,15,59,1
442790,140,64,76,60,1
442806,1278,610,668,1,4
442806,1278,610,668,12,3
442806,1278,610,668,21,4
442806,1278,610,668,32,3
442815,345,66,279,1,4
442815,345,66,279,2,1
442815,345,66,279,3,1
442815,322,62,260,4,1
442815,23,4,19,5,1
442815,23,4,19,20,1
442815,259,43,216,21,4
442815,259,43,216,22,1
442815,259,43,216,23,1
442815,240,40,200,24,1
442815,19,3,16,25,1
442815,19,3,16,40,1
442815,86,23,63,41,4
442815,86,23,63,42,1
442815,86,23,63,43,1
442815,82,22,60,44,1
442815,4,1,3,45,1
442815,4,1,3,60,1
442842,219,57,162,1,4
442842,75,27,48,2,1
442842,75,27,48,3,1
442842,19,4,15,4,1
442842,56,23,33,5,1
442842,144,30,114,12,3
442842,56,23,33,20,1
442842,126,33,93,21,4
442842,25,9,16,22,1
442842,25,9,16,23,1
442842,7,2,5,24,1
442842,18,7,11,25,1
442842,101,24,77,32,3
442842,18,7,11,40,1
442842,93,24,69,41,4
442842,50,18,32,42,1
442842,50,18,32,43,1
442842,12,2,10,44,1
442842,38,16,22,45,1
442842,43,6,37,52,3
442842,38,16,22,60,1
442879,1108,136,972,1,4
442879,1108,136,972,2,1
442879,1062,115,947,3,1
442879,317,42,275,4,1
442879,745,73,672,5,1
442879,46,21,25,11,1
442879,745,73,672,20,1
442879,1108,136,972,21,4
442879,1108,136,972,22,1
442879,1062,115,947,23,1
442879,317,42,275,24,1
442879,745,73,672,25,1
442879,46,21,25,31,1
442879,745,73,672,40,1
442888,84,57,27,1,4
442888,84,57,27,2,1
442888,84,57,27,3,1
442888,12,6,6,4,1
442888,72,51,21,5,1
442888,72,51,21,20,1
442888,84,57,27,21,4
442888,84,57,27,22,1
442888,84,57,27,23,1
442888,12,6,6,24,1
442888,72,51,21,25,1
442888,72,51,21,40,1
442897,114,37,77,1,4
442897,87,28,59,2,1
442897,87,28,59,3,1
442897,1,0,1,4,1
442897,86,28,58,5,1
442897,27,9,18,12,3
442897,13,6,7,19,1
442897,73,22,51,20,1
442897,114,37,77,41,4
442897,87,28,59,42,1
442897,87,28,59,43,1
442897,1,0,1,44,1
442897,86,28,58,45,1
442897,27,9,18,52,3
442897,13,6,7,59,1
442897,73,22,51,60,1
442930,804,318,486,1,4
442930,793,312,481,2,1
442930,793,312,481,3,1
442930,155,77,78,4,1
442930,638,235,403,5,1
442930,11,6,5,12,3
442930,94,31,63,19,1
442930,544,204,340,20,1
442930,804,318,486,21,4
442930,793,312,481,22,1
442930,793,312,481,23,1
442930,155,77,78,24,1
442930,638,235,403,25,1
442930,11,6,5,32,3
442930,94,31,63,39,1
442930,544,204,340,40,1
442949,82,0,82,1,4
442949,82,0,82,2,1
442949,67,0,67,3,1
442949,67,0,67,5,1
442949,15,0,15,11,1
442949,67,0,67,20,1
442949,32,0,32,21,4
442949,32,0,32,22,1
442949,32,0,32,23,1
442949,32,0,32,25,1
442949,32,0,32,40,1
442949,50,0,50,41,4
442949,50,0,50,42,1
442949,35,0,35,43,1
442949,35,0,35,45,1
442949,15,0,15,51,1
442949,35,0,35,60,1
442958,57,2,55,1,4
442958,57,2,55,2,1
442958,57,2,55,3,1
442958,18,1,17,4,1
442958,39,1,38,5,1
442958,39,1,38,20,1
442958,33,1,32,21,4
442958,33,1,32,22,1
442958,33,1,32,23,1
442958,15,1,14,24,1
442958,18,0,18,25,1
442958,18,0,18,40,1
442958,24,1,23,41,4
442958,24,1,23,42,1
442958,24,1,23,43,1
442958,3,0,3,44,1
442958,21,1,20,45,1
442958,21,1,20,60,1
442967,103,14,89,1,4
442967,103,14,89,2,1
442967,103,14,89,3,1
442967,34,2,32,4,1
442967,69,12,57,5,1
442967,69,12,57,20,1
442967,103,14,89,21,4
442967,103,14,89,22,1
442967,103,14,89,23,1
442967,34,2,32,24,1
442967,69,12,57,25,1
442967,69,12,57,40,1
442976,89,25,64,1,4
442976,89,25,64,2,1
442976,89,25,64,3,1
442976,40,14,26,4,1
442976,49,11,38,5,1
442976,49,11,38,20,1
442976,89,25,64,21,4
442976,89,25,64,22,1
442976,89,25,64,23,1
442976,40,14,26,24,1
442976,49,11,38,25,1
442976,49,11,38,40,1
442985,9,3,6,1,4
442985,9,3,6,2,1
442985,9,3,6,3,1
442985,3,1,2,4,1
442985,6,2,4,5,1
442985,6,2,4,20,1
442985,9,3,6,21,4
442985,9,3,6,22,1
442985,9,3,6,23,1
442985,3,1,2,24,1
442985,6,2,4,25,1
442985,6,2,4,40,1
443021,158,115,43,1,4
443021,158,115,43,2,1
443021,158,115,43,3,1
443021,108,79,29,4,1
443021,50,36,14,5,1
443021,50,36,14,20,1
443021,158,115,43,21,4
443021,158,115,43,22,1
443021,158,115,43,23,1
443021,108,79,29,24,1
443021,50,36,14,25,1
443021,50,36,14,40,1
443030,59,13,46,1,4
443030,59,13,46,12,3
443030,59,13,46,21,4
443030,59,13,46,32,3
443049,318,235,83,1,4
443049,135,97,38,2,1
443049,130,93,37,3,1
443049,6,2,4,4,1
443049,124,91,33,5,1
443049,5,4,1,11,1
443049,183,138,45,12,3
443049,17,11,6,19,1
443049,107,80,27,20,1
443049,219,157,62,21,4
443049,81,52,29,22,1
443049,79,51,28,23,1
443049,6,2,4,24,1
443049,73,49,24,25,1
443049,2,1,1,31,1
443049,138,105,33,32,3
443049,13,9,4,39,1
443049,60,40,20,40,1
443049,99,78,21,41,4
443049,54,45,9,42,1
443049,51,42,9,43,1
443049,51,42,9,45,1
443049,3,3,0,51,1
443049,45,33,12,52,3
443049,4,2,2,59,1
443049,47,40,7,60,1
443058,39,13,26,1,4
443058,39,13,26,2,1
443058,19,3,16,3,1
443058,3,0,3,4,1
443058,16,3,13,5,1
443058,20,10,10,11,1
443058,2,2,0,19,1
443058,14,1,13,20,1
443058,18,3,15,21,4
443058,18,3,15,22,1
443058,18,3,15,23,1
443058,2,0,2,24,1
443058,16,3,13,25,1
443058,2,2,0,39,1
443058,14,1,13,40,1
443058,21,10,11,41,4
443058,21,10,11,42,1
443058,1,0,1,43,1
443058,1,0,1,44,1
443058,20,10,10,51,1
443076,181,100,81,1,4
443076,6,1,5,2,1
443076,6,1,5,3,1
443076,1,0,1,4,1
443076,5,1,4,5,1
443076,175,99,76,12,3
443076,5,1,4,20,1
443076,146,84,62,21,4
443076,146,84,62,32,3
443076,35,16,19,41,4
443076,6,1,5,42,1
443076,6,1,5,43,1
443076,1,0,1,44,1
443076,5,1,4,45,1
443076,29,15,14,52,3
443076,5,1,4,60,1
443100,188,101,87,1,4
443100,188,101,87,2,1
443100,188,101,87,3,1
443100,79,47,32,4,1
443100,109,54,55,5,1
443100,109,54,55,20,1
443100,188,101,87,21,4
443100,188,101,87,22,1
443100,188,101,87,23,1
443100,79,47,32,24,1
443100,109,54,55,25,1
443100,109,54,55,40,1
443128,1342,655,687,1,4
443128,1342,655,687,12,3
443128,932,501,431,21,4
443128,932,501,431,32,3
443128,410,154,256,41,4
443128,410,154,256,52,3
443137,353,55,298,1,4
443137,353,55,298,2,1
443137,353,55,298,3,1
443137,283,43,240,4,1
443137,70,12,58,5,1
443137,70,12,58,20,1
443137,353,55,298,21,4
443137,353,55,298,22,1
443137,353,55,298,23,1
443137,283,43,240,24,1
443137,70,12,58,25,1
443137,70,12,58,40,1
443146,128,68,60,1,4
443146,128,68,60,2,1
443146,128,68,60,3,1
443146,15,10,5,4,1
443146,113,58,55,5,1
443146,113,58,55,20,1
443146,79,41,38,21,4
443146,79,41,38,22,1
443146,79,41,38,23,1
443146,10,7,3,24,1
443146,69,34,35,25,1
443146,69,34,35,40,1
443146,49,27,22,41,4
443146,49,27,22,42,1
443146,49,27,22,43,1
443146,5,3,2,44,1
443146,44,24,20,45,1
443146,44,24,20,60,1
443173,39,2,37,1,4
443173,39,2,37,2,1
443173,39,2,37,3,1
443173,12,1,11,4,1
443173,27,1,26,5,1
443173,27,1,26,20,1
443173,36,2,34,21,4
443173,36,2,34,22,1
443173,36,2,34,23,1
443173,11,1,10,24,1
443173,25,1,24,25,1
443173,25,1,24,40,1
443173,3,0,3,41,4
443173,3,0,3,42,1
443173,3,0,3,43,1
443173,1,0,1,44,1
443173,2,0,2,45,1
443173,2,0,2,60,1
443207,242,233,9,1,4
443207,242,233,9,2,1
443207,242,233,9,3,1
443207,241,232,9,4,1
443207,1,1,0,5,1
443207,1,1,0,20,1
443207,242,233,9,21,4
443207,242,233,9,22,1
443207,242,233,9,23,1
443207,241,232,9,24,1
443207,1,1,0,25,1
443207,1,1,0,40,1
443216,196,181,15,1,4
443216,196,181,15,2,1
443216,196,181,15,3,1
443216,35,34,1,4,1
443216,161,147,14,5,1
443216,161,147,14,20,1
443216,196,181,15,21,4
443216,196,181,15,22,1
443216,196,181,15,23,1
443216,35,34,1,24,1
443216,161,147,14,25,1
443216,161,147,14,40,1
443225,65,63,2,1,4
443225,65,63,2,2,1
443225,65,63,2,3,1
443225,57,55,2,4,1
443225,8,8,0,5,1
443225,8,8,0,20,1
443225,65,63,2,21,4
443225,65,63,2,22,1
443225,65,63,2,23,1
443225,57,55,2,24,1
443225,8,8,0,25,1
443225,8,8,0,40,1
443234,240,21,219,1,4
443234,240,21,219,2,1
443234,240,21,219,3,1
443234,35,4,31,4,1
443234,205,17,188,5,1
443234,205,17,188,20,1
443234,240,21,219,21,4
443234,240,21,219,22,1
443234,240,21,219,23,1
443234,35,4,31,24,1
443234,205,17,188,25,1
443234,205,17,188,40,1
443252,756,477,279,1,4
443252,756,477,279,2,1
443252,756,477,279,3,1
443252,490,302,188,4,1
443252,266,175,91,5,1
443252,266,175,91,20,1
443252,756,477,279,21,4
443252,756,477,279,22,1
443252,756,477,279,23,1
443252,490,302,188,24,1
443252,266,175,91,25,1
443252,266,175,91,40,1
443261,229,44,185,1,4
443261,229,44,185,2,1
443261,229,44,185,3,1
443261,68,7,61,4,1
443261,161,37,124,5,1
443261,161,37,124,20,1
443261,148,39,109,21,4
443261,148,39,109,22,1
443261,148,39,109,23,1
443261,45,6,39,24,1
443261,103,33,70,25,1
443261,103,33,70,40,1
443261,81,5,76,41,4
443261,81,5,76,42,1
443261,81,5,76,43,1
443261,23,1,22,44,1
443261,58,4,54,45,1
443261,58,4,54,60,1
443270,205,61,144,1,4
443270,205,61,144,2,1
443270,205,61,144,3,1
443270,90,23,67,4,1
443270,115,38,77,5,1
443270,115,38,77,20,1
443270,153,41,112,21,4
443270,153,41,112,22,1
443270,153,41,112,23,1
443270,71,16,55,24,1
443270,82,25,57,25,1
443270,82,25,57,40,1
443270,52,20,32,41,4
443270,52,20,32,42,1
443270,52,20,32,43,1
443270,19,7,12,44,1
443270,33,13,20,45,1
443270,33,13,20,60,1
443289,49,3,46,1,4
443289,49,3,46,2,1
443289,49,3,46,3,1
443289,17,1,16,4,1
443289,32,2,30,5,1
443289,32,2,30,20,1
443289,49,3,46,21,4
443289,49,3,46,22,1
443289,49,3,46,23,1
443289,17,1,16,24,1
443289,32,2,30,25,1
443289,32,2,30,40,1
443298,196,174,22,1,4
443298,196,174,22,2,1
443298,196,174,22,3,1
443298,30,27,3,4,1
443298,166,147,19,5,1
443298,166,147,19,20,1
443298,196,174,22,21,4
443298,196,174,22,22,1
443298,196,174,22,23,1
443298,30,27,3,24,1
443298,166,147,19,25,1
443298,166,147,19,40,1
443322,118,23,95,1,4
443322,118,23,95,2,1
443322,118,23,95,3,1
443322,78,16,62,4,1
443322,40,7,33,5,1
443322,40,7,33,20,1
443322,118,23,95,21,4
443322,118,23,95,22,1
443322,118,23,95,23,1
443322,78,16,62,24,1
443322,40,7,33,25,1
443322,40,7,33,40,1
443331,1435,342,1093,1,4
443331,1374,334,1040,2,1
443331,1374,334,1040,3,1
443331,16,6,10,4,1
443331,1358,328,1030,5,1
443331,61,8,53,12,3
443331,153,32,121,19,1
443331,1205,296,909,20,1
443331,1369,319,1050,21,4
443331,1310,313,997,22,1
443331,1310,313,997,23,1
443331,16,6,10,24,1
443331,1294,307,987,25,1
443331,59,6,53,32,3
443331,151,31,120,39,1
443331,1143,276,867,40,1
443331,66,23,43,41,4
443331,64,21,43,42,1
443331,64,21,43,43,1
443331,64,21,43,45,1
443331,2,2,0,52,3
443331,2,1,1,59,1
443331,62,20,42,60,1
443340,72,36,36,1,4
443340,72,36,36,2,1
443340,72,36,36,3,1
443340,9,1,8,4,1
443340,63,35,28,5,1
443340,13,6,7,19,1
443340,50,29,21,20,1
443340,71,36,35,21,4
443340,71,36,35,22,1
443340,71,36,35,23,1
443340,9,1,8,24,1
443340,62,35,27,25,1
443340,13,6,7,39,1
443340,49,29,20,40,1
443340,1,0,1,41,4
443340,1,0,1,42,1
443340,1,0,1,43,1
443340,1,0,1,45,1
443340,1,0,1,60,1
443359,107,80,27,1,4
443359,107,80,27,2,1
443359,107,80,27,3,1
443359,28,15,13,4,1
443359,79,65,14,5,1
443359,79,65,14,20,1
443359,100,77,23,21,4
443359,100,77,23,22,1
443359,100,77,23,23,1
443359,22,12,10,24,1
443359,78,65,13,25,1
443359,78,65,13,40,1
443359,7,3,4,41,4
443359,7,3,4,42,1
443359,7,3,4,43,1
443359,6,3,3,44,1
443359,1,0,1,45,1
443359,1,0,1,60,1
443377,105,101,4,1,4
443377,105,101,4,2,1
443377,105,101,4,3,1
443377,61,58,3,4,1
443377,44,43,1,5,1
443377,10,10,0,19,1
443377,34,33,1,20,1
443377,105,101,4,21,4
443377,105,101,4,22,1
443377,105,101,4,23,1
443377,61,58,3,24,1
443377,44,43,1,25,1
443377,10,10,0,39,1
443377,34,33,1,40,1
443410,1000,812,188,1,4
443410,894,729,165,2,1
443410,894,729,165,3,1
443410,156,122,34,4,1
443410,738,607,131,5,1
443410,106,83,23,12,3
443410,138,113,25,19,1
443410,600,494,106,20,1
443410,852,691,161,21,4
443410,791,647,144,22,1
443410,791,647,144,23,1
443410,148,116,32,24,1
443410,643,531,112,25,1
443410,61,44,17,32,3
443410,133,108,25,39,1
443410,510,423,87,40,1
443410,148,121,27,41,4
443410,103,82,21,42,1
443410,103,82,21,43,1
443410,8,6,2,44,1
443410,95,76,19,45,1
443410,45,39,6,52,3
443410,5,5,0,59,1
443410,90,71,19,60,1
443429,69,11,58,1,4
443429,69,11,58,2,1
443429,69,11,58,3,1
443429,10,2,8,4,1
443429,59,9,50,5,1
443429,59,9,50,20,1
443429,69,11,58,21,4
443429,69,11,58,22,1
443429,69,11,58,23,1
443429,10,2,8,24,1
443429,59,9,50,25,1
443429,59,9,50,40,1
443438,214,66,148,1,4
443438,214,66,148,2,1
443438,214,66,148,3,1
443438,14,9,5,4,1
443438,200,57,143,5,1
443438,32,10,22,19,1
443438,168,47,121,20,1
443438,214,66,148,21,4
443438,214,66,148,22,1
443438,214,66,148,23,1
443438,14,9,5,24,1
443438,200,57,143,25,1
443438,32,10,22,39,1
443438,168,47,121,40,1
443456,119,54,65,1,4
443456,108,48,60,2,1
443456,108,48,60,3,1
443456,108,48,60,5,1
443456,11,6,5,12,3
443456,108,48,60,20,1
443456,119,54,65,21,4
443456,108,48,60,22,1
443456,108,48,60,23,1
443456,108,48,60,25,1
443456,11,6,5,32,3
443456,108,48,60,40,1
443465,67,23,44,1,4
443465,66,22,44,2,1
443465,66,22,44,3,1
443465,66,22,44,5,1
443465,1,1,0,12,3
443465,66,22,44,20,1
443465,67,23,44,21,4
443465,66,22,44,22,1
443465,66,22,44,23,1
443465,66,22,44,25,1
443465,1,1,0,32,3
443465,66,22,44,40,1
443474,933,302,631,1,4
443474,829,266,563,2,1
443474,828,265,563,3,1
443474,41,9,32,4,1
443474,787,256,531,5,1
443474,1,1,0,11,1
443474,104,36,68,12,3
443474,41,18,23,19,1
443474,746,238,508,20,1
443474,933,302,631,21,4
443474,829,266,563,22,1
443474,828,265,563,23,1
443474,41,9,32,24,1
443474,787,256,531,25,1
443474,1,1,0,31,1
443474,104,36,68,32,3
443474,41,18,23,39,1
443474,746,238,508,40,1
443483,157,30,127,1,4
443483,157,30,127,2,1
443483,157,30,127,3,1
443483,49,11,38,4,1
443483,108,19,89,5,1
443483,108,19,89,20,1
443483,22,9,13,21,4
443483,22,9,13,22,1
443483,22,9,13,23,1
443483,9,4,5,24,1
443483,13,5,8,25,1
443483,13,5,8,40,1
443483,135,21,114,41,4
443483,135,21,114,42,1
443483,135,21,114,43,1
443483,40,7,33,44,1
443483,95,14,81,45,1
443483,95,14,81,60,1
443492,2683,1048,1635,1,4
443492,2683,1048,1635,2,1
443492,2108,842,1266,3,1
443492,572,247,325,4,1
443492,1536,595,941,5,1
443492,575,206,369,11,1
443492,315,136,179,19,1
443492,1221,459,762,20,1
443492,1725,691,1034,21,4
443492,1725,691,1034,22,1
443492,1707,683,1024,23,1
443492,503,214,289,24,1
443492,1204,469,735,25,1
443492,18,8,10,31,1
443492,262,112,150,39,1
443492,942,357,585,40,1
443492,958,357,601,41,4
443492,958,357,601,42,1
443492,401,159,242,43,1
443492,69,33,36,44,1
443492,332,126,206,45,1
443492,557,198,359,51,1
443492,53,24,29,59,1
443492,279,102,177,60,1
443526,591,465,126,1,4
443526,591,465,126,2,1
443526,591,465,126,3,1
443526,41,32,9,4,1
443526,550,433,117,5,1
443526,5,3,2,19,1
443526,545,430,115,20,1
443526,469,369,100,21,4
443526,469,369,100,22,1
443526,469,369,100,23,1
443526,35,26,9,24,1
443526,434,343,91,25,1
443526,4,3,1,39,1
443526,430,340,90,40,1
443526,122,96,26,41,4
443526,122,96,26,42,1
443526,122,96,26,43,1
443526,6,6,0,44,1
443526,116,90,26,45,1
443526,1,0,1,59,1
443526,115,90,25,60,1
443535,322,186,136,1,4
443535,322,186,136,2,1
443535,322,186,136,3,1
443535,50,30,20,4,1
443535,272,156,116,5,1
443535,17,7,10,19,1
443535,255,149,106,20,1
443535,222,120,102,21,4
443535,222,120,102,22,1
443535,222,120,102,23,1
443535,41,25,16,24,1
443535,181,95,86,25,1
443535,11,3,8,39,1
443535,170,92,78,40,1
443535,100,66,34,41,4
443535,100,66,34,42,1
443535,100,66,34,43,1
443535,9,5,4,44,1
443535,91,61,30,45,1
443535,6,4,2,59,1
443535,85,57,28,60,1
443544,372,100,272,1,4
443544,338,88,250,2,1
443544,338,88,250,3,1
443544,21,5,16,4,1
443544,317,83,234,5,1
443544,34,12,22,12,3
443544,14,5,9,19,1
443544,303,78,225,20,1
443544,372,100,272,21,4
443544,338,88,250,22,1
443544,338,88,250,23,1
443544,21,5,16,24,1
443544,317,83,234,25,1
443544,34,12,22,32,3
443544,14,5,9,39,1
443544,303,78,225,40,1
443562,2565,719,1846,1,4
443562,2470,690,1780,2,1
443562,2470,690,1780,3,1
443562,676,204,472,4,1
443562,1794,486,1308,5,1
443562,95,29,66,12,3
443562,20,12,8,19,1
443562,1774,474,1300,20,1
443562,1772,491,1281,21,4
443562,1719,475,1244,22,1
443562,1719,475,1244,23,1
443562,532,142,390,24,1
443562,1187,333,854,25,1
443562,53,16,37,32,3
443562,20,12,8,39,1
443562,1167,321,846,40,1
443562,793,228,565,41,4
443562,751,215,536,42,1
443562,751,215,536,43,1
443562,144,62,82,44,1
443562,607,153,454,45,1
443562,42,13,29,52,3
443562,607,153,454,60,1
443571,37,25,12,1,4
443571,37,25,12,2,1
443571,37,25,12,3,1
443571,12,8,4,4,1
443571,25,17,8,5,1
443571,25,17,8,20,1
443571,37,25,12,21,4
443571,37,25,12,22,1
443571,37,25,12,23,1
443571,12,8,4,24,1
443571,25,17,8,25,1
443571,25,17,8,40,1
443599,387,32,355,1,4
443599,293,22,271,2,1
443599,293,22,271,3,1
443599,22,2,20,4,1
443599,271,20,251,5,1
443599,94,10,84,12,3
443599,45,1,44,19,1
443599,226,19,207,20,1
443599,35,5,30,21,4
443599,27,3,24,22,1
443599,27,3,24,23,1
443599,3,0,3,24,1
443599,24,3,21,25,1
443599,8,2,6,32,3
443599,8,1,7,39,1
443599,16,2,14,40,1
443599,352,27,325,41,4
443599,266,19,247,42,1
443599,266,19,247,43,1
443599,19,2,17,44,1
443599,247,17,230,45,1
443599,86,8,78,52,3
443599,37,0,37,59,1
443599,210,17,193,60,1
443623,1108,535,573,1,4
443623,1108,535,573,2,1
443623,1108,535,573,3,1
443623,158,76,82,4,1
443623,950,459,491,5,1
443623,100,42,58,19,1
443623,850,417,433,20,1
443623,1108,535,573,21,4
443623,1108,535,573,22,1
443623,1108,535,573,23,1
443623,158,76,82,24,1
443623,950,459,491,25,1
443623,100,42,58,39,1
443623,850,417,433,40,1
443632,187,137,50,1,4
443632,187,137,50,2,1
443632,187,137,50,3,1
443632,85,59,26,4,1
443632,102,78,24,5,1
443632,102,78,24,20,1
443632,187,137,50,21,4
443632,187,137,50,22,1
443632,187,137,50,23,1
443632,85,59,26,24,1
443632,102,78,24,25,1
443632,102,78,24,40,1
443641,188,12,176,1,4
443641,188,12,176,2,1
443641,188,12,176,3,1
443641,46,2,44,4,1
443641,142,10,132,5,1
443641,142,10,132,20,1
443641,125,7,118,21,4
443641,125,7,118,22,1
443641,125,7,118,23,1
443641,31,1,30,24,1
443641,94,6,88,25,1
443641,94,6,88,40,1
443641,63,5,58,41,4
443641,63,5,58,42,1
443641,63,5,58,43,1
443641,15,1,14,44,1
443641,48,4,44,45,1
443641,48,4,44,60,1
443650,442,52,390,1,4
443650,442,52,390,2,1
443650,442,52,390,3,1
443650,117,13,104,4,1
443650,325,39,286,5,1
443650,53,12,41,19,1
443650,272,27,245,20,1
443650,275,32,243,21,4
443650,275,32,243,22,1
443650,275,32,243,23,1
443650,77,9,68,24,1
443650,198,23,175,25,1
443650,35,7,28,39,1
443650,163,16,147,40,1
443650,167,20,147,41,4
443650,167,20,147,42,1
443650,167,20,147,43,1
443650,40,4,36,44,1
443650,127,16,111,45,1
443650,18,5,13,59,1
443650,109,11,98,60,1
443669,328,47,281,1,4
443669,328,47,281,2,1
443669,328,47,281,3,1
443669,120,22,98,4,1
443669,208,25,183,5,1
443669,208,25,183,20,1
443669,328,47,281,21,4
443669,328,47,281,22,1
443669,328,47,281,23,1
443669,120,22,98,24,1
443669,208,25,183,25,1
443669,208,25,183,40,1
443678,94,6,88,1,4
443678,94,6,88,2,1
443678,94,6,88,3,1
443678,44,3,41,4,1
443678,50,3,47,5,1
443678,50,3,47,20,1
443678,56,2,54,21,4
443678,56,2,54,22,1
443678,56,2,54,23,1
443678,31,2,29,24,1
443678,25,0,25,25,1
443678,25,0,25,40,1
443678,38,4,34,41,4
443678,38,4,34,42,1
443678,38,4,34,43,1
443678,13,1,12,44,1
443678,25,3,22,45,1
443678,25,3,22,60,1
443687,417,185,232,1,4
443687,417,185,232,2,1
443687,417,185,232,3,1
443687,27,14,13,4,1
443687,390,171,219,5,1
443687,390,171,219,20,1
443687,341,151,190,21,4
443687,341,151,190,22,1
443687,341,151,190,23,1
443687,26,14,12,24,1
443687,315,137,178,25,1
443687,315,137,178,40,1
443687,76,34,42,41,4
443687,76,34,42,42,1
443687,76,34,42,43,1
443687,1,0,1,44,1
443687,75,34,41,45,1
443687,75,34,41,60,1
443696,25,9,16,1,4
443696,25,9,16,2,1
443696,22,9,13,3,1
443696,10,3,7,4,1
443696,12,6,6,5,1
443696,3,0,3,11,1
443696,12,6,6,20,1
443696,25,9,16,21,4
443696,25,9,16,22,1
443696,22,9,13,23,1
443696,10,3,7,24,1
443696,12,6,6,25,1
443696,3,0,3,31,1
443696,12,6,6,40,1
443702,15,11,4,1,4
443702,15,11,4,12,3
443702,11,9,2,21,4
443702,11,9,2,32,3
443702,4,2,2,41,4
443702,4,2,2,52,3
443739,282,21,261,1,4
443739,282,21,261,2,1
443739,282,21,261,3,1
443739,116,7,109,4,1
443739,166,14,152,5,1
443739,166,14,152,20,1
443739,282,21,261,21,4
443739,282,21,261,22,1
443739,282,21,261,23,1
443739,116,7,109,24,1
443739,166,14,152,25,1
443739,166,14,152,40,1
443748,527,70,457,1,4
443748,527,70,457,2,1
443748,527,70,457,3,1
443748,76,9,67,4,1
443748,451,61,390,5,1
443748,55,3,52,19,1
443748,396,58,338,20,1
443748,523,70,453,21,4
443748,523,70,453,22,1
443748,523,70,453,23,1
443748,76,9,67,24,1
443748,447,61,386,25,1
443748,55,3,52,39,1
443748,392,58,334,40,1
443748,4,0,4,41,4
443748,4,0,4,42,1
443748,4,0,4,43,1
443748,4,0,4,45,1
443748,4,0,4,60,1
443766,1973,512,1461,1,4
443766,1196,340,856,2,1
443766,1194,339,855,3,1
443766,209,68,141,4,1
443766,985,271,714,5,1
443766,2,1,1,11,1
443766,777,172,605,12,3
443766,146,48,98,19,1
443766,839,223,616,20,1
443766,142,64,78,21,4
443766,62,36,26,22,1
443766,62,36,26,23,1
443766,4,3,1,24,1
443766,58,33,25,25,1
443766,80,28,52,32,3
443766,9,6,3,39,1
443766,49,27,22,40,1
443766,1831,448,1383,41,4
443766,1134,304,830,42,1
443766,1132,303,829,43,1
443766,205,65,140,44,1
443766,927,238,689,45,1
443766,2,1,1,51,1
443766,697,144,553,52,3
443766,137,42,95,59,1
443766,790,196,594,60,1
443784,2329,874,1455,1,4
443784,1650,596,1054,2,1
443784,1644,596,1048,3,1
443784,214,80,134,4,1
443784,1430,516,914,5,1
443784,6,0,6,11,1
443784,679,278,401,12,3
443784,179,66,113,19,1
443784,1251,450,801,20,1
443784,267,138,129,21,4
443784,143,80,63,22,1
443784,143,80,63,23,1
443784,7,6,1,24,1
443784,136,74,62,25,1
443784,124,58,66,32,3
443784,21,15,6,39,1
443784,115,59,56,40,1
443784,2062,736,1326,41,4
443784,1507,516,991,42,1
443784,1501,516,985,43,1
443784,207,74,133,44,1
443784,1294,442,852,45,1
443784,6,0,6,51,1
443784,555,220,335,52,3
443784,158,51,107,59,1
443784,1136,391,745,60,1
443827,461,199,262,1,4
443827,461,199,262,2,1
443827,461,199,262,3,1
443827,87,43,44,4,1
443827,374,156,218,5,1
443827,18,6,12,19,1
443827,356,150,206,20,1
443827,461,199,262,21,4
443827,461,199,262,22,1
443827,461,199,262,23,1
443827,87,43,44,24,1
443827,374,156,218,25,1
443827,18,6,12,39,1
443827,356,150,206,40,1
443836,370,35,335,1,4
443836,370,35,335,2,1
443836,369,34,335,3,1
443836,57,4,53,4,1
443836,312,30,282,5,1
443836,1,1,0,11,1
443836,40,2,38,19,1
443836,272,28,244,20,1
443836,370,35,335,21,4
443836,370,35,335,22,1
443836,369,34,335,23,1
443836,57,4,53,24,1
443836,312,30,282,25,1
443836,1,1,0,31,1
443836,40,2,38,39,1
443836,272,28,244,40,1
443845,413,78,335,1,4
443845,413,78,335,2,1
443845,413,78,335,3,1
443845,124,25,99,4,1
443845,289,53,236,5,1
443845,289,53,236,20,1
443845,413,78,335,21,4
443845,413,78,335,22,1
443845,413,78,335,23,1
443845,124,25,99,24,1
443845,289,53,236,25,1
443845,289,53,236,40,1
443854,643,250,393,1,4
443854,643,250,393,2,1
443854,643,250,393,3,1
443854,100,42,58,4,1
443854,543,208,335,5,1
443854,74,32,42,19,1
443854,469,176,293,20,1
443854,602,234,368,21,4
443854,602,234,368,22,1
443854,602,234,368,23,1
443854,97,41,56,24,1
443854,505,193,312,25,1
443854,67,29,38,39,1
443854,438,164,274,40,1
443854,41,16,25,41,4
443854,41,16,25,42,1
443854,41,16,25,43,1
443854,3,1,2,44,1
443854,38,15,23,45,1
443854,7,3,4,59,1
443854,31,12,19,60,1
443881,889,295,594,1,4
443881,792,264,528,2,1
443881,792,264,528,3,1
443881,44,13,31,4,1
443881,748,251,497,5,1
443881,97,31,66,12,3
443881,73,35,38,19,1
443881,675,216,459,20,1
443881,889,295,594,21,4
443881,792,264,528,22,1
443881,792,264,528,23,1
443881,44,13,31,24,1
443881,748,251,497,25,1
443881,97,31,66,32,3
443881,73,35,38,39,1
443881,675,216,459,40,1
443890,1249,272,977,1,4
443890,1147,243,904,2,1
443890,1147,243,904,3,1
443890,68,11,57,4,1
443890,1079,232,847,5,1
443890,102,29,73,12,3
443890,64,13,51,19,1
443890,1015,219,796,20,1
443890,1249,272,977,21,4
443890,1147,243,904,22,1
443890,1147,243,904,23,1
443890,68,11,57,24,1
443890,1079,232,847,25,1
443890,102,29,73,32,3
443890,64,13,51,39,1
443890,1015,219,796,40,1
443906,61,32,29,1,4
443906,55,28,27,2,1
443906,55,28,27,3,1
443906,55,28,27,5,1
443906,6,4,2,12,3
443906,55,28,27,20,1
443906,61,32,29,21,4
443906,55,28,27,22,1
443906,55,28,27,23,1
443906,55,28,27,25,1
443906,6,4,2,32,3
443906,55,28,27,40,1
443924,1035,304,731,1,4
443924,937,272,665,2,1
443924,937,272,665,3,1
443924,39,10,29,4,1
443924,898,262,636,5,1
443924,98,32,66,12,3
443924,56,18,38,19,1
443924,842,244,598,20,1
443924,1035,304,731,21,4
443924,937,272,665,22,1
443924,937,272,665,23,1
443924,39,10,29,24,1
443924,898,262,636,25,1
443924,98,32,66,32,3
443924,56,18,38,39,1
443924,842,244,598,40,1
443942,105,6,99,1,4
443942,105,6,99,2,1
443942,105,6,99,3,1
443942,16,0,16,4,1
443942,89,6,83,5,1
443942,89,6,83,20,1
443942,105,6,99,21,4
443942,105,6,99,22,1
443942,105,6,99,23,1
443942,16,0,16,24,1
443942,89,6,83,25,1
443942,89,6,83,40,1
443951,96,55,41,1,4
443951,96,55,41,2,1
443951,96,55,41,3,1
443951,58,34,24,4,1
443951,38,21,17,5,1
443951,38,21,17,20,1
443951,96,55,41,21,4
443951,96,55,41,22,1
443951,96,55,41,23,1
443951,58,34,24,24,1
443951,38,21,17,25,1
443951,38,21,17,40,1
443979,57,1,56,1,4
443979,57,1,56,2,1
443979,57,1,56,3,1
443979,6,0,6,4,1
443979,51,1,50,5,1
443979,51,1,50,20,1
443979,39,1,38,21,4
443979,39,1,38,22,1
443979,39,1,38,23,1
443979,4,0,4,24,1
443979,35,1,34,25,1
443979,35,1,34,40,1
443979,18,0,18,41,4
443979,18,0,18,42,1
443979,18,0,18,43,1
443979,2,0,2,44,1
443979,16,0,16,45,1
443979,16,0,16,60,1
444024,859,150,709,1,4
444024,859,150,709,2,1
444024,859,150,709,3,1
444024,104,18,86,4,1
444024,755,132,623,5,1
444024,118,19,99,19,1
444024,637,113,524,20,1
444024,842,146,696,21,4
444024,842,146,696,22,1
444024,842,146,696,23,1
444024,104,18,86,24,1
444024,738,128,610,25,1
444024,118,19,99,39,1
444024,620,109,511,40,1
444024,17,4,13,41,4
444024,17,4,13,42,1
444024,17,4,13,43,1
444024,17,4,13,45,1
444024,17,4,13,60,1
444042,1869,605,1264,1,4
444042,1869,605,1264,2,1
444042,1868,605,1263,3,1
444042,315,104,211,4,1
444042,1553,501,1052,5,1
444042,1,0,1,11,1
444042,132,43,89,19,1
444042,1421,458,963,20,1
444042,1025,328,697,21,4
444042,1025,328,697,22,1
444042,1025,328,697,23,1
444042,260,83,177,24,1
444042,765,245,520,25,1
444042,92,34,58,39,1
444042,673,211,462,40,1
444042,844,277,567,41,4
444042,844,277,567,42,1
444042,843,277,566,43,1
444042,55,21,34,44,1
444042,788,256,532,45,1
444042,1,0,1,51,1
444042,40,9,31,59,1
444042,748,247,501,60,1
444051,99,4,95,1,4
444051,99,4,95,2,1
444051,99,4,95,3,1
444051,46,2,44,4,1
444051,53,2,51,5,1
444051,53,2,51,20,1
444051,71,2,69,21,4
444051,71,2,69,22,1
444051,71,2,69,23,1
444051,33,1,32,24,1
444051,38,1,37,25,1
444051,38,1,37,40,1
444051,28,2,26,41,4
444051,28,2,26,42,1
444051,28,2,26,43,1
444051,13,1,12,44,1
444051,15,1,14,45,1
444051,15,1,14,60,1
444079,158,95,63,1,4
444079,158,95,63,2,1
444079,158,95,63,3,1
444079,30,17,13,4,1
444079,128,78,50,5,1
444079,128,78,50,20,1
444079,144,95,49,21,4
444079,144,95,49,22,1
444079,144,95,49,23,1
444079,25,17,8,24,1
444079,119,78,41,25,1
444079,119,78,41,40,1
444079,14,0,14,41,4
444079,14,0,14,42,1
444079,14,0,14,43,1
444079,5,0,5,44,1
444079,9,0,9,45,1
444079,9,0,9,60,1
444088,272,57,215,1,4
444088,272,57,215,2,1
444088,272,57,215,3,1
444088,159,19,140,4,1
444088,113,38,75,5,1
444088,113,38,75,20,1
444088,272,57,215,21,4
444088,272,57,215,22,1
444088,272,57,215,23,1
444088,159,19,140,24,1
444088,113,38,75,25,1
444088,113,38,75,40,1
444103,11,10,1,1,4
444103,11,10,1,12,3
444103,7,7,0,21,4
444103,7,7,0,32,3
444103,4,3,1,41,4
444103,4,3,1,52,3
444121,73,23,50,1,4
444121,73,23,50,2,1
444121,73,23,50,3,1
444121,73,23,50,5,1
444121,73,23,50,20,1
444121,73,23,50,21,4
444121,73,23,50,22,1
444121,73,23,50,23,1
444121,73,23,50,25,1
444121,73,23,50,40,1
444130,10928,4212,6716,1,4
444130,250,72,178,2,1
444130,250,72,178,3,1
444130,250,72,178,5,1
444130,10678,4140,6538,12,3
444130,29,6,23,19,1
444130,221,66,155,20,1
444130,4786,2023,2763,21,4
444130,69,19,50,22,1
444130,69,19,50,23,1
444130,69,19,50,25,1
444130,4717,2004,2713,32,3
444130,3,0,3,39,1
444130,66,19,47,40,1
444130,6142,2189,3953,41,4
444130,181,53,128,42,1
444130,181,53,128,43,1
444130,181,53,128,45,1
444130,5961,2136,3825,52,3
444130,26,6,20,59,1
444130,155,47,108,60,1
444158,20826,7588,13238,1,4
444158,18061,6501,11560,2,1
444158,17902,6470,11432,3,1
444158,1559,708,851,4,1
444158,16343,5762,10581,5,1
444158,159,31,128,11,1
444158,2765,1087,1678,12,3
444158,2421,757,1664,19,1
444158,13922,5005,8917,20,1
444158,12777,4894,7883,21,4
444158,10124,3853,6271,22,1
444158,10105,3845,6260,23,1
444158,1081,478,603,24,1
444158,9024,3367,5657,25,1
444158,19,8,11,31,1
444158,2653,1041,1612,32,3
444158,1570,493,1077,39,1
444158,7454,2874,4580,40,1
444158,8049,2694,5355,41,4
444158,7937,2648,5289,42,1
444158,7797,2625,5172,43,1
444158,478,230,248,44,1
444158,7319,2395,4924,45,1
444158,140,23,117,51,1
444158,112,46,66,52,3
444158,851,264,587,59,1
444158,6468,2131,4337,60,1
444167,3800,943,2857,1,4
444167,3795,942,2853,2,1
444167,3761,931,2830,3,1
444167,581,189,392,4,1
444167,3180,742,2438,5,1
444167,34,11,23,11,1
444167,5,1,4,12,3
444167,544,122,422,19,1
444167,2636,620,2016,20,1
444167,2035,525,1510,21,4
444167,2035,525,1510,22,1
444167,2035,525,1510,23,1
444167,440,144,296,24,1
444167,1595,381,1214,25,1
444167,333,82,251,39,1
444167,1262,299,963,40,1
444167,1765,418,1347,41,4
444167,1760,417,1343,42,1
444167,1726,406,1320,43,1
444167,141,45,96,44,1
444167,1585,361,1224,45,1
444167,34,11,23,51,1
444167,5,1,4,52,3
444167,211,40,171,59,1
444167,1374,321,1053,60,1
444194,147,13,134,1,4
444194,147,13,134,2,1
444194,147,13,134,3,1
444194,33,8,25,4,1
444194,114,5,109,5,1
444194,114,5,109,20,1
444194,147,13,134,21,4
444194,147,13,134,22,1
444194,147,13,134,23,1
444194,33,8,25,24,1
444194,114,5,109,25,1
444194,114,5,109,40,1
444200,438,59,379,1,4
444200,438,59,379,2,1
444200,438,59,379,3,1
444200,427,59,368,4,1
444200,11,0,11,5,1
444200,11,0,11,20,1
444200,350,47,303,21,4
444200,350,47,303,22,1
444200,350,47,303,23,1
444200,342,47,295,24,1
444200,8,0,8,25,1
444200,8,0,8,40,1
444200,88,12,76,41,4
444200,88,12,76,42,1
444200,88,12,76,43,1
444200,85,12,73,44,1
444200,3,0,3,45,1
444200,3,0,3,60,1
444219,8034,3321,4713,1,4
444219,8034,3321,4713,2,1
444219,7396,3058,4338,3,1
444219,1524,680,844,4,1
444219,5872,2378,3494,5,1
444219,638,263,375,11,1
444219,962,366,596,19,1
444219,4910,2012,2898,20,1
444219,2017,912,1105,21,4
444219,2017,912,1105,22,1
444219,1915,883,1032,23,1
444219,543,237,306,24,1
444219,1372,646,726,25,1
444219,102,29,73,31,1
444219,81,35,46,39,1
444219,1291,611,680,40,1
444219,6017,2409,3608,41,4
444219,6017,2409,3608,42,1
444219,5481,2175,3306,43,1
444219,981,443,538,44,1
444219,4500,1732,2768,45,1
444219,536,234,302,51,1
444219,881,331,550,59,1
444219,3619,1401,2218,60,1
444228,31,0,31,1,4
444228,31,0,31,2,1
444228,31,0,31,3,1
444228,11,0,11,4,1
444228,20,0,20,5,1
444228,20,0,20,20,1
444228,31,0,31,21,4
444228,31,0,31,22,1
444228,31,0,31,23,1
444228,11,0,11,24,1
444228,20,0,20,25,1
444228,20,0,20,40,1
444237,494,127,367,1,4
444237,494,127,367,2,1
444237,494,127,367,3,1
444237,78,20,58,4,1
444237,416,107,309,5,1
444237,416,107,309,20,1
444237,494,127,367,21,4
444237,494,127,367,22,1
444237,494,127,367,23,1
444237,78,20,58,24,1
444237,416,107,309,25,1
444237,416,107,309,40,1
444255,190,39,151,1,4
444255,190,39,151,2,1
444255,190,39,151,3,1
444255,23,6,17,4,1
444255,167,33,134,5,1
444255,18,4,14,19,1
444255,149,29,120,20,1
444255,156,34,122,21,4
444255,156,34,122,22,1
444255,156,34,122,23,1
444255,21,6,15,24,1
444255,135,28,107,25,1
444255,17,4,13,39,1
444255,118,24,94,40,1
444255,34,5,29,41,4
444255,34,5,29,42,1
444255,34,5,29,43,1
444255,2,0,2,44,1
444255,32,5,27,45,1
444255,1,0,1,59,1
444255,31,5,26,60,1
444264,144,63,81,1,4
444264,144,63,81,2,1
444264,144,63,81,3,1
444264,47,21,26,4,1
444264,97,42,55,5,1
444264,97,42,55,20,1
444264,121,49,72,21,4
444264,121,49,72,22,1
444264,121,49,72,23,1
444264,36,15,21,24,1
444264,85,34,51,25,1
444264,85,34,51,40,1
444264,23,14,9,41,4
444264,23,14,9,42,1
444264,23,14,9,43,1
444264,11,6,5,44,1
444264,12,8,4,45,1
444264,12,8,4,60,1
444282,145,9,136,1,4
444282,145,9,136,2,1
444282,145,9,136,3,1
444282,58,6,52,4,1
444282,87,3,84,5,1
444282,87,3,84,20,1
444282,114,7,107,21,4
444282,114,7,107,22,1
444282,114,7,107,23,1
444282,45,5,40,24,1
444282,69,2,67,25,1
444282,69,2,67,40,1
444282,31,2,29,41,4
444282,31,2,29,42,1
444282,31,2,29,43,1
444282,13,1,12,44,1
444282,18,1,17,45,1
444282,18,1,17,60,1
444291,122,4,118,1,4
444291,122,4,118,2,1
444291,122,4,118,3,1
444291,47,1,46,4,1
444291,75,3,72,5,1
444291,75,3,72,20,1
444291,95,3,92,21,4
444291,95,3,92,22,1
444291,95,3,92,23,1
444291,39,1,38,24,1
444291,56,2,54,25,1
444291,56,2,54,40,1
444291,27,1,26,41,4
444291,27,1,26,42,1
444291,27,1,26,43,1
444291,8,0,8,44,1
444291,19,1,18,45,1
444291,19,1,18,60,1
444307,109,4,105,1,4
444307,109,4,105,2,1
444307,109,4,105,3,1
444307,50,2,48,4,1
444307,59,2,57,5,1
444307,59,2,57,20,1
444307,79,3,76,21,4
444307,79,3,76,22,1
444307,79,3,76,23,1
444307,40,2,38,24,1
444307,39,1,38,25,1
444307,39,1,38,40,1
444307,30,1,29,41,4
444307,30,1,29,42,1
444307,30,1,29,43,1
444307,10,0,10,44,1
444307,20,1,19,45,1
444307,20,1,19,60,1
444316,165,6,159,1,4
444316,165,6,159,2,1
444316,165,6,159,3,1
444316,149,4,145,4,1
444316,16,2,14,5,1
444316,16,2,14,20,1
444316,165,6,159,21,4
444316,165,6,159,22,1
444316,165,6,159,23,1
444316,149,4,145,24,1
444316,16,2,14,25,1
444316,16,2,14,40,1
444325,120,17,103,1,4
444325,120,17,103,2,1
444325,120,17,103,3,1
444325,34,7,27,4,1
444325,86,10,76,5,1
444325,86,10,76,20,1
444325,66,13,53,21,4
444325,66,13,53,22,1
444325,66,13,53,23,1
444325,29,5,24,24,1
444325,37,8,29,25,1
444325,37,8,29,40,1
444325,54,4,50,41,4
444325,54,4,50,42,1
444325,54,4,50,43,1
444325,5,2,3,44,1
444325,49,2,47,45,1
444325,49,2,47,60,1
444334,39,9,30,1,4
444334,39,9,30,2,1
444334,39,9,30,3,1
444334,22,5,17,4,1
444334,17,4,13,5,1
444334,17,4,13,20,1
444334,39,9,30,21,4
444334,39,9,30,22,1
444334,39,9,30,23,1
444334,22,5,17,24,1
444334,17,4,13,25,1
444334,17,4,13,40,1
444343,227,40,187,1,4
444343,227,40,187,2,1
444343,227,40,187,3,1
444343,140,24,116,4,1
444343,87,16,71,5,1
444343,18,3,15,19,1
444343,69,13,56,20,1
444343,227,40,187,21,4
444343,227,40,187,22,1
444343,227,40,187,23,1
444343,140,24,116,24,1
444343,87,16,71,25,1
444343,18,3,15,39,1
444343,69,13,56,40,1
444352,55,10,45,1,4
444352,55,10,45,2,1
444352,55,10,45,3,1
444352,11,4,7,4,1
444352,44,6,38,5,1
444352,44,6,38,20,1
444352,55,10,45,21,4
444352,55,10,45,22,1
444352,55,10,45,23,1
444352,11,4,7,24,1
444352,44,6,38,25,1
444352,44,6,38,40,1
444361,103,51,52,1,4
444361,103,51,52,2,1
444361,103,51,52,3,1
444361,30,11,19,4,1
444361,73,40,33,5,1
444361,73,40,33,20,1
444361,103,51,52,21,4
444361,103,51,52,22,1
444361,103,51,52,23,1
444361,30,11,19,24,1
444361,73,40,33,25,1
444361,73,40,33,40,1
444370,97,95,2,1,4
444370,97,95,2,2,1
444370,97,95,2,3,1
444370,22,22,0,4,1
444370,75,73,2,5,1
444370,75,73,2,20,1
444370,97,95,2,21,4
444370,97,95,2,22,1
444370,97,95,2,23,1
444370,22,22,0,24,1
444370,75,73,2,25,1
444370,75,73,2,40,1
444389,347,76,271,1,4
444389,347,76,271,2,1
444389,347,76,271,3,1
444389,72,15,57,4,1
444389,275,61,214,5,1
444389,275,61,214,20,1
444389,347,76,271,21,4
444389,347,76,271,22,1
444389,347,76,271,23,1
444389,72,15,57,24,1
444389,275,61,214,25,1
444389,275,61,214,40,1
444398,189,97,92,1,4
444398,189,97,92,2,1
444398,189,97,92,3,1
444398,19,10,9,4,1
444398,170,87,83,5,1
444398,20,7,13,19,1
444398,150,80,70,20,1
444398,140,69,71,21,4
444398,140,69,71,22,1
444398,140,69,71,23,1
444398,17,8,9,24,1
444398,123,61,62,25,1
444398,16,6,10,39,1
444398,107,55,52,40,1
444398,49,28,21,41,4
444398,49,28,21,42,1
444398,49,28,21,43,1
444398,2,2,0,44,1
444398,47,26,21,45,1
444398,4,1,3,59,1
444398,43,25,18,60,1
444404,70,38,32,1,4
444404,70,38,32,2,1
444404,70,38,32,3,1
444404,66,37,29,4,1
444404,4,1,3,5,1
444404,4,1,3,20,1
444404,42,24,18,21,4
444404,42,24,18,22,1
444404,42,24,18,23,1
444404,40,23,17,24,1
444404,2,1,1,25,1
444404,2,1,1,40,1
444404,28,14,14,41,4
444404,28,14,14,42,1
444404,28,14,14,43,1
444404,26,14,12,44,1
444404,2,0,2,45,1
444404,2,0,2,60,1
444413,113,113,0,1,4
444413,96,96,0,2,1
444413,96,96,0,3,1
444413,32,32,0,4,1
444413,64,64,0,5,1
444413,17,17,0,12,3
444413,7,7,0,19,1
444413,57,57,0,20,1
444413,113,113,0,21,4
444413,96,96,0,22,1
444413,96,96,0,23,1
444413,32,32,0,24,1
444413,64,64,0,25,1
444413,17,17,0,32,3
444413,7,7,0,39,1
444413,57,57,0,40,1
444422,141,1,140,1,4
444422,141,1,140,2,1
444422,141,1,140,3,1
444422,14,0,14,4,1
444422,127,1,126,5,1
444422,127,1,126,20,1
444422,141,1,140,21,4
444422,141,1,140,22,1
444422,141,1,140,23,1
444422,14,0,14,24,1
444422,127,1,126,25,1
444422,127,1,126,40,1
444440,82,7,75,1,4
444440,82,7,75,2,1
444440,82,7,75,3,1
444440,76,7,69,4,1
444440,6,0,6,5,1
444440,6,0,6,20,1
444440,82,7,75,21,4
444440,82,7,75,22,1
444440,82,7,75,23,1
444440,76,7,69,24,1
444440,6,0,6,25,1
444440,6,0,6,40,1
444468,27,0,27,1,4
444468,27,0,27,2,1
444468,27,0,27,3,1
444468,12,0,12,4,1
444468,15,0,15,5,1
444468,15,0,15,20,1
444468,27,0,27,21,4
444468,27,0,27,22,1
444468,27,0,27,23,1
444468,12,0,12,24,1
444468,15,0,15,25,1
444468,15,0,15,40,1
444486,386,31,355,1,4
444486,386,31,355,2,1
444486,386,31,355,3,1
444486,24,2,22,4,1
444486,362,29,333,5,1
444486,362,29,333,20,1
444486,281,22,259,21,4
444486,281,22,259,22,1
444486,281,22,259,23,1
444486,14,1,13,24,1
444486,267,21,246,25,1
444486,267,21,246,40,1
444486,105,9,96,41,4
444486,105,9,96,42,1
444486,105,9,96,43,1
444486,10,1,9,44,1
444486,95,8,87,45,1
444486,95,8,87,60,1
444510,166,40,126,1,4
444510,166,40,126,2,1
444510,166,40,126,3,1
444510,53,17,36,4,1
444510,113,23,90,5,1
444510,113,23,90,20,1
444510,148,33,115,21,4
444510,148,33,115,22,1
444510,148,33,115,23,1
444510,48,16,32,24,1
444510,100,17,83,25,1
444510,100,17,83,40,1
444510,18,7,11,41,4
444510,18,7,11,42,1
444510,18,7,11,43,1
444510,5,1,4,44,1
444510,13,6,7,45,1
444510,13,6,7,60,1
444529,121,23,98,1,4
444529,121,23,98,2,1
444529,121,23,98,3,1
444529,54,11,43,4,1
444529,67,12,55,5,1
444529,67,12,55,20,1
444529,121,23,98,21,4
444529,121,23,98,22,1
444529,121,23,98,23,1
444529,54,11,43,24,1
444529,67,12,55,25,1
444529,67,12,55,40,1
444547,31,2,29,1,4
444547,31,2,29,2,1
444547,31,2,29,3,1
444547,3,1,2,4,1
444547,28,1,27,5,1
444547,28,1,27,20,1
444547,23,2,21,21,4
444547,23,2,21,22,1
444547,23,2,21,23,1
444547,3,1,2,24,1
444547,20,1,19,25,1
444547,20,1,19,40,1
444547,8,0,8,41,4
444547,8,0,8,42,1
444547,8,0,8,43,1
444547,8,0,8,45,1
444547,8,0,8,60,1
444556,261,111,150,1,4
444556,261,111,150,2,1
444556,261,111,150,3,1
444556,257,108,149,4,1
444556,4,3,1,5,1
444556,4,3,1,20,1
444556,261,111,150,21,4
444556,261,111,150,22,1
444556,261,111,150,23,1
444556,257,108,149,24,1
444556,4,3,1,25,1
444556,4,3,1,40,1
444565,374,133,241,1,4
444565,374,133,241,2,1
444565,368,130,238,3,1
444565,28,11,17,4,1
444565,340,119,221,5,1
444565,6,3,3,11,1
444565,20,9,11,19,1
444565,320,110,210,20,1
444565,126,40,86,21,4
444565,126,40,86,22,1
444565,121,37,84,23,1
444565,9,3,6,24,1
444565,112,34,78,25,1
444565,5,3,2,31,1
444565,12,5,7,39,1
444565,100,29,71,40,1
444565,248,93,155,41,4
444565,248,93,155,42,1
444565,247,93,154,43,1
444565,19,8,11,44,1
444565,228,85,143,45,1
444565,1,0,1,51,1
444565,8,4,4,59,1
444565,220,81,139,60,1
444574,1083,240,843,1,4
444574,1083,240,843,2,1
444574,1083,240,843,3,1
444574,264,69,195,4,1
444574,819,171,648,5,1
444574,48,13,35,19,1
444574,771,158,613,20,1
444574,1083,240,843,21,4
444574,1083,240,843,22,1
444574,1083,240,843,23,1
444574,264,69,195,24,1
444574,819,171,648,25,1
444574,48,13,35,39,1
444574,771,158,613,40,1
444583,886,433,453,1,4
444583,886,433,453,2,1
444583,886,433,453,3,1
444583,490,260,230,4,1
444583,396,173,223,5,1
444583,396,173,223,20,1
444583,886,433,453,21,4
444583,886,433,453,22,1
444583,886,433,453,23,1
444583,490,260,230,24,1
444583,396,173,223,25,1
444583,396,173,223,40,1
444592,29,0,29,1,4
444592,29,0,29,2,1
444592,29,0,29,3,1
444592,23,0,23,4,1
444592,6,0,6,5,1
444592,6,0,6,20,1
444592,16,0,16,21,4
444592,16,0,16,22,1
444592,16,0,16,23,1
444592,14,0,14,24,1
444592,2,0,2,25,1
444592,2,0,2,40,1
444592,13,0,13,41,4
444592,13,0,13,42,1
444592,13,0,13,43,1
444592,9,0,9,44,1
444592,4,0,4,45,1
444592,4,0,4,60,1
444608,57,2,55,1,4
444608,57,2,55,2,1
444608,57,2,55,3,1
444608,11,0,11,4,1
444608,46,2,44,5,1
444608,46,2,44,20,1
444608,57,2,55,21,4
444608,57,2,55,22,1
444608,57,2,55,23,1
444608,11,0,11,24,1
444608,46,2,44,25,1
444608,46,2,44,40,1
444635,48,7,41,1,4
444635,48,7,41,2,1
444635,48,7,41,3,1
444635,10,1,9,4,1
444635,38,6,32,5,1
444635,38,6,32,20,1
444635,48,7,41,41,4
444635,48,7,41,42,1
444635,48,7,41,43,1
444635,10,1,9,44,1
444635,38,6,32,45,1
444635,38,6,32,60,1
444644,36,0,36,1,4
444644,36,0,36,2,1
444644,36,0,36,3,1
444644,6,0,6,4,1
444644,30,0,30,5,1
444644,30,0,30,20,1
444644,36,0,36,21,4
444644,36,0,36,22,1
444644,36,0,36,23,1
444644,6,0,6,24,1
444644,30,0,30,25,1
444644,30,0,30,40,1
444653,77,7,70,1,4
444653,77,7,70,2,1
444653,77,7,70,3,1
444653,70,7,63,4,1
444653,7,0,7,5,1
444653,7,0,7,20,1
444653,49,1,48,21,4
444653,49,1,48,22,1
444653,49,1,48,23,1
444653,46,1,45,24,1
444653,3,0,3,25,1
444653,3,0,3,40,1
444653,28,6,22,41,4
444653,28,6,22,42,1
444653,28,6,22,43,1
444653,24,6,18,44,1
444653,4,0,4,45,1
444653,4,0,4,60,1
444662,59,29,30,1,4
444662,59,29,30,2,1
444662,59,29,30,3,1
444662,32,15,17,4,1
444662,27,14,13,5,1
444662,27,14,13,20,1
444662,45,22,23,21,4
444662,45,22,23,22,1
444662,45,22,23,23,1
444662,32,15,17,24,1
444662,13,7,6,25,1
444662,13,7,6,40,1
444662,14,7,7,41,4
444662,14,7,7,42,1
444662,14,7,7,43,1
444662,14,7,7,45,1
444662,14,7,7,60,1
444671,258,131,127,1,4
444671,258,131,127,2,1
444671,258,131,127,3,1
444671,73,46,27,4,1
444671,185,85,100,5,1
444671,185,85,100,20,1
444671,258,131,127,21,4
444671,258,131,127,22,1
444671,258,131,127,23,1
444671,73,46,27,24,1
444671,185,85,100,25,1
444671,185,85,100,40,1
444680,52,28,24,1,4
444680,52,28,24,2,1
444680,52,28,24,3,1
444680,38,22,16,4,1
444680,14,6,8,5,1
444680,14,6,8,20,1
444680,52,28,24,21,4
444680,52,28,24,22,1
444680,52,28,24,23,1
444680,38,22,16,24,1
444680,14,6,8,25,1
444680,14,6,8,40,1
444699,53,21,32,1,4
444699,53,21,32,12,3
444699,48,19,29,21,4
444699,48,19,29,32,3
444699,5,2,3,41,4
444699,5,2,3,52,3
444705,19,5,14,1,4
444705,19,5,14,2,1
444705,19,5,14,3,1
444705,15,4,11,4,1
444705,4,1,3,5,1
444705,4,1,3,20,1
444705,19,5,14,21,4
444705,19,5,14,22,1
444705,19,5,14,23,1
444705,15,4,11,24,1
444705,4,1,3,25,1
444705,4,1,3,40,1
444714,539,78,461,1,4
444714,539,78,461,2,1
444714,539,78,461,3,1
444714,124,20,104,4,1
444714,415,58,357,5,1
444714,22,2,20,19,1
444714,393,56,337,20,1
444714,539,78,461,21,4
444714,539,78,461,22,1
444714,539,78,461,23,1
444714,124,20,104,24,1
444714,415,58,357,25,1
444714,22,2,20,39,1
444714,393,56,337,40,1
444723,2782,892,1890,1,4
444723,1634,517,1117,2,1
444723,1586,490,1096,3,1
444723,320,100,220,4,1
444723,1266,390,876,5,1
444723,48,27,21,11,1
444723,1148,375,773,12,3
444723,96,33,63,19,1
444723,1170,357,813,20,1
444723,1599,512,1087,21,4
444723,786,256,530,22,1
444723,785,255,530,23,1
444723,249,72,177,24,1
444723,536,183,353,25,1
444723,1,1,0,31,1
444723,813,256,557,32,3
444723,66,19,47,39,1
444723,470,164,306,40,1
444723,1183,380,803,41,4
444723,848,261,587,42,1
444723,801,235,566,43,1
444723,71,28,43,44,1
444723,730,207,523,45,1
444723,47,26,21,51,1
444723,335,119,216,52,3
444723,30,14,16,59,1
444723,700,193,507,60,1
444732,180,67,113,1,4
444732,180,67,113,2,1
444732,180,67,113,3,1
444732,101,44,57,4,1
444732,79,23,56,5,1
444732,79,23,56,20,1
444732,180,67,113,21,4
444732,180,67,113,22,1
444732,180,67,113,23,1
444732,101,44,57,24,1
444732,79,23,56,25,1
444732,79,23,56,40,1
444750,6,0,6,1,4
444750,6,0,6,2,1
444750,6,0,6,3,1
444750,1,0,1,4,1
444750,5,0,5,5,1
444750,5,0,5,20,1
444750,6,0,6,21,4
444750,6,0,6,22,1
444750,6,0,6,23,1
444750,1,0,1,24,1
444750,5,0,5,25,1
444750,5,0,5,40,1
444769,283,41,242,1,4
444769,283,41,242,2,1
444769,283,41,242,3,1
444769,43,4,39,4,1
444769,240,37,203,5,1
444769,240,37,203,20,1
444769,130,19,111,21,4
444769,130,19,111,22,1
444769,130,19,111,23,1
444769,3,1,2,24,1
444769,127,18,109,25,1
444769,127,18,109,40,1
444769,153,22,131,41,4
444769,153,22,131,42,1
444769,153,22,131,43,1
444769,40,3,37,44,1
444769,113,19,94,45,1
444769,113,19,94,60,1
444778,163,69,94,1,4
444778,122,56,66,2,1
444778,122,56,66,3,1
444778,4,3,1,4,1
444778,118,53,65,5,1
444778,41,13,28,12,3
444778,3,0,3,19,1
444778,115,53,62,20,1
444778,56,26,30,21,4
444778,54,25,29,22,1
444778,54,25,29,23,1
444778,1,1,0,24,1
444778,53,24,29,25,1
444778,2,1,1,32,3
444778,3,0,3,39,1
444778,50,24,26,40,1
444778,107,43,64,41,4
444778,68,31,37,42,1
444778,68,31,37,43,1
444778,3,2,1,44,1
444778,65,29,36,45,1
444778,39,12,27,52,3
444778,65,29,36,60,1
444787,86,14,72,1,4
444787,86,14,72,2,1
444787,86,14,72,3,1
444787,86,14,72,5,1
444787,45,7,38,19,1
444787,41,7,34,20,1
444787,86,14,72,21,4
444787,86,14,72,22,1
444787,86,14,72,23,1
444787,86,14,72,25,1
444787,45,7,38,39,1
444787,41,7,34,40,1
444796,92,50,42,1,4
444796,92,50,42,2,1
444796,92,50,42,3,1
444796,82,43,39,4,1
444796,10,7,3,5,1
444796,10,7,3,20,1
444796,92,50,42,21,4
444796,92,50,42,22,1
444796,92,50,42,23,1
444796,82,43,39,24,1
444796,10,7,3,25,1
444796,10,7,3,40,1
444811,289,35,254,1,4
444811,289,35,254,2,1
444811,289,35,254,3,1
444811,25,0,25,4,1
444811,264,35,229,5,1
444811,264,35,229,20,1
444811,198,19,179,21,4
444811,198,19,179,22,1
444811,198,19,179,23,1
444811,25,0,25,24,1
444811,173,19,154,25,1
444811,173,19,154,40,1
444811,91,16,75,41,4
444811,91,16,75,42,1
444811,91,16,75,43,1
444811,91,16,75,45,1
444811,91,16,75,60,1
444857,56,2,54,1,4
444857,56,2,54,2,1
444857,56,2,54,3,1
444857,16,1,15,4,1
444857,40,1,39,5,1
444857,40,1,39,20,1
444857,56,2,54,21,4
444857,56,2,54,22,1
444857,56,2,54,23,1
444857,16,1,15,24,1
444857,40,1,39,25,1
444857,40,1,39,40,1
444866,177,31,146,1,4
444866,177,31,146,2,1
444866,177,31,146,3,1
444866,26,4,22,4,1
444866,151,27,124,5,1
444866,151,27,124,20,1
444866,111,25,86,21,4
444866,111,25,86,22,1
444866,111,25,86,23,1
444866,21,4,17,24,1
444866,90,21,69,25,1
444866,90,21,69,40,1
444866,66,6,60,41,4
444866,66,6,60,42,1
444866,66,6,60,43,1
444866,5,0,5,44,1
444866,61,6,55,45,1
444866,61,6,55,60,1
444893,290,50,240,1,4
444893,290,50,240,2,1
444893,290,50,240,3,1
444893,206,35,171,4,1
444893,84,15,69,5,1
444893,84,15,69,20,1
444893,290,50,240,21,4
444893,290,50,240,22,1
444893,290,50,240,23,1
444893,206,35,171,24,1
444893,84,15,69,25,1
444893,84,15,69,40,1
444909,5,0,5,1,4
444909,5,0,5,2,1
444909,5,0,5,3,1
444909,4,0,4,4,1
444909,1,0,1,5,1
444909,1,0,1,20,1
444909,5,0,5,21,4
444909,5,0,5,22,1
444909,5,0,5,23,1
444909,4,0,4,24,1
444909,1,0,1,25,1
444909,1,0,1,40,1
444927,426,226,200,1,4
444927,426,226,200,2,1
444927,426,226,200,3,1
444927,86,44,42,4,1
444927,340,182,158,5,1
444927,61,29,32,19,1
444927,279,153,126,20,1
444927,305,159,146,21,4
444927,305,159,146,22,1
444927,305,159,146,23,1
444927,72,39,33,24,1
444927,233,120,113,25,1
444927,48,23,25,39,1
444927,185,97,88,40,1
444927,121,67,54,41,4
444927,121,67,54,42,1
444927,121,67,54,43,1
444927,14,5,9,44,1
444927,107,62,45,45,1
444927,13,6,7,59,1
444927,94,56,38,60,1
444936,49,4,45,1,4
444936,49,4,45,2,1
444936,49,4,45,3,1
444936,42,4,38,4,1
444936,7,0,7,5,1
444936,7,0,7,20,1
444936,49,4,45,21,4
444936,49,4,45,22,1
444936,49,4,45,23,1
444936,42,4,38,24,1
444936,7,0,7,25,1
444936,7,0,7,40,1
444945,129,10,119,1,4
444945,129,10,119,2,1
444945,129,10,119,3,1
444945,87,8,79,4,1
444945,42,2,40,5,1
444945,42,2,40,20,1
444945,129,10,119,21,4
444945,129,10,119,22,1
444945,129,10,119,23,1
444945,87,8,79,24,1
444945,42,2,40,25,1
444945,42,2,40,40,1
444954,2257,1179,1078,1,4
444954,2257,1179,1078,2,1
444954,2041,1041,1000,3,1
444954,534,270,264,4,1
444954,1507,771,736,5,1
444954,216,138,78,11,1
444954,409,236,173,19,1
444954,1098,535,563,20,1
444954,1402,731,671,21,4
444954,1402,731,671,22,1
444954,1350,683,667,23,1
444954,384,186,198,24,1
444954,966,497,469,25,1
444954,52,48,4,31,1
444954,273,162,111,39,1
444954,693,335,358,40,1
444954,855,448,407,41,4
444954,855,448,407,42,1
444954,691,358,333,43,1
444954,150,84,66,44,1
444954,541,274,267,45,1
444954,164,90,74,51,1
444954,136,74,62,59,1
444954,405,200,205,60,1
444972,64,29,35,1,4
444972,64,29,35,2,1
444972,64,29,35,3,1
444972,64,29,35,5,1
444972,64,29,35,20,1
444972,31,19,12,21,4
444972,31,19,12,22,1
444972,31,19,12,23,1
444972,31,19,12,25,1
444972,31,19,12,40,1
444972,33,10,23,41,4
444972,33,10,23,42,1
444972,33,10,23,43,1
444972,33,10,23,45,1
444972,33,10,23,60,1
444990,478,153,325,1,4
444990,478,153,325,2,1
444990,469,152,317,3,1
444990,469,152,317,5,1
444990,9,1,8,11,1
444990,131,40,91,19,1
444990,338,112,226,20,1
444990,439,140,299,21,4
444990,439,140,299,22,1
444990,438,139,299,23,1
444990,438,139,299,25,1
444990,1,1,0,31,1
444990,130,39,91,39,1
444990,308,100,208,40,1
444990,39,13,26,41,4
444990,39,13,26,42,1
444990,31,13,18,43,1
444990,31,13,18,45,1
444990,8,0,8,51,1
444990,1,1,0,59,1
444990,30,12,18,60,1
445018,1573,443,1130,1,4
445018,1573,443,1130,2,1
445018,1558,437,1121,3,1
445018,307,98,209,4,1
445018,1251,339,912,5,1
445018,15,6,9,11,1
445018,246,73,173,19,1
445018,1005,266,739,20,1
445018,984,284,700,21,4
445018,984,284,700,22,1
445018,984,284,700,23,1
445018,254,77,177,24,1
445018,730,207,523,25,1
445018,170,57,113,39,1
445018,560,150,410,40,1
445018,589,159,430,41,4
445018,589,159,430,42,1
445018,574,153,421,43,1
445018,53,21,32,44,1
445018,521,132,389,45,1
445018,15,6,9,51,1
445018,76,16,60,59,1
445018,445,116,329,60,1
445027,11619,4081,7538,1,4
445027,10105,3584,6521,2,1
445027,10103,3583,6520,3,1
445027,874,345,529,4,1
445027,9229,3238,5991,5,1
445027,2,1,1,11,1
445027,1514,497,1017,12,3
445027,1435,343,1092,19,1
445027,7794,2895,4899,20,1
445027,6119,2326,3793,21,4
445027,5440,2041,3399,22,1
445027,5440,2041,3399,23,1
445027,607,244,363,24,1
445027,4833,1797,3036,25,1
445027,679,285,394,32,3
445027,1018,251,767,39,1
445027,3815,1546,2269,40,1
445027,5500,1755,3745,41,4
445027,4665,1543,3122,42,1
445027,4663,1542,3121,43,1
445027,267,101,166,44,1
445027,4396,1441,2955,45,1
445027,2,1,1,51,1
445027,835,212,623,52,3
445027,417,92,325,59,1
445027,3979,1349,2630,60,1
445072,448,225,223,1,4
445072,448,225,223,2,1
445072,448,225,223,3,1
445072,41,19,22,4,1
445072,407,206,201,5,1
445072,1,0,1,19,1
445072,406,206,200,20,1
445072,349,175,174,21,4
445072,349,175,174,22,1
445072,349,175,174,23,1
445072,39,18,21,24,1
445072,310,157,153,25,1
445072,310,157,153,40,1
445072,99,50,49,41,4
445072,99,50,49,42,1
445072,99,50,49,43,1
445072,2,1,1,44,1
445072,97,49,48,45,1
445072,1,0,1,59,1
445072,96,49,47,60,1
445081,208,191,17,1,4
445081,208,191,17,2,1
445081,208,191,17,3,1
445081,23,23,0,4,1
445081,185,168,17,5,1
445081,2,1,1,19,1
445081,183,167,16,20,1
445081,148,136,12,21,4
445081,148,136,12,22,1
445081,148,136,12,23,1
445081,19,19,0,24,1
445081,129,117,12,25,1
445081,2,1,1,39,1
445081,127,116,11,40,1
445081,60,55,5,41,4
445081,60,55,5,42,1
445081,60,55,5,43,1
445081,4,4,0,44,1
445081,56,51,5,45,1
445081,56,51,5,60,1
445090,561,84,477,1,4
445090,561,84,477,2,1
445090,561,84,477,3,1
445090,274,44,230,4,1
445090,287,40,247,5,1
445090,287,40,247,20,1
445090,425,64,361,21,4
445090,425,64,361,22,1
445090,425,64,361,23,1
445090,243,43,200,24,1
445090,182,21,161,25,1
445090,182,21,161,40,1
445090,136,20,116,41,4
445090,136,20,116,42,1
445090,136,20,116,43,1
445090,31,1,30,44,1
445090,105,19,86,45,1
445090,105,19,86,60,1
445115,605,343,262,1,4
445115,605,343,262,2,1
445115,605,343,262,3,1
445115,65,30,35,4,1
445115,540,313,227,5,1
445115,32,18,14,19,1
445115,508,295,213,20,1
445115,605,343,262,21,4
445115,605,343,262,22,1
445115,605,343,262,23,1
445115,65,30,35,24,1
445115,540,313,227,25,1
445115,32,18,14,39,1
445115,508,295,213,40,1
445124,351,161,190,1,4
445124,351,161,190,2,1
445124,347,159,188,3,1
445124,25,9,16,4,1
445124,322,150,172,5,1
445124,4,2,2,11,1
445124,17,6,11,19,1
445124,305,144,161,20,1
445124,259,120,139,21,4
445124,259,120,139,22,1
445124,258,120,138,23,1
445124,12,5,7,24,1
445124,246,115,131,25,1
445124,1,0,1,31,1
445124,10,3,7,39,1
445124,236,112,124,40,1
445124,92,41,51,41,4
445124,92,41,51,42,1
445124,89,39,50,43,1
445124,13,4,9,44,1
445124,76,35,41,45,1
445124,3,2,1,51,1
445124,7,3,4,59,1
445124,69,32,37,60,1
445133,521,215,306,1,4
445133,463,190,273,2,1
445133,463,190,273,3,1
445133,62,16,46,4,1
445133,401,174,227,5,1
445133,58,25,33,12,3
445133,62,17,45,19,1
445133,339,157,182,20,1
445133,306,128,178,21,4
445133,257,104,153,22,1
445133,257,104,153,23,1
445133,39,9,30,24,1
445133,218,95,123,25,1
445133,49,24,25,32,3
445133,34,10,24,39,1
445133,184,85,99,40,1
445133,215,87,128,41,4
445133,206,86,120,42,1
445133,206,86,120,43,1
445133,23,7,16,44,1
445133,183,79,104,45,1
445133,9,1,8,52,3
445133,28,7,21,59,1
445133,155,72,83,60,1
445142,81,20,61,1,4
445142,81,20,61,2,1
445142,81,20,61,3,1
445142,81,20,61,5,1
445142,81,20,61,20,1
445142,81,20,61,21,4
445142,81,20,61,22,1
445142,81,20,61,23,1
445142,81,20,61,25,1
445142,81,20,61,40,1
445188,6195,3042,3153,1,4
445188,5837,2833,3004,2,1
445188,5837,2833,3004,3,1
445188,1654,805,849,4,1
445188,4183,2028,2155,5,1
445188,358,209,149,12,3
445188,103,47,56,19,1
445188,4080,1981,2099,20,1
445188,6132,2997,3135,21,4
445188,5776,2789,2987,22,1
445188,5776,2789,2987,23,1
445188,1653,804,849,24,1
445188,4123,1985,2138,25,1
445188,356,208,148,32,3
445188,102,46,56,39,1
445188,4021,1939,2082,40,1
445188,63,45,18,41,4
445188,61,44,17,42,1
445188,61,44,17,43,1
445188,1,1,0,44,1
445188,60,43,17,45,1
445188,2,1,1,52,3
445188,1,1,0,59,1
445188,59,42,17,60,1
445197,505,89,416,1,4
445197,505,89,416,2,1
445197,505,89,416,3,1
445197,85,9,76,4,1
445197,420,80,340,5,1
445197,40,10,30,19,1
445197,380,70,310,20,1
445197,460,68,392,21,4
445197,460,68,392,22,1
445197,460,68,392,23,1
445197,85,9,76,24,1
445197,375,59,316,25,1
445197,36,9,27,39,1
445197,339,50,289,40,1
445197,45,21,24,41,4
445197,45,21,24,42,1
445197,45,21,24,43,1
445197,45,21,24,45,1
445197,4,1,3,59,1
445197,41,20,21,60,1
445203,474,74,400,1,4
445203,474,74,400,2,1
445203,474,74,400,3,1
445203,147,23,124,4,1
445203,327,51,276,5,1
445203,3,1,2,19,1
445203,324,50,274,20,1
445203,474,74,400,21,4
445203,474,74,400,22,1
445203,474,74,400,23,1
445203,147,23,124,24,1
445203,327,51,276,25,1
445203,3,1,2,39,1
445203,324,50,274,40,1
445212,252,37,215,1,4
445212,252,37,215,2,1
445212,252,37,215,3,1
445212,40,6,34,4,1
445212,212,31,181,5,1
445212,212,31,181,20,1
445212,179,28,151,21,4
445212,179,28,151,22,1
445212,179,28,151,23,1
445212,28,4,24,24,1
445212,151,24,127,25,1
445212,151,24,127,40,1
445212,73,9,64,41,4
445212,73,9,64,42,1
445212,73,9,64,43,1
445212,12,2,10,44,1
445212,61,7,54,45,1
445212,61,7,54,60,1
445221,58,4,54,1,4
445221,58,4,54,2,1
445221,58,4,54,3,1
445221,23,3,20,4,1
445221,35,1,34,5,1
445221,35,1,34,20,1
445221,41,4,37,21,4
445221,41,4,37,22,1
445221,41,4,37,23,1
445221,17,3,14,24,1
445221,24,1,23,25,1
445221,24,1,23,40,1
445221,17,0,17,41,4
445221,17,0,17,42,1
445221,17,0,17,43,1
445221,6,0,6,44,1
445221,11,0,11,45,1
445221,11,0,11,60,1
445230,1018,238,780,1,4
445230,1018,238,780,2,1
445230,1018,238,780,3,1
445230,347,76,271,4,1
445230,671,162,509,5,1
445230,671,162,509,20,1
445230,1018,238,780,21,4
445230,1018,238,780,22,1
445230,1018,238,780,23,1
445230,347,76,271,24,1
445230,671,162,509,25,1
445230,671,162,509,40,1
445249,298,21,277,1,4
445249,298,21,277,2,1
445249,298,21,277,3,1
445249,82,4,78,4,1
445249,216,17,199,5,1
445249,23,1,22,19,1
445249,193,16,177,20,1
445249,298,21,277,21,4
445249,298,21,277,22,1
445249,298,21,277,23,1
445249,82,4,78,24,1
445249,216,17,199,25,1
445249,23,1,22,39,1
445249,193,16,177,40,1
445258,266,94,172,1,4
445258,266,94,172,2,1
445258,266,94,172,3,1
445258,47,25,22,4,1
445258,219,69,150,5,1
445258,39,11,28,19,1
445258,180,58,122,20,1
445258,266,94,172,21,4
445258,266,94,172,22,1
445258,266,94,172,23,1
445258,47,25,22,24,1
445258,219,69,150,25,1
445258,39,11,28,39,1
445258,180,58,122,40,1
445267,4555,1563,2992,1,4
445267,4330,1514,2816,2,1
445267,1624,321,1303,3,1
445267,1624,321,1303,5,1
445267,2706,1193,1513,11,1
445267,225,49,176,12,3
445267,753,150,603,19,1
445267,871,171,700,20,1
445267,1445,296,1149,21,4
445267,1246,251,995,22,1
445267,1238,248,990,23,1
445267,1238,248,990,25,1
445267,8,3,5,31,1
445267,199,45,154,32,3
445267,590,116,474,39,1
445267,648,132,516,40,1
445267,3110,1267,1843,41,4
445267,3084,1263,1821,42,1
445267,386,73,313,43,1
445267,386,73,313,45,1
445267,2698,1190,1508,51,1
445267,26,4,22,52,3
445267,163,34,129,59,1
445267,223,39,184,60,1
445276,420,189,231,1,4
445276,420,189,231,2,1
445276,420,189,231,3,1
445276,40,14,26,4,1
445276,380,175,205,5,1
445276,3,2,1,19,1
445276,377,173,204,20,1
445276,337,147,190,21,4
445276,337,147,190,22,1
445276,337,147,190,23,1
445276,36,13,23,24,1
445276,301,134,167,25,1
445276,3,2,1,39,1
445276,298,132,166,40,1
445276,83,42,41,41,4
445276,83,42,41,42,1
445276,83,42,41,43,1
445276,4,1,3,44,1
445276,79,41,38,45,1
445276,79,41,38,60,1
445300,455,211,244,1,4
445300,455,211,244,2,1
445300,455,211,244,3,1
445300,40,15,25,4,1
445300,415,196,219,5,1
445300,23,15,8,19,1
445300,392,181,211,20,1
445300,455,211,244,21,4
445300,455,211,244,22,1
445300,455,211,244,23,1
445300,40,15,25,24,1
445300,415,196,219,25,1
445300,23,15,8,39,1
445300,392,181,211,40,1
445319,180,92,88,1,4
445319,153,77,76,2,1
445319,153,77,76,3,1
445319,5,2,3,4,1
445319,148,75,73,5,1
445319,27,15,12,12,3
445319,10,5,5,19,1
445319,138,70,68,20,1
445319,180,92,88,21,4
445319,153,77,76,22,1
445319,153,77,76,23,1
445319,5,2,3,24,1
445319,148,75,73,25,1
445319,27,15,12,32,3
445319,10,5,5,39,1
445319,138,70,68,40,1
445328,282,30,252,1,4
445328,282,30,252,2,1
445328,264,30,234,3,1
445328,75,10,65,4,1
445328,189,20,169,5,1
445328,18,0,18,11,1
445328,5,1,4,19,1
445328,184,19,165,20,1
445328,282,30,252,21,4
445328,282,30,252,22,1
445328,264,30,234,23,1
445328,75,10,65,24,1
445328,189,20,169,25,1
445328,18,0,18,31,1
445328,5,1,4,39,1
445328,184,19,165,40,1
445346,267,35,232,1,4
445346,267,35,232,2,1
445346,265,33,232,3,1
445346,85,10,75,4,1
445346,180,23,157,5,1
445346,2,2,0,11,1
445346,14,1,13,19,1
445346,166,22,144,20,1
445346,267,35,232,21,4
445346,267,35,232,22,1
445346,265,33,232,23,1
445346,85,10,75,24,1
445346,180,23,157,25,1
445346,2,2,0,31,1
445346,14,1,13,39,1
445346,166,22,144,40,1
445364,392,71,321,1,4
445364,392,71,321,2,1
445364,392,71,321,3,1
445364,95,17,78,4,1
445364,297,54,243,5,1
445364,297,54,243,20,1
445364,392,71,321,21,4
445364,392,71,321,22,1
445364,392,71,321,23,1
445364,95,17,78,24,1
445364,297,54,243,25,1
445364,297,54,243,40,1
445373,434,71,363,1,4
445373,434,71,363,2,1
445373,434,71,363,3,1
445373,74,5,69,4,1
445373,360,66,294,5,1
445373,360,66,294,20,1
445373,434,71,363,21,4
445373,434,71,363,22,1
445373,434,71,363,23,1
445373,74,5,69,24,1
445373,360,66,294,25,1
445373,360,66,294,40,1
445382,327,46,281,1,4
445382,327,46,281,2,1
445382,327,46,281,3,1
445382,40,8,32,4,1
445382,287,38,249,5,1
445382,287,38,249,20,1
445382,327,46,281,21,4
445382,327,46,281,22,1
445382,327,46,281,23,1
445382,40,8,32,24,1
445382,287,38,249,25,1
445382,287,38,249,40,1
445391,216,86,130,1,4
445391,203,81,122,2,1
445391,203,81,122,3,1
445391,6,4,2,4,1
445391,197,77,120,5,1
445391,13,5,8,12,3
445391,13,3,10,19,1
445391,184,74,110,20,1
445391,216,86,130,21,4
445391,203,81,122,22,1
445391,203,81,122,23,1
445391,6,4,2,24,1
445391,197,77,120,25,1
445391,13,5,8,32,3
445391,13,3,10,39,1
445391,184,74,110,40,1
445434,711,284,427,1,4
445434,711,284,427,2,1
445434,711,284,427,3,1
445434,94,44,50,4,1
445434,617,240,377,5,1
445434,54,19,35,19,1
445434,563,221,342,20,1
445434,575,233,342,21,4
445434,575,233,342,22,1
445434,575,233,342,23,1
445434,92,42,50,24,1
445434,483,191,292,25,1
445434,40,13,27,39,1
445434,443,178,265,40,1
445434,136,51,85,41,4
445434,136,51,85,42,1
445434,136,51,85,43,1
445434,2,2,0,44,1
445434,134,49,85,45,1
445434,14,6,8,59,1
445434,120,43,77,60,1
445452,155,153,2,1,4
445452,155,153,2,2,1
445452,155,153,2,3,1
445452,155,153,2,5,1
445452,155,153,2,20,1
445452,155,153,2,21,4
445452,155,153,2,22,1
445452,155,153,2,23,1
445452,155,153,2,25,1
445452,155,153,2,40,1
445461,934,495,439,1,4
445461,934,495,439,2,1
445461,934,495,439,3,1
445461,174,82,92,4,1
445461,760,413,347,5,1
445461,760,413,347,20,1
445461,934,495,439,21,4
445461,934,495,439,22,1
445461,934,495,439,23,1
445461,174,82,92,24,1
445461,760,413,347,25,1
445461,760,413,347,40,1
445470,237,22,215,1,4
445470,237,22,215,2,1
445470,237,22,215,3,1
445470,48,3,45,4,1
445470,189,19,170,5,1
445470,36,3,33,19,1
445470,153,16,137,20,1
445470,208,16,192,21,4
445470,208,16,192,22,1
445470,208,16,192,23,1
445470,48,3,45,24,1
445470,160,13,147,25,1
445470,34,2,32,39,1
445470,126,11,115,40,1
445470,29,6,23,41,4
445470,29,6,23,42,1
445470,29,6,23,43,1
445470,29,6,23,45,1
445470,2,1,1,59,1
445470,27,5,22,60,1
445498,76,76,0,1,4
445498,76,76,0,2,1
445498,76,76,0,3,1
445498,29,29,0,4,1
445498,47,47,0,5,1
445498,47,47,0,20,1
445498,76,76,0,21,4
445498,76,76,0,22,1
445498,76,76,0,23,1
445498,29,29,0,24,1
445498,47,47,0,25,1
445498,47,47,0,40,1
445504,76,5,71,1,4
445504,76,5,71,2,1
445504,76,5,71,3,1
445504,18,1,17,4,1
445504,58,4,54,5,1
445504,58,4,54,20,1
445504,53,3,50,21,4
445504,53,3,50,22,1
445504,53,3,50,23,1
445504,14,0,14,24,1
445504,39,3,36,25,1
445504,39,3,36,40,1
445504,23,2,21,41,4
445504,23,2,21,42,1
445504,23,2,21,43,1
445504,4,1,3,44,1
445504,19,1,18,45,1
445504,19,1,18,60,1
445531,13,1,12,1,4
445531,13,1,12,2,1
445531,13,1,12,3,1
445531,13,1,12,5,1
445531,13,1,12,20,1
445531,13,1,12,21,4
445531,13,1,12,22,1
445531,13,1,12,23,1
445531,13,1,12,25,1
445531,13,1,12,40,1
445540,67,7,60,1,4
445540,67,7,60,2,1
445540,67,7,60,3,1
445540,16,0,16,4,1
445540,51,7,44,5,1
445540,51,7,44,20,1
445540,67,7,60,21,4
445540,67,7,60,22,1
445540,67,7,60,23,1
445540,16,0,16,24,1
445540,51,7,44,25,1
445540,51,7,44,40,1
445559,305,196,109,1,4
445559,305,196,109,2,1
445559,305,196,109,3,1
445559,64,46,18,4,1
445559,241,150,91,5,1
445559,27,17,10,19,1
445559,214,133,81,20,1
445559,305,196,109,21,4
445559,305,196,109,22,1
445559,305,196,109,23,1
445559,64,46,18,24,1
445559,241,150,91,25,1
445559,27,17,10,39,1
445559,214,133,81,40,1
445577,293,109,184,1,4
445577,293,109,184,2,1
445577,293,109,184,3,1
445577,117,35,82,4,1
445577,176,74,102,5,1
445577,176,74,102,20,1
445577,293,109,184,21,4
445577,293,109,184,22,1
445577,293,109,184,23,1
445577,117,35,82,24,1
445577,176,74,102,25,1
445577,176,74,102,40,1
445601,883,108,775,1,4
445601,883,108,775,2,1
445601,883,108,775,3,1
445601,404,57,347,4,1
445601,479,51,428,5,1
445601,479,51,428,20,1
445601,883,108,775,21,4
445601,883,108,775,22,1
445601,883,108,775,23,1
445601,404,57,347,24,1
445601,479,51,428,25,1
445601,479,51,428,40,1
445610,74,6,68,1,4
445610,74,6,68,2,1
445610,74,6,68,3,1
445610,2,1,1,4,1
445610,72,5,67,5,1
445610,72,5,67,20,1
445610,74,6,68,21,4
445610,74,6,68,22,1
445610,74,6,68,23,1
445610,2,1,1,24,1
445610,72,5,67,25,1
445610,72,5,67,40,1
445638,43,3,40,1,4
445638,43,3,40,2,1
445638,43,3,40,3,1
445638,5,0,5,4,1
445638,38,3,35,5,1
445638,38,3,35,20,1
445638,26,3,23,21,4
445638,26,3,23,22,1
445638,26,3,23,23,1
445638,3,0,3,24,1
445638,23,3,20,25,1
445638,23,3,20,40,1
445638,17,0,17,41,4
445638,17,0,17,42,1
445638,17,0,17,43,1
445638,2,0,2,44,1
445638,15,0,15,45,1
445638,15,0,15,60,1
445647,93,3,90,1,4
445647,93,3,90,2,1
445647,93,3,90,3,1
445647,13,0,13,4,1
445647,80,3,77,5,1
445647,80,3,77,20,1
445647,44,2,42,21,4
445647,44,2,42,22,1
445647,44,2,42,23,1
445647,6,0,6,24,1
445647,38,2,36,25,1
445647,38,2,36,40,1
445647,49,1,48,41,4
445647,49,1,48,42,1
445647,49,1,48,43,1
445647,7,0,7,44,1
445647,42,1,41,45,1
445647,42,1,41,60,1
445656,136,5,131,1,4
445656,136,5,131,2,1
445656,136,5,131,3,1
445656,28,0,28,4,1
445656,108,5,103,5,1
445656,108,5,103,20,1
445656,66,5,61,21,4
445656,66,5,61,22,1
445656,66,5,61,23,1
445656,12,0,12,24,1
445656,54,5,49,25,1
445656,54,5,49,40,1
445656,70,0,70,41,4
445656,70,0,70,42,1
445656,70,0,70,43,1
445656,16,0,16,44,1
445656,54,0,54,45,1
445656,54,0,54,60,1
445665,233,27,206,1,4
445665,233,27,206,2,1
445665,233,27,206,3,1
445665,67,7,60,4,1
445665,166,20,146,5,1
445665,166,20,146,20,1
445665,233,27,206,21,4
445665,233,27,206,22,1
445665,233,27,206,23,1
445665,67,7,60,24,1
445665,166,20,146,25,1
445665,166,20,146,40,1
445674,1162,689,473,1,4
445674,1162,689,473,2,1
445674,697,435,262,3,1
445674,163,101,62,4,1
445674,534,334,200,5,1
445674,465,254,211,11,1
445674,95,43,52,19,1
445674,439,291,148,20,1
445674,435,254,181,21,4
445674,435,254,181,22,1
445674,421,248,173,23,1
445674,150,92,58,24,1
445674,271,156,115,25,1
445674,14,6,8,31,1
445674,71,35,36,39,1
445674,200,121,79,40,1
445674,727,435,292,41,4
445674,727,435,292,42,1
445674,276,187,89,43,1
445674,13,9,4,44,1
445674,263,178,85,45,1
445674,451,248,203,51,1
445674,24,8,16,59,1
445674,239,170,69,60,1
445683,35,2,33,1,4
445683,35,2,33,2,1
445683,35,2,33,3,1
445683,34,1,33,4,1
445683,1,1,0,5,1
445683,1,1,0,20,1
445683,35,2,33,21,4
445683,35,2,33,22,1
445683,35,2,33,23,1
445683,34,1,33,24,1
445683,1,1,0,25,1
445683,1,1,0,40,1
445692,420,385,35,1,4
445692,420,385,35,2,1
445692,420,385,35,3,1
445692,138,128,10,4,1
445692,282,257,25,5,1
445692,21,20,1,19,1
445692,261,237,24,20,1
445692,420,385,35,21,4
445692,420,385,35,22,1
445692,420,385,35,23,1
445692,138,128,10,24,1
445692,282,257,25,25,1
445692,21,20,1,39,1
445692,261,237,24,40,1
445708,2325,852,1473,1,4
445708,2325,852,1473,2,1
445708,2325,852,1473,3,1
445708,624,231,393,4,1
445708,1701,621,1080,5,1
445708,164,52,112,19,1
445708,1537,569,968,20,1
445708,2286,833,1453,21,4
445708,2286,833,1453,22,1
445708,2286,833,1453,23,1
445708,622,229,393,24,1
445708,1664,604,1060,25,1
445708,163,52,111,39,1
445708,1501,552,949,40,1
445708,39,19,20,41,4
445708,39,19,20,42,1
445708,39,19,20,43,1
445708,2,2,0,44,1
445708,37,17,20,45,1
445708,1,0,1,59,1
445708,36,17,19,60,1
445717,2725,1304,1421,1,4
445717,2348,1201,1147,2,1
445717,2348,1201,1147,3,1
445717,41,16,25,4,1
445717,2307,1185,1122,5,1
445717,377,103,274,12,3
445717,271,164,107,19,1
445717,2036,1021,1015,20,1
445717,2725,1304,1421,21,4
445717,2348,1201,1147,22,1
445717,2348,1201,1147,23,1
445717,41,16,25,24,1
445717,2307,1185,1122,25,1
445717,377,103,274,32,3
445717,271,164,107,39,1
445717,2036,1021,1015,40,1
445726,269,156,113,1,4
445726,269,156,113,2,1
445726,269,156,113,3,1
445726,28,18,10,4,1
445726,241,138,103,5,1
445726,24,15,9,19,1
445726,217,123,94,20,1
445726,269,156,113,21,4
445726,269,156,113,22,1
445726,269,156,113,23,1
445726,28,18,10,24,1
445726,241,138,103,25,1
445726,24,15,9,39,1
445726,217,123,94,40,1
445735,1343,629,714,1,4
445735,264,53,211,2,1
445735,264,53,211,3,1
445735,264,53,211,5,1
445735,1079,576,503,12,3
445735,166,30,136,19,1
445735,98,23,75,20,1
445735,1297,614,683,21,4
445735,264,53,211,22,1
445735,264,53,211,23,1
445735,264,53,211,25,1
445735,1033,561,472,32,3
445735,166,30,136,39,1
445735,98,23,75,40,1
445735,46,15,31,41,4
445735,46,15,31,52,3
445744,464,71,393,1,4
445744,464,71,393,2,1
445744,464,71,393,3,1
445744,78,11,67,4,1
445744,386,60,326,5,1
445744,30,6,24,19,1
445744,356,54,302,20,1
445744,464,71,393,21,4
445744,464,71,393,22,1
445744,464,71,393,23,1
445744,78,11,67,24,1
445744,386,60,326,25,1
445744,30,6,24,39,1
445744,356,54,302,40,1
445753,130,58,72,1,4
445753,130,58,72,2,1
445753,130,58,72,3,1
445753,3,3,0,4,1
445753,127,55,72,5,1
445753,17,7,10,19,1
445753,110,48,62,20,1
445753,130,58,72,21,4
445753,130,58,72,22,1
445753,130,58,72,23,1
445753,3,3,0,24,1
445753,127,55,72,25,1
445753,17,7,10,39,1
445753,110,48,62,40,1
445762,77,70,7,1,4
445762,77,70,7,2,1
445762,77,70,7,3,1
445762,77,70,7,5,1
445762,77,70,7,20,1
445762,73,66,7,21,4
445762,73,66,7,22,1
445762,73,66,7,23,1
445762,73,66,7,25,1
445762,73,66,7,40,1
445762,4,4,0,41,4
445762,4,4,0,42,1
445762,4,4,0,43,1
445762,4,4,0,45,1
445762,4,4,0,60,1
445771,275,62,213,1,4
445771,275,62,213,2,1
445771,275,62,213,3,1
445771,32,10,22,4,1
445771,243,52,191,5,1
445771,243,52,191,20,1
445771,275,62,213,21,4
445771,275,62,213,22,1
445771,275,62,213,23,1
445771,32,10,22,24,1
445771,243,52,191,25,1
445771,243,52,191,40,1
445780,32,2,30,1,4
445780,32,2,30,2,1
445780,32,2,30,3,1
445780,15,1,14,4,1
445780,17,1,16,5,1
445780,17,1,16,20,1
445780,32,2,30,21,4
445780,32,2,30,22,1
445780,32,2,30,23,1
445780,15,1,14,24,1
445780,17,1,16,25,1
445780,17,1,16,40,1
445799,1728,1690,38,1,4
445799,1728,1690,38,2,1
445799,1728,1690,38,3,1
445799,560,552,8,4,1
445799,1168,1138,30,5,1
445799,1168,1138,30,20,1
445799,1728,1690,38,21,4
445799,1728,1690,38,22,1
445799,1728,1690,38,23,1
445799,560,552,8,24,1
445799,1168,1138,30,25,1
445799,1168,1138,30,40,1
445814,616,99,517,1,4
445814,616,99,517,2,1
445814,616,99,517,3,1
445814,99,15,84,4,1
445814,517,84,433,5,1
445814,79,2,77,19,1
445814,438,82,356,20,1
445814,616,99,517,21,4
445814,616,99,517,22,1
445814,616,99,517,23,1
445814,99,15,84,24,1
445814,517,84,433,25,1
445814,79,2,77,39,1
445814,438,82,356,40,1
445841,113,4,109,1,4
445841,113,4,109,2,1
445841,113,4,109,3,1
445841,11,0,11,4,1
445841,102,4,98,5,1
445841,102,4,98,20,1
445841,84,3,81,21,4
445841,84,3,81,22,1
445841,84,3,81,23,1
445841,9,0,9,24,1
445841,75,3,72,25,1
445841,75,3,72,40,1
445841,29,1,28,41,4
445841,29,1,28,42,1
445841,29,1,28,43,1
445841,2,0,2,44,1
445841,27,1,26,45,1
445841,27,1,26,60,1
445850,119,12,107,1,4
445850,119,12,107,2,1
445850,119,12,107,3,1
445850,9,3,6,4,1
445850,110,9,101,5,1
445850,110,9,101,20,1
445850,80,9,71,21,4
445850,80,9,71,22,1
445850,80,9,71,23,1
445850,8,2,6,24,1
445850,72,7,65,25,1
445850,72,7,65,40,1
445850,39,3,36,41,4
445850,39,3,36,42,1
445850,39,3,36,43,1
445850,1,1,0,44,1
445850,38,2,36,45,1
445850,38,2,36,60,1
445869,80,27,53,1,4
445869,80,27,53,12,3
445869,78,26,52,21,4
445869,78,26,52,32,3
445869,2,1,1,41,4
445869,2,1,1,52,3
445896,21,1,20,1,4
445896,21,1,20,2,1
445896,21,1,20,3,1
445896,9,0,9,4,1
445896,12,1,11,5,1
445896,12,1,11,20,1
445896,21,1,20,21,4
445896,21,1,20,22,1
445896,21,1,20,23,1
445896,9,0,9,24,1
445896,12,1,11,25,1
445896,12,1,11,40,1
445911,532,184,348,1,4
445911,532,184,348,2,1
445911,532,184,348,3,1
445911,82,25,57,4,1
445911,450,159,291,5,1
445911,450,159,291,20,1
445911,348,120,228,21,4
445911,348,120,228,22,1
445911,348,120,228,23,1
445911,61,19,42,24,1
445911,287,101,186,25,1
445911,287,101,186,40,1
445911,184,64,120,41,4
445911,184,64,120,42,1
445911,184,64,120,43,1
445911,21,6,15,44,1
445911,163,58,105,45,1
445911,163,58,105,60,1
445920,354,104,250,1,4
445920,354,104,250,2,1
445920,339,101,238,3,1
445920,42,12,30,4,1
445920,297,89,208,5,1
445920,15,3,12,11,1
445920,51,15,36,19,1
445920,246,74,172,20,1
445920,247,72,175,21,4
445920,247,72,175,22,1
445920,245,72,173,23,1
445920,41,12,29,24,1
445920,204,60,144,25,1
445920,2,0,2,31,1
445920,45,14,31,39,1
445920,159,46,113,40,1
445920,107,32,75,41,4
445920,107,32,75,42,1
445920,94,29,65,43,1
445920,1,0,1,44,1
445920,93,29,64,45,1
445920,13,3,10,51,1
445920,6,1,5,59,1
445920,87,28,59,60,1
445939,117,30,87,1,4
445939,117,30,87,2,1
445939,110,28,82,3,1
445939,6,1,5,4,1
445939,104,27,77,5,1
445939,7,2,5,11,1
445939,13,2,11,19,1
445939,91,25,66,20,1
445939,76,22,54,21,4
445939,76,22,54,22,1
445939,75,21,54,23,1
445939,6,1,5,24,1
445939,69,20,49,25,1
445939,1,1,0,31,1
445939,5,1,4,39,1
445939,64,19,45,40,1
445939,41,8,33,41,4
445939,41,8,33,42,1
445939,35,7,28,43,1
445939,35,7,28,45,1
445939,6,1,5,51,1
445939,8,1,7,59,1
445939,27,6,21,60,1
445948,207,35,172,1,4
445948,207,35,172,2,1
445948,207,35,172,3,1
445948,65,9,56,4,1
445948,142,26,116,5,1
445948,142,26,116,20,1
445948,202,34,168,21,4
445948,202,34,168,22,1
445948,202,34,168,23,1
445948,62,8,54,24,1
445948,140,26,114,25,1
445948,140,26,114,40,1
445948,5,1,4,41,4
445948,5,1,4,42,1
445948,5,1,4,43,1
445948,3,1,2,44,1
445948,2,0,2,45,1
445948,2,0,2,60,1
445957,268,86,182,1,4
445957,268,86,182,2,1
445957,268,86,182,3,1
445957,101,43,58,4,1
445957,167,43,124,5,1
445957,167,43,124,20,1
445957,268,86,182,41,4
445957,268,86,182,42,1
445957,268,86,182,43,1
445957,101,43,58,44,1
445957,167,43,124,45,1
445957,167,43,124,60,1
445984,33,33,0,1,4
445984,33,33,0,2,1
445984,33,33,0,3,1
445984,31,31,0,4,1
445984,2,2,0,5,1
445984,2,2,0,20,1
445984,33,33,0,21,4
445984,33,33,0,22,1
445984,33,33,0,23,1
445984,31,31,0,24,1
445984,2,2,0,25,1
445984,2,2,0,40,1
445993,307,21,286,1,4
445993,307,21,286,2,1
445993,307,21,286,3,1
445993,31,3,28,4,1
445993,276,18,258,5,1
445993,276,18,258,20,1
445993,221,15,206,21,4
445993,221,15,206,22,1
445993,221,15,206,23,1
445993,23,2,21,24,1
445993,198,13,185,25,1
445993,198,13,185,40,1
445993,86,6,80,41,4
445993,86,6,80,42,1
445993,86,6,80,43,1
445993,8,1,7,44,1
445993,78,5,73,45,1
445993,78,5,73,60,1
446002,65,18,47,1,4
446002,65,18,47,12,3
446002,35,11,24,21,4
446002,35,11,24,32,3
446002,30,7,23,41,4
446002,30,7,23,52,3
446039,42,17,25,1,4
446039,42,17,25,12,3
446039,37,15,22,21,4
446039,37,15,22,32,3
446039,5,2,3,41,4
446039,5,2,3,52,3
446048,988,507,481,1,4
446048,906,468,438,2,1
446048,904,468,436,3,1
446048,254,130,124,4,1
446048,650,338,312,5,1
446048,2,0,2,11,1
446048,82,39,43,12,3
446048,62,36,26,19,1
446048,588,302,286,20,1
446048,965,497,468,21,4
446048,890,461,429,22,1
446048,890,461,429,23,1
446048,254,130,124,24,1
446048,636,331,305,25,1
446048,75,36,39,32,3
446048,61,35,26,39,1
446048,575,296,279,40,1
446048,23,10,13,41,4
446048,16,7,9,42,1
446048,14,7,7,43,1
446048,14,7,7,45,1
446048,2,0,2,51,1
446048,7,3,4,52,3
446048,1,1,0,59,1
446048,13,6,7,60,1
446057,39,4,35,1,4
446057,39,4,35,2,1
446057,39,4,35,3,1
446057,11,2,9,4,1
446057,28,2,26,5,1
446057,28,2,26,20,1
446057,39,4,35,21,4
446057,39,4,35,22,1
446057,39,4,35,23,1
446057,11,2,9,24,1
446057,28,2,26,25,1
446057,28,2,26,40,1
446075,21,2,19,1,4
446075,21,2,19,2,1
446075,21,2,19,3,1
446075,4,0,4,4,1
446075,17,2,15,5,1
446075,17,2,15,20,1
446075,21,2,19,21,4
446075,21,2,19,22,1
446075,21,2,19,23,1
446075,4,0,4,24,1
446075,17,2,15,25,1
446075,17,2,15,40,1
446084,201,27,174,1,4
446084,201,27,174,2,1
446084,201,27,174,3,1
446084,56,3,53,4,1
446084,145,24,121,5,1
446084,145,24,121,20,1
446084,11,0,11,21,4
446084,11,0,11,22,1
446084,11,0,11,23,1
446084,11,0,11,25,1
446084,11,0,11,40,1
446084,190,27,163,41,4
446084,190,27,163,42,1
446084,190,27,163,43,1
446084,56,3,53,44,1
446084,134,24,110,45,1
446084,134,24,110,60,1
446093,167,12,155,1,4
446093,167,12,155,2,1
446093,167,12,155,3,1
446093,17,2,15,4,1
446093,150,10,140,5,1
446093,54,2,52,19,1
446093,96,8,88,20,1
446093,167,12,155,21,4
446093,167,12,155,22,1
446093,167,12,155,23,1
446093,17,2,15,24,1
446093,150,10,140,25,1
446093,54,2,52,39,1
446093,96,8,88,40,1
446109,185,34,151,1,4
446109,185,34,151,2,1
446109,185,34,151,3,1
446109,58,8,50,4,1
446109,127,26,101,5,1
446109,127,26,101,20,1
446109,185,34,151,21,4
446109,185,34,151,22,1
446109,185,34,151,23,1
446109,58,8,50,24,1
446109,127,26,101,25,1
446109,127,26,101,40,1
446118,615,93,522,1,4
446118,615,93,522,2,1
446118,615,93,522,3,1
446118,331,46,285,4,1
446118,284,47,237,5,1
446118,284,47,237,20,1
446118,615,93,522,21,4
446118,615,93,522,22,1
446118,615,93,522,23,1
446118,331,46,285,24,1
446118,284,47,237,25,1
446118,284,47,237,40,1
446127,228,22,206,1,4
446127,228,22,206,2,1
446127,228,22,206,3,1
446127,27,3,24,4,1
446127,201,19,182,5,1
446127,105,7,98,19,1
446127,96,12,84,20,1
446127,228,22,206,21,4
446127,228,22,206,22,1
446127,228,22,206,23,1
446127,27,3,24,24,1
446127,201,19,182,25,1
446127,105,7,98,39,1
446127,96,12,84,40,1
446136,422,95,327,1,4
446136,422,95,327,2,1
446136,422,95,327,3,1
446136,182,45,137,4,1
446136,240,50,190,5,1
446136,240,50,190,20,1
446136,422,95,327,21,4
446136,422,95,327,22,1
446136,422,95,327,23,1
446136,182,45,137,24,1
446136,240,50,190,25,1
446136,240,50,190,40,1
446145,36,6,30,1,4
446145,36,6,30,2,1
446145,36,6,30,3,1
446145,5,1,4,4,1
446145,31,5,26,5,1
446145,31,5,26,20,1
446145,28,5,23,21,4
446145,28,5,23,22,1
446145,28,5,23,23,1
446145,4,1,3,24,1
446145,24,4,20,25,1
446145,24,4,20,40,1
446145,8,1,7,41,4
446145,8,1,7,42,1
446145,8,1,7,43,1
446145,1,0,1,44,1
446145,7,1,6,45,1
446145,7,1,6,60,1
446163,60,32,28,1,4
446163,60,32,28,2,1
446163,60,32,28,3,1
446163,28,17,11,4,1
446163,32,15,17,5,1
446163,1,1,0,19,1
446163,31,14,17,20,1
446163,42,24,18,21,4
446163,42,24,18,22,1
446163,42,24,18,23,1
446163,17,11,6,24,1
446163,25,13,12,25,1
446163,1,1,0,39,1
446163,24,12,12,40,1
446163,18,8,10,41,4
446163,18,8,10,42,1
446163,18,8,10,43,1
446163,11,6,5,44,1
446163,7,2,5,45,1
446163,7,2,5,60,1
446190,27,1,26,1,4
446190,27,1,26,2,1
446190,27,1,26,3,1
446190,8,0,8,4,1
446190,19,1,18,5,1
446190,19,1,18,20,1
446190,27,1,26,21,4
446190,27,1,26,22,1
446190,27,1,26,23,1
446190,8,0,8,24,1
446190,19,1,18,25,1
446190,19,1,18,40,1
446206,33,1,32,1,4
446206,33,1,32,2,1
446206,33,1,32,3,1
446206,10,1,9,4,1
446206,23,0,23,5,1
446206,23,0,23,20,1
446206,26,1,25,21,4
446206,26,1,25,22,1
446206,26,1,25,23,1
446206,9,1,8,24,1
446206,17,0,17,25,1
446206,17,0,17,40,1
446206,7,0,7,41,4
446206,7,0,7,42,1
446206,7,0,7,43,1
446206,1,0,1,44,1
446206,6,0,6,45,1
446206,6,0,6,60,1
446215,44,1,43,1,4
446215,44,1,43,2,1
446215,44,1,43,3,1
446215,11,0,11,4,1
446215,33,1,32,5,1
446215,33,1,32,20,1
446215,44,1,43,21,4
446215,44,1,43,22,1
446215,44,1,43,23,1
446215,11,0,11,24,1
446215,33,1,32,25,1
446215,33,1,32,40,1
446224,64,23,41,1,4
446224,64,23,41,2,1
446224,64,23,41,3,1
446224,64,23,41,5,1
446224,64,23,41,20,1
446224,63,23,40,21,4
446224,63,23,40,22,1
446224,63,23,40,23,1
446224,63,23,40,25,1
446224,63,23,40,40,1
446224,1,0,1,41,4
446224,1,0,1,42,1
446224,1,0,1,43,1
446224,1,0,1,45,1
446224,1,0,1,60,1
446233,178,109,69,1,4
446233,178,109,69,2,1
446233,175,107,68,3,1
446233,80,45,35,4,1
446233,95,62,33,5,1
446233,3,2,1,11,1
446233,4,1,3,19,1
446233,91,61,30,20,1
446233,144,88,56,21,4
446233,144,88,56,22,1
446233,142,86,56,23,1
446233,77,45,32,24,1
446233,65,41,24,25,1
446233,2,2,0,31,1
446233,2,0,2,39,1
446233,63,41,22,40,1
446233,34,21,13,41,4
446233,34,21,13,42,1
446233,33,21,12,43,1
446233,3,0,3,44,1
446233,30,21,9,45,1
446233,1,0,1,51,1
446233,2,1,1,59,1
446233,28,20,8,60,1
446242,176,46,130,1,4
446242,176,46,130,2,1
446242,176,46,130,3,1
446242,51,13,38,4,1
446242,125,33,92,5,1
446242,125,33,92,20,1
446242,176,46,130,21,4
446242,176,46,130,22,1
446242,176,46,130,23,1
446242,51,13,38,24,1
446242,125,33,92,25,1
446242,125,33,92,40,1
446251,67,25,42,1,4
446251,67,25,42,2,1
446251,67,25,42,3,1
446251,30,13,17,4,1
446251,37,12,25,5,1
446251,37,12,25,20,1
446251,67,25,42,21,4
446251,67,25,42,22,1
446251,67,25,42,23,1
446251,30,13,17,24,1
446251,37,12,25,25,1
446251,37,12,25,40,1
446260,128,6,122,1,4
446260,128,6,122,2,1
446260,128,6,122,3,1
446260,31,0,31,4,1
446260,97,6,91,5,1
446260,97,6,91,20,1
446260,128,6,122,21,4
446260,128,6,122,22,1
446260,128,6,122,23,1
446260,31,0,31,24,1
446260,97,6,91,25,1
446260,97,6,91,40,1
446288,87,2,85,1,4
446288,87,2,85,2,1
446288,87,2,85,3,1
446288,17,1,16,4,1
446288,70,1,69,5,1
446288,70,1,69,20,1
446288,60,2,58,21,4
446288,60,2,58,22,1
446288,60,2,58,23,1
446288,11,1,10,24,1
446288,49,1,48,25,1
446288,49,1,48,40,1
446288,27,0,27,41,4
446288,27,0,27,42,1
446288,27,0,27,43,1
446288,6,0,6,44,1
446288,21,0,21,45,1
446288,21,0,21,60,1
446303,68,4,64,1,4
446303,68,4,64,2,1
446303,68,4,64,3,1
446303,24,2,22,4,1
446303,44,2,42,5,1
446303,44,2,42,20,1
446303,34,4,30,21,4
446303,34,4,30,22,1
446303,34,4,30,23,1
446303,14,2,12,24,1
446303,20,2,18,25,1
446303,20,2,18,40,1
446303,34,0,34,41,4
446303,34,0,34,42,1
446303,34,0,34,43,1
446303,10,0,10,44,1
446303,24,0,24,45,1
446303,24,0,24,60,1
446349,3,2,1,1,4
446349,3,2,1,2,1
446349,3,2,1,3,1
446349,2,1,1,4,1
446349,1,1,0,5,1
446349,1,1,0,20,1
446349,3,2,1,21,4
446349,3,2,1,22,1
446349,3,2,1,23,1
446349,2,1,1,24,1
446349,1,1,0,25,1
446349,1,1,0,40,1
446385,148,112,36,1,4
446385,148,112,36,2,1
446385,148,112,36,3,1
446385,25,17,8,4,1
446385,123,95,28,5,1
446385,43,30,13,19,1
446385,80,65,15,20,1
446385,142,107,35,21,4
446385,142,107,35,22,1
446385,142,107,35,23,1
446385,25,17,8,24,1
446385,117,90,27,25,1
446385,43,30,13,39,1
446385,74,60,14,40,1
446385,6,5,1,41,4
446385,6,5,1,42,1
446385,6,5,1,43,1
446385,6,5,1,45,1
446385,6,5,1,60,1
446394,105,46,59,1,4
446394,76,34,42,2,1
446394,76,34,42,3,1
446394,6,1,5,4,1
446394,70,33,37,5,1
446394,29,12,17,12,3
446394,6,3,3,19,1
446394,64,30,34,20,1
446394,7,3,4,21,4
446394,4,2,2,22,1
446394,4,2,2,23,1
446394,1,0,1,24,1
446394,3,2,1,25,1
446394,3,1,2,32,3
446394,1,1,0,39,1
446394,2,1,1,40,1
446394,98,43,55,41,4
446394,72,32,40,42,1
446394,72,32,40,43,1
446394,5,1,4,44,1
446394,67,31,36,45,1
446394,26,11,15,52,3
446394,5,2,3,59,1
446394,62,29,33,60,1
446400,148,44,104,1,4
446400,148,44,104,2,1
446400,148,44,104,3,1
446400,78,27,51,4,1
446400,70,17,53,5,1
446400,70,17,53,20,1
446400,148,44,104,21,4
446400,148,44,104,22,1
446400,148,44,104,23,1
446400,78,27,51,24,1
446400,70,17,53,25,1
446400,70,17,53,40,1
446437,401,195,206,1,4
446437,401,195,206,2,1
446437,401,195,206,3,1
446437,280,133,147,4,1
446437,121,62,59,5,1
446437,121,62,59,20,1
446437,268,145,123,21,4
446437,268,145,123,22,1
446437,268,145,123,23,1
446437,210,113,97,24,1
446437,58,32,26,25,1
446437,58,32,26,40,1
446437,133,50,83,41,4
446437,133,50,83,42,1
446437,133,50,83,43,1
446437,70,20,50,44,1
446437,63,30,33,45,1
446437,63,30,33,60,1
446446,45,12,33,1,4
446446,45,12,33,2,1
446446,45,12,33,3,1
446446,45,12,33,5,1
446446,45,12,33,20,1
446446,20,7,13,21,4
446446,20,7,13,22,1
446446,20,7,13,23,1
446446,20,7,13,25,1
446446,20,7,13,40,1
446446,25,5,20,41,4
446446,25,5,20,42,1
446446,25,5,20,43,1
446446,25,5,20,45,1
446446,25,5,20,60,1
446455,38,35,3,1,4
446455,38,35,3,2,1
446455,38,35,3,3,1
446455,26,25,1,4,1
446455,12,10,2,5,1
446455,12,10,2,20,1
446455,38,35,3,21,4
446455,38,35,3,22,1
446455,38,35,3,23,1
446455,26,25,1,24,1
446455,12,10,2,25,1
446455,12,10,2,40,1
446464,57,7,50,1,4
446464,57,7,50,2,1
446464,57,7,50,3,1
446464,2,0,2,4,1
446464,55,7,48,5,1
446464,55,7,48,20,1
446464,57,7,50,21,4
446464,57,7,50,22,1
446464,57,7,50,23,1
446464,2,0,2,24,1
446464,55,7,48,25,1
446464,55,7,48,40,1
446491,17,2,15,1,4
446491,17,2,15,2,1
446491,17,2,15,3,1
446491,10,2,8,4,1
446491,7,0,7,5,1
446491,7,0,7,20,1
446491,13,1,12,21,4
446491,13,1,12,22,1
446491,13,1,12,23,1
446491,7,1,6,24,1
446491,6,0,6,25,1
446491,6,0,6,40,1
446491,4,1,3,41,4
446491,4,1,3,42,1
446491,4,1,3,43,1
446491,3,1,2,44,1
446491,1,0,1,45,1
446491,1,0,1,60,1
446516,31,7,24,1,4
446516,31,7,24,2,1
446516,31,7,24,3,1
446516,24,6,18,4,1
446516,7,1,6,5,1
446516,7,1,6,20,1
446516,31,7,24,21,4
446516,31,7,24,22,1
446516,31,7,24,23,1
446516,24,6,18,24,1
446516,7,1,6,25,1
446516,7,1,6,40,1
446525,92,80,12,1,4
446525,92,80,12,2,1
446525,92,80,12,3,1
446525,42,37,5,4,1
446525,50,43,7,5,1
446525,16,12,4,19,1
446525,34,31,3,20,1
446525,92,80,12,21,4
446525,92,80,12,22,1
446525,92,80,12,23,1
446525,42,37,5,24,1
446525,50,43,7,25,1
446525,16,12,4,39,1
446525,34,31,3,40,1
446534,114,70,44,1,4
446534,114,70,44,2,1
446534,114,70,44,3,1
446534,81,47,34,4,1
446534,33,23,10,5,1
446534,33,23,10,20,1
446534,114,70,44,21,4
446534,114,70,44,22,1
446534,114,70,44,23,1
446534,81,47,34,24,1
446534,33,23,10,25,1
446534,33,23,10,40,1
446543,26,2,24,1,4
446543,26,2,24,2,1
446543,26,2,24,3,1
446543,24,1,23,4,1
446543,2,1,1,5,1
446543,2,1,1,20,1
446543,26,2,24,21,4
446543,26,2,24,22,1
446543,26,2,24,23,1
446543,24,1,23,24,1
446543,2,1,1,25,1
446543,2,1,1,40,1
446552,1502,680,822,1,4
446552,1502,680,822,2,1
446552,1502,680,822,3,1
446552,468,202,266,4,1
446552,1034,478,556,5,1
446552,1034,478,556,20,1
446552,1502,680,822,21,4
446552,1502,680,822,22,1
446552,1502,680,822,23,1
446552,468,202,266,24,1
446552,1034,478,556,25,1
446552,1034,478,556,40,1
446561,963,278,685,1,4
446561,963,278,685,2,1
446561,963,278,685,3,1
446561,144,43,101,4,1
446561,819,235,584,5,1
446561,24,10,14,19,1
446561,795,225,570,20,1
446561,963,278,685,21,4
446561,963,278,685,22,1
446561,963,278,685,23,1
446561,144,43,101,24,1
446561,819,235,584,25,1
446561,24,10,14,39,1
446561,795,225,570,40,1
446570,17,6,11,1,4
446570,17,6,11,2,1
446570,17,6,11,3,1
446570,14,4,10,4,1
446570,3,2,1,5,1
446570,3,2,1,20,1
446570,6,4,2,21,4
446570,6,4,2,22,1
446570,6,4,2,23,1
446570,5,3,2,24,1
446570,1,1,0,25,1
446570,1,1,0,40,1
446570,11,2,9,41,4
446570,11,2,9,42,1
446570,11,2,9,43,1
446570,9,1,8,44,1
446570,2,1,1,45,1
446570,2,1,1,60,1
446589,133,26,107,1,4
446589,133,26,107,2,1
446589,133,26,107,3,1
446589,38,6,32,4,1
446589,95,20,75,5,1
446589,95,20,75,20,1
446589,92,15,77,21,4
446589,92,15,77,22,1
446589,92,15,77,23,1
446589,27,5,22,24,1
446589,65,10,55,25,1
446589,65,10,55,40,1
446589,41,11,30,41,4
446589,41,11,30,42,1
446589,41,11,30,43,1
446589,11,1,10,44,1
446589,30,10,20,45,1
446589,30,10,20,60,1
446598,28,5,23,1,4
446598,28,5,23,2,1
446598,27,5,22,3,1
446598,5,2,3,4,1
446598,22,3,19,5,1
446598,1,0,1,11,1
446598,1,0,1,19,1
446598,21,3,18,20,1
446598,28,5,23,21,4
446598,28,5,23,22,1
446598,27,5,22,23,1
446598,5,2,3,24,1
446598,22,3,19,25,1
446598,1,0,1,31,1
446598,1,0,1,39,1
446598,21,3,18,40,1
446604,1561,1561,0,1,4
446604,1561,1561,0,2,1
446604,1561,1561,0,3,1
446604,305,305,0,4,1
446604,1256,1256,0,5,1
446604,171,171,0,19,1
446604,1085,1085,0,20,1
446604,1561,1561,0,21,4
446604,1561,1561,0,22,1
446604,1561,1561,0,23,1
446604,305,305,0,24,1
446604,1256,1256,0,25,1
446604,171,171,0,39,1
446604,1085,1085,0,40,1
446640,344,176,168,1,4
446640,289,148,141,2,1
446640,278,141,137,3,1
446640,108,49,59,4,1
446640,170,92,78,5,1
446640,11,7,4,11,1
446640,55,28,27,12,3
446640,5,0,5,19,1
446640,165,92,73,20,1
446640,281,143,138,21,4
446640,271,137,134,22,1
446640,271,137,134,23,1
446640,107,49,58,24,1
446640,164,88,76,25,1
446640,10,6,4,32,3
446640,4,0,4,39,1
446640,160,88,72,40,1
446640,63,33,30,41,4
446640,18,11,7,42,1
446640,7,4,3,43,1
446640,1,0,1,44,1
446640,6,4,2,45,1
446640,11,7,4,51,1
446640,45,22,23,52,3
446640,1,0,1,59,1
446640,5,4,1,60,1
446668,834,405,429,1,4
446668,834,405,429,2,1
446668,834,405,429,3,1
446668,292,136,156,4,1
446668,542,269,273,5,1
446668,71,27,44,19,1
446668,471,242,229,20,1
446668,578,282,296,21,4
446668,578,282,296,22,1
446668,578,282,296,23,1
446668,202,89,113,24,1
446668,376,193,183,25,1
446668,36,10,26,39,1
446668,340,183,157,40,1
446668,256,123,133,41,4
446668,256,123,133,42,1
446668,256,123,133,43,1
446668,90,47,43,44,1
446668,166,76,90,45,1
446668,35,17,18,59,1
446668,131,59,72,60,1
446677,140,50,90,1,4
446677,140,50,90,2,1
446677,140,50,90,3,1
446677,17,7,10,4,1
446677,123,43,80,5,1
446677,8,5,3,19,1
446677,115,38,77,20,1
446677,140,50,90,21,4
446677,140,50,90,22,1
446677,140,50,90,23,1
446677,17,7,10,24,1
446677,123,43,80,25,1
446677,8,5,3,39,1
446677,115,38,77,40,1
446710,58,25,33,1,4
446710,47,17,30,2,1
446710,47,17,30,3,1
446710,47,17,30,5,1
446710,11,8,3,12,3
446710,47,17,30,20,1
446710,58,25,33,21,4
446710,47,17,30,22,1
446710,47,17,30,23,1
446710,47,17,30,25,1
446710,11,8,3,32,3
446710,47,17,30,40,1
446729,61,24,37,1,4
446729,46,18,28,2,1
446729,46,18,28,3,1
446729,46,18,28,5,1
446729,15,6,9,12,3
446729,4,2,2,19,1
446729,42,16,26,20,1
446729,61,24,37,21,4
446729,46,18,28,22,1
446729,46,18,28,23,1
446729,46,18,28,25,1
446729,15,6,9,32,3
446729,4,2,2,39,1
446729,42,16,26,40,1
446738,1048,580,468,1,4
446738,816,450,366,2,1
446738,816,450,366,3,1
446738,17,3,14,4,1
446738,799,447,352,5,1
446738,232,130,102,12,3
446738,79,43,36,19,1
446738,720,404,316,20,1
446738,1048,580,468,21,4
446738,816,450,366,22,1
446738,816,450,366,23,1
446738,17,3,14,24,1
446738,799,447,352,25,1
446738,232,130,102,32,3
446738,79,43,36,39,1
446738,720,404,316,40,1
446747,756,345,411,1,4
446747,704,324,380,2,1
446747,704,324,380,3,1
446747,27,4,23,4,1
446747,677,320,357,5,1
446747,52,21,31,12,3
446747,92,54,38,19,1
446747,585,266,319,20,1
446747,756,345,411,21,4
446747,704,324,380,22,1
446747,704,324,380,23,1
446747,27,4,23,24,1
446747,677,320,357,25,1
446747,52,21,31,32,3
446747,92,54,38,39,1
446747,585,266,319,40,1
446756,706,311,395,1,4
446756,640,277,363,2,1
446756,640,277,363,3,1
446756,11,0,11,4,1
446756,629,277,352,5,1
446756,66,34,32,12,3
446756,48,23,25,19,1
446756,581,254,327,20,1
446756,706,311,395,21,4
446756,640,277,363,22,1
446756,640,277,363,23,1
446756,11,0,11,24,1
446756,629,277,352,25,1
446756,66,34,32,32,3
446756,48,23,25,39,1
446756,581,254,327,40,1
446765,166,69,97,1,4
446765,148,66,82,2,1
446765,148,66,82,3,1
446765,148,66,82,5,1
446765,18,3,15,12,3
446765,148,66,82,20,1
446765,166,69,97,21,4
446765,148,66,82,22,1
446765,148,66,82,23,1
446765,148,66,82,25,1
446765,18,3,15,32,3
446765,148,66,82,40,1
446774,5020,1705,3315,1,4
446774,5020,1705,3315,2,1
446774,2240,824,1416,3,1
446774,487,217,270,4,1
446774,1753,607,1146,5,1
446774,2780,881,1899,11,1
446774,311,149,162,19,1
446774,1442,458,984,20,1
446774,1191,441,750,21,4
446774,1191,441,750,22,1
446774,1178,435,743,23,1
446774,331,153,178,24,1
446774,847,282,565,25,1
446774,13,6,7,31,1
446774,125,41,84,39,1
446774,722,241,481,40,1
446774,3829,1264,2565,41,4
446774,3829,1264,2565,42,1
446774,1062,389,673,43,1
446774,156,64,92,44,1
446774,906,325,581,45,1
446774,2767,875,1892,51,1
446774,186,108,78,59,1
446774,720,217,503,60,1
446792,447,316,131,1,4
446792,447,316,131,2,1
446792,447,316,131,3,1
446792,60,44,16,4,1
446792,387,272,115,5,1
446792,36,26,10,19,1
446792,351,246,105,20,1
446792,344,245,99,21,4
446792,344,245,99,22,1
446792,344,245,99,23,1
446792,29,20,9,24,1
446792,315,225,90,25,1
446792,19,13,6,39,1
446792,296,212,84,40,1
446792,103,71,32,41,4
446792,103,71,32,42,1
446792,103,71,32,43,1
446792,31,24,7,44,1
446792,72,47,25,45,1
446792,17,13,4,59,1
446792,55,34,21,60,1
446808,384,191,193,1,4
446808,384,191,193,2,1
446808,384,191,193,3,1
446808,70,22,48,4,1
446808,314,169,145,5,1
446808,33,19,14,19,1
446808,281,150,131,20,1
446808,298,155,143,21,4
446808,298,155,143,22,1
446808,298,155,143,23,1
446808,35,11,24,24,1
446808,263,144,119,25,1
446808,16,12,4,39,1
446808,247,132,115,40,1
446808,86,36,50,41,4
446808,86,36,50,42,1
446808,86,36,50,43,1
446808,35,11,24,44,1
446808,51,25,26,45,1
446808,17,7,10,59,1
446808,34,18,16,60,1
446817,117,56,61,1,4
446817,117,56,61,2,1
446817,117,56,61,3,1
446817,117,56,61,5,1
446817,117,56,61,20,1
446817,80,36,44,21,4
446817,80,36,44,22,1
446817,80,36,44,23,1
446817,80,36,44,25,1
446817,80,36,44,40,1
446817,37,20,17,41,4
446817,37,20,17,42,1
446817,37,20,17,43,1
446817,37,20,17,45,1
446817,37,20,17,60,1
446835,721,377,344,1,4
446835,721,377,344,2,1
446835,721,377,344,3,1
446835,108,60,48,4,1
446835,613,317,296,5,1
446835,40,16,24,19,1
446835,573,301,272,20,1
446835,721,377,344,21,4
446835,721,377,344,22,1
446835,721,377,344,23,1
446835,108,60,48,24,1
446835,613,317,296,25,1
446835,40,16,24,39,1
446835,573,301,272,40,1
446844,572,303,269,1,4
446844,572,303,269,2,1
446844,572,303,269,3,1
446844,72,26,46,4,1
446844,500,277,223,5,1
446844,21,9,12,19,1
446844,479,268,211,20,1
446844,572,303,269,21,4
446844,572,303,269,22,1
446844,572,303,269,23,1
446844,72,26,46,24,1
446844,500,277,223,25,1
446844,21,9,12,39,1
446844,479,268,211,40,1
446853,232,45,187,1,4
446853,232,45,187,2,1
446853,232,45,187,3,1
446853,96,12,84,4,1
446853,136,33,103,5,1
446853,136,33,103,20,1
446853,232,45,187,21,4
446853,232,45,187,22,1
446853,232,45,187,23,1
446853,96,12,84,24,1
446853,136,33,103,25,1
446853,136,33,103,40,1
446880,395,50,345,1,4
446880,395,50,345,2,1
446880,395,50,345,3,1
446880,108,12,96,4,1
446880,287,38,249,5,1
446880,115,15,100,19,1
446880,172,23,149,20,1
446880,319,36,283,21,4
446880,319,36,283,22,1
446880,319,36,283,23,1
446880,94,10,84,24,1
446880,225,26,199,25,1
446880,98,12,86,39,1
446880,127,14,113,40,1
446880,76,14,62,41,4
446880,76,14,62,42,1
446880,76,14,62,43,1
446880,14,2,12,44,1
446880,62,12,50,45,1
446880,17,3,14,59,1
446880,45,9,36,60,1
446899,362,289,73,1,4
446899,362,289,73,2,1
446899,362,289,73,3,1
446899,58,44,14,4,1
446899,304,245,59,5,1
446899,13,9,4,19,1
446899,291,236,55,20,1
446899,300,240,60,21,4
446899,300,240,60,22,1
446899,300,240,60,23,1
446899,55,42,13,24,1
446899,245,198,47,25,1
446899,12,8,4,39,1
446899,233,190,43,40,1
446899,62,49,13,41,4
446899,62,49,13,42,1
446899,62,49,13,43,1
446899,3,2,1,44,1
446899,59,47,12,45,1
446899,1,1,0,59,1
446899,58,46,12,60,1
446905,351,295,56,1,4
446905,351,295,56,2,1
446905,351,295,56,3,1
446905,20,14,6,4,1
446905,331,281,50,5,1
446905,5,4,1,19,1
446905,326,277,49,20,1
446905,278,228,50,21,4
446905,278,228,50,22,1
446905,278,228,50,23,1
446905,16,10,6,24,1
446905,262,218,44,25,1
446905,3,2,1,39,1
446905,259,216,43,40,1
446905,73,67,6,41,4
446905,73,67,6,42,1
446905,73,67,6,43,1
446905,4,4,0,44,1
446905,69,63,6,45,1
446905,2,2,0,59,1
446905,67,61,6,60,1
446914,616,518,98,1,4
446914,616,518,98,2,1
446914,616,518,98,3,1
446914,86,71,15,4,1
446914,530,447,83,5,1
446914,2,2,0,19,1
446914,528,445,83,20,1
446914,432,361,71,21,4
446914,432,361,71,22,1
446914,432,361,71,23,1
446914,74,60,14,24,1
446914,358,301,57,25,1
446914,1,1,0,39,1
446914,357,300,57,40,1
446914,184,157,27,41,4
446914,184,157,27,42,1
446914,184,157,27,43,1
446914,12,11,1,44,1
446914,172,146,26,45,1
446914,1,1,0,59,1
446914,171,145,26,60,1
446923,458,260,198,1,4
446923,458,260,198,2,1
446923,458,260,198,3,1
446923,74,51,23,4,1
446923,384,209,175,5,1
446923,16,8,8,19,1
446923,368,201,167,20,1
446923,344,201,143,21,4
446923,344,201,143,22,1
446923,344,201,143,23,1
446923,68,48,20,24,1
446923,276,153,123,25,1
446923,8,4,4,39,1
446923,268,149,119,40,1
446923,114,59,55,41,4
446923,114,59,55,42,1
446923,114,59,55,43,1
446923,6,3,3,44,1
446923,108,56,52,45,1
446923,8,4,4,59,1
446923,100,52,48,60,1
446932,410,234,176,1,4
446932,410,234,176,12,3
446932,115,64,51,21,4
446932,115,64,51,32,3
446932,295,170,125,41,4
446932,295,170,125,52,3
446996,64,0,64,1,4
446996,64,0,64,2,1
446996,64,0,64,3,1
446996,29,0,29,4,1
446996,35,0,35,5,1
446996,35,0,35,20,1
446996,51,0,51,21,4
446996,51,0,51,22,1
446996,51,0,51,23,1
446996,26,0,26,24,1
446996,25,0,25,25,1
446996,25,0,25,40,1
446996,13,0,13,41,4
446996,13,0,13,42,1
446996,13,0,13,43,1
446996,3,0,3,44,1
446996,10,0,10,45,1
446996,10,0,10,60,1
447014,327,18,309,1,4
447014,327,18,309,2,1
447014,327,18,309,3,1
447014,123,5,118,4,1
447014,204,13,191,5,1
447014,112,4,108,19,1
447014,92,9,83,20,1
447014,327,18,309,21,4
447014,327,18,309,22,1
447014,327,18,309,23,1
447014,123,5,118,24,1
447014,204,13,191,25,1
447014,112,4,108,39,1
447014,92,9,83,40,1
447023,648,251,397,1,4
447023,648,251,397,2,1
447023,648,251,397,3,1
447023,294,140,154,4,1
447023,354,111,243,5,1
447023,354,111,243,20,1
447023,631,235,396,21,4
447023,631,235,396,22,1
447023,631,235,396,23,1
447023,279,126,153,24,1
447023,352,109,243,25,1
447023,352,109,243,40,1
447023,17,16,1,41,4
447023,17,16,1,42,1
447023,17,16,1,43,1
447023,15,14,1,44,1
447023,2,2,0,45,1
447023,2,2,0,60,1
447050,282,87,195,1,4
447050,178,55,123,2,1
447050,81,16,65,3,1
447050,3,2,1,4,1
447050,78,14,64,5,1
447050,97,39,58,11,1
447050,104,32,72,12,3
447050,61,9,52,19,1
447050,17,5,12,20,1
447050,145,52,93,21,4
447050,110,39,71,22,1
447050,53,12,41,23,1
447050,1,1,0,24,1
447050,52,11,41,25,1
447050,57,27,30,31,1
447050,35,13,22,32,3
447050,38,7,31,39,1
447050,14,4,10,40,1
447050,137,35,102,41,4
447050,68,16,52,42,1
447050,28,4,24,43,1
447050,2,1,1,44,1
447050,26,3,23,45,1
447050,40,12,28,51,1
447050,69,19,50,52,3
447050,23,2,21,59,1
447050,3,1,2,60,1
447069,371,200,171,1,4
447069,371,200,171,2,1
447069,371,200,171,3,1
447069,50,24,26,4,1
447069,321,176,145,5,1
447069,4,2,2,19,1
447069,317,174,143,20,1
447069,264,141,123,21,4
447069,264,141,123,22,1
447069,264,141,123,23,1
447069,44,22,22,24,1
447069,220,119,101,25,1
447069,3,1,2,39,1
447069,217,118,99,40,1
447069,107,59,48,41,4
447069,107,59,48,42,1
447069,107,59,48,43,1
447069,6,2,4,44,1
447069,101,57,44,45,1
447069,1,1,0,59,1
447069,100,56,44,60,1
447102,512,80,432,1,4
447102,512,80,432,2,1
447102,479,77,402,3,1
447102,116,13,103,4,1
447102,363,64,299,5,1
447102,33,3,30,11,1
447102,21,2,19,19,1
447102,342,62,280,20,1
447102,512,80,432,21,4
447102,512,80,432,22,1
447102,479,77,402,23,1
447102,116,13,103,24,1
447102,363,64,299,25,1
447102,33,3,30,31,1
447102,21,2,19,39,1
447102,342,62,280,40,1
447120,312,68,244,1,4
447120,312,68,244,2,1
447120,312,68,244,3,1
447120,69,10,59,4,1
447120,243,58,185,5,1
447120,11,2,9,19,1
447120,232,56,176,20,1
447120,312,68,244,21,4
447120,312,68,244,22,1
447120,312,68,244,23,1
447120,69,10,59,24,1
447120,243,58,185,25,1
447120,11,2,9,39,1
447120,232,56,176,40,1
447148,249,10,239,1,4
447148,249,10,239,2,1
447148,249,10,239,3,1
447148,103,3,100,4,1
447148,146,7,139,5,1
447148,146,7,139,20,1
447148,184,7,177,21,4
447148,184,7,177,22,1
447148,184,7,177,23,1
447148,79,3,76,24,1
447148,105,4,101,25,1
447148,105,4,101,40,1
447148,65,3,62,41,4
447148,65,3,62,42,1
447148,65,3,62,43,1
447148,24,0,24,44,1
447148,41,3,38,45,1
447148,41,3,38,60,1
447157,6,0,6,1,4
447157,6,0,6,2,1
447157,6,0,6,3,1
447157,2,0,2,4,1
447157,4,0,4,5,1
447157,4,0,4,20,1
447157,4,0,4,21,4
447157,4,0,4,22,1
447157,4,0,4,23,1
447157,2,0,2,24,1
447157,2,0,2,25,1
447157,2,0,2,40,1
447157,2,0,2,41,4
447157,2,0,2,42,1
447157,2,0,2,43,1
447157,2,0,2,45,1
447157,2,0,2,60,1
447166,92,1,91,1,4
447166,92,1,91,2,1
447166,92,1,91,3,1
447166,25,0,25,4,1
447166,67,1,66,5,1
447166,67,1,66,20,1
447166,72,1,71,21,4
447166,72,1,71,22,1
447166,72,1,71,23,1
447166,22,0,22,24,1
447166,50,1,49,25,1
447166,50,1,49,40,1
447166,20,0,20,41,4
447166,20,0,20,42,1
447166,20,0,20,43,1
447166,3,0,3,44,1
447166,17,0,17,45,1
447166,17,0,17,60,1
447175,136,11,125,1,4
447175,136,11,125,2,1
447175,136,11,125,3,1
447175,53,5,48,4,1
447175,83,6,77,5,1
447175,83,6,77,20,1
447175,103,7,96,21,4
447175,103,7,96,22,1
447175,103,7,96,23,1
447175,44,4,40,24,1
447175,59,3,56,25,1
447175,59,3,56,40,1
447175,33,4,29,41,4
447175,33,4,29,42,1
447175,33,4,29,43,1
447175,9,1,8,44,1
447175,24,3,21,45,1
447175,24,3,21,60,1
447209,462,59,403,1,4
447209,462,59,403,2,1
447209,462,59,403,3,1
447209,61,11,50,4,1
447209,401,48,353,5,1
447209,401,48,353,20,1
447209,462,59,403,21,4
447209,462,59,403,22,1
447209,462,59,403,23,1
447209,61,11,50,24,1
447209,401,48,353,25,1
447209,401,48,353,40,1
447218,420,51,369,1,4
447218,420,51,369,2,1
447218,420,51,369,3,1
447218,69,4,65,4,1
447218,351,47,304,5,1
447218,351,47,304,20,1
447218,420,51,369,21,4
447218,420,51,369,22,1
447218,420,51,369,23,1
447218,69,4,65,24,1
447218,351,47,304,25,1
447218,351,47,304,40,1
447227,573,99,474,1,4
447227,573,99,474,2,1
447227,573,99,474,3,1
447227,55,7,48,4,1
447227,518,92,426,5,1
447227,518,92,426,20,1
447227,573,99,474,21,4
447227,573,99,474,22,1
447227,573,99,474,23,1
447227,55,7,48,24,1
447227,518,92,426,25,1
447227,518,92,426,40,1
447236,367,87,280,1,4
447236,367,87,280,2,1
447236,367,87,280,3,1
447236,47,8,39,4,1
447236,320,79,241,5,1
447236,48,10,38,19,1
447236,272,69,203,20,1
447236,274,48,226,21,4
447236,274,48,226,22,1
447236,274,48,226,23,1
447236,46,8,38,24,1
447236,228,40,188,25,1
447236,33,5,28,39,1
447236,195,35,160,40,1
447236,93,39,54,41,4
447236,93,39,54,42,1
447236,93,39,54,43,1
447236,1,0,1,44,1
447236,92,39,53,45,1
447236,15,5,10,59,1
447236,77,34,43,60,1
447245,527,73,454,1,4
447245,527,73,454,2,1
447245,527,73,454,3,1
447245,115,17,98,4,1
447245,412,56,356,5,1
447245,412,56,356,20,1
447245,527,73,454,21,4
447245,527,73,454,22,1
447245,527,73,454,23,1
447245,115,17,98,24,1
447245,412,56,356,25,1
447245,412,56,356,40,1
447254,18,1,17,1,4
447254,18,1,17,2,1
447254,18,1,17,3,1
447254,10,1,9,4,1
447254,8,0,8,5,1
447254,8,0,8,20,1
447254,18,1,17,21,4
447254,18,1,17,22,1
447254,18,1,17,23,1
447254,10,1,9,24,1
447254,8,0,8,25,1
447254,8,0,8,40,1
447263,1036,131,905,1,4
447263,1036,131,905,2,1
447263,1036,131,905,3,1
447263,80,16,64,4,1
447263,956,115,841,5,1
447263,956,115,841,20,1
447263,1036,131,905,21,4
447263,1036,131,905,22,1
447263,1036,131,905,23,1
447263,80,16,64,24,1
447263,956,115,841,25,1
447263,956,115,841,40,1
447272,620,218,402,1,4
447272,319,117,202,2,1
447272,319,117,202,3,1
447272,44,21,23,4,1
447272,275,96,179,5,1
447272,301,101,200,12,3
447272,58,22,36,19,1
447272,217,74,143,20,1
447272,151,53,98,21,4
447272,84,34,50,22,1
447272,84,34,50,23,1
447272,9,3,6,24,1
447272,75,31,44,25,1
447272,67,19,48,32,3
447272,15,7,8,39,1
447272,60,24,36,40,1
447272,469,165,304,41,4
447272,235,83,152,42,1
447272,235,83,152,43,1
447272,35,18,17,44,1
447272,200,65,135,45,1
447272,234,82,152,52,3
447272,43,15,28,59,1
447272,157,50,107,60,1
447290,953,268,685,1,4
447290,953,268,685,2,1
447290,953,268,685,3,1
447290,115,42,73,4,1
447290,838,226,612,5,1
447290,149,33,116,19,1
447290,689,193,496,20,1
447290,953,268,685,21,4
447290,953,268,685,22,1
447290,953,268,685,23,1
447290,115,42,73,24,1
447290,838,226,612,25,1
447290,149,33,116,39,1
447290,689,193,496,40,1
447315,58,6,52,1,4
447315,58,6,52,2,1
447315,58,6,52,3,1
447315,19,0,19,4,1
447315,39,6,33,5,1
447315,39,6,33,20,1
447315,35,5,30,21,4
447315,35,5,30,22,1
447315,35,5,30,23,1
447315,12,0,12,24,1
447315,23,5,18,25,1
447315,23,5,18,40,1
447315,23,1,22,41,4
447315,23,1,22,42,1
447315,23,1,22,43,1
447315,7,0,7,44,1
447315,16,1,15,45,1
447315,16,1,15,60,1
447324,129,6,123,1,4
447324,129,6,123,2,1
447324,129,6,123,3,1
447324,50,2,48,4,1
447324,79,4,75,5,1
447324,79,4,75,20,1
447324,88,4,84,21,4
447324,88,4,84,22,1
447324,88,4,84,23,1
447324,38,2,36,24,1
447324,50,2,48,25,1
447324,50,2,48,40,1
447324,41,2,39,41,4
447324,41,2,39,42,1
447324,41,2,39,43,1
447324,12,0,12,44,1
447324,29,2,27,45,1
447324,29,2,27,60,1
447333,49,4,45,1,4
447333,49,4,45,2,1
447333,49,4,45,3,1
447333,11,0,11,4,1
447333,38,4,34,5,1
447333,38,4,34,20,1
447333,49,4,45,21,4
447333,49,4,45,22,1
447333,49,4,45,23,1
447333,11,0,11,24,1
447333,38,4,34,25,1
447333,38,4,34,40,1
447342,52,2,50,1,4
447342,52,2,50,2,1
447342,52,2,50,3,1
447342,23,1,22,4,1
447342,29,1,28,5,1
447342,29,1,28,20,1
447342,34,2,32,21,4
447342,34,2,32,22,1
447342,34,2,32,23,1
447342,15,1,14,24,1
447342,19,1,18,25,1
447342,19,1,18,40,1
447342,18,0,18,41,4
447342,18,0,18,42,1
447342,18,0,18,43,1
447342,8,0,8,44,1
447342,10,0,10,45,1
447342,10,0,10,60,1
447351,318,87,231,1,4
447351,318,87,231,2,1
447351,318,87,231,3,1
447351,40,12,28,4,1
447351,278,75,203,5,1
447351,34,11,23,19,1
447351,244,64,180,20,1
447351,318,87,231,21,4
447351,318,87,231,22,1
447351,318,87,231,23,1
447351,40,12,28,24,1
447351,278,75,203,25,1
447351,34,11,23,39,1
447351,244,64,180,40,1
447360,279,74,205,1,4
447360,279,74,205,2,1
447360,279,74,205,3,1
447360,19,8,11,4,1
447360,260,66,194,5,1
447360,42,10,32,19,1
447360,218,56,162,20,1
447360,279,74,205,21,4
447360,279,74,205,22,1
447360,279,74,205,23,1
447360,19,8,11,24,1
447360,260,66,194,25,1
447360,42,10,32,39,1
447360,218,56,162,40,1
447379,172,20,152,1,4
447379,172,20,152,2,1
447379,172,20,152,3,1
447379,16,2,14,4,1
447379,156,18,138,5,1
447379,45,5,40,19,1
447379,111,13,98,20,1
447379,172,20,152,21,4
447379,172,20,152,22,1
447379,172,20,152,23,1
447379,16,2,14,24,1
447379,156,18,138,25,1
447379,45,5,40,39,1
447379,111,13,98,40,1
447388,88,12,76,1,4
447388,88,12,76,2,1
447388,88,12,76,3,1
447388,88,12,76,5,1
447388,88,12,76,20,1
447388,88,12,76,21,4
447388,88,12,76,22,1
447388,88,12,76,23,1
447388,88,12,76,25,1
447388,88,12,76,40,1
447403,1083,1053,30,1,4
447403,1083,1053,30,2,1
447403,1083,1053,30,3,1
447403,326,321,5,4,1
447403,757,732,25,5,1
447403,757,732,25,20,1
447403,1083,1053,30,21,4
447403,1083,1053,30,22,1
447403,1083,1053,30,23,1
447403,326,321,5,24,1
447403,757,732,25,25,1
447403,757,732,25,40,1
447421,241,76,165,1,4
447421,241,76,165,2,1
447421,219,72,147,3,1
447421,73,21,52,4,1
447421,146,51,95,5,1
447421,22,4,18,11,1
447421,15,3,12,19,1
447421,131,48,83,20,1
447421,127,38,89,21,4
447421,127,38,89,22,1
447421,108,35,73,23,1
447421,47,14,33,24,1
447421,61,21,40,25,1
447421,19,3,16,31,1
447421,4,2,2,39,1
447421,57,19,38,40,1
447421,114,38,76,41,4
447421,114,38,76,42,1
447421,111,37,74,43,1
447421,26,7,19,44,1
447421,85,30,55,45,1
447421,3,1,2,51,1
447421,11,1,10,59,1
447421,74,29,45,60,1
447430,142,10,132,1,4
447430,142,10,132,2,1
447430,142,10,132,3,1
447430,37,2,35,4,1
447430,105,8,97,5,1
447430,105,8,97,20,1
447430,90,5,85,21,4
447430,90,5,85,22,1
447430,90,5,85,23,1
447430,26,2,24,24,1
447430,64,3,61,25,1
447430,64,3,61,40,1
447430,52,5,47,41,4
447430,52,5,47,42,1
447430,52,5,47,43,1
447430,11,0,11,44,1
447430,41,5,36,45,1
447430,41,5,36,60,1
447449,57,5,52,1,4
447449,57,5,52,2,1
447449,57,5,52,3,1
447449,33,3,30,4,1
447449,24,2,22,5,1
447449,24,2,22,20,1
447449,35,3,32,21,4
447449,35,3,32,22,1
447449,35,3,32,23,1
447449,18,2,16,24,1
447449,17,1,16,25,1
447449,17,1,16,40,1
447449,22,2,20,41,4
447449,22,2,20,42,1
447449,22,2,20,43,1
447449,15,1,14,44,1
447449,7,1,6,45,1
447449,7,1,6,60,1
447458,574,469,105,1,4
447458,574,469,105,2,1
447458,574,469,105,3,1
447458,33,23,10,4,1
447458,541,446,95,5,1
447458,32,26,6,19,1
447458,509,420,89,20,1
447458,574,469,105,21,4
447458,574,469,105,22,1
447458,574,469,105,23,1
447458,33,23,10,24,1
447458,541,446,95,25,1
447458,32,26,6,39,1
447458,509,420,89,40,1
447467,111,6,105,1,4
447467,111,6,105,2,1
447467,111,6,105,3,1
447467,70,5,65,4,1
447467,41,1,40,5,1
447467,41,1,40,20,1
447467,111,6,105,21,4
447467,111,6,105,22,1
447467,111,6,105,23,1
447467,70,5,65,24,1
447467,41,1,40,25,1
447467,41,1,40,40,1
447476,97,21,76,1,4
447476,97,21,76,2,1
447476,97,21,76,3,1
447476,11,5,6,4,1
447476,86,16,70,5,1
447476,9,0,9,19,1
447476,77,16,61,20,1
447476,83,19,64,21,4
447476,83,19,64,22,1
447476,83,19,64,23,1
447476,8,4,4,24,1
447476,75,15,60,25,1
447476,8,0,8,39,1
447476,67,15,52,40,1
447476,14,2,12,41,4
447476,14,2,12,42,1
447476,14,2,12,43,1
447476,3,1,2,44,1
447476,11,1,10,45,1
447476,1,0,1,59,1
447476,10,1,9,60,1
447494,298,39,259,1,4
447494,298,39,259,2,1
447494,298,39,259,3,1
447494,255,31,224,4,1
447494,43,8,35,5,1
447494,43,8,35,20,1
447494,210,22,188,21,4
447494,210,22,188,22,1
447494,210,22,188,23,1
447494,182,17,165,24,1
447494,28,5,23,25,1
447494,28,5,23,40,1
447494,88,17,71,41,4
447494,88,17,71,42,1
447494,88,17,71,43,1
447494,73,14,59,44,1
447494,15,3,12,45,1
447494,15,3,12,60,1
447519,321,26,295,1,4
447519,321,26,295,2,1
447519,321,26,295,3,1
447519,222,15,207,4,1
447519,99,11,88,5,1
447519,99,11,88,20,1
447519,225,18,207,21,4
447519,225,18,207,22,1
447519,225,18,207,23,1
447519,155,9,146,24,1
447519,70,9,61,25,1
447519,70,9,61,40,1
447519,96,8,88,41,4
447519,96,8,88,42,1
447519,96,8,88,43,1
447519,67,6,61,44,1
447519,29,2,27,45,1
447519,29,2,27,60,1
447528,138,40,98,1,4
447528,138,40,98,2,1
447528,138,40,98,3,1
447528,121,32,89,4,1
447528,17,8,9,5,1
447528,17,8,9,20,1
447528,138,40,98,21,4
447528,138,40,98,22,1
447528,138,40,98,23,1
447528,121,32,89,24,1
447528,17,8,9,25,1
447528,17,8,9,40,1
447582,2551,846,1705,1,4
447582,2551,846,1705,2,1
447582,2022,662,1360,3,1
447582,634,255,379,4,1
447582,1388,407,981,5,1
447582,529,184,345,11,1
447582,253,86,167,19,1
447582,1135,321,814,20,1
447582,1657,555,1102,21,4
447582,1657,555,1102,22,1
447582,1622,550,1072,23,1
447582,575,235,340,24,1
447582,1047,315,732,25,1
447582,35,5,30,31,1
447582,190,69,121,39,1
447582,857,246,611,40,1
447582,894,291,603,41,4
447582,894,291,603,42,1
447582,400,112,288,43,1
447582,59,20,39,44,1
447582,341,92,249,45,1
447582,494,179,315,51,1
447582,63,17,46,59,1
447582,278,75,203,60,1
447591,229,34,195,1,4
447591,229,34,195,2,1
447591,229,34,195,3,1
447591,228,34,194,4,1
447591,1,0,1,5,1
447591,1,0,1,20,1
447591,229,34,195,21,4
447591,229,34,195,22,1
447591,229,34,195,23,1
447591,228,34,194,24,1
447591,1,0,1,25,1
447591,1,0,1,40,1
447625,186,62,124,1,4
447625,186,62,124,2,1
447625,152,52,100,3,1
447625,64,22,42,4,1
447625,88,30,58,5,1
447625,34,10,24,11,1
447625,39,8,31,19,1
447625,49,22,27,20,1
447625,69,25,44,21,4
447625,69,25,44,22,1
447625,40,16,24,23,1
447625,23,10,13,24,1
447625,17,6,11,25,1
447625,29,9,20,31,1
447625,5,1,4,39,1
447625,12,5,7,40,1
447625,117,37,80,41,4
447625,117,37,80,42,1
447625,112,36,76,43,1
447625,41,12,29,44,1
447625,71,24,47,45,1
447625,5,1,4,51,1
447625,34,7,27,59,1
447625,37,17,20,60,1
447634,362,86,276,1,4
447634,362,86,276,2,1
447634,362,86,276,3,1
447634,50,9,41,4,1
447634,312,77,235,5,1
447634,43,10,33,19,1
447634,269,67,202,20,1
447634,362,86,276,21,4
447634,362,86,276,22,1
447634,362,86,276,23,1
447634,50,9,41,24,1
447634,312,77,235,25,1
447634,43,10,33,39,1
447634,269,67,202,40,1
447652,391,138,253,1,4
447652,359,128,231,2,1
447652,359,128,231,3,1
447652,15,4,11,4,1
447652,344,124,220,5,1
447652,32,10,22,12,3
447652,20,6,14,19,1
447652,324,118,206,20,1
447652,391,138,253,21,4
447652,359,128,231,22,1
447652,359,128,231,23,1
447652,15,4,11,24,1
447652,344,124,220,25,1
447652,32,10,22,32,3
447652,20,6,14,39,1
447652,324,118,206,40,1
447661,158,65,93,1,4
447661,129,61,68,2,1
447661,129,61,68,3,1
447661,129,61,68,5,1
447661,29,4,25,12,3
447661,129,61,68,20,1
447661,158,65,93,21,4
447661,129,61,68,22,1
447661,129,61,68,23,1
447661,129,61,68,25,1
447661,29,4,25,32,3
447661,129,61,68,40,1
447670,264,89,175,1,4
447670,264,89,175,2,1
447670,256,85,171,3,1
447670,21,9,12,4,1
447670,235,76,159,5,1
447670,8,4,4,11,1
447670,48,10,38,19,1
447670,187,66,121,20,1
447670,209,72,137,21,4
447670,209,72,137,22,1
447670,207,72,135,23,1
447670,21,9,12,24,1
447670,186,63,123,25,1
447670,2,0,2,31,1
447670,45,9,36,39,1
447670,141,54,87,40,1
447670,55,17,38,41,4
447670,55,17,38,42,1
447670,49,13,36,43,1
447670,49,13,36,45,1
447670,6,4,2,51,1
447670,3,1,2,59,1
447670,46,12,34,60,1
447689,9719,4487,5232,1,4
447689,9719,4487,5232,2,1
447689,9325,4355,4970,3,1
447689,2107,976,1131,4,1
447689,7218,3379,3839,5,1
447689,394,132,262,11,1
447689,793,358,435,19,1
447689,6425,3021,3404,20,1
447689,6832,3173,3659,21,4
447689,6832,3173,3659,22,1
447689,6710,3133,3577,23,1
447689,1752,800,952,24,1
447689,4958,2333,2625,25,1
447689,122,40,82,31,1
447689,518,241,277,39,1
447689,4440,2092,2348,40,1
447689,2887,1314,1573,41,4
447689,2887,1314,1573,42,1
447689,2615,1222,1393,43,1
447689,355,176,179,44,1
447689,2260,1046,1214,45,1
447689,272,92,180,51,1
447689,275,117,158,59,1
447689,1985,929,1056,60,1
447698,124,41,83,1,4
447698,124,41,83,12,3
447698,95,36,59,21,4
447698,95,36,59,32,3
447698,29,5,24,41,4
447698,29,5,24,52,3
447704,64,7,57,1,4
447704,64,7,57,2,1
447704,64,7,57,3,1
447704,15,1,14,4,1
447704,49,6,43,5,1
447704,49,6,43,20,1
447704,56,7,49,21,4
447704,56,7,49,22,1
447704,56,7,49,23,1
447704,13,1,12,24,1
447704,43,6,37,25,1
447704,43,6,37,40,1
447704,8,0,8,41,4
447704,8,0,8,42,1
447704,8,0,8,43,1
447704,2,0,2,44,1
447704,6,0,6,45,1
447704,6,0,6,60,1
447713,78,20,58,1,4
447713,78,20,58,2,1
447713,78,20,58,3,1
447713,27,3,24,4,1
447713,51,17,34,5,1
447713,51,17,34,20,1
447713,78,20,58,41,4
447713,78,20,58,42,1
447713,78,20,58,43,1
447713,27,3,24,44,1
447713,51,17,34,45,1
447713,51,17,34,60,1
447722,73,21,52,1,4
447722,73,21,52,2,1
447722,73,21,52,3,1
447722,14,5,9,4,1
447722,59,16,43,5,1
447722,59,16,43,20,1
447722,73,21,52,21,4
447722,73,21,52,22,1
447722,73,21,52,23,1
447722,14,5,9,24,1
447722,59,16,43,25,1
447722,59,16,43,40,1
447731,148,2,146,1,4
447731,148,2,146,2,1
447731,148,2,146,3,1
447731,58,0,58,4,1
447731,90,2,88,5,1
447731,90,2,88,20,1
447731,78,0,78,21,4
447731,78,0,78,22,1
447731,78,0,78,23,1
447731,45,0,45,24,1
447731,33,0,33,25,1
447731,33,0,33,40,1
447731,70,2,68,41,4
447731,70,2,68,42,1
447731,70,2,68,43,1
447731,13,0,13,44,1
447731,57,2,55,45,1
447731,57,2,55,60,1
447759,234,73,161,1,4
447759,234,73,161,2,1
447759,234,73,161,3,1
447759,48,12,36,4,1
447759,186,61,125,5,1
447759,186,61,125,20,1
447759,234,73,161,21,4
447759,234,73,161,22,1
447759,234,73,161,23,1
447759,48,12,36,24,1
447759,186,61,125,25,1
447759,186,61,125,40,1
447768,1634,353,1281,1,4
447768,1634,353,1281,2,1
447768,1634,353,1281,3,1
447768,184,38,146,4,1
447768,1450,315,1135,5,1
447768,280,54,226,19,1
447768,1170,261,909,20,1
447768,1634,353,1281,21,4
447768,1634,353,1281,22,1
447768,1634,353,1281,23,1
447768,184,38,146,24,1
447768,1450,315,1135,25,1
447768,280,54,226,39,1
447768,1170,261,909,40,1
447777,686,418,268,1,4
447777,686,418,268,2,1
447777,686,418,268,3,1
447777,322,200,122,4,1
447777,364,218,146,5,1
447777,2,0,2,19,1
447777,362,218,144,20,1
447777,15,6,9,21,4
447777,15,6,9,22,1
447777,15,6,9,23,1
447777,3,3,0,24,1
447777,12,3,9,25,1
447777,2,0,2,39,1
447777,10,3,7,40,1
447777,671,412,259,41,4
447777,671,412,259,42,1
447777,671,412,259,43,1
447777,319,197,122,44,1
447777,352,215,137,45,1
447777,352,215,137,60,1
447795,28,7,21,1,4
447795,28,7,21,2,1
447795,28,7,21,3,1
447795,27,7,20,4,1
447795,1,0,1,5,1
447795,1,0,1,20,1
447795,28,7,21,21,4
447795,28,7,21,22,1
447795,28,7,21,23,1
447795,27,7,20,24,1
447795,1,0,1,25,1
447795,1,0,1,40,1
447801,177,78,99,1,4
447801,177,78,99,12,3
447801,118,55,63,21,4
447801,118,55,63,32,3
447801,59,23,36,41,4
447801,59,23,36,52,3
447810,321,26,295,1,4
447810,321,26,295,2,1
447810,321,26,295,3,1
447810,128,9,119,4,1
447810,193,17,176,5,1
447810,193,17,176,20,1
447810,321,26,295,21,4
447810,321,26,295,22,1
447810,321,26,295,23,1
447810,128,9,119,24,1
447810,193,17,176,25,1
447810,193,17,176,40,1
447847,126,120,6,1,4
447847,126,120,6,2,1
447847,126,120,6,3,1
447847,5,5,0,4,1
447847,121,115,6,5,1
447847,121,115,6,20,1
447847,126,120,6,21,4
447847,126,120,6,22,1
447847,126,120,6,23,1
447847,5,5,0,24,1
447847,121,115,6,25,1
447847,121,115,6,40,1
447856,103,18,85,1,4
447856,103,18,85,2,1
447856,103,18,85,3,1
447856,41,4,37,4,1
447856,62,14,48,5,1
447856,62,14,48,20,1
447856,103,18,85,21,4
447856,103,18,85,22,1
447856,103,18,85,23,1
447856,41,4,37,24,1
447856,62,14,48,25,1
447856,62,14,48,40,1
447865,36,26,10,1,4
447865,36,26,10,2,1
447865,36,26,10,3,1
447865,10,7,3,4,1
447865,26,19,7,5,1
447865,26,19,7,20,1
447865,28,20,8,21,4
447865,28,20,8,22,1
447865,28,20,8,23,1
447865,8,6,2,24,1
447865,20,14,6,25,1
447865,20,14,6,40,1
447865,8,6,2,41,4
447865,8,6,2,42,1
447865,8,6,2,43,1
447865,2,1,1,44,1
447865,6,5,1,45,1
447865,6,5,1,60,1
447874,375,361,14,1,4
447874,375,361,14,2,1
447874,375,361,14,3,1
447874,152,138,14,4,1
447874,223,223,0,5,1
447874,223,223,0,20,1
447874,375,361,14,21,4
447874,375,361,14,22,1
447874,375,361,14,23,1
447874,152,138,14,24,1
447874,223,223,0,25,1
447874,223,223,0,40,1
447883,65,44,21,1,4
447883,65,44,21,2,1
447883,65,44,21,3,1
447883,55,40,15,4,1
447883,10,4,6,5,1
447883,10,4,6,20,1
447883,39,27,12,21,4
447883,39,27,12,22,1
447883,39,27,12,23,1
447883,33,25,8,24,1
447883,6,2,4,25,1
447883,6,2,4,40,1
447883,26,17,9,41,4
447883,26,17,9,42,1
447883,26,17,9,43,1
447883,22,15,7,44,1
447883,4,2,2,45,1
447883,4,2,2,60,1
447892,167,39,128,1,4
447892,167,39,128,2,1
447892,167,39,128,3,1
447892,43,10,33,4,1
447892,124,29,95,5,1
447892,124,29,95,20,1
447892,128,31,97,21,4
447892,128,31,97,22,1
447892,128,31,97,23,1
447892,38,8,30,24,1
447892,90,23,67,25,1
447892,90,23,67,40,1
447892,39,8,31,41,4
447892,39,8,31,42,1
447892,39,8,31,43,1
447892,5,2,3,44,1
447892,34,6,28,45,1
447892,34,6,28,60,1
447908,29,2,27,1,4
447908,29,2,27,2,1
447908,29,2,27,3,1
447908,9,1,8,4,1
447908,20,1,19,5,1
447908,20,1,19,20,1
447908,25,2,23,21,4
447908,25,2,23,22,1
447908,25,2,23,23,1
447908,8,1,7,24,1
447908,17,1,16,25,1
447908,17,1,16,40,1
447908,4,0,4,41,4
447908,4,0,4,42,1
447908,4,0,4,43,1
447908,1,0,1,44,1
447908,3,0,3,45,1
447908,3,0,3,60,1
447917,64,13,51,1,4
447917,64,13,51,2,1
447917,64,13,51,3,1
447917,22,8,14,4,1
447917,42,5,37,5,1
447917,42,5,37,20,1
447917,52,12,40,21,4
447917,52,12,40,22,1
447917,52,12,40,23,1
447917,16,7,9,24,1
447917,36,5,31,25,1
447917,36,5,31,40,1
447917,12,1,11,41,4
447917,12,1,11,42,1
447917,12,1,11,43,1
447917,6,1,5,44,1
447917,6,0,6,45,1
447917,6,0,6,60,1
447935,427,36,391,1,4
447935,427,36,391,2,1
447935,427,36,391,3,1
447935,62,1,61,4,1
447935,365,35,330,5,1
447935,188,21,167,19,1
447935,177,14,163,20,1
447935,427,36,391,21,4
447935,427,36,391,22,1
447935,427,36,391,23,1
447935,62,1,61,24,1
447935,365,35,330,25,1
447935,188,21,167,39,1
447935,177,14,163,40,1
447953,367,174,193,1,4
447953,348,164,184,2,1
447953,348,164,184,3,1
447953,66,33,33,4,1
447953,282,131,151,5,1
447953,19,10,9,12,3
447953,27,11,16,19,1
447953,255,120,135,20,1
447953,327,152,175,21,4
447953,315,147,168,22,1
447953,315,147,168,23,1
447953,64,33,31,24,1
447953,251,114,137,25,1
447953,12,5,7,32,3
447953,27,11,16,39,1
447953,224,103,121,40,1
447953,40,22,18,41,4
447953,33,17,16,42,1
447953,33,17,16,43,1
447953,2,0,2,44,1
447953,31,17,14,45,1
447953,7,5,2,52,3
447953,31,17,14,60,1
447962,162,2,160,1,4
447962,162,2,160,2,1
447962,162,2,160,3,1
447962,28,2,26,4,1
447962,134,0,134,5,1
447962,134,0,134,20,1
447962,162,2,160,21,4
447962,162,2,160,22,1
447962,162,2,160,23,1
447962,28,2,26,24,1
447962,134,0,134,25,1
447962,134,0,134,40,1
447971,45,1,44,1,4
447971,45,1,44,2,1
447971,45,1,44,3,1
447971,36,1,35,4,1
447971,9,0,9,5,1
447971,9,0,9,20,1
447971,45,1,44,21,4
447971,45,1,44,22,1
447971,45,1,44,23,1
447971,36,1,35,24,1
447971,9,0,9,25,1
447971,9,0,9,40,1
447980,44,2,42,1,4
447980,44,2,42,2,1
447980,44,2,42,3,1
447980,27,2,25,4,1
447980,17,0,17,5,1
447980,17,0,17,20,1
447980,37,1,36,21,4
447980,37,1,36,22,1
447980,37,1,36,23,1
447980,21,1,20,24,1
447980,16,0,16,25,1
447980,16,0,16,40,1
447980,7,1,6,41,4
447980,7,1,6,42,1
447980,7,1,6,43,1
447980,6,1,5,44,1
447980,1,0,1,45,1
447980,1,0,1,60,1
447999,125,36,89,1,4
447999,125,36,89,2,1
447999,125,36,89,3,1
447999,31,7,24,4,1
447999,94,29,65,5,1
447999,94,29,65,20,1
447999,125,36,89,21,4
447999,125,36,89,22,1
447999,125,36,89,23,1
447999,31,7,24,24,1
447999,94,29,65,25,1
447999,94,29,65,40,1
448008,20,0,20,1,4
448008,20,0,20,2,1
448008,20,0,20,3,1
448008,11,0,11,4,1
448008,9,0,9,5,1
448008,9,0,9,20,1
448008,20,0,20,21,4
448008,20,0,20,22,1
448008,20,0,20,23,1
448008,11,0,11,24,1
448008,9,0,9,25,1
448008,9,0,9,40,1
448017,134,2,132,1,4
448017,134,2,132,2,1
448017,134,2,132,3,1
448017,4,1,3,4,1
448017,130,1,129,5,1
448017,130,1,129,20,1
448017,134,2,132,21,4
448017,134,2,132,22,1
448017,134,2,132,23,1
448017,4,1,3,24,1
448017,130,1,129,25,1
448017,130,1,129,40,1
448026,90,0,90,1,4
448026,90,0,90,2,1
448026,90,0,90,3,1
448026,16,0,16,4,1
448026,74,0,74,5,1
448026,74,0,74,20,1
448026,84,0,84,21,4
448026,84,0,84,22,1
448026,84,0,84,23,1
448026,16,0,16,24,1
448026,68,0,68,25,1
448026,68,0,68,40,1
448026,6,0,6,41,4
448026,6,0,6,42,1
448026,6,0,6,43,1
448026,6,0,6,45,1
448026,6,0,6,60,1
448035,25,3,22,1,4
448035,25,3,22,2,1
448035,25,3,22,3,1
448035,5,0,5,4,1
448035,20,3,17,5,1
448035,20,3,17,20,1
448035,20,3,17,21,4
448035,20,3,17,22,1
448035,20,3,17,23,1
448035,4,0,4,24,1
448035,16,3,13,25,1
448035,16,3,13,40,1
448035,5,0,5,41,4
448035,5,0,5,42,1
448035,5,0,5,43,1
448035,1,0,1,44,1
448035,4,0,4,45,1
448035,4,0,4,60,1
448044,7,1,6,1,4
448044,7,1,6,2,1
448044,7,1,6,3,1
448044,6,1,5,4,1
448044,1,0,1,5,1
448044,1,0,1,20,1
448044,7,1,6,21,4
448044,7,1,6,22,1
448044,7,1,6,23,1
448044,6,1,5,24,1
448044,1,0,1,25,1
448044,1,0,1,40,1
448053,52,3,49,1,4
448053,52,3,49,2,1
448053,52,3,49,3,1
448053,29,3,26,4,1
448053,23,0,23,5,1
448053,23,0,23,20,1
448053,52,3,49,21,4
448053,52,3,49,22,1
448053,52,3,49,23,1
448053,29,3,26,24,1
448053,23,0,23,25,1
448053,23,0,23,40,1
448071,238,34,204,1,4
448071,238,34,204,2,1
448071,238,34,204,3,1
448071,107,14,93,4,1
448071,131,20,111,5,1
448071,131,20,111,20,1
448071,163,23,140,21,4
448071,163,23,140,22,1
448071,163,23,140,23,1
448071,69,9,60,24,1
448071,94,14,80,25,1
448071,94,14,80,40,1
448071,75,11,64,41,4
448071,75,11,64,42,1
448071,75,11,64,43,1
448071,38,5,33,44,1
448071,37,6,31,45,1
448071,37,6,31,60,1
448105,18,8,10,1,4
448105,18,8,10,2,1
448105,18,8,10,3,1
448105,10,5,5,4,1
448105,8,3,5,5,1
448105,8,3,5,20,1
448105,18,8,10,21,4
448105,18,8,10,22,1
448105,18,8,10,23,1
448105,10,5,5,24,1
448105,8,3,5,25,1
448105,8,3,5,40,1
448114,599,201,398,1,4
448114,599,201,398,2,1
448114,599,201,398,3,1
448114,187,67,120,4,1
448114,412,134,278,5,1
448114,2,1,1,19,1
448114,410,133,277,20,1
448114,586,195,391,21,4
448114,586,195,391,22,1
448114,586,195,391,23,1
448114,187,67,120,24,1
448114,399,128,271,25,1
448114,1,1,0,39,1
448114,398,127,271,40,1
448114,13,6,7,41,4
448114,13,6,7,42,1
448114,13,6,7,43,1
448114,13,6,7,45,1
448114,1,0,1,59,1
448114,12,6,6,60,1
448123,120,25,95,1,4
448123,120,25,95,2,1
448123,120,25,95,3,1
448123,102,19,83,4,1
448123,18,6,12,5,1
448123,18,6,12,20,1
448123,120,25,95,21,4
448123,120,25,95,22,1
448123,120,25,95,23,1
448123,102,19,83,24,1
448123,18,6,12,25,1
448123,18,6,12,40,1
448141,39,2,37,1,4
448141,39,2,37,2,1
448141,39,2,37,3,1
448141,20,1,19,4,1
448141,19,1,18,5,1
448141,19,1,18,20,1
448141,39,2,37,21,4
448141,39,2,37,22,1
448141,39,2,37,23,1
448141,20,1,19,24,1
448141,19,1,18,25,1
448141,19,1,18,40,1
448150,121,15,106,1,4
448150,121,15,106,2,1
448150,121,15,106,3,1
448150,77,13,64,4,1
448150,44,2,42,5,1
448150,44,2,42,20,1
448150,121,15,106,21,4
448150,121,15,106,22,1
448150,121,15,106,23,1
448150,77,13,64,24,1
448150,44,2,42,25,1
448150,44,2,42,40,1
448196,178,16,162,1,4
448196,178,16,162,2,1
448196,178,16,162,3,1
448196,89,8,81,4,1
448196,89,8,81,5,1
448196,89,8,81,20,1
448196,155,14,141,21,4
448196,155,14,141,22,1
448196,155,14,141,23,1
448196,79,7,72,24,1
448196,76,7,69,25,1
448196,76,7,69,40,1
448196,23,2,21,41,4
448196,23,2,21,42,1
448196,23,2,21,43,1
448196,10,1,9,44,1
448196,13,1,12,45,1
448196,13,1,12,60,1
448202,53,4,49,1,4
448202,53,4,49,2,1
448202,53,4,49,3,1
448202,11,1,10,4,1
448202,42,3,39,5,1
448202,42,3,39,20,1
448202,33,2,31,21,4
448202,33,2,31,22,1
448202,33,2,31,23,1
448202,7,1,6,24,1
448202,26,1,25,25,1
448202,26,1,25,40,1
448202,20,2,18,41,4
448202,20,2,18,42,1
448202,20,2,18,43,1
448202,4,0,4,44,1
448202,16,2,14,45,1
448202,16,2,14,60,1
448211,45,3,42,1,4
448211,45,3,42,2,1
448211,45,3,42,3,1
448211,36,2,34,4,1
448211,9,1,8,5,1
448211,9,1,8,20,1
448211,19,0,19,21,4
448211,19,0,19,22,1
448211,19,0,19,23,1
448211,16,0,16,24,1
448211,3,0,3,25,1
448211,3,0,3,40,1
448211,26,3,23,41,4
448211,26,3,23,42,1
448211,26,3,23,43,1
448211,20,2,18,44,1
448211,6,1,5,45,1
448211,6,1,5,60,1
448220,42,4,38,1,4
448220,42,4,38,2,1
448220,42,4,38,3,1
448220,9,0,9,4,1
448220,33,4,29,5,1
448220,33,4,29,20,1
448220,42,4,38,21,4
448220,42,4,38,22,1
448220,42,4,38,23,1
448220,9,0,9,24,1
448220,33,4,29,25,1
448220,33,4,29,40,1
448239,176,3,173,1,4
448239,176,3,173,2,1
448239,176,3,173,3,1
448239,176,3,173,5,1
448239,176,3,173,20,1
448239,176,3,173,21,4
448239,176,3,173,22,1
448239,176,3,173,23,1
448239,176,3,173,25,1
448239,176,3,173,40,1
448248,1959,856,1103,1,4
448248,1959,856,1103,2,1
448248,815,329,486,3,1
448248,788,317,471,4,1
448248,27,12,15,5,1
448248,1144,527,617,11,1
448248,27,12,15,20,1
448248,253,34,219,21,4
448248,253,34,219,22,1
448248,175,29,146,23,1
448248,168,28,140,24,1
448248,7,1,6,25,1
448248,78,5,73,31,1
448248,7,1,6,40,1
448248,1706,822,884,41,4
448248,1706,822,884,42,1
448248,640,300,340,43,1
448248,620,289,331,44,1
448248,20,11,9,45,1
448248,1066,522,544,51,1
448248,20,11,9,60,1
448257,23,0,23,1,4
448257,23,0,23,2,1
448257,23,0,23,3,1
448257,17,0,17,4,1
448257,6,0,6,5,1
448257,6,0,6,20,1
448257,23,0,23,21,4
448257,23,0,23,22,1
448257,23,0,23,23,1
448257,17,0,17,24,1
448257,6,0,6,25,1
448257,6,0,6,40,1
448275,21,5,16,1,4
448275,21,5,16,2,1
448275,21,5,16,3,1
448275,15,3,12,4,1
448275,6,2,4,5,1
448275,6,2,4,20,1
448275,21,5,16,21,4
448275,21,5,16,22,1
448275,21,5,16,23,1
448275,15,3,12,24,1
448275,6,2,4,25,1
448275,6,2,4,40,1
448284,1653,520,1133,1,4
448284,726,288,438,2,1
448284,721,286,435,3,1
448284,1,1,0,4,1
448284,720,285,435,5,1
448284,5,2,3,11,1
448284,927,232,695,12,3
448284,71,27,44,19,1
448284,649,258,391,20,1
448284,898,327,571,21,4
448284,517,215,302,22,1
448284,516,215,301,23,1
448284,1,1,0,24,1
448284,515,214,301,25,1
448284,1,0,1,31,1
448284,381,112,269,32,3
448284,48,18,30,39,1
448284,467,196,271,40,1
448284,755,193,562,41,4
448284,209,73,136,42,1
448284,205,71,134,43,1
448284,205,71,134,45,1
448284,4,2,2,51,1
448284,546,120,426,52,3
448284,23,9,14,59,1
448284,182,62,120,60,1
448309,1118,249,869,1,4
448309,922,162,760,2,1
448309,922,162,760,3,1
448309,10,4,6,4,1
448309,912,158,754,5,1
448309,196,87,109,12,3
448309,109,25,84,19,1
448309,803,133,670,20,1
448309,1118,249,869,21,4
448309,922,162,760,22,1
448309,922,162,760,23,1
448309,10,4,6,24,1
448309,912,158,754,25,1
448309,196,87,109,32,3
448309,109,25,84,39,1
448309,803,133,670,40,1
448345,862,359,503,1,4
448345,862,359,503,2,1
448345,862,359,503,3,1
448345,308,137,171,4,1
448345,554,222,332,5,1
448345,30,12,18,19,1
448345,524,210,314,20,1
448345,523,208,315,21,4
448345,523,208,315,22,1
448345,523,208,315,23,1
448345,173,73,100,24,1
448345,350,135,215,25,1
448345,16,7,9,39,1
448345,334,128,206,40,1
448345,339,151,188,41,4
448345,339,151,188,42,1
448345,339,151,188,43,1
448345,135,64,71,44,1
448345,204,87,117,45,1
448345,14,5,9,59,1
448345,190,82,108,60,1
448354,216,26,190,1,4
448354,216,26,190,2,1
448354,216,26,190,3,1
448354,87,10,77,4,1
448354,129,16,113,5,1
448354,129,16,113,20,1
448354,148,16,132,21,4
448354,148,16,132,22,1
448354,148,16,132,23,1
448354,63,7,56,24,1
448354,85,9,76,25,1
448354,85,9,76,40,1
448354,68,10,58,41,4
448354,68,10,58,42,1
448354,68,10,58,43,1
448354,24,3,21,44,1
448354,44,7,37,45,1
448354,44,7,37,60,1
448372,144,66,78,1,4
448372,144,66,78,2,1
448372,144,66,78,3,1
448372,2,0,2,4,1
448372,142,66,76,5,1
448372,26,14,12,19,1
448372,116,52,64,20,1
448372,144,66,78,21,4
448372,144,66,78,22,1
448372,144,66,78,23,1
448372,2,0,2,24,1
448372,142,66,76,25,1
448372,26,14,12,39,1
448372,116,52,64,40,1
448406,175,10,165,1,4
448406,175,10,165,2,1
448406,175,10,165,3,1
448406,113,7,106,4,1
448406,62,3,59,5,1
448406,62,3,59,20,1
448406,175,10,165,21,4
448406,175,10,165,22,1
448406,175,10,165,23,1
448406,113,7,106,24,1
448406,62,3,59,25,1
448406,62,3,59,40,1
448415,603,40,563,1,4
448415,603,40,563,2,1
448415,603,40,563,3,1
448415,122,8,114,4,1
448415,481,32,449,5,1
448415,17,0,17,19,1
448415,464,32,432,20,1
448415,603,40,563,21,4
448415,603,40,563,22,1
448415,603,40,563,23,1
448415,122,8,114,24,1
448415,481,32,449,25,1
448415,17,0,17,39,1
448415,464,32,432,40,1
448424,88,3,85,1,4
448424,88,3,85,2,1
448424,88,3,85,3,1
448424,27,1,26,4,1
448424,61,2,59,5,1
448424,61,2,59,20,1
448424,74,3,71,21,4
448424,74,3,71,22,1
448424,74,3,71,23,1
448424,24,1,23,24,1
448424,50,2,48,25,1
448424,50,2,48,40,1
448424,14,0,14,41,4
448424,14,0,14,42,1
448424,14,0,14,43,1
448424,3,0,3,44,1
448424,11,0,11,45,1
448424,11,0,11,60,1
448433,1916,1857,59,1,4
448433,1916,1857,59,2,1
448433,1916,1857,59,3,1
448433,459,445,14,4,1
448433,1457,1412,45,5,1
448433,1457,1412,45,20,1
448433,1916,1857,59,21,4
448433,1916,1857,59,22,1
448433,1916,1857,59,23,1
448433,459,445,14,24,1
448433,1457,1412,45,25,1
448433,1457,1412,45,40,1
448442,369,293,76,1,4
448442,369,293,76,2,1
448442,369,293,76,3,1
448442,51,40,11,4,1
448442,318,253,65,5,1
448442,3,2,1,19,1
448442,315,251,64,20,1
448442,282,222,60,21,4
448442,282,222,60,22,1
448442,282,222,60,23,1
448442,41,34,7,24,1
448442,241,188,53,25,1
448442,3,2,1,39,1
448442,238,186,52,40,1
448442,87,71,16,41,4
448442,87,71,16,42,1
448442,87,71,16,43,1
448442,10,6,4,44,1
448442,77,65,12,45,1
448442,77,65,12,60,1
448451,439,380,59,1,4
448451,439,380,59,2,1
448451,439,380,59,3,1
448451,52,44,8,4,1
448451,387,336,51,5,1
448451,12,8,4,19,1
448451,375,328,47,20,1
448451,351,309,42,21,4
448451,351,309,42,22,1
448451,351,309,42,23,1
448451,48,42,6,24,1
448451,303,267,36,25,1
448451,11,7,4,39,1
448451,292,260,32,40,1
448451,88,71,17,41,4
448451,88,71,17,42,1
448451,88,71,17,43,1
448451,4,2,2,44,1
448451,84,69,15,45,1
448451,1,1,0,59,1
448451,83,68,15,60,1
448460,186,166,20,1,4
448460,186,166,20,2,1
448460,186,166,20,3,1
448460,35,30,5,4,1
448460,151,136,15,5,1
448460,151,136,15,20,1
448460,147,129,18,21,4
448460,147,129,18,22,1
448460,147,129,18,23,1
448460,32,27,5,24,1
448460,115,102,13,25,1
448460,115,102,13,40,1
448460,39,37,2,41,4
448460,39,37,2,42,1
448460,39,37,2,43,1
448460,3,3,0,44,1
448460,36,34,2,45,1
448460,36,34,2,60,1
448479,402,316,86,1,4
448479,402,316,86,2,1
448479,402,316,86,3,1
448479,81,63,18,4,1
448479,321,253,68,5,1
448479,14,12,2,19,1
448479,307,241,66,20,1
448479,270,220,50,21,4
448479,270,220,50,22,1
448479,270,220,50,23,1
448479,59,48,11,24,1
448479,211,172,39,25,1
448479,13,12,1,39,1
448479,198,160,38,40,1
448479,132,96,36,41,4
448479,132,96,36,42,1
448479,132,96,36,43,1
448479,22,15,7,44,1
448479,110,81,29,45,1
448479,1,0,1,59,1
448479,109,81,28,60,1
448488,242,180,62,1,4
448488,242,180,62,2,1
448488,242,180,62,3,1
448488,48,30,18,4,1
448488,194,150,44,5,1
448488,12,3,9,19,1
448488,182,147,35,20,1
448488,181,135,46,21,4
448488,181,135,46,22,1
448488,181,135,46,23,1
448488,44,28,16,24,1
448488,137,107,30,25,1
448488,6,1,5,39,1
448488,131,106,25,40,1
448488,61,45,16,41,4
448488,61,45,16,42,1
448488,61,45,16,43,1
448488,4,2,2,44,1
448488,57,43,14,45,1
448488,6,2,4,59,1
448488,51,41,10,60,1
448497,219,185,34,1,4
448497,219,185,34,2,1
448497,219,185,34,3,1
448497,39,32,7,4,1
448497,180,153,27,5,1
448497,5,4,1,19,1
448497,175,149,26,20,1
448497,172,144,28,21,4
448497,172,144,28,22,1
448497,172,144,28,23,1
448497,35,28,7,24,1
448497,137,116,21,25,1
448497,5,4,1,39,1
448497,132,112,20,40,1
448497,47,41,6,41,4
448497,47,41,6,42,1
448497,47,41,6,43,1
448497,4,4,0,44,1
448497,43,37,6,45,1
448497,43,37,6,60,1
448503,408,217,191,1,4
448503,408,217,191,2,1
448503,408,217,191,3,1
448503,40,24,16,4,1
448503,368,193,175,5,1
448503,12,0,12,19,1
448503,356,193,163,20,1
448503,253,138,115,21,4
448503,253,138,115,22,1
448503,253,138,115,23,1
448503,38,22,16,24,1
448503,215,116,99,25,1
448503,1,0,1,39,1
448503,214,116,98,40,1
448503,155,79,76,41,4
448503,155,79,76,42,1
448503,155,79,76,43,1
448503,2,2,0,44,1
448503,153,77,76,45,1
448503,11,0,11,59,1
448503,142,77,65,60,1
448512,519,271,248,1,4
448512,519,271,248,2,1
448512,519,271,248,3,1
448512,47,28,19,4,1
448512,472,243,229,5,1
448512,26,8,18,19,1
448512,446,235,211,20,1
448512,362,195,167,21,4
448512,362,195,167,22,1
448512,362,195,167,23,1
448512,40,24,16,24,1
448512,322,171,151,25,1
448512,17,7,10,39,1
448512,305,164,141,40,1
448512,157,76,81,41,4
448512,157,76,81,42,1
448512,157,76,81,43,1
448512,7,4,3,44,1
448512,150,72,78,45,1
448512,9,1,8,59,1
448512,141,71,70,60,1
448521,34,16,18,1,4
448521,27,10,17,2,1
448521,27,10,17,3,1
448521,27,10,17,5,1
448521,7,6,1,12,3
448521,27,10,17,20,1
448521,34,16,18,21,4
448521,27,10,17,22,1
448521,27,10,17,23,1
448521,27,10,17,25,1
448521,7,6,1,32,3
448521,27,10,17,40,1
448558,54,18,36,1,4
448558,54,18,36,2,1
448558,54,18,36,3,1
448558,54,18,36,5,1
448558,54,18,36,20,1
448558,54,18,36,21,4
448558,54,18,36,22,1
448558,54,18,36,23,1
448558,54,18,36,25,1
448558,54,18,36,40,1
448567,784,256,528,1,4
448567,718,233,485,2,1
448567,718,233,485,3,1
448567,28,8,20,4,1
448567,690,225,465,5,1
448567,66,23,43,12,3
448567,34,12,22,19,1
448567,656,213,443,20,1
448567,784,256,528,21,4
448567,718,233,485,22,1
448567,718,233,485,23,1
448567,28,8,20,24,1
448567,690,225,465,25,1
448567,66,23,43,32,3
448567,34,12,22,39,1
448567,656,213,443,40,1
448576,2307,1356,951,1,4
448576,2307,1356,951,2,1
448576,2307,1356,951,3,1
448576,518,329,189,4,1
448576,1789,1027,762,5,1
448576,200,122,78,19,1
448576,1589,905,684,20,1
448576,1422,825,597,21,4
448576,1422,825,597,22,1
448576,1422,825,597,23,1
448576,357,215,142,24,1
448576,1065,610,455,25,1
448576,104,56,48,39,1
448576,961,554,407,40,1
448576,885,531,354,41,4
448576,885,531,354,42,1
448576,885,531,354,43,1
448576,161,114,47,44,1
448576,724,417,307,45,1
448576,96,66,30,59,1
448576,628,351,277,60,1
448585,477,75,402,1,4
448585,477,75,402,2,1
448585,476,74,402,3,1
448585,27,11,16,4,1
448585,449,63,386,5,1
448585,1,1,0,11,1
448585,81,10,71,19,1
448585,368,53,315,20,1
448585,61,16,45,21,4
448585,61,16,45,22,1
448585,61,16,45,23,1
448585,3,3,0,24,1
448585,58,13,45,25,1
448585,5,2,3,39,1
448585,53,11,42,40,1
448585,416,59,357,41,4
448585,416,59,357,42,1
448585,415,58,357,43,1
448585,24,8,16,44,1
448585,391,50,341,45,1
448585,1,1,0,51,1
448585,76,8,68,59,1
448585,315,42,273,60,1
448594,4102,1551,2551,1,4
448594,4102,1551,2551,2,1
448594,3799,1446,2353,3,1
448594,819,371,448,4,1
448594,2980,1075,1905,5,1
448594,303,105,198,11,1
448594,604,206,398,19,1
448594,2376,869,1507,20,1
448594,1361,574,787,21,4
448594,1361,574,787,22,1
448594,1348,565,783,23,1
448594,394,173,221,24,1
448594,954,392,562,25,1
448594,13,9,4,31,1
448594,147,55,92,39,1
448594,807,337,470,40,1
448594,2741,977,1764,41,4
448594,2741,977,1764,42,1
448594,2451,881,1570,43,1
448594,425,198,227,44,1
448594,2026,683,1343,45,1
448594,290,96,194,51,1
448594,457,151,306,59,1
448594,1569,532,1037,60,1
448600,317,26,291,1,4
448600,317,26,291,2,1
448600,317,26,291,3,1
448600,37,4,33,4,1
448600,280,22,258,5,1
448600,34,2,32,19,1
448600,246,20,226,20,1
448600,173,18,155,21,4
448600,173,18,155,22,1
448600,173,18,155,23,1
448600,24,3,21,24,1
448600,149,15,134,25,1
448600,19,1,18,39,1
448600,130,14,116,40,1
448600,144,8,136,41,4
448600,144,8,136,42,1
448600,144,8,136,43,1
448600,13,1,12,44,1
448600,131,7,124,45,1
448600,15,1,14,59,1
448600,116,6,110,60,1
448619,312,32,280,1,4
448619,312,32,280,2,1
448619,312,32,280,3,1
448619,87,14,73,4,1
448619,225,18,207,5,1
448619,225,18,207,20,1
448619,210,25,185,21,4
448619,210,25,185,22,1
448619,210,25,185,23,1
448619,66,13,53,24,1
448619,144,12,132,25,1
448619,144,12,132,40,1
448619,102,7,95,41,4
448619,102,7,95,42,1
448619,102,7,95,43,1
448619,21,1,20,44,1
448619,81,6,75,45,1
448619,81,6,75,60,1
448628,348,199,149,1,4
448628,348,199,149,2,1
448628,348,199,149,3,1
448628,22,13,9,4,1
448628,326,186,140,5,1
448628,1,0,1,19,1
448628,325,186,139,20,1
448628,254,142,112,21,4
448628,254,142,112,22,1
448628,254,142,112,23,1
448628,18,11,7,24,1
448628,236,131,105,25,1
448628,236,131,105,40,1
448628,94,57,37,41,4
448628,94,57,37,42,1
448628,94,57,37,43,1
448628,4,2,2,44,1
448628,90,55,35,45,1
448628,1,0,1,59,1
448628,89,55,34,60,1
448646,70,8,62,1,4
448646,70,8,62,2,1
448646,70,8,62,3,1
448646,49,8,41,4,1
448646,21,0,21,5,1
448646,21,0,21,20,1
448646,70,8,62,21,4
448646,70,8,62,22,1
448646,70,8,62,23,1
448646,49,8,41,24,1
448646,21,0,21,25,1
448646,21,0,21,40,1
448664,425,268,157,1,4
448664,425,268,157,2,1
448664,425,268,157,3,1
448664,147,86,61,4,1
448664,278,182,96,5,1
448664,41,23,18,19,1
448664,237,159,78,20,1
448664,288,195,93,21,4
448664,288,195,93,22,1
448664,288,195,93,23,1
448664,111,68,43,24,1
448664,177,127,50,25,1
448664,32,21,11,39,1
448664,145,106,39,40,1
448664,137,73,64,41,4
448664,137,73,64,42,1
448664,137,73,64,43,1
448664,36,18,18,44,1
448664,101,55,46,45,1
448664,9,2,7,59,1
448664,92,53,39,60,1
448673,1851,365,1486,1,4
448673,1851,365,1486,2,1
448673,1791,358,1433,3,1
448673,85,18,67,4,1
448673,1706,340,1366,5,1
448673,60,7,53,11,1
448673,387,62,325,19,1
448673,1319,278,1041,20,1
448673,1010,195,815,21,4
448673,1010,195,815,22,1
448673,1010,195,815,23,1
448673,60,15,45,24,1
448673,950,180,770,25,1
448673,273,43,230,39,1
448673,677,137,540,40,1
448673,841,170,671,41,4
448673,841,170,671,42,1
448673,781,163,618,43,1
448673,25,3,22,44,1
448673,756,160,596,45,1
448673,60,7,53,51,1
448673,114,19,95,59,1
448673,642,141,501,60,1
448691,30,9,21,1,4
448691,30,9,21,12,3
448691,30,9,21,41,4
448691,30,9,21,52,3
448707,254,79,175,1,4
448707,254,79,175,2,1
448707,254,79,175,3,1
448707,199,70,129,4,1
448707,55,9,46,5,1
448707,55,9,46,20,1
448707,254,79,175,21,4
448707,254,79,175,22,1
448707,254,79,175,23,1
448707,199,70,129,24,1
448707,55,9,46,25,1
448707,55,9,46,40,1
448716,276,45,231,1,4
448716,276,45,231,2,1
448716,276,45,231,3,1
448716,200,34,166,4,1
448716,76,11,65,5,1
448716,76,11,65,20,1
448716,276,45,231,21,4
448716,276,45,231,22,1
448716,276,45,231,23,1
448716,200,34,166,24,1
448716,76,11,65,25,1
448716,76,11,65,40,1
448734,398,119,279,1,4
448734,154,57,97,2,1
448734,151,57,94,3,1
448734,19,9,10,4,1
448734,132,48,84,5,1
448734,3,0,3,11,1
448734,244,62,182,12,3
448734,28,10,18,19,1
448734,104,38,66,20,1
448734,106,29,77,21,4
448734,55,17,38,22,1
448734,55,17,38,23,1
448734,9,3,6,24,1
448734,46,14,32,25,1
448734,51,12,39,32,3
448734,9,2,7,39,1
448734,37,12,25,40,1
448734,292,90,202,41,4
448734,99,40,59,42,1
448734,96,40,56,43,1
448734,10,6,4,44,1
448734,86,34,52,45,1
448734,3,0,3,51,1
448734,193,50,143,52,3
448734,19,8,11,59,1
448734,67,26,41,60,1
448752,322,114,208,1,4
448752,322,114,208,2,1
448752,322,114,208,3,1
448752,32,11,21,4,1
448752,290,103,187,5,1
448752,27,9,18,19,1
448752,263,94,169,20,1
448752,322,114,208,21,4
448752,322,114,208,22,1
448752,322,114,208,23,1
448752,32,11,21,24,1
448752,290,103,187,25,1
448752,27,9,18,39,1
448752,263,94,169,40,1
448761,159,42,117,1,4
448761,159,42,117,2,1
448761,159,42,117,3,1
448761,26,5,21,4,1
448761,133,37,96,5,1
448761,133,37,96,20,1
448761,159,42,117,21,4
448761,159,42,117,22,1
448761,159,42,117,23,1
448761,26,5,21,24,1
448761,133,37,96,25,1
448761,133,37,96,40,1
448770,291,284,7,1,4
448770,291,284,7,2,1
448770,291,284,7,3,1
448770,42,41,1,4,1
448770,249,243,6,5,1
448770,249,243,6,20,1
448770,259,253,6,21,4
448770,259,253,6,22,1
448770,259,253,6,23,1
448770,39,38,1,24,1
448770,220,215,5,25,1
448770,220,215,5,40,1
448770,32,31,1,41,4
448770,32,31,1,42,1
448770,32,31,1,43,1
448770,3,3,0,44,1
448770,29,28,1,45,1
448770,29,28,1,60,1
448789,9,6,3,1,4
448789,9,6,3,2,1
448789,9,6,3,3,1
448789,9,6,3,5,1
448789,9,6,3,20,1
448789,9,6,3,21,4
448789,9,6,3,22,1
448789,9,6,3,23,1
448789,9,6,3,25,1
448789,9,6,3,40,1
448798,66,13,53,1,4
448798,66,13,53,2,1
448798,66,13,53,3,1
448798,32,6,26,4,1
448798,34,7,27,5,1
448798,34,7,27,20,1
448798,61,12,49,21,4
448798,61,12,49,22,1
448798,61,12,49,23,1
448798,31,6,25,24,1
448798,30,6,24,25,1
448798,30,6,24,40,1
448798,5,1,4,41,4
448798,5,1,4,42,1
448798,5,1,4,43,1
448798,1,0,1,44,1
448798,4,1,3,45,1
448798,4,1,3,60,1
448804,328,80,248,1,4
448804,328,80,248,2,1
448804,275,75,200,3,1
448804,275,75,200,5,1
448804,53,5,48,11,1
448804,75,18,57,19,1
448804,200,57,143,20,1
448804,67,21,46,21,4
448804,67,21,46,22,1
448804,61,20,41,23,1
448804,61,20,41,25,1
448804,6,1,5,31,1
448804,27,10,17,39,1
448804,34,10,24,40,1
448804,261,59,202,41,4
448804,261,59,202,42,1
448804,214,55,159,43,1
448804,214,55,159,45,1
448804,47,4,43,51,1
448804,48,8,40,59,1
448804,166,47,119,60,1
448822,20,8,12,1,4
448822,20,8,12,2,1
448822,20,8,12,3,1
448822,20,8,12,5,1
448822,20,8,12,20,1
448822,20,8,12,21,4
448822,20,8,12,22,1
448822,20,8,12,23,1
448822,20,8,12,25,1
448822,20,8,12,40,1
448831,60,21,39,1,4
448831,58,20,38,2,1
448831,58,20,38,3,1
448831,58,20,38,5,1
448831,2,1,1,12,3
448831,58,20,38,20,1
448831,60,21,39,21,4
448831,58,20,38,22,1
448831,58,20,38,23,1
448831,58,20,38,25,1
448831,2,1,1,32,3
448831,58,20,38,40,1
448840,4660,1802,2858,1,4
448840,4025,1570,2455,2,1
448840,3955,1540,2415,3,1
448840,528,165,363,4,1
448840,3427,1375,2052,5,1
448840,70,30,40,11,1
448840,635,232,403,12,3
448840,601,260,341,19,1
448840,2826,1115,1711,20,1
448840,2792,1084,1708,21,4
448840,2658,1028,1630,22,1
448840,2652,1025,1627,23,1
448840,518,162,356,24,1
448840,2134,863,1271,25,1
448840,6,3,3,31,1
448840,134,56,78,32,3
448840,368,154,214,39,1
448840,1766,709,1057,40,1
448840,1868,718,1150,41,4
448840,1367,542,825,42,1
448840,1303,515,788,43,1
448840,10,3,7,44,1
448840,1293,512,781,45,1
448840,64,27,37,51,1
448840,501,176,325,52,3
448840,233,106,127,59,1
448840,1060,406,654,60,1
448859,133,130,3,1,4
448859,133,130,3,2,1
448859,133,130,3,3,1
448859,61,59,2,4,1
448859,72,71,1,5,1
448859,12,12,0,19,1
448859,60,59,1,20,1
448859,133,130,3,21,4
448859,133,130,3,22,1
448859,133,130,3,23,1
448859,61,59,2,24,1
448859,72,71,1,25,1
448859,12,12,0,39,1
448859,60,59,1,40,1
448886,10400,3320,7080,1,4
448886,8564,2854,5710,2,1
448886,8555,2851,5704,3,1
448886,1080,306,774,4,1
448886,7475,2545,4930,5,1
448886,9,3,6,11,1
448886,1836,466,1370,12,3
448886,1221,454,767,19,1
448886,6254,2091,4163,20,1
448886,8918,2809,6109,21,4
448886,7577,2487,5090,22,1
448886,7575,2486,5089,23,1
448886,1069,300,769,24,1
448886,6506,2186,4320,25,1
448886,2,1,1,31,1
448886,1341,322,1019,32,3
448886,968,370,598,39,1
448886,5538,1816,3722,40,1
448886,1482,511,971,41,4
448886,987,367,620,42,1
448886,980,365,615,43,1
448886,11,6,5,44,1
448886,969,359,610,45,1
448886,7,2,5,51,1
448886,495,144,351,52,3
448886,253,84,169,59,1
448886,716,275,441,60,1
448895,488,60,428,1,4
448895,488,60,428,2,1
448895,488,60,428,3,1
448895,132,15,117,4,1
448895,356,45,311,5,1
448895,356,45,311,20,1
448895,488,60,428,21,4
448895,488,60,428,22,1
448895,488,60,428,23,1
448895,132,15,117,24,1
448895,356,45,311,25,1
448895,356,45,311,40,1
448974,378,44,334,1,4
448974,378,44,334,2,1
448974,378,44,334,3,1
448974,295,37,258,4,1
448974,83,7,76,5,1
448974,83,7,76,20,1
448974,254,28,226,21,4
448974,254,28,226,22,1
448974,254,28,226,23,1
448974,202,24,178,24,1
448974,52,4,48,25,1
448974,52,4,48,40,1
448974,124,16,108,41,4
448974,124,16,108,42,1
448974,124,16,108,43,1
448974,93,13,80,44,1
448974,31,3,28,45,1
448974,31,3,28,60,1
448983,441,90,351,1,4
448983,441,90,351,2,1
448983,441,90,351,3,1
448983,339,73,266,4,1
448983,102,17,85,5,1
448983,102,17,85,20,1
448983,323,65,258,21,4
448983,323,65,258,22,1
448983,323,65,258,23,1
448983,249,55,194,24,1
448983,74,10,64,25,1
448983,74,10,64,40,1
448983,118,25,93,41,4
448983,118,25,93,42,1
448983,118,25,93,43,1
448983,90,18,72,44,1
448983,28,7,21,45,1
448983,28,7,21,60,1
449010,991,517,474,1,4
449010,991,517,474,2,1
449010,991,517,474,3,1
449010,308,158,150,4,1
449010,683,359,324,5,1
449010,157,69,88,19,1
449010,526,290,236,20,1
449010,926,480,446,21,4
449010,926,480,446,22,1
449010,926,480,446,23,1
449010,293,148,145,24,1
449010,633,332,301,25,1
449010,149,66,83,39,1
449010,484,266,218,40,1
449010,65,37,28,41,4
449010,65,37,28,42,1
449010,65,37,28,43,1
449010,15,10,5,44,1
449010,50,27,23,45,1
449010,8,3,5,59,1
449010,42,24,18,60,1
449038,2973,1191,1782,1,4
449038,2005,839,1166,2,1
449038,2004,839,1165,3,1
449038,240,91,149,4,1
449038,1764,748,1016,5,1
449038,1,0,1,11,1
449038,968,352,616,12,3
449038,204,84,120,19,1
449038,1560,664,896,20,1
449038,511,294,217,21,4
449038,291,199,92,22,1
449038,290,199,91,23,1
449038,18,15,3,24,1
449038,272,184,88,25,1
449038,1,0,1,31,1
449038,220,95,125,32,3
449038,39,27,12,39,1
449038,233,157,76,40,1
449038,2462,897,1565,41,4
449038,1714,640,1074,42,1
449038,1714,640,1074,43,1
449038,222,76,146,44,1
449038,1492,564,928,45,1
449038,748,257,491,52,3
449038,165,57,108,59,1
449038,1327,507,820,60,1
449074,889,119,770,1,4
449074,889,119,770,2,1
449074,889,119,770,3,1
449074,296,39,257,4,1
449074,593,80,513,5,1
449074,593,80,513,20,1
449074,889,119,770,21,4
449074,889,119,770,22,1
449074,889,119,770,23,1
449074,296,39,257,24,1
449074,593,80,513,25,1
449074,593,80,513,40,1
449083,323,308,15,1,4
449083,323,308,15,2,1
449083,323,308,15,3,1
449083,93,88,5,4,1
449083,230,220,10,5,1
449083,230,220,10,20,1
449083,323,308,15,21,4
449083,323,308,15,22,1
449083,323,308,15,23,1
449083,93,88,5,24,1
449083,230,220,10,25,1
449083,230,220,10,40,1
449092,178,171,7,1,4
449092,178,171,7,2,1
449092,178,171,7,3,1
449092,47,40,7,4,1
449092,131,131,0,5,1
449092,1,1,0,19,1
449092,130,130,0,20,1
449092,178,171,7,21,4
449092,178,171,7,22,1
449092,178,171,7,23,1
449092,47,40,7,24,1
449092,131,131,0,25,1
449092,1,1,0,39,1
449092,130,130,0,40,1
449117,320,37,283,1,4
449117,320,37,283,2,1
449117,320,37,283,3,1
449117,46,7,39,4,1
449117,274,30,244,5,1
449117,92,6,86,19,1
449117,182,24,158,20,1
449117,221,29,192,21,4
449117,221,29,192,22,1
449117,221,29,192,23,1
449117,41,7,34,24,1
449117,180,22,158,25,1
449117,76,5,71,39,1
449117,104,17,87,40,1
449117,99,8,91,41,4
449117,99,8,91,42,1
449117,99,8,91,43,1
449117,5,0,5,44,1
449117,94,8,86,45,1
449117,16,1,15,59,1
449117,78,7,71,60,1
449126,222,30,192,1,4
449126,222,30,192,2,1
449126,222,30,192,3,1
449126,46,4,42,4,1
449126,176,26,150,5,1
449126,27,3,24,19,1
449126,149,23,126,20,1
449126,149,17,132,21,4
449126,149,17,132,22,1
449126,149,17,132,23,1
449126,34,1,33,24,1
449126,115,16,99,25,1
449126,18,2,16,39,1
449126,97,14,83,40,1
449126,73,13,60,41,4
449126,73,13,60,42,1
449126,73,13,60,43,1
449126,12,3,9,44,1
449126,61,10,51,45,1
449126,9,1,8,59,1
449126,52,9,43,60,1
449135,395,140,255,1,4
449135,395,140,255,2,1
449135,395,140,255,3,1
449135,177,58,119,4,1
449135,218,82,136,5,1
449135,218,82,136,20,1
449135,395,140,255,21,4
449135,395,140,255,22,1
449135,395,140,255,23,1
449135,177,58,119,24,1
449135,218,82,136,25,1
449135,218,82,136,40,1
449144,188,58,130,1,4
449144,188,58,130,2,1
449144,188,58,130,3,1
449144,87,33,54,4,1
449144,101,25,76,5,1
449144,101,25,76,20,1
449144,188,58,130,21,4
449144,188,58,130,22,1
449144,188,58,130,23,1
449144,87,33,54,24,1
449144,101,25,76,25,1
449144,101,25,76,40,1
449153,169,64,105,1,4
449153,169,64,105,2,1
449153,169,64,105,3,1
449153,73,26,47,4,1
449153,96,38,58,5,1
449153,96,38,58,20,1
449153,169,64,105,21,4
449153,169,64,105,22,1
449153,169,64,105,23,1
449153,73,26,47,24,1
449153,96,38,58,25,1
449153,96,38,58,40,1
449162,73,3,70,1,4
449162,73,3,70,2,1
449162,73,3,70,3,1
449162,33,1,32,4,1
449162,40,2,38,5,1
449162,40,2,38,20,1
449162,73,3,70,21,4
449162,73,3,70,22,1
449162,73,3,70,23,1
449162,33,1,32,24,1
449162,40,2,38,25,1
449162,40,2,38,40,1
449171,111,1,110,1,4
449171,111,1,110,2,1
449171,111,1,110,3,1
449171,34,1,33,4,1
449171,77,0,77,5,1
449171,77,0,77,20,1
449171,72,1,71,21,4
449171,72,1,71,22,1
449171,72,1,71,23,1
449171,26,1,25,24,1
449171,46,0,46,25,1
449171,46,0,46,40,1
449171,39,0,39,41,4
449171,39,0,39,42,1
449171,39,0,39,43,1
449171,8,0,8,44,1
449171,31,0,31,45,1
449171,31,0,31,60,1
449180,78,3,75,1,4
449180,78,3,75,2,1
449180,78,3,75,3,1
449180,17,0,17,4,1
449180,61,3,58,5,1
449180,61,3,58,20,1
449180,57,2,55,21,4
449180,57,2,55,22,1
449180,57,2,55,23,1
449180,11,0,11,24,1
449180,46,2,44,25,1
449180,46,2,44,40,1
449180,21,1,20,41,4
449180,21,1,20,42,1
449180,21,1,20,43,1
449180,6,0,6,44,1
449180,15,1,14,45,1
449180,15,1,14,60,1
449199,69,4,65,1,4
449199,69,4,65,2,1
449199,69,4,65,3,1
449199,28,1,27,4,1
449199,41,3,38,5,1
449199,41,3,38,20,1
449199,51,3,48,21,4
449199,51,3,48,22,1
449199,51,3,48,23,1
449199,22,1,21,24,1
449199,29,2,27,25,1
449199,29,2,27,40,1
449199,18,1,17,41,4
449199,18,1,17,42,1
449199,18,1,17,43,1
449199,6,0,6,44,1
449199,12,1,11,45,1
449199,12,1,11,60,1
449205,43,0,43,1,4
449205,43,0,43,2,1
449205,43,0,43,3,1
449205,18,0,18,4,1
449205,25,0,25,5,1
449205,25,0,25,20,1
449205,43,0,43,21,4
449205,43,0,43,22,1
449205,43,0,43,23,1
449205,18,0,18,24,1
449205,25,0,25,25,1
449205,25,0,25,40,1
449214,51,2,49,1,4
449214,51,2,49,2,1
449214,51,2,49,3,1
449214,24,0,24,4,1
449214,27,2,25,5,1
449214,27,2,25,20,1
449214,51,2,49,21,4
449214,51,2,49,22,1
449214,51,2,49,23,1
449214,24,0,24,24,1
449214,27,2,25,25,1
449214,27,2,25,40,1
449223,73,1,72,1,4
449223,73,1,72,2,1
449223,73,1,72,3,1
449223,25,0,25,4,1
449223,48,1,47,5,1
449223,48,1,47,20,1
449223,73,1,72,21,4
449223,73,1,72,22,1
449223,73,1,72,23,1
449223,25,0,25,24,1
449223,48,1,47,25,1
449223,48,1,47,40,1
449232,78,4,74,1,4
449232,78,4,74,2,1
449232,78,4,74,3,1
449232,24,1,23,4,1
449232,54,3,51,5,1
449232,54,3,51,20,1
449232,78,4,74,21,4
449232,78,4,74,22,1
449232,78,4,74,23,1
449232,24,1,23,24,1
449232,54,3,51,25,1
449232,54,3,51,40,1
449241,63,1,62,1,4
449241,63,1,62,2,1
449241,63,1,62,3,1
449241,16,0,16,4,1
449241,47,1,46,5,1
449241,47,1,46,20,1
449241,38,1,37,21,4
449241,38,1,37,22,1
449241,38,1,37,23,1
449241,13,0,13,24,1
449241,25,1,24,25,1
449241,25,1,24,40,1
449241,25,0,25,41,4
449241,25,0,25,42,1
449241,25,0,25,43,1
449241,3,0,3,44,1
449241,22,0,22,45,1
449241,22,0,22,60,1
449250,272,69,203,1,4
449250,272,69,203,2,1
449250,272,69,203,3,1
449250,254,65,189,4,1
449250,18,4,14,5,1
449250,18,4,14,20,1
449250,272,69,203,21,4
449250,272,69,203,22,1
449250,272,69,203,23,1
449250,254,65,189,24,1
449250,18,4,14,25,1
449250,18,4,14,40,1
449269,697,282,415,1,4
449269,697,282,415,2,1
449269,697,282,415,3,1
449269,120,51,69,4,1
449269,577,231,346,5,1
449269,577,231,346,20,1
449269,697,282,415,21,4
449269,697,282,415,22,1
449269,697,282,415,23,1
449269,120,51,69,24,1
449269,577,231,346,25,1
449269,577,231,346,40,1
449302,33,3,30,1,4
449302,33,3,30,2,1
449302,33,3,30,3,1
449302,4,1,3,4,1
449302,29,2,27,5,1
449302,5,0,5,19,1
449302,24,2,22,20,1
449302,26,3,23,21,4
449302,26,3,23,22,1
449302,26,3,23,23,1
449302,4,1,3,24,1
449302,22,2,20,25,1
449302,5,0,5,39,1
449302,17,2,15,40,1
449302,7,0,7,41,4
449302,7,0,7,42,1
449302,7,0,7,43,1
449302,7,0,7,45,1
449302,7,0,7,60,1
449311,176,3,173,1,4
449311,176,3,173,2,1
449311,176,3,173,3,1
449311,58,1,57,4,1
449311,118,2,116,5,1
449311,118,2,116,20,1
449311,119,3,116,21,4
449311,119,3,116,22,1
449311,119,3,116,23,1
449311,43,1,42,24,1
449311,76,2,74,25,1
449311,76,2,74,40,1
449311,57,0,57,41,4
449311,57,0,57,42,1
449311,57,0,57,43,1
449311,15,0,15,44,1
449311,42,0,42,45,1
449311,42,0,42,60,1
449320,748,739,9,1,4
449320,748,739,9,2,1
449320,748,739,9,3,1
449320,120,118,2,4,1
449320,628,621,7,5,1
449320,628,621,7,20,1
449320,748,739,9,21,4
449320,748,739,9,22,1
449320,748,739,9,23,1
449320,120,118,2,24,1
449320,628,621,7,25,1
449320,628,621,7,40,1
449339,55422,33356,22066,1,4
449339,43964,26433,17531,2,1
449339,42460,25445,17015,3,1
449339,6480,3159,3321,4,1
449339,35980,22286,13694,5,1
449339,1504,988,516,11,1
449339,11458,6923,4535,12,3
449339,4497,2626,1871,19,1
449339,31483,19660,11823,20,1
449339,3786,1775,2011,21,4
449339,3275,1505,1770,22,1
449339,3271,1503,1768,23,1
449339,387,126,261,24,1
449339,2884,1377,1507,25,1
449339,4,2,2,31,1
449339,511,270,241,32,3
449339,444,177,267,39,1
449339,2440,1200,1240,40,1
449339,51636,31581,20055,41,4
449339,40689,24928,15761,42,1
449339,39189,23942,15247,43,1
449339,6093,3033,3060,44,1
449339,33096,20909,12187,45,1
449339,1500,986,514,51,1
449339,10947,6653,4294,52,3
449339,4053,2449,1604,59,1
449339,29043,18460,10583,60,1
449348,45,21,24,1,4
449348,25,12,13,2,1
449348,25,12,13,3,1
449348,3,2,1,4,1
449348,22,10,12,5,1
449348,20,9,11,12,3
449348,20,10,10,19,1
449348,2,0,2,20,1
449348,18,12,6,21,4
449348,7,5,2,22,1
449348,7,5,2,23,1
449348,1,1,0,24,1
449348,6,4,2,25,1
449348,11,7,4,32,3
449348,4,4,0,39,1
449348,2,0,2,40,1
449348,27,9,18,41,4
449348,18,7,11,42,1
449348,18,7,11,43,1
449348,2,1,1,44,1
449348,16,6,10,45,1
449348,9,2,7,52,3
449348,16,6,10,59,1
449357,118,11,107,1,4
449357,118,11,107,2,1
449357,118,11,107,3,1
449357,32,5,27,4,1
449357,86,6,80,5,1
449357,86,6,80,20,1
449357,118,11,107,21,4
449357,118,11,107,22,1
449357,118,11,107,23,1
449357,32,5,27,24,1
449357,86,6,80,25,1
449357,86,6,80,40,1
449366,241,2,239,1,4
449366,241,2,239,2,1
449366,241,2,239,3,1
449366,171,2,169,4,1
449366,70,0,70,5,1
449366,70,0,70,20,1
449366,206,2,204,21,4
449366,206,2,204,22,1
449366,206,2,204,23,1
449366,141,2,139,24,1
449366,65,0,65,25,1
449366,65,0,65,40,1
449366,35,0,35,41,4
449366,35,0,35,42,1
449366,35,0,35,43,1
449366,30,0,30,44,1
449366,5,0,5,45,1
449366,5,0,5,60,1
449375,78,55,23,1,4
449375,78,55,23,2,1
449375,78,55,23,3,1
449375,32,23,9,4,1
449375,46,32,14,5,1
449375,46,32,14,20,1
449375,52,36,16,21,4
449375,52,36,16,22,1
449375,52,36,16,23,1
449375,20,13,7,24,1
449375,32,23,9,25,1
449375,32,23,9,40,1
449375,26,19,7,41,4
449375,26,19,7,42,1
449375,26,19,7,43,1
449375,12,10,2,44,1
449375,14,9,5,45,1
449375,14,9,5,60,1
449384,135,99,36,1,4
449384,135,99,36,2,1
449384,135,99,36,3,1
449384,3,1,2,4,1
449384,132,98,34,5,1
449384,132,98,34,20,1
449384,135,99,36,21,4
449384,135,99,36,22,1
449384,135,99,36,23,1
449384,3,1,2,24,1
449384,132,98,34,25,1
449384,132,98,34,40,1
449393,129,35,94,1,4
449393,129,35,94,2,1
449393,129,35,94,3,1
449393,61,14,47,4,1
449393,68,21,47,5,1
449393,68,21,47,20,1
449393,129,35,94,21,4
449393,129,35,94,22,1
449393,129,35,94,23,1
449393,61,14,47,24,1
449393,68,21,47,25,1
449393,68,21,47,40,1
449436,206,30,176,1,4
449436,206,30,176,2,1
449436,206,30,176,3,1
449436,166,23,143,4,1
449436,40,7,33,5,1
449436,40,7,33,20,1
449436,156,22,134,21,4
449436,156,22,134,22,1
449436,156,22,134,23,1
449436,129,19,110,24,1
449436,27,3,24,25,1
449436,27,3,24,40,1
449436,50,8,42,41,4
449436,50,8,42,42,1
449436,50,8,42,43,1
449436,37,4,33,44,1
449436,13,4,9,45,1
449436,13,4,9,60,1
449445,90,24,66,1,4
449445,90,24,66,2,1
449445,90,24,66,3,1
449445,64,16,48,4,1
449445,26,8,18,5,1
449445,26,8,18,20,1
449445,90,24,66,21,4
449445,90,24,66,22,1
449445,90,24,66,23,1
449445,64,16,48,24,1
449445,26,8,18,25,1
449445,26,8,18,40,1
449454,69,8,61,1,4
449454,69,8,61,2,1
449454,69,8,61,3,1
449454,10,0,10,4,1
449454,59,8,51,5,1
449454,59,8,51,20,1
449454,60,8,52,21,4
449454,60,8,52,22,1
449454,60,8,52,23,1
449454,9,0,9,24,1
449454,51,8,43,25,1
449454,51,8,43,40,1
449454,9,0,9,41,4
449454,9,0,9,42,1
449454,9,0,9,43,1
449454,1,0,1,44,1
449454,8,0,8,45,1
449454,8,0,8,60,1
449463,29,7,22,1,4
449463,29,7,22,2,1
449463,29,7,22,3,1
449463,20,2,18,4,1
449463,9,5,4,5,1
449463,9,5,4,20,1
449463,18,4,14,21,4
449463,18,4,14,22,1
449463,18,4,14,23,1
449463,14,0,14,24,1
449463,4,4,0,25,1
449463,4,4,0,40,1
449463,11,3,8,41,4
449463,11,3,8,42,1
449463,11,3,8,43,1
449463,6,2,4,44,1
449463,5,1,4,45,1
449463,5,1,4,60,1
449472,80,2,78,1,4
449472,80,2,78,2,1
449472,80,2,78,3,1
449472,28,1,27,4,1
449472,52,1,51,5,1
449472,52,1,51,20,1
449472,80,2,78,21,4
449472,80,2,78,22,1
449472,80,2,78,23,1
449472,28,1,27,24,1
449472,52,1,51,25,1
449472,52,1,51,40,1
449481,56,23,33,1,4
449481,56,23,33,12,3
449481,56,23,33,21,4
449481,56,23,33,32,3
449490,113,15,98,1,4
449490,113,15,98,2,1
449490,113,15,98,3,1
449490,55,6,49,4,1
449490,58,9,49,5,1
449490,58,9,49,20,1
449490,113,15,98,21,4
449490,113,15,98,22,1
449490,113,15,98,23,1
449490,55,6,49,24,1
449490,58,9,49,25,1
449490,58,9,49,40,1
449506,544,98,446,1,4
449506,544,98,446,2,1
449506,544,98,446,3,1
449506,94,23,71,4,1
449506,450,75,375,5,1
449506,450,75,375,20,1
449506,544,98,446,21,4
449506,544,98,446,22,1
449506,544,98,446,23,1
449506,94,23,71,24,1
449506,450,75,375,25,1
449506,450,75,375,40,1
449524,234,79,155,1,4
449524,234,79,155,2,1
449524,234,79,155,3,1
449524,26,6,20,4,1
449524,208,73,135,5,1
449524,60,23,37,19,1
449524,148,50,98,20,1
449524,234,79,155,21,4
449524,234,79,155,22,1
449524,234,79,155,23,1
449524,26,6,20,24,1
449524,208,73,135,25,1
449524,60,23,37,39,1
449524,148,50,98,40,1
449533,46,3,43,1,4
449533,46,3,43,2,1
449533,46,3,43,3,1
449533,18,0,18,4,1
449533,28,3,25,5,1
449533,28,3,25,20,1
449533,46,3,43,21,4
449533,46,3,43,22,1
449533,46,3,43,23,1
449533,18,0,18,24,1
449533,28,3,25,25,1
449533,28,3,25,40,1
449579,11,3,8,1,4
449579,11,3,8,12,3
449579,11,3,8,21,4
449579,11,3,8,32,3
449597,33,0,33,1,4
449597,33,0,33,2,1
449597,33,0,33,3,1
449597,19,0,19,4,1
449597,14,0,14,5,1
449597,14,0,14,20,1
449597,23,0,23,21,4
449597,23,0,23,22,1
449597,23,0,23,23,1
449597,12,0,12,24,1
449597,11,0,11,25,1
449597,11,0,11,40,1
449597,10,0,10,41,4
449597,10,0,10,42,1
449597,10,0,10,43,1
449597,7,0,7,44,1
449597,3,0,3,45,1
449597,3,0,3,60,1
449603,130,120,10,1,4
449603,130,120,10,2,1
449603,130,120,10,3,1
449603,92,87,5,4,1
449603,38,33,5,5,1
449603,38,33,5,20,1
449603,119,111,8,21,4
449603,119,111,8,22,1
449603,119,111,8,23,1
449603,86,82,4,24,1
449603,33,29,4,25,1
449603,33,29,4,40,1
449603,11,9,2,41,4
449603,11,9,2,42,1
449603,11,9,2,43,1
449603,6,5,1,44,1
449603,5,4,1,45,1
449603,5,4,1,60,1
449612,195,92,103,1,4
449612,195,92,103,2,1
449612,195,92,103,3,1
449612,33,16,17,4,1
449612,162,76,86,5,1
449612,16,9,7,19,1
449612,146,67,79,20,1
449612,195,92,103,21,4
449612,195,92,103,22,1
449612,195,92,103,23,1
449612,33,16,17,24,1
449612,162,76,86,25,1
449612,16,9,7,39,1
449612,146,67,79,40,1
449658,114,114,0,1,4
449658,114,114,0,2,1
449658,114,114,0,3,1
449658,29,29,0,4,1
449658,85,85,0,5,1
449658,3,3,0,19,1
449658,82,82,0,20,1
449658,113,113,0,21,4
449658,113,113,0,22,1
449658,113,113,0,23,1
449658,29,29,0,24,1
449658,84,84,0,25,1
449658,3,3,0,39,1
449658,81,81,0,40,1
449658,1,1,0,41,4
449658,1,1,0,42,1
449658,1,1,0,43,1
449658,1,1,0,45,1
449658,1,1,0,60,1
449667,66,9,57,1,4
449667,66,9,57,2,1
449667,66,9,57,3,1
449667,11,1,10,4,1
449667,55,8,47,5,1
449667,55,8,47,20,1
449667,66,9,57,21,4
449667,66,9,57,22,1
449667,66,9,57,23,1
449667,11,1,10,24,1
449667,55,8,47,25,1
449667,55,8,47,40,1
449676,119,53,66,1,4
449676,119,53,66,2,1
449676,119,53,66,3,1
449676,62,24,38,4,1
449676,57,29,28,5,1
449676,57,29,28,20,1
449676,119,53,66,41,4
449676,119,53,66,42,1
449676,119,53,66,43,1
449676,62,24,38,44,1
449676,57,29,28,45,1
449676,57,29,28,60,1
449685,124,13,111,1,4
449685,124,13,111,2,1
449685,124,13,111,3,1
449685,117,13,104,4,1
449685,7,0,7,5,1
449685,7,0,7,20,1
449685,124,13,111,21,4
449685,124,13,111,22,1
449685,124,13,111,23,1
449685,117,13,104,24,1
449685,7,0,7,25,1
449685,7,0,7,40,1
449700,505,110,395,1,4
449700,505,110,395,2,1
449700,505,110,395,3,1
449700,204,42,162,4,1
449700,301,68,233,5,1
449700,301,68,233,20,1
449700,505,110,395,21,4
449700,505,110,395,22,1
449700,505,110,395,23,1
449700,204,42,162,24,1
449700,301,68,233,25,1
449700,301,68,233,40,1
449719,202,20,182,1,4
449719,202,20,182,2,1
449719,202,20,182,3,1
449719,66,5,61,4,1
449719,136,15,121,5,1
449719,136,15,121,20,1
449719,202,20,182,21,4
449719,202,20,182,22,1
449719,202,20,182,23,1
449719,66,5,61,24,1
449719,136,15,121,25,1
449719,136,15,121,40,1
449728,65,3,62,1,4
449728,65,3,62,2,1
449728,65,3,62,3,1
449728,5,1,4,4,1
449728,60,2,58,5,1
449728,60,2,58,20,1
449728,65,3,62,21,4
449728,65,3,62,22,1
449728,65,3,62,23,1
449728,5,1,4,24,1
449728,60,2,58,25,1
449728,60,2,58,40,1
449746,59,35,24,1,4
449746,59,35,24,2,1
449746,59,35,24,3,1
449746,42,25,17,4,1
449746,17,10,7,5,1
449746,17,10,7,20,1
449746,59,35,24,21,4
449746,59,35,24,22,1
449746,59,35,24,23,1
449746,42,25,17,24,1
449746,17,10,7,25,1
449746,17,10,7,40,1
449764,118,82,36,1,4
449764,118,82,36,2,1
449764,118,82,36,3,1
449764,31,28,3,4,1
449764,87,54,33,5,1
449764,17,11,6,19,1
449764,70,43,27,20,1
449764,110,74,36,21,4
449764,110,74,36,22,1
449764,110,74,36,23,1
449764,31,28,3,24,1
449764,79,46,33,25,1
449764,17,11,6,39,1
449764,62,35,27,40,1
449764,8,8,0,41,4
449764,8,8,0,42,1
449764,8,8,0,43,1
449764,8,8,0,45,1
449764,8,8,0,60,1
449773,199,76,123,1,4
449773,199,76,123,2,1
449773,199,76,123,3,1
449773,115,46,69,4,1
449773,84,30,54,5,1
449773,84,30,54,20,1
449773,130,47,83,21,4
449773,130,47,83,22,1
449773,130,47,83,23,1
449773,78,25,53,24,1
449773,52,22,30,25,1
449773,52,22,30,40,1
449773,69,29,40,41,4
449773,69,29,40,42,1
449773,69,29,40,43,1
449773,37,21,16,44,1
449773,32,8,24,45,1
449773,32,8,24,60,1
449782,70,2,68,1,4
449782,70,2,68,2,1
449782,70,2,68,3,1
449782,57,2,55,4,1
449782,13,0,13,5,1
449782,13,0,13,20,1
449782,36,1,35,21,4
449782,36,1,35,22,1
449782,36,1,35,23,1
449782,28,1,27,24,1
449782,8,0,8,25,1
449782,8,0,8,40,1
449782,34,1,33,41,4
449782,34,1,33,42,1
449782,34,1,33,43,1
449782,29,1,28,44,1
449782,5,0,5,45,1
449782,5,0,5,60,1
449791,93,8,85,1,4
449791,93,8,85,2,1
449791,93,8,85,3,1
449791,41,6,35,4,1
449791,52,2,50,5,1
449791,52,2,50,20,1
449791,93,8,85,21,4
449791,93,8,85,22,1
449791,93,8,85,23,1
449791,41,6,35,24,1
449791,52,2,50,25,1
449791,52,2,50,40,1
449807,119,2,117,1,4
449807,119,2,117,2,1
449807,119,2,117,3,1
449807,53,0,53,4,1
449807,66,2,64,5,1
449807,66,2,64,20,1
449807,119,2,117,21,4
449807,119,2,117,22,1
449807,119,2,117,23,1
449807,53,0,53,24,1
449807,66,2,64,25,1
449807,66,2,64,40,1
449816,509,330,179,1,4
449816,509,330,179,2,1
449816,158,84,74,3,1
449816,63,33,30,4,1
449816,95,51,44,5,1
449816,351,246,105,11,1
449816,95,51,44,20,1
449816,34,28,6,21,4
449816,34,28,6,22,1
449816,34,28,6,23,1
449816,9,7,2,24,1
449816,25,21,4,25,1
449816,25,21,4,40,1
449816,475,302,173,41,4
449816,475,302,173,42,1
449816,124,56,68,43,1
449816,54,26,28,44,1
449816,70,30,40,45,1
449816,351,246,105,51,1
449816,70,30,40,60,1
449852,64,0,64,1,4
449852,64,0,64,2,1
449852,64,0,64,3,1
449852,38,0,38,4,1
449852,26,0,26,5,1
449852,26,0,26,20,1
449852,56,0,56,21,4
449852,56,0,56,22,1
449852,56,0,56,23,1
449852,34,0,34,24,1
449852,22,0,22,25,1
449852,22,0,22,40,1
449852,8,0,8,41,4
449852,8,0,8,42,1
449852,8,0,8,43,1
449852,4,0,4,44,1
449852,4,0,4,45,1
449852,4,0,4,60,1
449861,88,4,84,1,4
449861,88,4,84,2,1
449861,88,4,84,3,1
449861,46,3,43,4,1
449861,42,1,41,5,1
449861,42,1,41,19,1
449861,88,4,84,21,4
449861,88,4,84,22,1
449861,88,4,84,23,1
449861,46,3,43,24,1
449861,42,1,41,25,1
449861,42,1,41,39,1
449870,362,176,186,1,4
449870,142,62,80,2,1
449870,86,40,46,3,1
449870,21,11,10,4,1
449870,65,29,36,5,1
449870,56,22,34,11,1
449870,220,114,106,12,3
449870,13,5,8,19,1
449870,52,24,28,20,1
449870,305,150,155,21,4
449870,127,54,73,22,1
449870,71,32,39,23,1
449870,17,10,7,24,1
449870,54,22,32,25,1
449870,56,22,34,31,1
449870,178,96,82,32,3
449870,10,4,6,39,1
449870,44,18,26,40,1
449870,57,26,31,41,4
449870,15,8,7,42,1
449870,15,8,7,43,1
449870,4,1,3,44,1
449870,11,7,4,45,1
449870,42,18,24,52,3
449870,3,1,2,59,1
449870,8,6,2,60,1
449889,3021,965,2056,1,4
449889,3021,965,2056,12,3
449889,3021,965,2056,21,4
449889,3021,965,2056,32,3
449898,983,221,762,1,4
449898,654,154,500,2,1
449898,654,154,500,3,1
449898,43,16,27,4,1
449898,611,138,473,5,1
449898,329,67,262,12,3
449898,180,46,134,19,1
449898,431,92,339,20,1
449898,343,87,256,21,4
449898,296,75,221,22,1
449898,296,75,221,23,1
449898,12,8,4,24,1
449898,284,67,217,25,1
449898,47,12,35,32,3
449898,40,12,28,39,1
449898,244,55,189,40,1
449898,640,134,506,41,4
449898,358,79,279,42,1
449898,358,79,279,43,1
449898,31,8,23,44,1
449898,327,71,256,45,1
449898,282,55,227,52,3
449898,140,34,106,59,1
449898,187,37,150,60,1
449904,248,25,223,1,4
449904,248,25,223,2,1
449904,248,25,223,3,1
449904,81,9,72,4,1
449904,167,16,151,5,1
449904,167,16,151,20,1
449904,248,25,223,21,4
449904,248,25,223,22,1
449904,248,25,223,23,1
449904,81,9,72,24,1
449904,167,16,151,25,1
449904,167,16,151,40,1
449922,220,105,115,1,4
449922,220,105,115,12,3
449922,220,105,115,21,4
449922,220,105,115,32,3
449931,1221,495,726,1,4
449931,790,315,475,2,1
449931,790,315,475,3,1
449931,32,12,20,4,1
449931,758,303,455,5,1
449931,431,180,251,12,3
449931,84,31,53,19,1
449931,674,272,402,20,1
449931,382,131,251,21,4
449931,250,82,168,22,1
449931,250,82,168,23,1
449931,2,2,0,24,1
449931,248,80,168,25,1
449931,132,49,83,32,3
449931,19,3,16,39,1
449931,229,77,152,40,1
449931,839,364,475,41,4
449931,540,233,307,42,1
449931,540,233,307,43,1
449931,30,10,20,44,1
449931,510,223,287,45,1
449931,299,131,168,52,3
449931,65,28,37,59,1
449931,445,195,250,60,1
449959,194,17,177,1,4
449959,194,17,177,2,1
449959,194,17,177,3,1
449959,35,4,31,4,1
449959,159,13,146,5,1
449959,159,13,146,20,1
449959,115,8,107,21,4
449959,115,8,107,22,1
449959,115,8,107,23,1
449959,25,3,22,24,1
449959,90,5,85,25,1
449959,90,5,85,40,1
449959,79,9,70,41,4
449959,79,9,70,42,1
449959,79,9,70,43,1
449959,10,1,9,44,1
449959,69,8,61,45,1
449959,69,8,61,60,1
449968,301,26,275,1,4
449968,301,26,275,2,1
449968,301,26,275,3,1
449968,73,7,66,4,1
449968,228,19,209,5,1
449968,228,19,209,20,1
449968,211,13,198,21,4
449968,211,13,198,22,1
449968,211,13,198,23,1
449968,50,5,45,24,1
449968,161,8,153,25,1
449968,161,8,153,40,1
449968,90,13,77,41,4
449968,90,13,77,42,1
449968,90,13,77,43,1
449968,23,2,21,44,1
449968,67,11,56,45,1
449968,67,11,56,60,1
449977,237,12,225,1,4
449977,237,12,225,2,1
449977,237,12,225,3,1
449977,44,1,43,4,1
449977,193,11,182,5,1
449977,193,11,182,20,1
449977,174,8,166,21,4
449977,174,8,166,22,1
449977,174,8,166,23,1
449977,34,1,33,24,1
449977,140,7,133,25,1
449977,140,7,133,40,1
449977,63,4,59,41,4
449977,63,4,59,42,1
449977,63,4,59,43,1
449977,10,0,10,44,1
449977,53,4,49,45,1
449977,53,4,49,60,1
449986,280,24,256,1,4
449986,280,24,256,2,1
449986,280,24,256,3,1
449986,84,1,83,4,1
449986,196,23,173,5,1
449986,196,23,173,20,1
449986,200,16,184,21,4
449986,200,16,184,22,1
449986,200,16,184,23,1
449986,67,1,66,24,1
449986,133,15,118,25,1
449986,133,15,118,40,1
449986,80,8,72,41,4
449986,80,8,72,42,1
449986,80,8,72,43,1
449986,17,0,17,44,1
449986,63,8,55,45,1
449986,63,8,55,60,1
449995,181,16,165,1,4
449995,181,16,165,2,1
449995,181,16,165,3,1
449995,37,5,32,4,1
449995,144,11,133,5,1
449995,144,11,133,20,1
449995,134,12,122,21,4
449995,134,12,122,22,1
449995,134,12,122,23,1
449995,29,3,26,24,1
449995,105,9,96,25,1
449995,105,9,96,40,1
449995,47,4,43,41,4
449995,47,4,43,42,1
449995,47,4,43,43,1
449995,8,2,6,44,1
449995,39,2,37,45,1
449995,39,2,37,60,1
450003,277,74,203,1,4
450003,277,74,203,2,1
450003,277,74,203,3,1
450003,82,24,58,4,1
450003,195,50,145,5,1
450003,11,1,10,19,1
450003,184,49,135,20,1
450003,202,51,151,21,4
450003,202,51,151,22,1
450003,202,51,151,23,1
450003,65,19,46,24,1
450003,137,32,105,25,1
450003,9,0,9,39,1
450003,128,32,96,40,1
450003,75,23,52,41,4
450003,75,23,52,42,1
450003,75,23,52,43,1
450003,17,5,12,44,1
450003,58,18,40,45,1
450003,2,1,1,59,1
450003,56,17,39,60,1
450021,167,26,141,1,4
450021,167,26,141,2,1
450021,167,26,141,3,1
450021,149,24,125,4,1
450021,18,2,16,5,1
450021,18,2,16,20,1
450021,166,26,140,21,4
450021,166,26,140,22,1
450021,166,26,140,23,1
450021,149,24,125,24,1
450021,17,2,15,25,1
450021,17,2,15,40,1
450021,1,0,1,41,4
450021,1,0,1,42,1
450021,1,0,1,43,1
450021,1,0,1,45,1
450021,1,0,1,60,1
450049,466,257,209,1,4
450049,466,257,209,2,1
450049,466,257,209,3,1
450049,82,41,41,4,1
450049,384,216,168,5,1
450049,80,43,37,19,1
450049,304,173,131,20,1
450049,360,206,154,21,4
450049,360,206,154,22,1
450049,360,206,154,23,1
450049,69,35,34,24,1
450049,291,171,120,25,1
450049,59,34,25,39,1
450049,232,137,95,40,1
450049,106,51,55,41,4
450049,106,51,55,42,1
450049,106,51,55,43,1
450049,13,6,7,44,1
450049,93,45,48,45,1
450049,21,9,12,59,1
450049,72,36,36,60,1
450058,628,60,568,1,4
450058,628,60,568,2,1
450058,628,60,568,3,1
450058,36,9,27,4,1
450058,592,51,541,5,1
450058,191,11,180,19,1
450058,401,40,361,20,1
450058,628,60,568,21,4
450058,628,60,568,22,1
450058,628,60,568,23,1
450058,36,9,27,24,1
450058,592,51,541,25,1
450058,191,11,180,39,1
450058,401,40,361,40,1
450067,501,111,390,1,4
450067,501,111,390,2,1
450067,501,111,390,3,1
450067,94,27,67,4,1
450067,407,84,323,5,1
450067,60,10,50,19,1
450067,347,74,273,20,1
450067,501,111,390,21,4
450067,501,111,390,22,1
450067,501,111,390,23,1
450067,94,27,67,24,1
450067,407,84,323,25,1
450067,60,10,50,39,1
450067,347,74,273,40,1
450076,543,77,466,1,4
450076,543,77,466,2,1
450076,543,77,466,3,1
450076,142,17,125,4,1
450076,401,60,341,5,1
450076,401,60,341,20,1
450076,543,77,466,21,4
450076,543,77,466,22,1
450076,543,77,466,23,1
450076,142,17,125,24,1
450076,401,60,341,25,1
450076,401,60,341,40,1
450085,643,272,371,1,4
450085,643,272,371,2,1
450085,643,272,371,3,1
450085,175,69,106,4,1
450085,468,203,265,5,1
450085,90,34,56,19,1
450085,378,169,209,20,1
450085,565,239,326,21,4
450085,565,239,326,22,1
450085,565,239,326,23,1
450085,163,63,100,24,1
450085,402,176,226,25,1
450085,77,31,46,39,1
450085,325,145,180,40,1
450085,78,33,45,41,4
450085,78,33,45,42,1
450085,78,33,45,43,1
450085,12,6,6,44,1
450085,66,27,39,45,1
450085,13,3,10,59,1
450085,53,24,29,60,1
450094,1185,672,513,1,4
450094,1185,672,513,2,1
450094,1185,672,513,3,1
450094,255,147,108,4,1
450094,930,525,405,5,1
450094,158,80,78,19,1
450094,772,445,327,20,1
450094,626,358,268,21,4
450094,626,358,268,22,1
450094,626,358,268,23,1
450094,139,82,57,24,1
450094,487,276,211,25,1
450094,84,36,48,39,1
450094,403,240,163,40,1
450094,559,314,245,41,4
450094,559,314,245,42,1
450094,559,314,245,43,1
450094,116,65,51,44,1
450094,443,249,194,45,1
450094,74,44,30,59,1
450094,369,205,164,60,1
450119,181,44,137,1,4
450119,181,44,137,2,1
450119,181,44,137,3,1
450119,99,19,80,4,1
450119,82,25,57,5,1
450119,82,25,57,20,1
450119,107,27,80,21,4
450119,107,27,80,22,1
450119,107,27,80,23,1
450119,62,14,48,24,1
450119,45,13,32,25,1
450119,45,13,32,40,1
450119,74,17,57,41,4
450119,74,17,57,42,1
450119,74,17,57,43,1
450119,37,5,32,44,1
450119,37,12,25,45,1
450119,37,12,25,60,1
450128,231,24,207,1,4
450128,231,24,207,2,1
450128,231,24,207,3,1
450128,59,5,54,4,1
450128,172,19,153,5,1
450128,172,19,153,20,1
450128,169,14,155,21,4
450128,169,14,155,22,1
450128,169,14,155,23,1
450128,41,2,39,24,1
450128,128,12,116,25,1
450128,128,12,116,40,1
450128,62,10,52,41,4
450128,62,10,52,42,1
450128,62,10,52,43,1
450128,18,3,15,44,1
450128,44,7,37,45,1
450128,44,7,37,60,1
450146,80,8,72,1,4
450146,80,8,72,2,1
450146,80,8,72,3,1
450146,2,1,1,4,1
450146,78,7,71,5,1
450146,78,7,71,20,1
450146,77,8,69,21,4
450146,77,8,69,22,1
450146,77,8,69,23,1
450146,2,1,1,24,1
450146,75,7,68,25,1
450146,75,7,68,40,1
450146,3,0,3,41,4
450146,3,0,3,42,1
450146,3,0,3,43,1
450146,3,0,3,45,1
450146,3,0,3,60,1
450155,286,50,236,1,4
450155,286,50,236,2,1
450155,286,50,236,3,1
450155,142,27,115,4,1
450155,144,23,121,5,1
450155,144,23,121,20,1
450155,286,50,236,21,4
450155,286,50,236,22,1
450155,286,50,236,23,1
450155,142,27,115,24,1
450155,144,23,121,25,1
450155,144,23,121,40,1
450173,11170,913,10257,1,4
450173,11170,913,10257,2,1
450173,11170,913,10257,3,1
450173,3240,235,3005,4,1
450173,7930,678,7252,5,1
450173,231,20,211,19,1
450173,7699,658,7041,20,1
450173,11129,913,10216,21,4
450173,11129,913,10216,22,1
450173,11129,913,10216,23,1
450173,3240,235,3005,24,1
450173,7889,678,7211,25,1
450173,230,20,210,39,1
450173,7659,658,7001,40,1
450173,41,0,41,41,4
450173,41,0,41,42,1
450173,41,0,41,43,1
450173,41,0,41,45,1
450173,1,0,1,59,1
450173,40,0,40,60,1
450182,482,109,373,1,4
450182,482,109,373,2,1
450182,482,109,373,3,1
450182,114,22,92,4,1
450182,368,87,281,5,1
450182,368,87,281,20,1
450182,482,109,373,21,4
450182,482,109,373,22,1
450182,482,109,373,23,1
450182,114,22,92,24,1
450182,368,87,281,25,1
450182,368,87,281,40,1
450191,470,72,398,1,4
450191,470,72,398,2,1
450191,470,72,398,3,1
450191,234,38,196,4,1
450191,236,34,202,5,1
450191,236,34,202,20,1
450191,322,55,267,21,4
450191,322,55,267,22,1
450191,322,55,267,23,1
450191,182,31,151,24,1
450191,140,24,116,25,1
450191,140,24,116,40,1
450191,148,17,131,41,4
450191,148,17,131,42,1
450191,148,17,131,43,1
450191,52,7,45,44,1
450191,96,10,86,45,1
450191,96,10,86,60,1
450207,230,141,89,1,4
450207,230,141,89,2,1
450207,230,141,89,3,1
450207,26,18,8,4,1
450207,204,123,81,5,1
450207,5,2,3,19,1
450207,199,121,78,20,1
450207,163,107,56,21,4
450207,163,107,56,22,1
450207,163,107,56,23,1
450207,21,16,5,24,1
450207,142,91,51,25,1
450207,1,0,1,39,1
450207,141,91,50,40,1
450207,67,34,33,41,4
450207,67,34,33,42,1
450207,67,34,33,43,1
450207,5,2,3,44,1
450207,62,32,30,45,1
450207,4,2,2,59,1
450207,58,30,28,60,1
450216,656,458,198,1,4
450216,656,458,198,2,1
450216,656,458,198,3,1
450216,156,106,50,4,1
450216,500,352,148,5,1
450216,6,4,2,19,1
450216,494,348,146,20,1
450216,551,389,162,21,4
450216,551,389,162,22,1
450216,551,389,162,23,1
450216,140,94,46,24,1
450216,411,295,116,25,1
450216,6,4,2,39,1
450216,405,291,114,40,1
450216,105,69,36,41,4
450216,105,69,36,42,1
450216,105,69,36,43,1
450216,16,12,4,44,1
450216,89,57,32,45,1
450216,89,57,32,60,1
450225,357,264,93,1,4
450225,357,264,93,2,1
450225,357,264,93,3,1
450225,85,63,22,4,1
450225,272,201,71,5,1
450225,4,4,0,19,1
450225,268,197,71,20,1
450225,278,207,71,21,4
450225,278,207,71,22,1
450225,278,207,71,23,1
450225,72,54,18,24,1
450225,206,153,53,25,1
450225,3,3,0,39,1
450225,203,150,53,40,1
450225,79,57,22,41,4
450225,79,57,22,42,1
450225,79,57,22,43,1
450225,13,9,4,44,1
450225,66,48,18,45,1
450225,1,1,0,59,1
450225,65,47,18,60,1
450234,303,180,123,1,4
450234,303,180,123,2,1
450234,303,180,123,3,1
450234,31,28,3,4,1
450234,272,152,120,5,1
450234,12,5,7,19,1
450234,260,147,113,20,1
450234,206,129,77,21,4
450234,206,129,77,22,1
450234,206,129,77,23,1
450234,24,22,2,24,1
450234,182,107,75,25,1
450234,3,2,1,39,1
450234,179,105,74,40,1
450234,97,51,46,41,4
450234,97,51,46,42,1
450234,97,51,46,43,1
450234,7,6,1,44,1
450234,90,45,45,45,1
450234,9,3,6,59,1
450234,81,42,39,60,1
450243,483,383,100,1,4
450243,483,383,100,2,1
450243,483,383,100,3,1
450243,48,41,7,4,1
450243,435,342,93,5,1
450243,1,1,0,19,1
450243,434,341,93,20,1
450243,345,272,73,21,4
450243,345,272,73,22,1
450243,345,272,73,23,1
450243,43,37,6,24,1
450243,302,235,67,25,1
450243,1,1,0,39,1
450243,301,234,67,40,1
450243,138,111,27,41,4
450243,138,111,27,42,1
450243,138,111,27,43,1
450243,5,4,1,44,1
450243,133,107,26,45,1
450243,133,107,26,60,1
450252,690,437,253,1,4
450252,690,437,253,2,1
450252,690,437,253,3,1
450252,153,97,56,4,1
450252,537,340,197,5,1
450252,2,0,2,19,1
450252,535,340,195,20,1
450252,512,331,181,21,4
450252,512,331,181,22,1
450252,512,331,181,23,1
450252,134,87,47,24,1
450252,378,244,134,25,1
450252,2,0,2,39,1
450252,376,244,132,40,1
450252,178,106,72,41,4
450252,178,106,72,42,1
450252,178,106,72,43,1
450252,19,10,9,44,1
450252,159,96,63,45,1
450252,159,96,63,60,1
450261,206,162,44,1,4
450261,206,162,44,2,1
450261,206,162,44,3,1
450261,56,40,16,4,1
450261,150,122,28,5,1
450261,150,122,28,20,1
450261,158,124,34,21,4
450261,158,124,34,22,1
450261,158,124,34,23,1
450261,51,37,14,24,1
450261,107,87,20,25,1
450261,107,87,20,40,1
450261,48,38,10,41,4
450261,48,38,10,42,1
450261,48,38,10,43,1
450261,5,3,2,44,1
450261,43,35,8,45,1
450261,43,35,8,60,1
450270,330,166,164,1,4
450270,330,166,164,2,1
450270,330,166,164,3,1
450270,37,25,12,4,1
450270,293,141,152,5,1
450270,5,2,3,19,1
450270,288,139,149,20,1
450270,230,114,116,21,4
450270,230,114,116,22,1
450270,230,114,116,23,1
450270,35,23,12,24,1
450270,195,91,104,25,1
450270,4,2,2,39,1
450270,191,89,102,40,1
450270,100,52,48,41,4
450270,100,52,48,42,1
450270,100,52,48,43,1
450270,2,2,0,44,1
450270,98,50,48,45,1
450270,1,0,1,59,1
450270,97,50,47,60,1
450289,410,90,320,1,4
450289,410,90,320,2,1
450289,410,90,320,3,1
450289,215,55,160,4,1
450289,195,35,160,5,1
450289,195,35,160,20,1
450289,262,73,189,21,4
450289,262,73,189,22,1
450289,262,73,189,23,1
450289,161,46,115,24,1
450289,101,27,74,25,1
450289,101,27,74,40,1
450289,148,17,131,41,4
450289,148,17,131,42,1
450289,148,17,131,43,1
450289,54,9,45,44,1
450289,94,8,86,45,1
450289,94,8,86,60,1
450298,347,114,233,1,4
450298,255,90,165,2,1
450298,254,90,164,3,1
450298,37,10,27,4,1
450298,217,80,137,5,1
450298,1,0,1,11,1
450298,92,24,68,12,3
450298,17,8,9,19,1
450298,200,72,128,20,1
450298,22,12,10,21,4
450298,14,8,6,22,1
450298,14,8,6,23,1
450298,1,0,1,24,1
450298,13,8,5,25,1
450298,8,4,4,32,3
450298,2,2,0,39,1
450298,11,6,5,40,1
450298,325,102,223,41,4
450298,241,82,159,42,1
450298,240,82,158,43,1
450298,36,10,26,44,1
450298,204,72,132,45,1
450298,1,0,1,51,1
450298,84,20,64,52,3
450298,15,6,9,59,1
450298,189,66,123,60,1
450304,215,103,112,1,4
450304,215,103,112,12,3
450304,151,78,73,21,4
450304,151,78,73,32,3
450304,64,25,39,41,4
450304,64,25,39,52,3
450377,852,206,646,1,4
450377,390,113,277,2,1
450377,389,112,277,3,1
450377,64,19,45,4,1
450377,325,93,232,5,1
450377,1,1,0,11,1
450377,462,93,369,12,3
450377,65,23,42,19,1
450377,260,70,190,20,1
450377,61,33,28,21,4
450377,32,24,8,22,1
450377,32,24,8,23,1
450377,4,4,0,24,1
450377,28,20,8,25,1
450377,29,9,20,32,3
450377,4,4,0,39,1
450377,24,16,8,40,1
450377,791,173,618,41,4
450377,358,89,269,42,1
450377,357,88,269,43,1
450377,60,15,45,44,1
450377,297,73,224,45,1
450377,1,1,0,51,1
450377,433,84,349,52,3
450377,61,19,42,59,1
450377,236,54,182,60,1
450395,151,2,149,1,4
450395,151,2,149,2,1
450395,151,2,149,3,1
450395,15,0,15,4,1
450395,136,2,134,5,1
450395,136,2,134,20,1
450395,151,2,149,21,4
450395,151,2,149,22,1
450395,151,2,149,23,1
450395,15,0,15,24,1
450395,136,2,134,25,1
450395,136,2,134,40,1
450401,312,7,305,1,4
450401,312,7,305,2,1
450401,312,7,305,3,1
450401,107,3,104,4,1
450401,205,4,201,5,1
450401,205,4,201,20,1
450401,312,7,305,21,4
450401,312,7,305,22,1
450401,312,7,305,23,1
450401,107,3,104,24,1
450401,205,4,201,25,1
450401,205,4,201,40,1
450429,163,39,124,1,4
450429,163,39,124,2,1
450429,155,36,119,3,1
450429,17,7,10,4,1
450429,138,29,109,5,1
450429,8,3,5,11,1
450429,18,3,15,19,1
450429,120,26,94,20,1
450429,104,22,82,21,4
450429,104,22,82,22,1
450429,103,22,81,23,1
450429,16,7,9,24,1
450429,87,15,72,25,1
450429,1,0,1,31,1
450429,16,3,13,39,1
450429,71,12,59,40,1
450429,59,17,42,41,4
450429,59,17,42,42,1
450429,52,14,38,43,1
450429,1,0,1,44,1
450429,51,14,37,45,1
450429,7,3,4,51,1
450429,2,0,2,59,1
450429,49,14,35,60,1
450447,194,67,127,1,4
450447,194,67,127,2,1
450447,194,67,127,3,1
450447,22,13,9,4,1
450447,172,54,118,5,1
450447,13,5,8,19,1
450447,159,49,110,20,1
450447,136,49,87,21,4
450447,136,49,87,22,1
450447,136,49,87,23,1
450447,12,6,6,24,1
450447,124,43,81,25,1
450447,7,5,2,39,1
450447,117,38,79,40,1
450447,58,18,40,41,4
450447,58,18,40,42,1
450447,58,18,40,43,1
450447,10,7,3,44,1
450447,48,11,37,45,1
450447,6,0,6,59,1
450447,42,11,31,60,1
450456,301,66,235,1,4
450456,271,57,214,2,1
450456,271,57,214,3,1
450456,11,1,10,4,1
450456,260,56,204,5,1
450456,30,9,21,12,3
450456,19,7,12,19,1
450456,241,49,192,20,1
450456,301,66,235,21,4
450456,271,57,214,22,1
450456,271,57,214,23,1
450456,11,1,10,24,1
450456,260,56,204,25,1
450456,30,9,21,32,3
450456,19,7,12,39,1
450456,241,49,192,40,1
450465,356,170,186,1,4
450465,356,170,186,2,1
450465,356,170,186,3,1
450465,31,19,12,4,1
450465,325,151,174,5,1
450465,21,12,9,19,1
450465,304,139,165,20,1
450465,279,128,151,21,4
450465,279,128,151,22,1
450465,279,128,151,23,1
450465,15,8,7,24,1
450465,264,120,144,25,1
450465,13,7,6,39,1
450465,251,113,138,40,1
450465,77,42,35,41,4
450465,77,42,35,42,1
450465,77,42,35,43,1
450465,16,11,5,44,1
450465,61,31,30,45,1
450465,8,5,3,59,1
450465,53,26,27,60,1
450474,827,302,525,1,4
450474,735,275,460,2,1
450474,735,275,460,3,1
450474,29,8,21,4,1
450474,706,267,439,5,1
450474,92,27,65,12,3
450474,60,31,29,19,1
450474,646,236,410,20,1
450474,827,302,525,21,4
450474,735,275,460,22,1
450474,735,275,460,23,1
450474,29,8,21,24,1
450474,706,267,439,25,1
450474,92,27,65,32,3
450474,60,31,29,39,1
450474,646,236,410,40,1
450483,313,143,170,1,4
450483,303,135,168,2,1
450483,303,135,168,3,1
450483,18,5,13,4,1
450483,285,130,155,5,1
450483,10,8,2,12,3
450483,21,7,14,19,1
450483,264,123,141,20,1
450483,313,143,170,21,4
450483,303,135,168,22,1
450483,303,135,168,23,1
450483,18,5,13,24,1
450483,285,130,155,25,1
450483,10,8,2,32,3
450483,21,7,14,39,1
450483,264,123,141,40,1
450526,704,196,508,1,4
450526,388,113,275,2,1
450526,387,112,275,3,1
450526,46,19,27,4,1
450526,341,93,248,5,1
450526,1,1,0,11,1
450526,316,83,233,12,3
450526,68,20,48,19,1
450526,273,73,200,20,1
450526,136,45,91,21,4
450526,89,26,63,22,1
450526,89,26,63,23,1
450526,13,6,7,24,1
450526,76,20,56,25,1
450526,47,19,28,32,3
450526,17,4,13,39,1
450526,59,16,43,40,1
450526,568,151,417,41,4
450526,299,87,212,42,1
450526,298,86,212,43,1
450526,33,13,20,44,1
450526,265,73,192,45,1
450526,1,1,0,51,1
450526,269,64,205,52,3
450526,51,16,35,59,1
450526,214,57,157,60,1
450535,551,139,412,1,4
450535,207,66,141,2,1
450535,207,66,141,3,1
450535,25,5,20,4,1
450535,182,61,121,5,1
450535,344,73,271,12,3
450535,45,11,34,19,1
450535,137,50,87,20,1
450535,87,28,59,21,4
450535,63,20,43,22,1
450535,63,20,43,23,1
450535,7,0,7,24,1
450535,56,20,36,25,1
450535,24,8,16,32,3
450535,11,1,10,39,1
450535,45,19,26,40,1
450535,464,111,353,41,4
450535,144,46,98,42,1
450535,144,46,98,43,1
450535,18,5,13,44,1
450535,126,41,85,45,1
450535,320,65,255,52,3
450535,34,10,24,59,1
450535,92,31,61,60,1
450544,487,215,272,1,4
450544,270,131,139,2,1
450544,270,131,139,3,1
450544,25,12,13,4,1
450544,245,119,126,5,1
450544,217,84,133,12,3
450544,62,28,34,19,1
450544,183,91,92,20,1
450544,140,69,71,21,4
450544,77,44,33,22,1
450544,77,44,33,23,1
450544,4,2,2,24,1
450544,73,42,31,25,1
450544,63,25,38,32,3
450544,16,7,9,39,1
450544,57,35,22,40,1
450544,347,146,201,41,4
450544,193,87,106,42,1
450544,193,87,106,43,1
450544,21,10,11,44,1
450544,172,77,95,45,1
450544,154,59,95,52,3
450544,46,21,25,59,1
450544,126,56,70,60,1
450571,1506,275,1231,1,4
450571,1506,275,1231,2,1
450571,1491,275,1216,3,1
450571,68,20,48,4,1
450571,1423,255,1168,5,1
450571,15,0,15,11,1
450571,264,48,216,19,1
450571,1159,207,952,20,1
450571,834,148,686,21,4
450571,834,148,686,22,1
450571,834,148,686,23,1
450571,45,15,30,24,1
450571,789,133,656,25,1
450571,200,32,168,39,1
450571,589,101,488,40,1
450571,672,127,545,41,4
450571,672,127,545,42,1
450571,657,127,530,43,1
450571,23,5,18,44,1
450571,634,122,512,45,1
450571,15,0,15,51,1
450571,64,16,48,59,1
450571,570,106,464,60,1
450580,88,3,85,1,4
450580,88,3,85,2,1
450580,88,3,85,3,1
450580,27,1,26,4,1
450580,61,2,59,5,1
450580,61,2,59,20,1
450580,63,2,61,21,4
450580,63,2,61,22,1
450580,63,2,61,23,1
450580,18,0,18,24,1
450580,45,2,43,25,1
450580,45,2,43,40,1
450580,25,1,24,41,4
450580,25,1,24,42,1
450580,25,1,24,43,1
450580,9,1,8,44,1
450580,16,0,16,45,1
450580,16,0,16,60,1
450599,140,15,125,1,4
450599,140,15,125,2,1
450599,140,15,125,3,1
450599,55,10,45,4,1
450599,85,5,80,5,1
450599,85,5,80,20,1
450599,137,15,122,21,4
450599,137,15,122,22,1
450599,137,15,122,23,1
450599,55,10,45,24,1
450599,82,5,77,25,1
450599,82,5,77,40,1
450599,3,0,3,41,4
450599,3,0,3,42,1
450599,3,0,3,43,1
450599,3,0,3,45,1
450599,3,0,3,60,1
450605,127,5,122,1,4
450605,127,5,122,2,1
450605,127,5,122,3,1
450605,52,1,51,4,1
450605,75,4,71,5,1
450605,75,4,71,20,1
450605,94,5,89,21,4
450605,94,5,89,22,1
450605,94,5,89,23,1
450605,40,1,39,24,1
450605,54,4,50,25,1
450605,54,4,50,40,1
450605,33,0,33,41,4
450605,33,0,33,42,1
450605,33,0,33,43,1
450605,12,0,12,44,1
450605,21,0,21,45,1
450605,21,0,21,60,1
450614,123,9,114,1,4
450614,123,9,114,2,1
450614,123,9,114,3,1
450614,42,5,37,4,1
450614,81,4,77,5,1
450614,81,4,77,20,1
450614,98,7,91,21,4
450614,98,7,91,22,1
450614,98,7,91,23,1
450614,39,5,34,24,1
450614,59,2,57,25,1
450614,59,2,57,40,1
450614,25,2,23,41,4
450614,25,2,23,42,1
450614,25,2,23,43,1
450614,3,0,3,44,1
450614,22,2,20,45,1
450614,22,2,20,60,1
450623,168,4,164,1,4
450623,168,4,164,2,1
450623,168,4,164,3,1
450623,24,1,23,4,1
450623,144,3,141,5,1
450623,144,3,141,20,1
450623,80,1,79,21,4
450623,80,1,79,22,1
450623,80,1,79,23,1
450623,20,1,19,24,1
450623,60,0,60,25,1
450623,60,0,60,40,1
450623,88,3,85,41,4
450623,88,3,85,42,1
450623,88,3,85,43,1
450623,4,0,4,44,1
450623,84,3,81,45,1
450623,84,3,81,60,1
450632,154,35,119,1,4
450632,154,35,119,2,1
450632,154,35,119,3,1
450632,31,8,23,4,1
450632,123,27,96,5,1
450632,123,27,96,20,1
450632,154,35,119,41,4
450632,154,35,119,42,1
450632,154,35,119,43,1
450632,31,8,23,44,1
450632,123,27,96,45,1
450632,123,27,96,60,1
450641,119,7,112,1,4
450641,119,7,112,2,1
450641,119,7,112,3,1
450641,22,0,22,4,1
450641,97,7,90,5,1
450641,97,7,90,20,1
450641,93,4,89,21,4
450641,93,4,89,22,1
450641,93,4,89,23,1
450641,19,0,19,24,1
450641,74,4,70,25,1
450641,74,4,70,40,1
450641,26,3,23,41,4
450641,26,3,23,42,1
450641,26,3,23,43,1
450641,3,0,3,44,1
450641,23,3,20,45,1
450641,23,3,20,60,1
450650,225,19,206,1,4
450650,225,19,206,2,1
450650,225,19,206,3,1
450650,73,6,67,4,1
450650,152,13,139,5,1
450650,152,13,139,20,1
450650,84,6,78,21,4
450650,84,6,78,22,1
450650,84,6,78,23,1
450650,32,1,31,24,1
450650,52,5,47,25,1
450650,52,5,47,40,1
450650,141,13,128,41,4
450650,141,13,128,42,1
450650,141,13,128,43,1
450650,41,5,36,44,1
450650,100,8,92,45,1
450650,100,8,92,60,1
450669,33,16,17,1,4
450669,33,16,17,2,1
450669,33,16,17,3,1
450669,11,7,4,4,1
450669,22,9,13,5,1
450669,22,9,13,20,1
450669,33,16,17,21,4
450669,33,16,17,22,1
450669,33,16,17,23,1
450669,11,7,4,24,1
450669,22,9,13,25,1
450669,22,9,13,40,1
450678,101,17,84,1,4
450678,101,17,84,2,1
450678,101,17,84,3,1
450678,14,1,13,4,1
450678,87,16,71,5,1
450678,87,16,71,20,1
450678,101,17,84,21,4
450678,101,17,84,22,1
450678,101,17,84,23,1
450678,14,1,13,24,1
450678,87,16,71,25,1
450678,87,16,71,40,1
450696,465,66,399,1,4
450696,465,66,399,2,1
450696,465,66,399,3,1
450696,62,7,55,4,1
450696,403,59,344,5,1
450696,56,8,48,19,1
450696,347,51,296,20,1
450696,430,65,365,21,4
450696,430,65,365,22,1
450696,430,65,365,23,1
450696,62,7,55,24,1
450696,368,58,310,25,1
450696,53,8,45,39,1
450696,315,50,265,40,1
450696,35,1,34,41,4
450696,35,1,34,42,1
450696,35,1,34,43,1
450696,35,1,34,45,1
450696,3,0,3,59,1
450696,32,1,31,60,1
450702,451,69,382,1,4
450702,451,69,382,2,1
450702,451,69,382,3,1
450702,42,8,34,4,1
450702,409,61,348,5,1
450702,75,13,62,19,1
450702,334,48,286,20,1
450702,420,67,353,21,4
450702,420,67,353,22,1
450702,420,67,353,23,1
450702,42,8,34,24,1
450702,378,59,319,25,1
450702,65,13,52,39,1
450702,313,46,267,40,1
450702,31,2,29,41,4
450702,31,2,29,42,1
450702,31,2,29,43,1
450702,31,2,29,45,1
450702,10,0,10,59,1
450702,21,2,19,60,1
450720,142,10,132,1,4
450720,142,10,132,2,1
450720,142,10,132,3,1
450720,22,4,18,4,1
450720,120,6,114,5,1
450720,120,6,114,20,1
450720,89,5,84,21,4
450720,89,5,84,22,1
450720,89,5,84,23,1
450720,19,4,15,24,1
450720,70,1,69,25,1
450720,70,1,69,40,1
450720,53,5,48,41,4
450720,53,5,48,42,1
450720,53,5,48,43,1
450720,3,0,3,44,1
450720,50,5,45,45,1
450720,50,5,45,60,1
450739,172,9,163,1,4
450739,172,9,163,2,1
450739,172,9,163,3,1
450739,40,2,38,4,1
450739,132,7,125,5,1
450739,132,7,125,20,1
450739,90,6,84,21,4
450739,90,6,84,22,1
450739,90,6,84,23,1
450739,18,2,16,24,1
450739,72,4,68,25,1
450739,72,4,68,40,1
450739,82,3,79,41,4
450739,82,3,79,42,1
450739,82,3,79,43,1
450739,22,0,22,44,1
450739,60,3,57,45,1
450739,60,3,57,60,1
450757,104,4,100,1,4
450757,104,4,100,2,1
450757,104,4,100,3,1
450757,19,1,18,4,1
450757,85,3,82,5,1
450757,85,3,82,20,1
450757,83,4,79,21,4
450757,83,4,79,22,1
450757,83,4,79,23,1
450757,15,1,14,24,1
450757,68,3,65,25,1
450757,68,3,65,40,1
450757,21,0,21,41,4
450757,21,0,21,42,1
450757,21,0,21,43,1
450757,4,0,4,44,1
450757,17,0,17,45,1
450757,17,0,17,60,1
450766,215,84,131,1,4
450766,56,11,45,2,1
450766,56,11,45,3,1
450766,56,11,45,5,1
450766,159,73,86,12,3
450766,15,2,13,19,1
450766,41,9,32,20,1
450766,57,10,47,21,4
450766,43,7,36,22,1
450766,43,7,36,23,1
450766,43,7,36,25,1
450766,14,3,11,32,3
450766,11,0,11,39,1
450766,32,7,25,40,1
450766,158,74,84,41,4
450766,13,4,9,42,1
450766,13,4,9,43,1
450766,13,4,9,45,1
450766,145,70,75,52,3
450766,4,2,2,59,1
450766,9,2,7,60,1
450784,81,3,78,1,4
450784,81,3,78,2,1
450784,81,3,78,3,1
450784,21,0,21,4,1
450784,60,3,57,5,1
450784,60,3,57,20,1
450784,62,2,60,21,4
450784,62,2,60,22,1
450784,62,2,60,23,1
450784,15,0,15,24,1
450784,47,2,45,25,1
450784,47,2,45,40,1
450784,19,1,18,41,4
450784,19,1,18,42,1
450784,19,1,18,43,1
450784,6,0,6,44,1
450784,13,1,12,45,1
450784,13,1,12,60,1
450793,114,5,109,1,4
450793,114,5,109,2,1
450793,114,5,109,3,1
450793,41,2,39,4,1
450793,73,3,70,5,1
450793,73,3,70,20,1
450793,80,4,76,21,4
450793,80,4,76,22,1
450793,80,4,76,23,1
450793,30,2,28,24,1
450793,50,2,48,25,1
450793,50,2,48,40,1
450793,34,1,33,41,4
450793,34,1,33,42,1
450793,34,1,33,43,1
450793,11,0,11,44,1
450793,23,1,22,45,1
450793,23,1,22,60,1
450809,41,0,41,1,4
450809,41,0,41,2,1
450809,41,0,41,3,1
450809,21,0,21,4,1
450809,20,0,20,5,1
450809,20,0,20,20,1
450809,41,0,41,21,4
450809,41,0,41,22,1
450809,41,0,41,23,1
450809,21,0,21,24,1
450809,20,0,20,25,1
450809,20,0,20,40,1
450818,57,6,51,1,4
450818,57,6,51,2,1
450818,57,6,51,3,1
450818,18,3,15,4,1
450818,39,3,36,5,1
450818,39,3,36,20,1
450818,57,6,51,21,4
450818,57,6,51,22,1
450818,57,6,51,23,1
450818,18,3,15,24,1
450818,39,3,36,25,1
450818,39,3,36,40,1
450827,113,13,100,1,4
450827,113,13,100,2,1
450827,113,13,100,3,1
450827,40,3,37,4,1
450827,73,10,63,5,1
450827,73,10,63,20,1
450827,84,9,75,21,4
450827,84,9,75,22,1
450827,84,9,75,23,1
450827,32,3,29,24,1
450827,52,6,46,25,1
450827,52,6,46,40,1
450827,29,4,25,41,4
450827,29,4,25,42,1
450827,29,4,25,43,1
450827,8,0,8,44,1
450827,21,4,17,45,1
450827,21,4,17,60,1
450836,114,17,97,1,4
450836,114,17,97,2,1
450836,114,17,97,3,1
450836,42,8,34,4,1
450836,72,9,63,5,1
450836,72,9,63,20,1
450836,114,17,97,21,4
450836,114,17,97,22,1
450836,114,17,97,23,1
450836,42,8,34,24,1
450836,72,9,63,25,1
450836,72,9,63,40,1
450845,32,2,30,1,4
450845,32,2,30,2,1
450845,32,2,30,3,1
450845,7,0,7,4,1
450845,25,2,23,5,1
450845,25,2,23,20,1
450845,21,2,19,21,4
450845,21,2,19,22,1
450845,21,2,19,23,1
450845,5,0,5,24,1
450845,16,2,14,25,1
450845,16,2,14,40,1
450845,11,0,11,41,4
450845,11,0,11,42,1
450845,11,0,11,43,1
450845,2,0,2,44,1
450845,9,0,9,45,1
450845,9,0,9,60,1
450854,94,2,92,1,4
450854,94,2,92,2,1
450854,94,2,92,3,1
450854,34,0,34,4,1
450854,60,2,58,5,1
450854,60,2,58,20,1
450854,67,1,66,21,4
450854,67,1,66,22,1
450854,67,1,66,23,1
450854,24,0,24,24,1
450854,43,1,42,25,1
450854,43,1,42,40,1
450854,27,1,26,41,4
450854,27,1,26,42,1
450854,27,1,26,43,1
450854,10,0,10,44,1
450854,17,1,16,45,1
450854,17,1,16,60,1
450863,46,1,45,1,4
450863,46,1,45,2,1
450863,46,1,45,3,1
450863,18,1,17,4,1
450863,28,0,28,5,1
450863,28,0,28,20,1
450863,46,1,45,21,4
450863,46,1,45,22,1
450863,46,1,45,23,1
450863,18,1,17,24,1
450863,28,0,28,25,1
450863,28,0,28,40,1
450872,84,2,82,1,4
450872,84,2,82,2,1
450872,84,2,82,3,1
450872,24,1,23,4,1
450872,60,1,59,5,1
450872,60,1,59,20,1
450872,59,2,57,21,4
450872,59,2,57,22,1
450872,59,2,57,23,1
450872,18,1,17,24,1
450872,41,1,40,25,1
450872,41,1,40,40,1
450872,25,0,25,41,4
450872,25,0,25,42,1
450872,25,0,25,43,1
450872,6,0,6,44,1
450872,19,0,19,45,1
450872,19,0,19,60,1
450881,57,3,54,1,4
450881,57,3,54,2,1
450881,57,3,54,3,1
450881,16,0,16,4,1
450881,41,3,38,5,1
450881,41,3,38,20,1
450881,57,3,54,21,4
450881,57,3,54,22,1
450881,57,3,54,23,1
450881,16,0,16,24,1
450881,41,3,38,25,1
450881,41,3,38,40,1
450933,20185,12248,7937,1,4
450933,14853,9278,5575,2,1
450933,14685,9161,5524,3,1
450933,704,401,303,4,1
450933,13981,8760,5221,5,1
450933,168,117,51,11,1
450933,5332,2970,2362,12,3
450933,2292,1438,854,19,1
450933,11689,7322,4367,20,1
450933,12365,6685,5680,21,4
450933,7033,3715,3318,22,1
450933,7031,3713,3318,23,1
450933,451,213,238,24,1
450933,6580,3500,3080,25,1
450933,2,2,0,31,1
450933,5332,2970,2362,32,3
450933,1169,613,556,39,1
450933,5411,2887,2524,40,1
450933,7820,5563,2257,41,4
450933,7820,5563,2257,42,1
450933,7654,5448,2206,43,1
450933,253,188,65,44,1
450933,7401,5260,2141,45,1
450933,166,115,51,51,1
450933,1123,825,298,59,1
450933,6278,4435,1843,60,1
450942,953,455,498,1,4
450942,953,455,498,12,3
450942,627,304,323,21,4
450942,627,304,323,32,3
450942,326,151,175,41,4
450942,326,151,175,52,3
450951,136,75,61,1,4
450951,136,75,61,2,1
450951,136,75,61,3,1
450951,24,11,13,4,1
450951,112,64,48,5,1
450951,112,64,48,20,1
450951,136,75,61,21,4
450951,136,75,61,22,1
450951,136,75,61,23,1
450951,24,11,13,24,1
450951,112,64,48,25,1
450951,112,64,48,40,1
450960,181,19,162,1,4
450960,181,19,162,2,1
450960,181,19,162,3,1
450960,173,17,156,4,1
450960,8,2,6,5,1
450960,8,2,6,20,1
450960,181,19,162,21,4
450960,181,19,162,22,1
450960,181,19,162,23,1
450960,173,17,156,24,1
450960,8,2,6,25,1
450960,8,2,6,40,1
450979,7093,4656,2437,1,4
450979,3996,2708,1288,2,1
450979,3790,2571,1219,3,1
450979,74,47,27,4,1
450979,3716,2524,1192,5,1
450979,206,137,69,11,1
450979,3097,1948,1149,12,3
450979,764,495,269,19,1
450979,2952,2029,923,20,1
450979,5560,3524,2036,21,4
450979,2463,1576,887,22,1
450979,2451,1572,879,23,1
450979,66,40,26,24,1
450979,2385,1532,853,25,1
450979,12,4,8,31,1
450979,3097,1948,1149,32,3
450979,525,306,219,39,1
450979,1860,1226,634,40,1
450979,1533,1132,401,41,4
450979,1533,1132,401,42,1
450979,1339,999,340,43,1
450979,8,7,1,44,1
450979,1331,992,339,45,1
450979,194,133,61,51,1
450979,239,189,50,59,1
450979,1092,803,289,60,1
450988,197,44,153,1,4
450988,197,44,153,2,1
450988,197,44,153,3,1
450988,110,31,79,4,1
450988,87,13,74,5,1
450988,87,13,74,20,1
450988,106,35,71,21,4
450988,106,35,71,22,1
450988,106,35,71,23,1
450988,69,26,43,24,1
450988,37,9,28,25,1
450988,37,9,28,40,1
450988,91,9,82,41,4
450988,91,9,82,42,1
450988,91,9,82,43,1
450988,41,5,36,44,1
450988,50,4,46,45,1
450988,50,4,46,60,1
451006,146,27,119,1,4
451006,146,27,119,2,1
451006,146,27,119,3,1
451006,34,5,29,4,1
451006,112,22,90,5,1
451006,112,22,90,20,1
451006,106,18,88,21,4
451006,106,18,88,22,1
451006,106,18,88,23,1
451006,23,4,19,24,1
451006,83,14,69,25,1
451006,83,14,69,40,1
451006,40,9,31,41,4
451006,40,9,31,42,1
451006,40,9,31,43,1
451006,11,1,10,44,1
451006,29,8,21,45,1
451006,29,8,21,60,1
451015,278,56,222,1,4
451015,278,56,222,2,1
451015,278,56,222,3,1
451015,255,50,205,4,1
451015,23,6,17,5,1
451015,23,6,17,20,1
451015,278,56,222,21,4
451015,278,56,222,22,1
451015,278,56,222,23,1
451015,255,50,205,24,1
451015,23,6,17,25,1
451015,23,6,17,40,1
451033,22,0,22,1,4
451033,22,0,22,2,1
451033,22,0,22,3,1
451033,22,0,22,5,1
451033,22,0,22,20,1
451033,22,0,22,41,4
451033,22,0,22,42,1
451033,22,0,22,43,1
451033,22,0,22,45,1
451033,22,0,22,60,1
451042,64,12,52,1,4
451042,64,12,52,2,1
451042,64,12,52,3,1
451042,53,12,41,4,1
451042,11,0,11,5,1
451042,11,0,11,20,1
451042,20,2,18,21,4
451042,20,2,18,22,1
451042,20,2,18,23,1
451042,15,2,13,24,1
451042,5,0,5,25,1
451042,5,0,5,40,1
451042,44,10,34,41,4
451042,44,10,34,42,1
451042,44,10,34,43,1
451042,38,10,28,44,1
451042,6,0,6,45,1
451042,6,0,6,60,1
451051,68,4,64,1,4
451051,68,4,64,2,1
451051,68,4,64,3,1
451051,23,1,22,4,1
451051,45,3,42,5,1
451051,45,3,42,20,1
451051,16,0,16,21,4
451051,16,0,16,22,1
451051,16,0,16,23,1
451051,6,0,6,24,1
451051,10,0,10,25,1
451051,10,0,10,40,1
451051,52,4,48,41,4
451051,52,4,48,42,1
451051,52,4,48,43,1
451051,17,1,16,44,1
451051,35,3,32,45,1
451051,35,3,32,60,1
451060,300,194,106,1,4
451060,270,174,96,2,1
451060,265,170,95,3,1
451060,47,28,19,4,1
451060,218,142,76,5,1
451060,5,4,1,11,1
451060,30,20,10,12,3
451060,23,10,13,19,1
451060,195,132,63,20,1
451060,222,137,85,21,4
451060,203,126,77,22,1
451060,202,125,77,23,1
451060,43,25,18,24,1
451060,159,100,59,25,1
451060,1,1,0,31,1
451060,19,11,8,32,3
451060,22,10,12,39,1
451060,137,90,47,40,1
451060,78,57,21,41,4
451060,67,48,19,42,1
451060,63,45,18,43,1
451060,4,3,1,44,1
451060,59,42,17,45,1
451060,4,3,1,51,1
451060,11,9,2,52,3
451060,1,0,1,59,1
451060,58,42,16,60,1
451079,77,18,59,1,4
451079,77,18,59,12,3
451079,77,18,59,21,4
451079,77,18,59,32,3
451097,152,32,120,1,4
451097,152,32,120,2,1
451097,152,32,120,3,1
451097,46,11,35,4,1
451097,106,21,85,5,1
451097,106,21,85,20,1
451097,47,14,33,21,4
451097,47,14,33,22,1
451097,47,14,33,23,1
451097,27,4,23,24,1
451097,20,10,10,25,1
451097,20,10,10,40,1
451097,105,18,87,41,4
451097,105,18,87,42,1
451097,105,18,87,43,1
451097,19,7,12,44,1
451097,86,11,75,45,1
451097,86,11,75,60,1
451103,822,235,587,1,4
451103,822,235,587,2,1
451103,507,141,366,3,1
451103,172,53,119,4,1
451103,335,88,247,5,1
451103,315,94,221,11,1
451103,335,88,247,20,1
451103,822,235,587,21,4
451103,822,235,587,22,1
451103,507,141,366,23,1
451103,172,53,119,24,1
451103,335,88,247,25,1
451103,315,94,221,31,1
451103,335,88,247,40,1
451121,119,12,107,1,4
451121,119,12,107,2,1
451121,119,12,107,3,1
451121,1,1,0,4,1
451121,118,11,107,5,1
451121,118,11,107,20,1
451121,62,7,55,21,4
451121,62,7,55,22,1
451121,62,7,55,23,1
451121,62,7,55,25,1
451121,62,7,55,40,1
451121,57,5,52,41,4
451121,57,5,52,42,1
451121,57,5,52,43,1
451121,1,1,0,44,1
451121,56,4,52,45,1
451121,56,4,52,60,1
451130,213,127,86,1,4
451130,213,127,86,12,3
451130,210,125,85,21,4
451130,210,125,85,32,3
451130,3,2,1,41,4
451130,3,2,1,52,3
451149,619,46,573,1,4
451149,619,46,573,2,1
451149,619,46,573,3,1
451149,253,15,238,4,1
451149,366,31,335,5,1
451149,366,31,335,20,1
451149,619,46,573,21,4
451149,619,46,573,22,1
451149,619,46,573,23,1
451149,253,15,238,24,1
451149,366,31,335,25,1
451149,366,31,335,40,1
451158,666,34,632,1,4
451158,666,34,632,2,1
451158,666,34,632,3,1
451158,297,19,278,4,1
451158,369,15,354,5,1
451158,369,15,354,20,1
451158,666,34,632,21,4
451158,666,34,632,22,1
451158,666,34,632,23,1
451158,297,19,278,24,1
451158,369,15,354,25,1
451158,369,15,354,40,1
451167,103,65,38,1,4
451167,103,65,38,2,1
451167,103,65,38,3,1
451167,42,25,17,4,1
451167,61,40,21,5,1
451167,61,40,21,20,1
451167,84,52,32,21,4
451167,84,52,32,22,1
451167,84,52,32,23,1
451167,34,20,14,24,1
451167,50,32,18,25,1
451167,50,32,18,40,1
451167,19,13,6,41,4
451167,19,13,6,42,1
451167,19,13,6,43,1
451167,8,5,3,44,1
451167,11,8,3,45,1
451167,11,8,3,60,1
451194,26,4,22,1,4
451194,26,4,22,2,1
451194,26,4,22,3,1
451194,10,1,9,4,1
451194,16,3,13,5,1
451194,16,3,13,20,1
451194,26,4,22,21,4
451194,26,4,22,22,1
451194,26,4,22,23,1
451194,10,1,9,24,1
451194,16,3,13,25,1
451194,16,3,13,40,1
451219,17,9,8,1,4
451219,17,9,8,2,1
451219,17,9,8,3,1
451219,5,4,1,4,1
451219,12,5,7,5,1
451219,12,5,7,20,1
451219,8,3,5,21,4
451219,8,3,5,22,1
451219,8,3,5,23,1
451219,2,1,1,24,1
451219,6,2,4,25,1
451219,6,2,4,40,1
451219,9,6,3,41,4
451219,9,6,3,42,1
451219,9,6,3,43,1
451219,3,3,0,44,1
451219,6,3,3,45,1
451219,6,3,3,60,1
451228,208,184,24,1,4
451228,208,184,24,2,1
451228,208,184,24,3,1
451228,72,69,3,4,1
451228,136,115,21,5,1
451228,136,115,21,20,1
451228,208,184,24,21,4
451228,208,184,24,22,1
451228,208,184,24,23,1
451228,72,69,3,24,1
451228,136,115,21,25,1
451228,136,115,21,40,1
451237,59,3,56,1,4
451237,59,3,56,2,1
451237,59,3,56,3,1
451237,29,2,27,4,1
451237,30,1,29,5,1
451237,30,1,29,20,1
451237,59,3,56,21,4
451237,59,3,56,22,1
451237,59,3,56,23,1
451237,29,2,27,24,1
451237,30,1,29,25,1
451237,30,1,29,40,1
451255,25,0,25,1,4
451255,25,0,25,2,1
451255,25,0,25,3,1
451255,16,0,16,4,1
451255,9,0,9,5,1
451255,9,0,9,20,1
451255,19,0,19,21,4
451255,19,0,19,22,1
451255,19,0,19,23,1
451255,13,0,13,24,1
451255,6,0,6,25,1
451255,6,0,6,40,1
451255,6,0,6,41,4
451255,6,0,6,42,1
451255,6,0,6,43,1
451255,3,0,3,44,1
451255,3,0,3,45,1
451255,3,0,3,60,1
451264,177,42,135,1,4
451264,177,42,135,2,1
451264,177,42,135,3,1
451264,13,3,10,4,1
451264,164,39,125,5,1
451264,164,39,125,20,1
451264,177,42,135,21,4
451264,177,42,135,22,1
451264,177,42,135,23,1
451264,13,3,10,24,1
451264,164,39,125,25,1
451264,164,39,125,40,1
451282,193,7,186,1,4
451282,193,7,186,2,1
451282,193,7,186,3,1
451282,33,0,33,4,1
451282,160,7,153,5,1
451282,160,7,153,20,1
451282,125,5,120,21,4
451282,125,5,120,22,1
451282,125,5,120,23,1
451282,21,0,21,24,1
451282,104,5,99,25,1
451282,104,5,99,40,1
451282,68,2,66,41,4
451282,68,2,66,42,1
451282,68,2,66,43,1
451282,12,0,12,44,1
451282,56,2,54,45,1
451282,56,2,54,60,1
451291,22,3,19,1,4
451291,22,3,19,2,1
451291,22,3,19,3,1
451291,8,3,5,4,1
451291,14,0,14,5,1
451291,14,0,14,20,1
451291,22,3,19,41,4
451291,22,3,19,42,1
451291,22,3,19,43,1
451291,8,3,5,44,1
451291,14,0,14,45,1
451291,14,0,14,60,1
451307,61,1,60,1,4
451307,61,1,60,2,1
451307,61,1,60,3,1
451307,17,0,17,4,1
451307,44,1,43,5,1
451307,44,1,43,20,1
451307,47,1,46,21,4
451307,47,1,46,22,1
451307,47,1,46,23,1
451307,8,0,8,24,1
451307,39,1,38,25,1
451307,39,1,38,40,1
451307,14,0,14,41,4
451307,14,0,14,42,1
451307,14,0,14,43,1
451307,9,0,9,44,1
451307,5,0,5,45,1
451307,5,0,5,60,1
451316,72,0,72,1,4
451316,72,0,72,2,1
451316,72,0,72,3,1
451316,15,0,15,4,1
451316,57,0,57,5,1
451316,57,0,57,20,1
451316,72,0,72,21,4
451316,72,0,72,22,1
451316,72,0,72,23,1
451316,15,0,15,24,1
451316,57,0,57,25,1
451316,57,0,57,40,1
451334,96,20,76,1,4
451334,96,20,76,2,1
451334,96,20,76,3,1
451334,22,6,16,4,1
451334,74,14,60,5,1
451334,74,14,60,20,1
451334,86,19,67,21,4
451334,86,19,67,22,1
451334,86,19,67,23,1
451334,21,6,15,24,1
451334,65,13,52,25,1
451334,65,13,52,40,1
451334,10,1,9,41,4
451334,10,1,9,42,1
451334,10,1,9,43,1
451334,1,0,1,44,1
451334,9,1,8,45,1
451334,9,1,8,60,1
451343,160,9,151,1,4
451343,160,9,151,2,1
451343,160,9,151,3,1
451343,5,0,5,4,1
451343,155,9,146,5,1
451343,155,9,146,20,1
451343,112,5,107,21,4
451343,112,5,107,22,1
451343,112,5,107,23,1
451343,5,0,5,24,1
451343,107,5,102,25,1
451343,107,5,102,40,1
451343,48,4,44,41,4
451343,48,4,44,42,1
451343,48,4,44,43,1
451343,48,4,44,45,1
451343,48,4,44,60,1
451352,345,49,296,1,4
451352,345,49,296,2,1
451352,345,49,296,3,1
451352,86,12,74,4,1
451352,259,37,222,5,1
451352,259,37,222,20,1
451352,213,27,186,21,4
451352,213,27,186,22,1
451352,213,27,186,23,1
451352,65,9,56,24,1
451352,148,18,130,25,1
451352,148,18,130,40,1
451352,132,22,110,41,4
451352,132,22,110,42,1
451352,132,22,110,43,1
451352,21,3,18,44,1
451352,111,19,92,45,1
451352,111,19,92,60,1
451361,22,5,17,1,4
451361,22,5,17,2,1
451361,22,5,17,3,1
451361,17,4,13,4,1
451361,5,1,4,5,1
451361,5,1,4,20,1
451361,17,5,12,21,4
451361,17,5,12,22,1
451361,17,5,12,23,1
451361,14,4,10,24,1
451361,3,1,2,25,1
451361,3,1,2,40,1
451361,5,0,5,41,4
451361,5,0,5,42,1
451361,5,0,5,43,1
451361,3,0,3,44,1
451361,2,0,2,45,1
451361,2,0,2,60,1
451370,61,61,0,1,4
451370,61,61,0,2,1
451370,61,61,0,3,1
451370,8,8,0,4,1
451370,53,53,0,5,1
451370,11,11,0,19,1
451370,42,42,0,20,1
451370,61,61,0,21,4
451370,61,61,0,22,1
451370,61,61,0,23,1
451370,8,8,0,24,1
451370,53,53,0,25,1
451370,11,11,0,39,1
451370,42,42,0,40,1
451398,182,182,0,1,4
451398,182,182,0,2,1
451398,182,182,0,3,1
451398,54,54,0,4,1
451398,128,128,0,5,1
451398,18,18,0,19,1
451398,110,110,0,20,1
451398,182,182,0,21,4
451398,182,182,0,22,1
451398,182,182,0,23,1
451398,54,54,0,24,1
451398,128,128,0,25,1
451398,18,18,0,39,1
451398,110,110,0,40,1
451404,307,307,0,1,4
451404,307,307,0,2,1
451404,307,307,0,3,1
451404,68,68,0,4,1
451404,239,239,0,5,1
451404,78,78,0,19,1
451404,161,161,0,20,1
451404,307,307,0,21,4
451404,307,307,0,22,1
451404,307,307,0,23,1
451404,68,68,0,24,1
451404,239,239,0,25,1
451404,78,78,0,39,1
451404,161,161,0,40,1
451413,155,87,68,1,4
451413,155,87,68,2,1
451413,155,87,68,3,1
451413,8,5,3,4,1
451413,147,82,65,5,1
451413,147,82,65,20,1
451413,155,87,68,21,4
451413,155,87,68,22,1
451413,155,87,68,23,1
451413,8,5,3,24,1
451413,147,82,65,25,1
451413,147,82,65,40,1
451422,110,19,91,1,4
451422,110,19,91,2,1
451422,110,19,91,3,1
451422,110,19,91,5,1
451422,110,19,91,20,1
451422,110,19,91,21,4
451422,110,19,91,22,1
451422,110,19,91,23,1
451422,110,19,91,25,1
451422,110,19,91,40,1
451440,359,72,287,1,4
451440,359,72,287,2,1
451440,359,72,287,3,1
451440,149,33,116,4,1
451440,210,39,171,5,1
451440,210,39,171,20,1
451440,359,72,287,21,4
451440,359,72,287,22,1
451440,359,72,287,23,1
451440,149,33,116,24,1
451440,210,39,171,25,1
451440,210,39,171,40,1
451459,108,45,63,1,4
451459,108,45,63,2,1
451459,108,45,63,3,1
451459,39,21,18,4,1
451459,69,24,45,5,1
451459,69,24,45,20,1
451459,108,45,63,21,4
451459,108,45,63,22,1
451459,108,45,63,23,1
451459,39,21,18,24,1
451459,69,24,45,25,1
451459,69,24,45,40,1
451468,212,9,203,1,4
451468,212,9,203,2,1
451468,212,9,203,3,1
451468,14,1,13,4,1
451468,198,8,190,5,1
451468,198,8,190,20,1
451468,212,9,203,21,4
451468,212,9,203,22,1
451468,212,9,203,23,1
451468,14,1,13,24,1
451468,198,8,190,25,1
451468,198,8,190,40,1
451477,292,252,40,1,4
451477,292,252,40,2,1
451477,292,252,40,3,1
451477,156,136,20,4,1
451477,136,116,20,5,1
451477,136,116,20,20,1
451477,292,252,40,21,4
451477,292,252,40,22,1
451477,292,252,40,23,1
451477,156,136,20,24,1
451477,136,116,20,25,1
451477,136,116,20,40,1
451495,47,6,41,1,4
451495,47,6,41,2,1
451495,47,6,41,3,1
451495,22,1,21,4,1
451495,25,5,20,5,1
451495,25,5,20,20,1
451495,30,5,25,21,4
451495,30,5,25,22,1
451495,30,5,25,23,1
451495,6,1,5,24,1
451495,24,4,20,25,1
451495,24,4,20,40,1
451495,17,1,16,41,4
451495,17,1,16,42,1
451495,17,1,16,43,1
451495,16,0,16,44,1
451495,1,1,0,45,1
451495,1,1,0,60,1
451501,125,53,72,1,4
451501,125,53,72,2,1
451501,125,53,72,3,1
451501,45,27,18,4,1
451501,80,26,54,5,1
451501,80,26,54,20,1
451501,125,53,72,21,4
451501,125,53,72,22,1
451501,125,53,72,23,1
451501,45,27,18,24,1
451501,80,26,54,25,1
451501,80,26,54,40,1
451510,542,303,239,1,4
451510,542,303,239,12,3
451510,427,230,197,21,4
451510,427,230,197,32,3
451510,115,73,42,41,4
451510,115,73,42,52,3
451529,51,0,51,1,4
451529,51,0,51,2,1
451529,51,0,51,3,1
451529,35,0,35,4,1
451529,16,0,16,5,1
451529,16,0,16,20,1
451529,16,0,16,21,4
451529,16,0,16,22,1
451529,16,0,16,23,1
451529,9,0,9,24,1
451529,7,0,7,25,1
451529,7,0,7,40,1
451529,35,0,35,41,4
451529,35,0,35,42,1
451529,35,0,35,43,1
451529,26,0,26,44,1
451529,9,0,9,45,1
451529,9,0,9,60,1
451538,120,107,13,1,4
451538,120,107,13,2,1
451538,120,107,13,3,1
451538,105,95,10,4,1
451538,15,12,3,5,1
451538,15,12,3,20,1
451538,120,107,13,21,4
451538,120,107,13,22,1
451538,120,107,13,23,1
451538,105,95,10,24,1
451538,15,12,3,25,1
451538,15,12,3,40,1
451547,25,1,24,1,4
451547,25,1,24,2,1
451547,25,1,24,3,1
451547,22,1,21,4,1
451547,3,0,3,5,1
451547,3,0,3,20,1
451547,25,1,24,21,4
451547,25,1,24,22,1
451547,25,1,24,23,1
451547,22,1,21,24,1
451547,3,0,3,25,1
451547,3,0,3,40,1
451556,1296,559,737,1,4
451556,1296,559,737,2,1
451556,1296,559,737,3,1
451556,434,219,215,4,1
451556,862,340,522,5,1
451556,590,229,361,19,1
451556,272,111,161,20,1
451556,1296,559,737,21,4
451556,1296,559,737,22,1
451556,1296,559,737,23,1
451556,434,219,215,24,1
451556,862,340,522,25,1
451556,590,229,361,39,1
451556,272,111,161,40,1
451565,171,7,164,1,4
451565,171,7,164,2,1
451565,171,7,164,3,1
451565,31,1,30,4,1
451565,140,6,134,5,1
451565,140,6,134,20,1
451565,122,4,118,21,4
451565,122,4,118,22,1
451565,122,4,118,23,1
451565,25,1,24,24,1
451565,97,3,94,25,1
451565,97,3,94,40,1
451565,49,3,46,41,4
451565,49,3,46,42,1
451565,49,3,46,43,1
451565,6,0,6,44,1
451565,43,3,40,45,1
451565,43,3,40,60,1
451574,179,10,169,1,4
451574,179,10,169,2,1
451574,179,10,169,3,1
451574,96,6,90,4,1
451574,83,4,79,5,1
451574,83,4,79,20,1
451574,179,10,169,21,4
451574,179,10,169,22,1
451574,179,10,169,23,1
451574,96,6,90,24,1
451574,83,4,79,25,1
451574,83,4,79,40,1
451583,165,94,71,1,4
451583,165,94,71,2,1
451583,143,83,60,3,1
451583,63,39,24,4,1
451583,80,44,36,5,1
451583,22,11,11,11,1
451583,80,44,36,20,1
451583,73,29,44,21,4
451583,73,29,44,22,1
451583,64,29,35,23,1
451583,27,9,18,24,1
451583,37,20,17,25,1
451583,9,0,9,31,1
451583,37,20,17,40,1
451583,92,65,27,41,4
451583,92,65,27,42,1
451583,79,54,25,43,1
451583,36,30,6,44,1
451583,43,24,19,45,1
451583,13,11,2,51,1
451583,43,24,19,60,1
451592,7,0,7,1,4
451592,7,0,7,2,1
451592,7,0,7,3,1
451592,7,0,7,5,1
451592,7,0,7,20,1
451592,3,0,3,21,4
451592,3,0,3,22,1
451592,3,0,3,23,1
451592,3,0,3,25,1
451592,3,0,3,40,1
451592,4,0,4,41,4
451592,4,0,4,42,1
451592,4,0,4,43,1
451592,4,0,4,45,1
451592,4,0,4,60,1
451617,37,2,35,1,4
451617,37,2,35,2,1
451617,37,2,35,3,1
451617,10,0,10,4,1
451617,27,2,25,5,1
451617,27,2,25,20,1
451617,34,2,32,21,4
451617,34,2,32,22,1
451617,34,2,32,23,1
451617,9,0,9,24,1
451617,25,2,23,25,1
451617,25,2,23,40,1
451617,3,0,3,41,4
451617,3,0,3,42,1
451617,3,0,3,43,1
451617,1,0,1,44,1
451617,2,0,2,45,1
451617,2,0,2,60,1
451626,93,14,79,1,4
451626,93,14,79,2,1
451626,93,14,79,3,1
451626,32,6,26,4,1
451626,61,8,53,5,1
451626,61,8,53,20,1
451626,80,14,66,21,4
451626,80,14,66,22,1
451626,80,14,66,23,1
451626,32,6,26,24,1
451626,48,8,40,25,1
451626,48,8,40,40,1
451626,13,0,13,41,4
451626,13,0,13,42,1
451626,13,0,13,43,1
451626,13,0,13,45,1
451626,13,0,13,60,1
451635,25,3,22,1,4
451635,25,3,22,2,1
451635,25,3,22,3,1
451635,12,0,12,4,1
451635,13,3,10,5,1
451635,13,3,10,20,1
451635,25,3,22,21,4
451635,25,3,22,22,1
451635,25,3,22,23,1
451635,12,0,12,24,1
451635,13,3,10,25,1
451635,13,3,10,40,1
451644,8,1,7,1,4
451644,8,1,7,2,1
451644,8,1,7,3,1
451644,3,0,3,4,1
451644,5,1,4,5,1
451644,5,1,4,20,1
451644,8,1,7,21,4
451644,8,1,7,22,1
451644,8,1,7,23,1
451644,3,0,3,24,1
451644,5,1,4,25,1
451644,5,1,4,40,1
451653,30,1,29,1,4
451653,30,1,29,2,1
451653,30,1,29,3,1
451653,19,1,18,4,1
451653,11,0,11,5,1
451653,11,0,11,20,1
451653,30,1,29,21,4
451653,30,1,29,22,1
451653,30,1,29,23,1
451653,19,1,18,24,1
451653,11,0,11,25,1
451653,11,0,11,40,1
451662,10906,4232,6674,1,4
451662,10906,4232,6674,2,1
451662,10896,4228,6668,3,1
451662,1339,626,713,4,1
451662,9557,3602,5955,5,1
451662,10,4,6,11,1
451662,1161,428,733,19,1
451662,8396,3174,5222,20,1
451662,556,225,331,21,4
451662,556,225,331,22,1
451662,556,225,331,23,1
451662,36,13,23,24,1
451662,520,212,308,25,1
451662,54,18,36,39,1
451662,466,194,272,40,1
451662,10350,4007,6343,41,4
451662,10350,4007,6343,42,1
451662,10340,4003,6337,43,1
451662,1303,613,690,44,1
451662,9037,3390,5647,45,1
451662,10,4,6,51,1
451662,1107,410,697,59,1
451662,7930,2980,4950,60,1
451671,1877,758,1119,1,4
451671,1728,706,1022,2,1
451671,1671,676,995,3,1
451671,83,38,45,4,1
451671,1588,638,950,5,1
451671,57,30,27,11,1
451671,149,52,97,12,3
451671,402,167,235,19,1
451671,1186,471,715,20,1
451671,875,360,515,21,4
451671,837,341,496,22,1
451671,825,339,486,23,1
451671,80,37,43,24,1
451671,745,302,443,25,1
451671,12,2,10,31,1
451671,38,19,19,32,3
451671,244,106,138,39,1
451671,501,196,305,40,1
451671,1002,398,604,41,4
451671,891,365,526,42,1
451671,846,337,509,43,1
451671,3,1,2,44,1
451671,843,336,507,45,1
451671,45,28,17,51,1
451671,111,33,78,52,3
451671,158,61,97,59,1
451671,685,275,410,60,1
451699,899,207,692,1,4
451699,899,207,692,2,1
451699,899,207,692,3,1
451699,114,27,87,4,1
451699,785,180,605,5,1
451699,166,35,131,19,1
451699,619,145,474,20,1
451699,899,207,692,21,4
451699,899,207,692,22,1
451699,899,207,692,23,1
451699,114,27,87,24,1
451699,785,180,605,25,1
451699,166,35,131,39,1
451699,619,145,474,40,1
451705,75,26,49,1,4
451705,75,26,49,2,1
451705,75,26,49,3,1
451705,13,4,9,4,1
451705,62,22,40,5,1
451705,9,2,7,19,1
451705,53,20,33,20,1
451705,75,26,49,21,4
451705,75,26,49,22,1
451705,75,26,49,23,1
451705,13,4,9,24,1
451705,62,22,40,25,1
451705,9,2,7,39,1
451705,53,20,33,40,1
451714,257,17,240,1,4
451714,257,17,240,2,1
451714,257,17,240,3,1
451714,62,2,60,4,1
451714,195,15,180,5,1
451714,195,15,180,20,1
451714,257,17,240,21,4
451714,257,17,240,22,1
451714,257,17,240,23,1
451714,62,2,60,24,1
451714,195,15,180,25,1
451714,195,15,180,40,1
451741,631,206,425,1,4
451741,631,206,425,2,1
451741,631,206,425,3,1
451741,121,56,65,4,1
451741,510,150,360,5,1
451741,162,48,114,19,1
451741,348,102,246,20,1
451741,552,176,376,21,4
451741,552,176,376,22,1
451741,552,176,376,23,1
451741,121,56,65,24,1
451741,431,120,311,25,1
451741,136,40,96,39,1
451741,295,80,215,40,1
451741,79,30,49,41,4
451741,79,30,49,42,1
451741,79,30,49,43,1
451741,79,30,49,45,1
451741,26,8,18,59,1
451741,53,22,31,60,1
451750,760,80,680,1,4
451750,760,80,680,2,1
451750,760,80,680,3,1
451750,48,6,42,4,1
451750,712,74,638,5,1
451750,153,19,134,19,1
451750,559,55,504,20,1
451750,449,50,399,21,4
451750,449,50,399,22,1
451750,449,50,399,23,1
451750,46,6,40,24,1
451750,403,44,359,25,1
451750,123,17,106,39,1
451750,280,27,253,40,1
451750,311,30,281,41,4
451750,311,30,281,42,1
451750,311,30,281,43,1
451750,2,0,2,44,1
451750,309,30,279,45,1
451750,30,2,28,59,1
451750,279,28,251,60,1
451769,395,104,291,1,4
451769,395,104,291,2,1
451769,384,103,281,3,1
451769,21,4,17,4,1
451769,363,99,264,5,1
451769,11,1,10,11,1
451769,56,14,42,19,1
451769,307,85,222,20,1
451769,258,76,182,21,4
451769,258,76,182,22,1
451769,257,76,181,23,1
451769,21,4,17,24,1
451769,236,72,164,25,1
451769,1,0,1,31,1
451769,50,14,36,39,1
451769,186,58,128,40,1
451769,137,28,109,41,4
451769,137,28,109,42,1
451769,127,27,100,43,1
451769,127,27,100,45,1
451769,10,1,9,51,1
451769,6,0,6,59,1
451769,121,27,94,60,1
451796,1003,486,517,1,4
451796,1003,486,517,2,1
451796,995,481,514,3,1
451796,294,157,137,4,1
451796,701,324,377,5,1
451796,8,5,3,11,1
451796,128,53,75,19,1
451796,573,271,302,20,1
451796,697,352,345,21,4
451796,697,352,345,22,1
451796,696,351,345,23,1
451796,247,132,115,24,1
451796,449,219,230,25,1
451796,1,1,0,31,1
451796,88,36,52,39,1
451796,361,183,178,40,1
451796,306,134,172,41,4
451796,306,134,172,42,1
451796,299,130,169,43,1
451796,47,25,22,44,1
451796,252,105,147,45,1
451796,7,4,3,51,1
451796,40,17,23,59,1
451796,212,88,124,60,1
451802,18,1,17,1,4
451802,18,1,17,2,1
451802,18,1,17,3,1
451802,9,0,9,4,1
451802,9,1,8,5,1
451802,9,1,8,20,1
451802,18,1,17,21,4
451802,18,1,17,22,1
451802,18,1,17,23,1
451802,9,0,9,24,1
451802,9,1,8,25,1
451802,9,1,8,40,1
451811,38,3,35,1,4
451811,38,3,35,2,1
451811,38,3,35,3,1
451811,10,2,8,4,1
451811,28,1,27,5,1
451811,28,1,27,20,1
451811,11,1,10,21,4
451811,11,1,10,22,1
451811,11,1,10,23,1
451811,1,1,0,24,1
451811,10,0,10,25,1
451811,10,0,10,40,1
451811,27,2,25,41,4
451811,27,2,25,42,1
451811,27,2,25,43,1
451811,9,1,8,44,1
451811,18,1,17,45,1
451811,18,1,17,60,1
451820,1413,818,595,1,4
451820,1413,818,595,2,1
451820,1413,818,595,3,1
451820,213,125,88,4,1
451820,1200,693,507,5,1
451820,249,142,107,19,1
451820,951,551,400,20,1
451820,1071,627,444,21,4
451820,1071,627,444,22,1
451820,1071,627,444,23,1
451820,174,97,77,24,1
451820,897,530,367,25,1
451820,198,115,83,39,1
451820,699,415,284,40,1
451820,342,191,151,41,4
451820,342,191,151,42,1
451820,342,191,151,43,1
451820,39,28,11,44,1
451820,303,163,140,45,1
451820,51,27,24,59,1
451820,252,136,116,60,1
451848,570,309,261,1,4
451848,570,309,261,2,1
451848,570,309,261,3,1
451848,96,43,53,4,1
451848,474,266,208,5,1
451848,56,30,26,19,1
451848,418,236,182,20,1
451848,338,176,162,21,4
451848,338,176,162,22,1
451848,338,176,162,23,1
451848,72,33,39,24,1
451848,266,143,123,25,1
451848,39,19,20,39,1
451848,227,124,103,40,1
451848,232,133,99,41,4
451848,232,133,99,42,1
451848,232,133,99,43,1
451848,24,10,14,44,1
451848,208,123,85,45,1
451848,17,11,6,59,1
451848,191,112,79,60,1
451857,252,26,226,1,4
451857,252,26,226,2,1
451857,252,26,226,3,1
451857,78,8,70,4,1
451857,174,18,156,5,1
451857,2,0,2,19,1
451857,172,18,154,20,1
451857,252,26,226,21,4
451857,252,26,226,22,1
451857,252,26,226,23,1
451857,78,8,70,24,1
451857,174,18,156,25,1
451857,2,0,2,39,1
451857,172,18,154,40,1
451866,318,72,246,1,4
451866,318,72,246,2,1
451866,318,72,246,3,1
451866,108,19,89,4,1
451866,210,53,157,5,1
451866,1,0,1,19,1
451866,209,53,156,20,1
451866,318,72,246,21,4
451866,318,72,246,22,1
451866,318,72,246,23,1
451866,108,19,89,24,1
451866,210,53,157,25,1
451866,1,0,1,39,1
451866,209,53,156,40,1
451875,254,73,181,1,4
451875,254,73,181,2,1
451875,254,73,181,3,1
451875,16,6,10,4,1
451875,238,67,171,5,1
451875,43,11,32,19,1
451875,195,56,139,20,1
451875,24,14,10,21,4
451875,24,14,10,22,1
451875,24,14,10,23,1
451875,1,1,0,24,1
451875,23,13,10,25,1
451875,1,0,1,39,1
451875,22,13,9,40,1
451875,230,59,171,41,4
451875,230,59,171,42,1
451875,230,59,171,43,1
451875,15,5,10,44,1
451875,215,54,161,45,1
451875,42,11,31,59,1
451875,173,43,130,60,1
451884,375,94,281,1,4
451884,375,94,281,2,1
451884,375,94,281,3,1
451884,38,13,25,4,1
451884,337,81,256,5,1
451884,79,25,54,19,1
451884,258,56,202,20,1
451884,19,7,12,21,4
451884,19,7,12,22,1
451884,19,7,12,23,1
451884,19,7,12,25,1
451884,2,1,1,39,1
451884,17,6,11,40,1
451884,356,87,269,41,4
451884,356,87,269,42,1
451884,356,87,269,43,1
451884,38,13,25,44,1
451884,318,74,244,45,1
451884,77,24,53,59,1
451884,241,50,191,60,1
451909,487,41,446,1,4
451909,487,41,446,2,1
451909,487,41,446,3,1
451909,96,7,89,4,1
451909,391,34,357,5,1
451909,21,1,20,19,1
451909,370,33,337,20,1
451909,487,41,446,21,4
451909,487,41,446,22,1
451909,487,41,446,23,1
451909,96,7,89,24,1
451909,391,34,357,25,1
451909,21,1,20,39,1
451909,370,33,337,40,1
451918,142,7,135,1,4
451918,142,7,135,2,1
451918,142,7,135,3,1
451918,36,2,34,4,1
451918,106,5,101,5,1
451918,106,5,101,20,1
451918,116,6,110,21,4
451918,116,6,110,22,1
451918,116,6,110,23,1
451918,25,1,24,24,1
451918,91,5,86,25,1
451918,91,5,86,40,1
451918,26,1,25,41,4
451918,26,1,25,42,1
451918,26,1,25,43,1
451918,11,1,10,44,1
451918,15,0,15,45,1
451918,15,0,15,60,1
451936,282,230,52,1,4
451936,282,230,52,2,1
451936,282,230,52,3,1
451936,43,34,9,4,1
451936,239,196,43,5,1
451936,7,4,3,19,1
451936,232,192,40,20,1
451936,232,186,46,21,4
451936,232,186,46,22,1
451936,232,186,46,23,1
451936,38,30,8,24,1
451936,194,156,38,25,1
451936,7,4,3,39,1
451936,187,152,35,40,1
451936,50,44,6,41,4
451936,50,44,6,42,1
451936,50,44,6,43,1
451936,5,4,1,44,1
451936,45,40,5,45,1
451936,45,40,5,60,1
451945,372,208,164,1,4
451945,372,208,164,2,1
451945,372,208,164,3,1
451945,54,36,18,4,1
451945,318,172,146,5,1
451945,7,1,6,19,1
451945,311,171,140,20,1
451945,267,160,107,21,4
451945,267,160,107,22,1
451945,267,160,107,23,1
451945,46,31,15,24,1
451945,221,129,92,25,1
451945,5,1,4,39,1
451945,216,128,88,40,1
451945,105,48,57,41,4
451945,105,48,57,42,1
451945,105,48,57,43,1
451945,8,5,3,44,1
451945,97,43,54,45,1
451945,2,0,2,59,1
451945,95,43,52,60,1
451954,208,172,36,1,4
451954,208,172,36,2,1
451954,208,172,36,3,1
451954,46,35,11,4,1
451954,162,137,25,5,1
451954,7,6,1,19,1
451954,155,131,24,20,1
451954,154,124,30,21,4
451954,154,124,30,22,1
451954,154,124,30,23,1
451954,41,30,11,24,1
451954,113,94,19,25,1
451954,6,5,1,39,1
451954,107,89,18,40,1
451954,54,48,6,41,4
451954,54,48,6,42,1
451954,54,48,6,43,1
451954,5,5,0,44,1
451954,49,43,6,45,1
451954,1,1,0,59,1
451954,48,42,6,60,1
451963,345,262,83,1,4
451963,345,262,83,2,1
451963,345,262,83,3,1
451963,66,50,16,4,1
451963,279,212,67,5,1
451963,9,6,3,19,1
451963,270,206,64,20,1
451963,283,214,69,21,4
451963,283,214,69,22,1
451963,283,214,69,23,1
451963,59,45,14,24,1
451963,224,169,55,25,1
451963,7,5,2,39,1
451963,217,164,53,40,1
451963,62,48,14,41,4
451963,62,48,14,42,1
451963,62,48,14,43,1
451963,7,5,2,44,1
451963,55,43,12,45,1
451963,2,1,1,59,1
451963,53,42,11,60,1
451972,247,173,74,1,4
451972,247,173,74,2,1
451972,247,173,74,3,1
451972,31,20,11,4,1
451972,216,153,63,5,1
451972,1,1,0,19,1
451972,215,152,63,20,1
451972,171,120,51,21,4
451972,171,120,51,22,1
451972,171,120,51,23,1
451972,29,18,11,24,1
451972,142,102,40,25,1
451972,1,1,0,39,1
451972,141,101,40,40,1
451972,76,53,23,41,4
451972,76,53,23,42,1
451972,76,53,23,43,1
451972,2,2,0,44,1
451972,74,51,23,45,1
451972,74,51,23,60,1
451981,178,137,41,1,4
451981,178,137,41,2,1
451981,178,137,41,3,1
451981,46,37,9,4,1
451981,132,100,32,5,1
451981,4,2,2,19,1
451981,128,98,30,20,1
451981,130,100,30,21,4
451981,130,100,30,22,1
451981,130,100,30,23,1
451981,39,32,7,24,1
451981,91,68,23,25,1
451981,2,0,2,39,1
451981,89,68,21,40,1
451981,48,37,11,41,4
451981,48,37,11,42,1
451981,48,37,11,43,1
451981,7,5,2,44,1
451981,41,32,9,45,1
451981,2,2,0,59,1
451981,39,30,9,60,1
451990,451,231,220,1,4
451990,451,231,220,2,1
451990,451,231,220,3,1
451990,77,49,28,4,1
451990,374,182,192,5,1
451990,4,2,2,19,1
451990,370,180,190,20,1
451990,318,178,140,21,4
451990,318,178,140,22,1
451990,318,178,140,23,1
451990,63,42,21,24,1
451990,255,136,119,25,1
451990,2,2,0,39,1
451990,253,134,119,40,1
451990,133,53,80,41,4
451990,133,53,80,42,1
451990,133,53,80,43,1
451990,14,7,7,44,1
451990,119,46,73,45,1
451990,2,0,2,59,1
451990,117,46,71,60,1
452009,45,1,44,1,4
452009,45,1,44,2,1
452009,45,1,44,3,1
452009,6,0,6,4,1
452009,39,1,38,5,1
452009,39,1,38,20,1
452009,45,1,44,21,4
452009,45,1,44,22,1
452009,45,1,44,23,1
452009,6,0,6,24,1
452009,39,1,38,25,1
452009,39,1,38,40,1
452018,495,251,244,1,4
452018,495,251,244,2,1
452018,495,251,244,3,1
452018,145,84,61,4,1
452018,350,167,183,5,1
452018,54,21,33,19,1
452018,296,146,150,20,1
452018,365,194,171,21,4
452018,365,194,171,22,1
452018,365,194,171,23,1
452018,111,67,44,24,1
452018,254,127,127,25,1
452018,45,18,27,39,1
452018,209,109,100,40,1
452018,130,57,73,41,4
452018,130,57,73,42,1
452018,130,57,73,43,1
452018,34,17,17,44,1
452018,96,40,56,45,1
452018,9,3,6,59,1
452018,87,37,50,60,1
452027,781,379,402,1,4
452027,781,379,402,2,1
452027,781,379,402,3,1
452027,187,93,94,4,1
452027,594,286,308,5,1
452027,142,73,69,19,1
452027,452,213,239,20,1
452027,513,250,263,21,4
452027,513,250,263,22,1
452027,513,250,263,23,1
452027,119,58,61,24,1
452027,394,192,202,25,1
452027,76,40,36,39,1
452027,318,152,166,40,1
452027,268,129,139,41,4
452027,268,129,139,42,1
452027,268,129,139,43,1
452027,68,35,33,44,1
452027,200,94,106,45,1
452027,66,33,33,59,1
452027,134,61,73,60,1
452036,375,193,182,1,4
452036,375,193,182,2,1
452036,375,193,182,3,1
452036,78,42,36,4,1
452036,297,151,146,5,1
452036,297,151,146,20,1
452036,375,193,182,21,4
452036,375,193,182,22,1
452036,375,193,182,23,1
452036,78,42,36,24,1
452036,297,151,146,25,1
452036,297,151,146,40,1
452045,439,218,221,1,4
452045,439,218,221,2,1
452045,439,218,221,3,1
452045,91,33,58,4,1
452045,348,185,163,5,1
452045,348,185,163,20,1
452045,439,218,221,21,4
452045,439,218,221,22,1
452045,439,218,221,23,1
452045,91,33,58,24,1
452045,348,185,163,25,1
452045,348,185,163,40,1
452054,488,247,241,1,4
452054,488,247,241,2,1
452054,488,247,241,3,1
452054,90,48,42,4,1
452054,398,199,199,5,1
452054,43,24,19,19,1
452054,355,175,180,20,1
452054,488,247,241,21,4
452054,488,247,241,22,1
452054,488,247,241,23,1
452054,90,48,42,24,1
452054,398,199,199,25,1
452054,43,24,19,39,1
452054,355,175,180,40,1
452063,892,471,421,1,4
452063,892,471,421,2,1
452063,892,471,421,3,1
452063,141,65,76,4,1
452063,751,406,345,5,1
452063,51,19,32,19,1
452063,700,387,313,20,1
452063,892,471,421,21,4
452063,892,471,421,22,1
452063,892,471,421,23,1
452063,141,65,76,24,1
452063,751,406,345,25,1
452063,51,19,32,39,1
452063,700,387,313,40,1
452072,116,8,108,1,4
452072,116,8,108,2,1
452072,116,8,108,3,1
452072,43,4,39,4,1
452072,73,4,69,5,1
452072,73,4,69,20,1
452072,116,8,108,21,4
452072,116,8,108,22,1
452072,116,8,108,23,1
452072,43,4,39,24,1
452072,73,4,69,25,1
452072,73,4,69,40,1
452081,423,13,410,1,4
452081,423,13,410,2,1
452081,423,13,410,3,1
452081,79,3,76,4,1
452081,344,10,334,5,1
452081,344,10,334,20,1
452081,423,13,410,21,4
452081,423,13,410,22,1
452081,423,13,410,23,1
452081,79,3,76,24,1
452081,344,10,334,25,1
452081,344,10,334,40,1
452090,243,98,145,1,4
452090,108,34,74,2,1
452090,108,34,74,3,1
452090,3,1,2,4,1
452090,105,33,72,5,1
452090,135,64,71,12,3
452090,10,2,8,19,1
452090,95,31,64,20,1
452090,85,31,54,21,4
452090,41,12,29,22,1
452090,41,12,29,23,1
452090,41,12,29,25,1
452090,44,19,25,32,3
452090,5,1,4,39,1
452090,36,11,25,40,1
452090,158,67,91,41,4
452090,67,22,45,42,1
452090,67,22,45,43,1
452090,3,1,2,44,1
452090,64,21,43,45,1
452090,91,45,46,52,3
452090,5,1,4,59,1
452090,59,20,39,60,1
452106,100,97,3,1,4
452106,100,97,3,2,1
452106,100,97,3,3,1
452106,28,27,1,4,1
452106,72,70,2,5,1
452106,72,70,2,20,1
452106,100,97,3,21,4
452106,100,97,3,22,1
452106,100,97,3,23,1
452106,28,27,1,24,1
452106,72,70,2,25,1
452106,72,70,2,40,1
452115,656,96,560,1,4
452115,656,96,560,2,1
452115,656,96,560,3,1
452115,291,41,250,4,1
452115,365,55,310,5,1
452115,365,55,310,20,1
452115,458,79,379,21,4
452115,458,79,379,22,1
452115,458,79,379,23,1
452115,237,38,199,24,1
452115,221,41,180,25,1
452115,221,41,180,40,1
452115,198,17,181,41,4
452115,198,17,181,42,1
452115,198,17,181,43,1
452115,54,3,51,44,1
452115,144,14,130,45,1
452115,144,14,130,60,1
452124,346,142,204,1,4
452124,346,142,204,2,1
452124,346,142,204,3,1
452124,69,26,43,4,1
452124,277,116,161,5,1
452124,19,8,11,19,1
452124,258,108,150,20,1
452124,346,142,204,21,4
452124,346,142,204,22,1
452124,346,142,204,23,1
452124,69,26,43,24,1
452124,277,116,161,25,1
452124,19,8,11,39,1
452124,258,108,150,40,1
452373,554,87,467,1,4
452373,554,87,467,2,1
452373,554,87,467,3,1
452373,70,14,56,4,1
452373,484,73,411,5,1
452373,161,22,139,19,1
452373,323,51,272,20,1
452373,290,41,249,21,4
452373,290,41,249,22,1
452373,290,41,249,23,1
452373,42,8,34,24,1
452373,248,33,215,25,1
452373,98,11,87,39,1
452373,150,22,128,40,1
452373,264,46,218,41,4
452373,264,46,218,42,1
452373,264,46,218,43,1
452373,28,6,22,44,1
452373,236,40,196,45,1
452373,63,11,52,59,1
452373,173,29,144,60,1
452692,2,0,2,1,4
452692,2,0,2,2,1
452692,2,0,2,3,1
452692,1,0,1,4,1
452692,1,0,1,5,1
452692,1,0,1,20,1
452692,2,0,2,21,4
452692,2,0,2,22,1
452692,2,0,2,23,1
452692,1,0,1,24,1
452692,1,0,1,25,1
452692,1,0,1,40,1
452771,16,2,14,1,4
452771,16,2,14,2,1
452771,16,2,14,3,1
452771,10,1,9,4,1
452771,6,1,5,5,1
452771,6,1,5,20,1
452771,16,2,14,41,4
452771,16,2,14,42,1
452771,16,2,14,43,1
452771,10,1,9,44,1
452771,6,1,5,45,1
452771,6,1,5,60,1
452780,18,1,17,1,4
452780,18,1,17,2,1
452780,18,1,17,3,1
452780,12,1,11,4,1
452780,6,0,6,5,1
452780,6,0,6,20,1
452780,18,1,17,41,4
452780,18,1,17,42,1
452780,18,1,17,43,1
452780,12,1,11,44,1
452780,6,0,6,45,1
452780,6,0,6,60,1
452841,134,13,121,1,4
452841,134,13,121,2,1
452841,134,13,121,3,1
452841,130,13,117,4,1
452841,4,0,4,5,1
452841,4,0,4,20,1
452841,134,13,121,21,4
452841,134,13,121,22,1
452841,134,13,121,23,1
452841,130,13,117,24,1
452841,4,0,4,25,1
452841,4,0,4,40,1
452948,505,60,445,1,4
452948,505,60,445,2,1
452948,505,60,445,3,1
452948,24,5,19,4,1
452948,481,55,426,5,1
452948,119,16,103,19,1
452948,362,39,323,20,1
452948,278,31,247,21,4
452948,278,31,247,22,1
452948,278,31,247,23,1
452948,22,4,18,24,1
452948,256,27,229,25,1
452948,41,6,35,39,1
452948,215,21,194,40,1
452948,227,29,198,41,4
452948,227,29,198,42,1
452948,227,29,198,43,1
452948,2,1,1,44,1
452948,225,28,197,45,1
452948,78,10,68,59,1
452948,147,18,129,60,1
452984,16,2,14,1,4
452984,16,2,14,2,1
452984,16,2,14,3,1
452984,7,1,6,4,1
452984,9,1,8,5,1
452984,9,1,8,20,1
452984,16,2,14,41,4
452984,16,2,14,42,1
452984,16,2,14,43,1
452984,7,1,6,44,1
452984,9,1,8,45,1
452984,9,1,8,60,1
453075,66,9,57,1,4
453075,66,9,57,2,1
453075,66,9,57,3,1
453075,28,4,24,4,1
453075,38,5,33,5,1
453075,38,5,33,20,1
453075,64,9,55,21,4
453075,64,9,55,22,1
453075,64,9,55,23,1
453075,27,4,23,24,1
453075,37,5,32,25,1
453075,37,5,32,40,1
453075,2,0,2,41,4
453075,2,0,2,42,1
453075,2,0,2,43,1
453075,1,0,1,44,1
453075,1,0,1,45,1
453075,1,0,1,60,1
453109,161,95,66,1,4
453109,161,95,66,2,1
453109,161,95,66,3,1
453109,105,68,37,4,1
453109,56,27,29,5,1
453109,5,1,4,19,1
453109,51,26,25,20,1
453109,161,95,66,21,4
453109,161,95,66,22,1
453109,161,95,66,23,1
453109,105,68,37,24,1
453109,56,27,29,25,1
453109,5,1,4,39,1
453109,51,26,25,40,1
453127,568,222,346,1,4
453127,424,171,253,2,1
453127,424,171,253,3,1
453127,69,34,35,4,1
453127,355,137,218,5,1
453127,144,51,93,12,3
453127,51,21,30,19,1
453127,304,116,188,20,1
453127,59,38,21,21,4
453127,36,28,8,22,1
453127,36,28,8,23,1
453127,3,3,0,24,1
453127,33,25,8,25,1
453127,23,10,13,32,3
453127,10,8,2,39,1
453127,23,17,6,40,1
453127,509,184,325,41,4
453127,388,143,245,42,1
453127,388,143,245,43,1
453127,66,31,35,44,1
453127,322,112,210,45,1
453127,121,41,80,52,3
453127,41,13,28,59,1
453127,281,99,182,60,1
453163,3802,1061,2741,1,4
453163,2116,668,1448,2,1
453163,2111,666,1445,3,1
453163,340,122,218,4,1
453163,1771,544,1227,5,1
453163,5,2,3,11,1
453163,1686,393,1293,12,3
453163,240,77,163,19,1
453163,1531,467,1064,20,1
453163,266,129,137,21,4
453163,131,82,49,22,1
453163,131,82,49,23,1
453163,13,9,4,24,1
453163,118,73,45,25,1
453163,135,47,88,32,3
453163,26,17,9,39,1
453163,92,56,36,40,1
453163,3536,932,2604,41,4
453163,1985,586,1399,42,1
453163,1980,584,1396,43,1
453163,327,113,214,44,1
453163,1653,471,1182,45,1
453163,5,2,3,51,1
453163,1551,346,1205,52,3
453163,214,60,154,59,1
453163,1439,411,1028,60,1
453215,788,290,498,1,4
453215,580,206,374,2,1
453215,578,206,372,3,1
453215,62,21,41,4,1
453215,516,185,331,5,1
453215,2,0,2,11,1
453215,208,84,124,12,3
453215,65,28,37,19,1
453215,451,157,294,20,1
453215,112,57,55,21,4
453215,58,32,26,22,1
453215,58,32,26,23,1
453215,3,3,0,24,1
453215,55,29,26,25,1
453215,54,25,29,32,3
453215,9,4,5,39,1
453215,46,25,21,40,1
453215,676,233,443,41,4
453215,522,174,348,42,1
453215,520,174,346,43,1
453215,59,18,41,44,1
453215,461,156,305,45,1
453215,2,0,2,51,1
453215,154,59,95,52,3
453215,56,24,32,59,1
453215,405,132,273,60,1
453297,40,21,19,1,4
453297,40,21,19,2,1
453297,40,21,19,3,1
453297,2,1,1,4,1
453297,38,20,18,5,1
453297,38,20,18,20,1
453297,40,21,19,21,4
453297,40,21,19,22,1
453297,40,21,19,23,1
453297,2,1,1,24,1
453297,38,20,18,25,1
453297,38,20,18,40,1
453455,167,28,139,1,4
453455,167,28,139,2,1
453455,165,28,137,3,1
453455,5,0,5,4,1
453455,160,28,132,5,1
453455,2,0,2,11,1
453455,32,4,28,19,1
453455,128,24,104,20,1
453455,105,15,90,21,4
453455,105,15,90,22,1
453455,105,15,90,23,1
453455,4,0,4,24,1
453455,101,15,86,25,1
453455,27,3,24,39,1
453455,74,12,62,40,1
453455,62,13,49,41,4
453455,62,13,49,42,1
453455,60,13,47,43,1
453455,1,0,1,44,1
453455,59,13,46,45,1
453455,2,0,2,51,1
453455,5,1,4,59,1
453455,54,12,42,60,1
453464,130,31,99,1,4
453464,130,31,99,2,1
453464,129,31,98,3,1
453464,17,4,13,4,1
453464,112,27,85,5,1
453464,1,0,1,11,1
453464,22,6,16,19,1
453464,90,21,69,20,1
453464,98,24,74,21,4
453464,98,24,74,22,1
453464,98,24,74,23,1
453464,15,3,12,24,1
453464,83,21,62,25,1
453464,17,4,13,39,1
453464,66,17,49,40,1
453464,32,7,25,41,4
453464,32,7,25,42,1
453464,31,7,24,43,1
453464,2,1,1,44,1
453464,29,6,23,45,1
453464,1,0,1,51,1
453464,5,2,3,59,1
453464,24,4,20,60,1
453473,137,30,107,1,4
453473,137,30,107,2,1
453473,137,30,107,3,1
453473,13,3,10,4,1
453473,124,27,97,5,1
453473,23,3,20,19,1
453473,101,24,77,20,1
453473,77,15,62,21,4
453473,77,15,62,22,1
453473,77,15,62,23,1
453473,12,3,9,24,1
453473,65,12,53,25,1
453473,16,2,14,39,1
453473,49,10,39,40,1
453473,60,15,45,41,4
453473,60,15,45,42,1
453473,60,15,45,43,1
453473,1,0,1,44,1
453473,59,15,44,45,1
453473,7,1,6,59,1
453473,52,14,38,60,1
453482,82,17,65,1,4
453482,82,17,65,2,1
453482,82,17,65,3,1
453482,6,2,4,4,1
453482,76,15,61,5,1
453482,13,2,11,19,1
453482,63,13,50,20,1
453482,56,11,45,21,4
453482,56,11,45,22,1
453482,56,11,45,23,1
453482,4,1,3,24,1
453482,52,10,42,25,1
453482,11,2,9,39,1
453482,41,8,33,40,1
453482,26,6,20,41,4
453482,26,6,20,42,1
453482,26,6,20,43,1
453482,2,1,1,44,1
453482,24,5,19,45,1
453482,2,0,2,59,1
453482,22,5,17,60,1
453552,352,63,289,1,4
453552,352,63,289,2,1
453552,352,63,289,3,1
453552,299,54,245,4,1
453552,53,9,44,5,1
453552,53,9,44,20,1
453552,239,49,190,21,4
453552,239,49,190,22,1
453552,239,49,190,23,1
453552,203,41,162,24,1
453552,36,8,28,25,1
453552,36,8,28,40,1
453552,113,14,99,41,4
453552,113,14,99,42,1
453552,113,14,99,43,1
453552,96,13,83,44,1
453552,17,1,16,45,1
453552,17,1,16,60,1
453570,50,1,49,1,4
453570,50,1,49,2,1
453570,50,1,49,3,1
453570,18,0,18,4,1
453570,32,1,31,5,1
453570,32,1,31,20,1
453570,50,1,49,21,4
453570,50,1,49,22,1
453570,50,1,49,23,1
453570,18,0,18,24,1
453570,32,1,31,25,1
453570,32,1,31,40,1
453747,165,28,137,1,4
453747,165,28,137,2,1
453747,165,28,137,3,1
453747,39,6,33,4,1
453747,126,22,104,5,1
453747,62,10,52,19,1
453747,64,12,52,20,1
453747,126,17,109,21,4
453747,126,17,109,22,1
453747,126,17,109,23,1
453747,36,5,31,24,1
453747,90,12,78,25,1
453747,55,6,49,39,1
453747,35,6,29,40,1
453747,39,11,28,41,4
453747,39,11,28,42,1
453747,39,11,28,43,1
453747,3,1,2,44,1
453747,36,10,26,45,1
453747,7,4,3,59,1
453747,29,6,23,60,1
453756,102,62,40,1,4
453756,102,62,40,2,1
453756,102,62,40,3,1
453756,65,42,23,4,1
453756,37,20,17,5,1
453756,37,20,17,20,1
453756,102,62,40,21,4
453756,102,62,40,22,1
453756,102,62,40,23,1
453756,65,42,23,24,1
453756,37,20,17,25,1
453756,37,20,17,40,1
453817,267,257,10,1,4
453817,267,257,10,2,1
453817,267,257,10,3,1
453817,68,65,3,4,1
453817,199,192,7,5,1
453817,199,192,7,20,1
453817,267,257,10,21,4
453817,267,257,10,22,1
453817,267,257,10,23,1
453817,68,65,3,24,1
453817,199,192,7,25,1
453817,199,192,7,40,1
454078,40,23,17,1,4
454078,40,23,17,2,1
454078,40,23,17,3,1
454078,17,12,5,4,1
454078,23,11,12,5,1
454078,23,11,12,20,1
454078,40,23,17,21,4
454078,40,23,17,22,1
454078,40,23,17,23,1
454078,17,12,5,24,1
454078,23,11,12,25,1
454078,23,11,12,40,1
454175,607,101,506,1,4
454175,607,101,506,2,1
454175,607,101,506,3,1
454175,134,32,102,4,1
454175,473,69,404,5,1
454175,1,0,1,19,1
454175,472,69,403,20,1
454175,607,101,506,21,4
454175,607,101,506,22,1
454175,607,101,506,23,1
454175,134,32,102,24,1
454175,473,69,404,25,1
454175,1,0,1,39,1
454175,472,69,403,40,1
454184,516,206,310,1,4
454184,516,206,310,2,1
454184,504,203,301,3,1
454184,127,42,85,4,1
454184,377,161,216,5,1
454184,12,3,9,11,1
454184,12,9,3,19,1
454184,365,152,213,20,1
454184,493,196,297,21,4
454184,493,196,297,22,1
454184,490,195,295,23,1
454184,125,42,83,24,1
454184,365,153,212,25,1
454184,3,1,2,31,1
454184,12,9,3,39,1
454184,353,144,209,40,1
454184,23,10,13,41,4
454184,23,10,13,42,1
454184,14,8,6,43,1
454184,2,0,2,44,1
454184,12,8,4,45,1
454184,9,2,7,51,1
454184,12,8,4,60,1
454227,13720,1120,12600,1,4
454227,10783,927,9856,2,1
454227,10778,927,9851,3,1
454227,13,3,10,4,1
454227,10765,924,9841,5,1
454227,5,0,5,11,1
454227,2937,193,2744,12,3
454227,5083,423,4660,19,1
454227,5682,501,5181,20,1
454227,2489,274,2215,21,4
454227,2334,256,2078,22,1
454227,2334,256,2078,23,1
454227,13,3,10,24,1
454227,2321,253,2068,25,1
454227,155,18,137,32,3
454227,1433,147,1286,39,1
454227,888,106,782,40,1
454227,11231,846,10385,41,4
454227,8449,671,7778,42,1
454227,8444,671,7773,43,1
454227,8444,671,7773,45,1
454227,5,0,5,51,1
454227,2782,175,2607,52,3
454227,3650,276,3374,59,1
454227,4794,395,4399,60,1
454236,667,105,562,1,4
454236,667,105,562,2,1
454236,666,105,561,3,1
454236,13,3,10,4,1
454236,653,102,551,5,1
454236,1,0,1,11,1
454236,267,37,230,19,1
454236,386,65,321,20,1
454236,346,52,294,21,4
454236,346,52,294,22,1
454236,346,52,294,23,1
454236,13,3,10,24,1
454236,333,49,284,25,1
454236,171,24,147,39,1
454236,162,25,137,40,1
454236,321,53,268,41,4
454236,321,53,268,42,1
454236,320,53,267,43,1
454236,320,53,267,45,1
454236,1,0,1,51,1
454236,96,13,83,59,1
454236,224,40,184,60,1
454245,515,72,443,1,4
454245,515,72,443,2,1
454245,515,72,443,3,1
454245,6,1,5,4,1
454245,509,71,438,5,1
454245,185,29,156,19,1
454245,324,42,282,20,1
454245,307,43,264,21,4
454245,307,43,264,22,1
454245,307,43,264,23,1
454245,5,1,4,24,1
454245,302,42,260,25,1
454245,131,21,110,39,1
454245,171,21,150,40,1
454245,208,29,179,41,4
454245,208,29,179,42,1
454245,208,29,179,43,1
454245,1,0,1,44,1
454245,207,29,178,45,1
454245,54,8,46,59,1
454245,153,21,132,60,1
454306,329,62,267,1,4
454306,329,62,267,2,1
454306,329,62,267,3,1
454306,117,22,95,4,1
454306,212,40,172,5,1
454306,212,40,172,20,1
454306,329,62,267,21,4
454306,329,62,267,22,1
454306,329,62,267,23,1
454306,117,22,95,24,1
454306,212,40,172,25,1
454306,212,40,172,40,1
454315,89,1,88,1,4
454315,89,1,88,2,1
454315,89,1,88,3,1
454315,30,1,29,4,1
454315,59,0,59,5,1
454315,59,0,59,20,1
454315,68,1,67,21,4
454315,68,1,67,22,1
454315,68,1,67,23,1
454315,24,1,23,24,1
454315,44,0,44,25,1
454315,44,0,44,40,1
454315,21,0,21,41,4
454315,21,0,21,42,1
454315,21,0,21,43,1
454315,6,0,6,44,1
454315,15,0,15,45,1
454315,15,0,15,60,1
454324,70,0,70,1,4
454324,70,0,70,2,1
454324,70,0,70,3,1
454324,25,0,25,4,1
454324,45,0,45,5,1
454324,45,0,45,20,1
454324,53,0,53,21,4
454324,53,0,53,22,1
454324,53,0,53,23,1
454324,20,0,20,24,1
454324,33,0,33,25,1
454324,33,0,33,40,1
454324,17,0,17,41,4
454324,17,0,17,42,1
454324,17,0,17,43,1
454324,5,0,5,44,1
454324,12,0,12,45,1
454324,12,0,12,60,1
454333,85,3,82,1,4
454333,85,3,82,2,1
454333,85,3,82,3,1
454333,31,2,29,4,1
454333,54,1,53,5,1
454333,54,1,53,20,1
454333,59,2,57,21,4
454333,59,2,57,22,1
454333,59,2,57,23,1
454333,24,1,23,24,1
454333,35,1,34,25,1
454333,35,1,34,40,1
454333,26,1,25,41,4
454333,26,1,25,42,1
454333,26,1,25,43,1
454333,7,1,6,44,1
454333,19,0,19,45,1
454333,19,0,19,60,1
454342,87,2,85,1,4
454342,87,2,85,2,1
454342,87,2,85,3,1
454342,29,0,29,4,1
454342,58,2,56,5,1
454342,58,2,56,20,1
454342,67,2,65,21,4
454342,67,2,65,22,1
454342,67,2,65,23,1
454342,22,0,22,24,1
454342,45,2,43,25,1
454342,45,2,43,40,1
454342,20,0,20,41,4
454342,20,0,20,42,1
454342,20,0,20,43,1
454342,7,0,7,44,1
454342,13,0,13,45,1
454342,13,0,13,60,1
454351,123,3,120,1,4
454351,123,3,120,2,1
454351,123,3,120,3,1
454351,38,1,37,4,1
454351,85,2,83,5,1
454351,85,2,83,20,1
454351,123,3,120,21,4
454351,123,3,120,22,1
454351,123,3,120,23,1
454351,38,1,37,24,1
454351,85,2,83,25,1
454351,85,2,83,40,1
454360,163,6,157,1,4
454360,163,6,157,2,1
454360,163,6,157,3,1
454360,45,1,44,4,1
454360,118,5,113,5,1
454360,118,5,113,20,1
454360,121,5,116,21,4
454360,121,5,116,22,1
454360,121,5,116,23,1
454360,33,1,32,24,1
454360,88,4,84,25,1
454360,88,4,84,40,1
454360,42,1,41,41,4
454360,42,1,41,42,1
454360,42,1,41,43,1
454360,12,0,12,44,1
454360,30,1,29,45,1
454360,30,1,29,60,1
454379,130,9,121,1,4
454379,130,9,121,2,1
454379,130,9,121,3,1
454379,41,5,36,4,1
454379,89,4,85,5,1
454379,89,4,85,20,1
454379,130,9,121,21,4
454379,130,9,121,22,1
454379,130,9,121,23,1
454379,41,5,36,24,1
454379,89,4,85,25,1
454379,89,4,85,40,1
454388,87,8,79,1,4
454388,87,8,79,2,1
454388,87,8,79,3,1
454388,36,1,35,4,1
454388,51,7,44,5,1
454388,51,7,44,20,1
454388,63,7,56,21,4
454388,63,7,56,22,1
454388,63,7,56,23,1
454388,22,1,21,24,1
454388,41,6,35,25,1
454388,41,6,35,40,1
454388,24,1,23,41,4
454388,24,1,23,42,1
454388,24,1,23,43,1
454388,14,0,14,44,1
454388,10,1,9,45,1
454388,10,1,9,60,1
454397,117,4,113,1,4
454397,117,4,113,2,1
454397,117,4,113,3,1
454397,53,2,51,4,1
454397,64,2,62,5,1
454397,64,2,62,20,1
454397,81,2,79,21,4
454397,81,2,79,22,1
454397,81,2,79,23,1
454397,37,1,36,24,1
454397,44,1,43,25,1
454397,44,1,43,40,1
454397,36,2,34,41,4
454397,36,2,34,42,1
454397,36,2,34,43,1
454397,16,1,15,44,1
454397,20,1,19,45,1
454397,20,1,19,60,1
454458,84,26,58,1,4
454458,84,26,58,2,1
454458,84,26,58,3,1
454458,15,3,12,4,1
454458,69,23,46,5,1
454458,69,23,46,20,1
454458,84,26,58,21,4
454458,84,26,58,22,1
454458,84,26,58,23,1
454458,15,3,12,24,1
454458,69,23,46,25,1
454458,69,23,46,40,1
454467,95,7,88,1,4
454467,95,7,88,2,1
454467,95,7,88,3,1
454467,29,2,27,4,1
454467,66,5,61,5,1
454467,66,5,61,20,1
454467,72,5,67,21,4
454467,72,5,67,22,1
454467,72,5,67,23,1
454467,25,2,23,24,1
454467,47,3,44,25,1
454467,47,3,44,40,1
454467,23,2,21,41,4
454467,23,2,21,42,1
454467,23,2,21,43,1
454467,4,0,4,44,1
454467,19,2,17,45,1
454467,19,2,17,60,1
454476,61,2,59,1,4
454476,61,2,59,2,1
454476,61,2,59,3,1
454476,18,0,18,4,1
454476,43,2,41,5,1
454476,43,2,41,20,1
454476,37,1,36,21,4
454476,37,1,36,22,1
454476,37,1,36,23,1
454476,12,0,12,24,1
454476,25,1,24,25,1
454476,25,1,24,40,1
454476,24,1,23,41,4
454476,24,1,23,42,1
454476,24,1,23,43,1
454476,6,0,6,44,1
454476,18,1,17,45,1
454476,18,1,17,60,1
454485,28,1,27,1,4
454485,28,1,27,2,1
454485,28,1,27,3,1
454485,10,0,10,4,1
454485,18,1,17,5,1
454485,18,1,17,20,1
454485,28,1,27,21,4
454485,28,1,27,22,1
454485,28,1,27,23,1
454485,10,0,10,24,1
454485,18,1,17,25,1
454485,18,1,17,40,1
454494,62,5,57,1,4
454494,62,5,57,2,1
454494,62,5,57,3,1
454494,20,1,19,4,1
454494,42,4,38,5,1
454494,42,4,38,20,1
454494,62,5,57,21,4
454494,62,5,57,22,1
454494,62,5,57,23,1
454494,20,1,19,24,1
454494,42,4,38,25,1
454494,42,4,38,40,1
454500,96,6,90,1,4
454500,96,6,90,2,1
454500,96,6,90,3,1
454500,33,2,31,4,1
454500,63,4,59,5,1
454500,63,4,59,20,1
454500,67,4,63,21,4
454500,67,4,63,22,1
454500,67,4,63,23,1
454500,24,2,22,24,1
454500,43,2,41,25,1
454500,43,2,41,40,1
454500,29,2,27,41,4
454500,29,2,27,42,1
454500,29,2,27,43,1
454500,9,0,9,44,1
454500,20,2,18,45,1
454500,20,2,18,60,1
454519,92,2,90,1,4
454519,92,2,90,2,1
454519,92,2,90,3,1
454519,37,1,36,4,1
454519,55,1,54,5,1
454519,55,1,54,20,1
454519,63,1,62,21,4
454519,63,1,62,22,1
454519,63,1,62,23,1
454519,22,1,21,24,1
454519,41,0,41,25,1
454519,41,0,41,40,1
454519,29,1,28,41,4
454519,29,1,28,42,1
454519,29,1,28,43,1
454519,15,0,15,44,1
454519,14,1,13,45,1
454519,14,1,13,60,1
454528,66,3,63,1,4
454528,66,3,63,2,1
454528,66,3,63,3,1
454528,22,1,21,4,1
454528,44,2,42,5,1
454528,44,2,42,20,1
454528,45,3,42,21,4
454528,45,3,42,22,1
454528,45,3,42,23,1
454528,17,1,16,24,1
454528,28,2,26,25,1
454528,28,2,26,40,1
454528,21,0,21,41,4
454528,21,0,21,42,1
454528,21,0,21,43,1
454528,5,0,5,44,1
454528,16,0,16,45,1
454528,16,0,16,60,1
454537,61,3,58,1,4
454537,61,3,58,2,1
454537,61,3,58,3,1
454537,57,3,54,4,1
454537,4,0,4,5,1
454537,4,0,4,20,1
454537,61,3,58,21,4
454537,61,3,58,22,1
454537,61,3,58,23,1
454537,57,3,54,24,1
454537,4,0,4,25,1
454537,4,0,4,40,1
454546,98,3,95,1,4
454546,98,3,95,2,1
454546,98,3,95,3,1
454546,25,1,24,4,1
454546,73,2,71,5,1
454546,73,2,71,20,1
454546,98,3,95,21,4
454546,98,3,95,22,1
454546,98,3,95,23,1
454546,25,1,24,24,1
454546,73,2,71,25,1
454546,73,2,71,40,1
454555,224,12,212,1,4
454555,224,12,212,2,1
454555,224,12,212,3,1
454555,56,10,46,4,1
454555,168,2,166,5,1
454555,168,2,166,20,1
454555,224,12,212,21,4
454555,224,12,212,22,1
454555,224,12,212,23,1
454555,56,10,46,24,1
454555,168,2,166,25,1
454555,168,2,166,40,1
454573,276,6,270,1,4
454573,276,6,270,2,1
454573,276,6,270,3,1
454573,88,1,87,4,1
454573,188,5,183,5,1
454573,188,5,183,20,1
454573,276,6,270,21,4
454573,276,6,270,22,1
454573,276,6,270,23,1
454573,88,1,87,24,1
454573,188,5,183,25,1
454573,188,5,183,40,1
454582,458,179,279,1,4
454582,383,149,234,2,1
454582,379,145,234,3,1
454582,379,145,234,5,1
454582,4,4,0,11,1
454582,75,30,45,12,3
454582,70,30,40,19,1
454582,309,115,194,20,1
454582,1,1,0,21,4
454582,1,1,0,22,1
454582,1,1,0,23,1
454582,1,1,0,25,1
454582,1,1,0,40,1
454582,457,178,279,41,4
454582,382,148,234,42,1
454582,378,144,234,43,1
454582,378,144,234,45,1
454582,4,4,0,51,1
454582,75,30,45,52,3
454582,70,30,40,59,1
454582,308,114,194,60,1
454591,124,36,88,1,4
454591,124,36,88,2,1
454591,118,35,83,3,1
454591,25,8,17,4,1
454591,93,27,66,5,1
454591,6,1,5,11,1
454591,14,6,8,19,1
454591,79,21,58,20,1
454591,82,24,58,21,4
454591,82,24,58,22,1
454591,79,23,56,23,1
454591,21,5,16,24,1
454591,58,18,40,25,1
454591,3,1,2,31,1
454591,13,6,7,39,1
454591,45,12,33,40,1
454591,42,12,30,41,4
454591,42,12,30,42,1
454591,39,12,27,43,1
454591,4,3,1,44,1
454591,35,9,26,45,1
454591,3,0,3,51,1
454591,1,0,1,59,1
454591,34,9,25,60,1
454607,211,13,198,1,4
454607,211,13,198,2,1
454607,211,13,198,3,1
454607,30,0,30,4,1
454607,181,13,168,5,1
454607,181,13,168,20,1
454607,211,13,198,21,4
454607,211,13,198,22,1
454607,211,13,198,23,1
454607,30,0,30,24,1
454607,181,13,168,25,1
454607,181,13,168,40,1
454616,242,217,25,1,4
454616,242,217,25,2,1
454616,233,208,25,3,1
454616,45,39,6,4,1
454616,188,169,19,5,1
454616,9,9,0,11,1
454616,36,34,2,19,1
454616,152,135,17,20,1
454616,153,138,15,21,4
454616,153,138,15,22,1
454616,151,136,15,23,1
454616,33,29,4,24,1
454616,118,107,11,25,1
454616,2,2,0,31,1
454616,27,26,1,39,1
454616,91,81,10,40,1
454616,89,79,10,41,4
454616,89,79,10,42,1
454616,82,72,10,43,1
454616,12,10,2,44,1
454616,70,62,8,45,1
454616,7,7,0,51,1
454616,9,8,1,59,1
454616,61,54,7,60,1
454625,460,59,401,1,4
454625,460,59,401,2,1
454625,460,59,401,3,1
454625,243,31,212,4,1
454625,217,28,189,5,1
454625,217,28,189,20,1
454625,307,47,260,21,4
454625,307,47,260,22,1
454625,307,47,260,23,1
454625,186,27,159,24,1
454625,121,20,101,25,1
454625,121,20,101,40,1
454625,153,12,141,41,4
454625,153,12,141,42,1
454625,153,12,141,43,1
454625,57,4,53,44,1
454625,96,8,88,45,1
454625,96,8,88,60,1
454652,162,9,153,1,4
454652,162,9,153,2,1
454652,162,9,153,3,1
454652,20,0,20,4,1
454652,142,9,133,5,1
454652,142,9,133,20,1
454652,162,9,153,21,4
454652,162,9,153,22,1
454652,162,9,153,23,1
454652,20,0,20,24,1
454652,142,9,133,25,1
454652,142,9,133,40,1
454689,785,441,344,1,4
454689,4,0,4,2,1
454689,4,0,4,3,1
454689,2,0,2,4,1
454689,2,0,2,5,1
454689,781,441,340,12,3
454689,2,0,2,20,1
454689,720,405,315,21,4
454689,4,0,4,22,1
454689,4,0,4,23,1
454689,2,0,2,24,1
454689,2,0,2,25,1
454689,716,405,311,32,3
454689,2,0,2,40,1
454689,65,36,29,41,4
454689,65,36,29,52,3
454698,329,161,168,1,4
454698,329,161,168,2,1
454698,329,161,168,3,1
454698,229,118,111,4,1
454698,100,43,57,5,1
454698,100,43,57,20,1
454698,329,161,168,21,4
454698,329,161,168,22,1
454698,329,161,168,23,1
454698,229,118,111,24,1
454698,100,43,57,25,1
454698,100,43,57,40,1
454704,33,32,1,1,4
454704,33,32,1,2,1
454704,33,32,1,3,1
454704,17,16,1,4,1
454704,16,16,0,5,1
454704,16,16,0,20,1
454704,33,32,1,21,4
454704,33,32,1,22,1
454704,33,32,1,23,1
454704,17,16,1,24,1
454704,16,16,0,25,1
454704,16,16,0,40,1
454722,23,1,22,1,4
454722,23,1,22,2,1
454722,23,1,22,3,1
454722,7,0,7,4,1
454722,16,1,15,5,1
454722,16,1,15,20,1
454722,19,0,19,21,4
454722,19,0,19,22,1
454722,19,0,19,23,1
454722,6,0,6,24,1
454722,13,0,13,25,1
454722,13,0,13,40,1
454722,4,1,3,41,4
454722,4,1,3,42,1
454722,4,1,3,43,1
454722,1,0,1,44,1
454722,3,1,2,45,1
454722,3,1,2,60,1
454731,123,44,79,1,4
454731,123,44,79,2,1
454731,123,44,79,3,1
454731,51,18,33,4,1
454731,72,26,46,5,1
454731,72,26,46,20,1
454731,123,44,79,21,4
454731,123,44,79,22,1
454731,123,44,79,23,1
454731,51,18,33,24,1
454731,72,26,46,25,1
454731,72,26,46,40,1
454740,215,64,151,1,4
454740,215,64,151,2,1
454740,165,45,120,3,1
454740,8,3,5,4,1
454740,157,42,115,5,1
454740,50,19,31,11,1
454740,11,3,8,19,1
454740,146,39,107,20,1
454740,46,14,32,21,4
454740,46,14,32,22,1
454740,39,11,28,23,1
454740,4,2,2,24,1
454740,35,9,26,25,1
454740,7,3,4,31,1
454740,6,3,3,39,1
454740,29,6,23,40,1
454740,169,50,119,41,4
454740,169,50,119,42,1
454740,126,34,92,43,1
454740,4,1,3,44,1
454740,122,33,89,45,1
454740,43,16,27,51,1
454740,5,0,5,59,1
454740,117,33,84,60,1
454759,23,20,3,1,4
454759,23,20,3,2,1
454759,23,20,3,3,1
454759,23,20,3,5,1
454759,23,20,3,20,1
454759,4,2,2,21,4
454759,4,2,2,22,1
454759,4,2,2,23,1
454759,4,2,2,25,1
454759,4,2,2,40,1
454759,19,18,1,41,4
454759,19,18,1,42,1
454759,19,18,1,43,1
454759,19,18,1,45,1
454759,19,18,1,60,1
454768,174,11,163,1,4
454768,174,11,163,2,1
454768,174,11,163,3,1
454768,15,2,13,4,1
454768,159,9,150,5,1
454768,159,9,150,20,1
454768,120,6,114,21,4
454768,120,6,114,22,1
454768,120,6,114,23,1
454768,11,1,10,24,1
454768,109,5,104,25,1
454768,109,5,104,40,1
454768,54,5,49,41,4
454768,54,5,49,42,1
454768,54,5,49,43,1
454768,4,1,3,44,1
454768,50,4,46,45,1
454768,50,4,46,60,1
454777,204,22,182,1,4
454777,204,22,182,2,1
454777,204,22,182,3,1
454777,18,1,17,4,1
454777,186,21,165,5,1
454777,186,21,165,20,1
454777,154,16,138,21,4
454777,154,16,138,22,1
454777,154,16,138,23,1
454777,14,1,13,24,1
454777,140,15,125,25,1
454777,140,15,125,40,1
454777,50,6,44,41,4
454777,50,6,44,42,1
454777,50,6,44,43,1
454777,4,0,4,44,1
454777,46,6,40,45,1
454777,46,6,40,60,1
454786,856,358,498,1,4
454786,856,358,498,2,1
454786,856,358,498,3,1
454786,378,162,216,4,1
454786,478,196,282,5,1
454786,478,196,282,20,1
454786,70,28,42,21,4
454786,70,28,42,22,1
454786,70,28,42,23,1
454786,23,8,15,24,1
454786,47,20,27,25,1
454786,47,20,27,40,1
454786,786,330,456,41,4
454786,786,330,456,42,1
454786,786,330,456,43,1
454786,355,154,201,44,1
454786,431,176,255,45,1
454786,431,176,255,60,1
454795,228,51,177,1,4
454795,228,51,177,2,1
454795,228,51,177,3,1
454795,55,17,38,4,1
454795,173,34,139,5,1
454795,173,34,139,20,1
454795,117,26,91,21,4
454795,117,26,91,22,1
454795,117,26,91,23,1
454795,31,11,20,24,1
454795,86,15,71,25,1
454795,86,15,71,40,1
454795,111,25,86,41,4
454795,111,25,86,42,1
454795,111,25,86,43,1
454795,24,6,18,44,1
454795,87,19,68,45,1
454795,87,19,68,60,1
454801,69,8,61,1,4
454801,69,8,61,2,1
454801,69,8,61,3,1
454801,30,5,25,4,1
454801,39,3,36,5,1
454801,39,3,36,20,1
454801,32,5,27,21,4
454801,32,5,27,22,1
454801,32,5,27,23,1
454801,30,5,25,24,1
454801,2,0,2,25,1
454801,2,0,2,40,1
454801,37,3,34,41,4
454801,37,3,34,42,1
454801,37,3,34,43,1
454801,37,3,34,45,1
454801,37,3,34,60,1
454810,351,182,169,1,4
454810,351,182,169,2,1
454810,351,182,169,3,1
454810,111,54,57,4,1
454810,240,128,112,5,1
454810,240,128,112,20,1
454810,351,182,169,21,4
454810,351,182,169,22,1
454810,351,182,169,23,1
454810,111,54,57,24,1
454810,240,128,112,25,1
454810,240,128,112,40,1
454829,633,195,438,1,4
454829,162,75,87,2,1
454829,162,75,87,3,1
454829,34,14,20,4,1
454829,128,61,67,5,1
454829,471,120,351,12,3
454829,128,61,67,20,1
454829,275,93,182,21,4
454829,72,36,36,22,1
454829,72,36,36,23,1
454829,15,5,10,24,1
454829,57,31,26,25,1
454829,203,57,146,32,3
454829,57,31,26,40,1
454829,358,102,256,41,4
454829,90,39,51,42,1
454829,90,39,51,43,1
454829,19,9,10,44,1
454829,71,30,41,45,1
454829,268,63,205,52,3
454829,71,30,41,60,1
454838,43,11,32,1,4
454838,43,11,32,12,3
454838,43,11,32,21,4
454838,43,11,32,32,3
454847,63,10,53,1,4
454847,63,10,53,2,1
454847,63,10,53,3,1
454847,57,8,49,4,1
454847,6,2,4,5,1
454847,6,2,4,20,1
454847,63,10,53,21,4
454847,63,10,53,22,1
454847,63,10,53,23,1
454847,57,8,49,24,1
454847,6,2,4,25,1
454847,6,2,4,40,1
454856,696,90,606,1,4
454856,696,90,606,2,1
454856,696,90,606,3,1
454856,696,90,606,5,1
454856,115,16,99,19,1
454856,581,74,507,20,1
454856,696,90,606,21,4
454856,696,90,606,22,1
454856,696,90,606,23,1
454856,696,90,606,25,1
454856,115,16,99,39,1
454856,581,74,507,40,1
454865,204,35,169,1,4
454865,204,35,169,2,1
454865,204,35,169,3,1
454865,46,4,42,4,1
454865,158,31,127,5,1
454865,158,31,127,20,1
454865,198,33,165,21,4
454865,198,33,165,22,1
454865,198,33,165,23,1
454865,41,3,38,24,1
454865,157,30,127,25,1
454865,157,30,127,40,1
454865,6,2,4,41,4
454865,6,2,4,42,1
454865,6,2,4,43,1
454865,5,1,4,44,1
454865,1,1,0,45,1
454865,1,1,0,60,1
454874,55,4,51,1,4
454874,55,4,51,2,1
454874,55,4,51,3,1
454874,22,2,20,4,1
454874,33,2,31,5,1
454874,33,2,31,20,1
454874,44,4,40,21,4
454874,44,4,40,22,1
454874,44,4,40,23,1
454874,19,2,17,24,1
454874,25,2,23,25,1
454874,25,2,23,40,1
454874,11,0,11,41,4
454874,11,0,11,42,1
454874,11,0,11,43,1
454874,3,0,3,44,1
454874,8,0,8,45,1
454874,8,0,8,60,1
454883,632,30,602,1,4
454883,632,30,602,2,1
454883,632,30,602,3,1
454883,78,3,75,4,1
454883,554,27,527,5,1
454883,144,6,138,19,1
454883,410,21,389,20,1
454883,632,30,602,21,4
454883,632,30,602,22,1
454883,632,30,602,23,1
454883,78,3,75,24,1
454883,554,27,527,25,1
454883,144,6,138,39,1
454883,410,21,389,40,1
454892,32,0,32,1,4
454892,32,0,32,2,1
454892,32,0,32,3,1
454892,17,0,17,4,1
454892,15,0,15,5,1
454892,15,0,15,20,1
454892,19,0,19,21,4
454892,19,0,19,22,1
454892,19,0,19,23,1
454892,11,0,11,24,1
454892,8,0,8,25,1
454892,8,0,8,40,1
454892,13,0,13,41,4
454892,13,0,13,42,1
454892,13,0,13,43,1
454892,6,0,6,44,1
454892,7,0,7,45,1
454892,7,0,7,60,1
454908,38,20,18,1,4
454908,38,20,18,2,1
454908,38,20,18,3,1
454908,8,5,3,4,1
454908,30,15,15,5,1
454908,30,15,15,20,1
454908,38,20,18,21,4
454908,38,20,18,22,1
454908,38,20,18,23,1
454908,8,5,3,24,1
454908,30,15,15,25,1
454908,30,15,15,40,1
454917,198,25,173,1,4
454917,198,25,173,2,1
454917,198,25,173,3,1
454917,191,25,166,4,1
454917,7,0,7,5,1
454917,7,0,7,20,1
454917,167,23,144,21,4
454917,167,23,144,22,1
454917,167,23,144,23,1
454917,161,23,138,24,1
454917,6,0,6,25,1
454917,6,0,6,40,1
454917,31,2,29,41,4
454917,31,2,29,42,1
454917,31,2,29,43,1
454917,30,2,28,44,1
454917,1,0,1,45,1
454917,1,0,1,60,1
454926,225,17,208,1,4
454926,225,17,208,2,1
454926,225,17,208,3,1
454926,42,1,41,4,1
454926,183,16,167,5,1
454926,183,16,167,20,1
454926,225,17,208,21,4
454926,225,17,208,22,1
454926,225,17,208,23,1
454926,42,1,41,24,1
454926,183,16,167,25,1
454926,183,16,167,40,1
454935,67,0,67,1,4
454935,67,0,67,2,1
454935,67,0,67,3,1
454935,56,0,56,4,1
454935,11,0,11,5,1
454935,11,0,11,20,1
454935,67,0,67,21,4
454935,67,0,67,22,1
454935,67,0,67,23,1
454935,56,0,56,24,1
454935,11,0,11,25,1
454935,11,0,11,40,1
454944,139,6,133,1,4
454944,139,6,133,2,1
454944,139,6,133,3,1
454944,26,0,26,4,1
454944,113,6,107,5,1
454944,113,6,107,20,1
454944,120,6,114,21,4
454944,120,6,114,22,1
454944,120,6,114,23,1
454944,23,0,23,24,1
454944,97,6,91,25,1
454944,97,6,91,40,1
454944,19,0,19,41,4
454944,19,0,19,42,1
454944,19,0,19,43,1
454944,3,0,3,44,1
454944,16,0,16,45,1
454944,16,0,16,60,1
454953,33,0,33,1,4
454953,33,0,33,2,1
454953,33,0,33,3,1
454953,4,0,4,4,1
454953,29,0,29,5,1
454953,29,0,29,20,1
454953,19,0,19,21,4
454953,19,0,19,22,1
454953,19,0,19,23,1
454953,2,0,2,24,1
454953,17,0,17,25,1
454953,17,0,17,40,1
454953,14,0,14,41,4
454953,14,0,14,42,1
454953,14,0,14,43,1
454953,2,0,2,44,1
454953,12,0,12,45,1
454953,12,0,12,60,1
454962,31,0,31,1,4
454962,31,0,31,2,1
454962,31,0,31,3,1
454962,17,0,17,4,1
454962,14,0,14,5,1
454962,14,0,14,20,1
454962,25,0,25,21,4
454962,25,0,25,22,1
454962,25,0,25,23,1
454962,16,0,16,24,1
454962,9,0,9,25,1
454962,9,0,9,40,1
454962,6,0,6,41,4
454962,6,0,6,42,1
454962,6,0,6,43,1
454962,1,0,1,44,1
454962,5,0,5,45,1
454962,5,0,5,60,1
454971,177,5,172,1,4
454971,177,5,172,2,1
454971,177,5,172,3,1
454971,25,1,24,4,1
454971,152,4,148,5,1
454971,152,4,148,20,1
454971,101,2,99,21,4
454971,101,2,99,22,1
454971,101,2,99,23,1
454971,20,0,20,24,1
454971,81,2,79,25,1
454971,81,2,79,40,1
454971,76,3,73,41,4
454971,76,3,73,42,1
454971,76,3,73,43,1
454971,5,1,4,44,1
454971,71,2,69,45,1
454971,71,2,69,60,1
454980,133,3,130,1,4
454980,133,3,130,2,1
454980,133,3,130,3,1
454980,15,2,13,4,1
454980,118,1,117,5,1
454980,118,1,117,20,1
454980,83,1,82,21,4
454980,83,1,82,22,1
454980,83,1,82,23,1
454980,10,1,9,24,1
454980,73,0,73,25,1
454980,73,0,73,40,1
454980,50,2,48,41,4
454980,50,2,48,42,1
454980,50,2,48,43,1
454980,5,1,4,44,1
454980,45,1,44,45,1
454980,45,1,44,60,1
454999,114,2,112,1,4
454999,114,2,112,2,1
454999,114,2,112,3,1
454999,11,0,11,4,1
454999,103,2,101,5,1
454999,103,2,101,20,1
454999,85,2,83,21,4
454999,85,2,83,22,1
454999,85,2,83,23,1
454999,10,0,10,24,1
454999,75,2,73,25,1
454999,75,2,73,40,1
454999,29,0,29,41,4
454999,29,0,29,42,1
454999,29,0,29,43,1
454999,1,0,1,44,1
454999,28,0,28,45,1
454999,28,0,28,60,1
455008,139,2,137,1,4
455008,139,2,137,2,1
455008,139,2,137,3,1
455008,26,0,26,4,1
455008,113,2,111,5,1
455008,113,2,111,20,1
455008,94,1,93,21,4
455008,94,1,93,22,1
455008,94,1,93,23,1
455008,25,0,25,24,1
455008,69,1,68,25,1
455008,69,1,68,40,1
455008,45,1,44,41,4
455008,45,1,44,42,1
455008,45,1,44,43,1
455008,1,0,1,44,1
455008,44,1,43,45,1
455008,44,1,43,60,1
455017,35,2,33,1,4
455017,35,2,33,2,1
455017,35,2,33,3,1
455017,9,0,9,4,1
455017,26,2,24,5,1
455017,26,2,24,20,1
455017,22,1,21,21,4
455017,22,1,21,22,1
455017,22,1,21,23,1
455017,6,0,6,24,1
455017,16,1,15,25,1
455017,16,1,15,40,1
455017,13,1,12,41,4
455017,13,1,12,42,1
455017,13,1,12,43,1
455017,3,0,3,44,1
455017,10,1,9,45,1
455017,10,1,9,60,1
455026,96,88,8,1,4
455026,96,88,8,2,1
455026,96,88,8,3,1
455026,19,16,3,4,1
455026,77,72,5,5,1
455026,77,72,5,20,1
455026,96,88,8,41,4
455026,96,88,8,42,1
455026,96,88,8,43,1
455026,19,16,3,44,1
455026,77,72,5,45,1
455026,77,72,5,60,1
455035,17,9,8,1,4
455035,17,9,8,2,1
455035,17,9,8,3,1
455035,10,6,4,4,1
455035,7,3,4,5,1
455035,7,3,4,20,1
455035,17,9,8,21,4
455035,17,9,8,22,1
455035,17,9,8,23,1
455035,10,6,4,24,1
455035,7,3,4,25,1
455035,7,3,4,40,1
455053,47,11,36,1,4
455053,47,11,36,2,1
455053,47,11,36,3,1
455053,20,6,14,4,1
455053,27,5,22,5,1
455053,27,5,22,20,1
455053,6,1,5,21,4
455053,6,1,5,22,1
455053,6,1,5,23,1
455053,4,1,3,24,1
455053,2,0,2,25,1
455053,2,0,2,40,1
455053,41,10,31,41,4
455053,41,10,31,42,1
455053,41,10,31,43,1
455053,16,5,11,44,1
455053,25,5,20,45,1
455053,25,5,20,60,1
455062,73,4,69,1,4
455062,73,4,69,2,1
455062,73,4,69,3,1
455062,9,0,9,4,1
455062,64,4,60,5,1
455062,64,4,60,20,1
455062,27,2,25,21,4
455062,27,2,25,22,1
455062,27,2,25,23,1
455062,4,0,4,24,1
455062,23,2,21,25,1
455062,23,2,21,40,1
455062,46,2,44,41,4
455062,46,2,44,42,1
455062,46,2,44,43,1
455062,5,0,5,44,1
455062,41,2,39,45,1
455062,41,2,39,60,1
455071,119,27,92,1,4
455071,119,27,92,2,1
455071,119,27,92,3,1
455071,41,15,26,4,1
455071,78,12,66,5,1
455071,78,12,66,20,1
455071,119,27,92,41,4
455071,119,27,92,42,1
455071,119,27,92,43,1
455071,41,15,26,44,1
455071,78,12,66,45,1
455071,78,12,66,60,1
455080,97,8,89,1,4
455080,97,8,89,2,1
455080,97,8,89,3,1
455080,63,6,57,4,1
455080,34,2,32,5,1
455080,34,2,32,20,1
455080,75,5,70,21,4
455080,75,5,70,22,1
455080,75,5,70,23,1
455080,50,5,45,24,1
455080,25,0,25,25,1
455080,25,0,25,40,1
455080,22,3,19,41,4
455080,22,3,19,42,1
455080,22,3,19,43,1
455080,13,1,12,44,1
455080,9,2,7,45,1
455080,9,2,7,60,1
455099,68,48,20,1,4
455099,68,48,20,12,3
455099,9,7,2,21,4
455099,9,7,2,32,3
455099,59,41,18,41,4
455099,59,41,18,52,3
455105,58,3,55,1,4
455105,58,3,55,2,1
455105,58,3,55,3,1
455105,12,1,11,4,1
455105,46,2,44,5,1
455105,46,2,44,20,1
455105,58,3,55,21,4
455105,58,3,55,22,1
455105,58,3,55,23,1
455105,12,1,11,24,1
455105,46,2,44,25,1
455105,46,2,44,40,1
455114,9191,3975,5216,1,4
455114,9191,3975,5216,2,1
455114,8164,3479,4685,3,1
455114,1661,818,843,4,1
455114,6503,2661,3842,5,1
455114,1027,496,531,11,1
455114,1089,457,632,19,1
455114,5414,2204,3210,20,1
455114,3933,1853,2080,21,4
455114,3933,1853,2080,22,1
455114,3898,1835,2063,23,1
455114,829,398,431,24,1
455114,3069,1437,1632,25,1
455114,35,18,17,31,1
455114,512,248,264,39,1
455114,2557,1189,1368,40,1
455114,5258,2122,3136,41,4
455114,5258,2122,3136,42,1
455114,4266,1644,2622,43,1
455114,832,420,412,44,1
455114,3434,1224,2210,45,1
455114,992,478,514,51,1
455114,577,209,368,59,1
455114,2857,1015,1842,60,1
455141,156,9,147,1,4
455141,156,9,147,2,1
455141,156,9,147,3,1
455141,69,1,68,4,1
455141,87,8,79,5,1
455141,87,8,79,20,1
455141,156,9,147,21,4
455141,156,9,147,22,1
455141,156,9,147,23,1
455141,69,1,68,24,1
455141,87,8,79,25,1
455141,87,8,79,40,1
455169,1410,591,819,1,4
455169,1410,591,819,12,3
455169,1141,486,655,21,4
455169,1141,486,655,32,3
455169,269,105,164,41,4
455169,269,105,164,52,3
455178,78,22,56,1,4
455178,78,22,56,12,3
455178,75,22,53,21,4
455178,75,22,53,32,3
455178,3,0,3,41,4
455178,3,0,3,52,3
455187,136,0,136,1,4
455187,136,0,136,2,1
455187,136,0,136,3,1
455187,126,0,126,4,1
455187,10,0,10,5,1
455187,10,0,10,20,1
455187,68,0,68,21,4
455187,68,0,68,22,1
455187,68,0,68,23,1
455187,63,0,63,24,1
455187,5,0,5,25,1
455187,5,0,5,40,1
455187,68,0,68,41,4
455187,68,0,68,42,1
455187,68,0,68,43,1
455187,63,0,63,44,1
455187,5,0,5,45,1
455187,5,0,5,60,1
455196,1887,183,1704,1,4
455196,1887,183,1704,2,1
455196,1887,183,1704,3,1
455196,119,16,103,4,1
455196,1768,167,1601,5,1
455196,294,22,272,19,1
455196,1474,145,1329,20,1
455196,1887,183,1704,21,4
455196,1887,183,1704,22,1
455196,1887,183,1704,23,1
455196,119,16,103,24,1
455196,1768,167,1601,25,1
455196,294,22,272,39,1
455196,1474,145,1329,40,1
455202,274,46,228,1,4
455202,274,46,228,2,1
455202,274,46,228,3,1
455202,9,1,8,4,1
455202,265,45,220,5,1
455202,265,45,220,20,1
455202,274,46,228,21,4
455202,274,46,228,22,1
455202,274,46,228,23,1
455202,9,1,8,24,1
455202,265,45,220,25,1
455202,265,45,220,40,1
455211,115,10,105,1,4
455211,115,10,105,2,1
455211,115,10,105,3,1
455211,16,1,15,4,1
455211,99,9,90,5,1
455211,99,9,90,20,1
455211,106,9,97,21,4
455211,106,9,97,22,1
455211,106,9,97,23,1
455211,16,1,15,24,1
455211,90,8,82,25,1
455211,90,8,82,40,1
455211,9,1,8,41,4
455211,9,1,8,42,1
455211,9,1,8,43,1
455211,9,1,8,45,1
455211,9,1,8,60,1
455220,62,1,61,1,4
455220,62,1,61,2,1
455220,62,1,61,3,1
455220,58,1,57,4,1
455220,4,0,4,5,1
455220,4,0,4,20,1
455220,62,1,61,21,4
455220,62,1,61,22,1
455220,62,1,61,23,1
455220,58,1,57,24,1
455220,4,0,4,25,1
455220,4,0,4,40,1
455239,72,0,72,1,4
455239,72,0,72,2,1
455239,72,0,72,3,1
455239,40,0,40,4,1
455239,32,0,32,5,1
455239,32,0,32,20,1
455239,40,0,40,21,4
455239,40,0,40,22,1
455239,40,0,40,23,1
455239,20,0,20,24,1
455239,20,0,20,25,1
455239,20,0,20,40,1
455239,32,0,32,41,4
455239,32,0,32,42,1
455239,32,0,32,43,1
455239,20,0,20,44,1
455239,12,0,12,45,1
455239,12,0,12,60,1
455248,4,0,4,1,4
455248,4,0,4,2,1
455248,4,0,4,3,1
455248,4,0,4,5,1
455248,4,0,4,20,1
455248,4,0,4,21,4
455248,4,0,4,22,1
455248,4,0,4,23,1
455248,4,0,4,25,1
455248,4,0,4,40,1
455257,347,347,0,1,4
455257,347,347,0,2,1
455257,347,347,0,3,1
455257,69,69,0,4,1
455257,278,278,0,5,1
455257,25,25,0,19,1
455257,253,253,0,20,1
455257,347,347,0,21,4
455257,347,347,0,22,1
455257,347,347,0,23,1
455257,69,69,0,24,1
455257,278,278,0,25,1
455257,25,25,0,39,1
455257,253,253,0,40,1
455275,271,12,259,1,4
455275,271,12,259,2,1
455275,271,12,259,3,1
455275,128,5,123,4,1
455275,143,7,136,5,1
455275,143,7,136,20,1
455275,271,12,259,21,4
455275,271,12,259,22,1
455275,271,12,259,23,1
455275,128,5,123,24,1
455275,143,7,136,25,1
455275,143,7,136,40,1
455284,244,10,234,1,4
455284,244,10,234,2,1
455284,244,10,234,3,1
455284,47,0,47,4,1
455284,197,10,187,5,1
455284,197,10,187,20,1
455284,192,9,183,21,4
455284,192,9,183,22,1
455284,192,9,183,23,1
455284,38,0,38,24,1
455284,154,9,145,25,1
455284,154,9,145,40,1
455284,52,1,51,41,4
455284,52,1,51,42,1
455284,52,1,51,43,1
455284,9,0,9,44,1
455284,43,1,42,45,1
455284,43,1,42,60,1
455293,12,1,11,1,4
455293,12,1,11,2,1
455293,12,1,11,3,1
455293,4,0,4,4,1
455293,8,1,7,5,1
455293,8,1,7,20,1
455293,12,1,11,21,4
455293,12,1,11,22,1
455293,12,1,11,23,1
455293,4,0,4,24,1
455293,8,1,7,25,1
455293,8,1,7,40,1
455327,72,21,51,1,4
455327,72,21,51,2,1
455327,72,21,51,3,1
455327,60,21,39,4,1
455327,12,0,12,5,1
455327,12,0,12,20,1
455327,29,7,22,21,4
455327,29,7,22,22,1
455327,29,7,22,23,1
455327,23,7,16,24,1
455327,6,0,6,25,1
455327,6,0,6,40,1
455327,43,14,29,41,4
455327,43,14,29,42,1
455327,43,14,29,43,1
455327,37,14,23,44,1
455327,6,0,6,45,1
455327,6,0,6,60,1
455336,176,158,18,1,4
455336,176,158,18,2,1
455336,176,158,18,3,1
455336,172,155,17,4,1
455336,4,3,1,5,1
455336,4,3,1,20,1
455336,176,158,18,21,4
455336,176,158,18,22,1
455336,176,158,18,23,1
455336,172,155,17,24,1
455336,4,3,1,25,1
455336,4,3,1,40,1
455345,60,12,48,1,4
455345,60,12,48,2,1
455345,60,12,48,3,1
455345,25,7,18,4,1
455345,35,5,30,5,1
455345,35,5,30,20,1
455345,60,12,48,21,4
455345,60,12,48,22,1
455345,60,12,48,23,1
455345,25,7,18,24,1
455345,35,5,30,25,1
455345,35,5,30,40,1
455354,303,9,294,1,4
455354,303,9,294,2,1
455354,303,9,294,3,1
455354,62,1,61,4,1
455354,241,8,233,5,1
455354,241,8,233,20,1
455354,303,9,294,21,4
455354,303,9,294,22,1
455354,303,9,294,23,1
455354,62,1,61,24,1
455354,241,8,233,25,1
455354,241,8,233,40,1
455372,14,1,13,1,4
455372,14,1,13,2,1
455372,14,1,13,3,1
455372,6,0,6,4,1
455372,8,1,7,5,1
455372,8,1,7,20,1
455372,13,0,13,21,4
455372,13,0,13,22,1
455372,13,0,13,23,1
455372,6,0,6,24,1
455372,7,0,7,25,1
455372,7,0,7,40,1
455372,1,1,0,41,4
455372,1,1,0,42,1
455372,1,1,0,43,1
455372,1,1,0,45,1
455372,1,1,0,60,1
455381,67,1,66,1,4
455381,67,1,66,2,1
455381,67,1,66,3,1
455381,7,0,7,4,1
455381,60,1,59,5,1
455381,60,1,59,20,1
455381,34,1,33,21,4
455381,34,1,33,22,1
455381,34,1,33,23,1
455381,5,0,5,24,1
455381,29,1,28,25,1
455381,29,1,28,40,1
455381,33,0,33,41,4
455381,33,0,33,42,1
455381,33,0,33,43,1
455381,2,0,2,44,1
455381,31,0,31,45,1
455381,31,0,31,60,1
455390,265,42,223,1,4
455390,265,42,223,2,1
455390,265,42,223,3,1
455390,56,9,47,4,1
455390,209,33,176,5,1
455390,150,26,124,19,1
455390,59,7,52,20,1
455390,93,17,76,21,4
455390,93,17,76,22,1
455390,93,17,76,23,1
455390,29,6,23,24,1
455390,64,11,53,25,1
455390,34,9,25,39,1
455390,30,2,28,40,1
455390,172,25,147,41,4
455390,172,25,147,42,1
455390,172,25,147,43,1
455390,27,3,24,44,1
455390,145,22,123,45,1
455390,116,17,99,59,1
455390,29,5,24,60,1
455406,359,187,172,1,4
455406,359,187,172,12,3
455406,355,186,169,21,4
455406,355,186,169,32,3
455406,4,1,3,41,4
455406,4,1,3,52,3
455415,18,4,14,1,4
455415,18,4,14,2,1
455415,18,4,14,3,1
455415,5,2,3,4,1
455415,13,2,11,5,1
455415,13,2,11,20,1
455415,10,2,8,21,4
455415,10,2,8,22,1
455415,10,2,8,23,1
455415,3,1,2,24,1
455415,7,1,6,25,1
455415,7,1,6,40,1
455415,8,2,6,41,4
455415,8,2,6,42,1
455415,8,2,6,43,1
455415,2,1,1,44,1
455415,6,1,5,45,1
455415,6,1,5,60,1
455424,402,302,100,1,4
455424,402,302,100,2,1
455424,402,302,100,3,1
455424,130,93,37,4,1
455424,272,209,63,5,1
455424,72,48,24,19,1
455424,200,161,39,20,1
455424,402,302,100,21,4
455424,402,302,100,22,1
455424,402,302,100,23,1
455424,130,93,37,24,1
455424,272,209,63,25,1
455424,72,48,24,39,1
455424,200,161,39,40,1
455433,273,54,219,1,4
455433,273,54,219,12,3
455433,125,25,100,21,4
455433,125,25,100,32,3
455433,148,29,119,41,4
455433,148,29,119,52,3
455460,208,51,157,1,4
455460,208,51,157,2,1
455460,208,51,157,3,1
455460,20,5,15,4,1
455460,188,46,142,5,1
455460,188,46,142,20,1
455460,208,51,157,21,4
455460,208,51,157,22,1
455460,208,51,157,23,1
455460,20,5,15,24,1
455460,188,46,142,25,1
455460,188,46,142,40,1
455479,817,95,722,1,4
455479,817,95,722,2,1
455479,817,95,722,3,1
455479,99,16,83,4,1
455479,718,79,639,5,1
455479,115,12,103,19,1
455479,603,67,536,20,1
455479,817,95,722,21,4
455479,817,95,722,22,1
455479,817,95,722,23,1
455479,99,16,83,24,1
455479,718,79,639,25,1
455479,115,12,103,39,1
455479,603,67,536,40,1
455488,363,73,290,1,4
455488,363,73,290,2,1
455488,363,73,290,3,1
455488,105,27,78,4,1
455488,258,46,212,5,1
455488,39,4,35,19,1
455488,219,42,177,20,1
455488,290,70,220,21,4
455488,290,70,220,22,1
455488,290,70,220,23,1
455488,84,26,58,24,1
455488,206,44,162,25,1
455488,33,4,29,39,1
455488,173,40,133,40,1
455488,73,3,70,41,4
455488,73,3,70,42,1
455488,73,3,70,43,1
455488,21,1,20,44,1
455488,52,2,50,45,1
455488,6,0,6,59,1
455488,46,2,44,60,1
455497,80,23,57,1,4
455497,80,23,57,2,1
455497,80,23,57,3,1
455497,80,23,57,5,1
455497,80,23,57,20,1
455497,80,23,57,21,4
455497,80,23,57,22,1
455497,80,23,57,23,1
455497,80,23,57,25,1
455497,80,23,57,40,1
455512,2641,1051,1590,1,4
455512,2641,1051,1590,2,1
455512,2397,948,1449,3,1
455512,410,170,240,4,1
455512,1987,778,1209,5,1
455512,244,103,141,11,1
455512,399,166,233,19,1
455512,1588,612,976,20,1
455512,830,350,480,21,4
455512,830,350,480,22,1
455512,807,338,469,23,1
455512,196,82,114,24,1
455512,611,256,355,25,1
455512,23,12,11,31,1
455512,69,40,29,39,1
455512,542,216,326,40,1
455512,1811,701,1110,41,4
455512,1811,701,1110,42,1
455512,1590,610,980,43,1
455512,214,88,126,44,1
455512,1376,522,854,45,1
455512,221,91,130,51,1
455512,330,126,204,59,1
455512,1046,396,650,60,1
455549,97,7,90,1,4
455549,97,7,90,2,1
455549,97,7,90,3,1
455549,33,3,30,4,1
455549,64,4,60,5,1
455549,64,4,60,20,1
455549,97,7,90,21,4
455549,97,7,90,22,1
455549,97,7,90,23,1
455549,33,3,30,24,1
455549,64,4,60,25,1
455549,64,4,60,40,1
455558,165,81,84,1,4
455558,165,81,84,2,1
455558,165,81,84,3,1
455558,71,43,28,4,1
455558,94,38,56,5,1
455558,94,38,56,20,1
455558,165,81,84,21,4
455558,165,81,84,22,1
455558,165,81,84,23,1
455558,71,43,28,24,1
455558,94,38,56,25,1
455558,94,38,56,40,1
455567,355,162,193,1,4
455567,355,162,193,2,1
455567,355,162,193,3,1
455567,48,28,20,4,1
455567,307,134,173,5,1
455567,27,6,21,19,1
455567,280,128,152,20,1
455567,355,162,193,21,4
455567,355,162,193,22,1
455567,355,162,193,23,1
455567,48,28,20,24,1
455567,307,134,173,25,1
455567,27,6,21,39,1
455567,280,128,152,40,1
455585,182,45,137,1,4
455585,182,45,137,2,1
455585,171,41,130,3,1
455585,32,2,30,4,1
455585,139,39,100,5,1
455585,11,4,7,11,1
455585,29,9,20,19,1
455585,110,30,80,20,1
455585,127,34,93,21,4
455585,127,34,93,22,1
455585,127,34,93,23,1
455585,29,1,28,24,1
455585,98,33,65,25,1
455585,27,9,18,39,1
455585,71,24,47,40,1
455585,55,11,44,41,4
455585,55,11,44,42,1
455585,44,7,37,43,1
455585,3,1,2,44,1
455585,41,6,35,45,1
455585,11,4,7,51,1
455585,2,0,2,59,1
455585,39,6,33,60,1
455600,393,106,287,1,4
455600,393,106,287,2,1
455600,393,106,287,3,1
455600,63,16,47,4,1
455600,330,90,240,5,1
455600,59,11,48,19,1
455600,271,79,192,20,1
455600,393,106,287,21,4
455600,393,106,287,22,1
455600,393,106,287,23,1
455600,63,16,47,24,1
455600,330,90,240,25,1
455600,59,11,48,39,1
455600,271,79,192,40,1
455619,604,122,482,1,4
455619,604,122,482,2,1
455619,604,122,482,3,1
455619,74,18,56,4,1
455619,530,104,426,5,1
455619,92,13,79,19,1
455619,438,91,347,20,1
455619,604,122,482,21,4
455619,604,122,482,22,1
455619,604,122,482,23,1
455619,74,18,56,24,1
455619,530,104,426,25,1
455619,92,13,79,39,1
455619,438,91,347,40,1
455628,711,168,543,1,4
455628,711,168,543,2,1
455628,711,168,543,3,1
455628,71,20,51,4,1
455628,640,148,492,5,1
455628,96,29,67,19,1
455628,544,119,425,20,1
455628,711,168,543,21,4
455628,711,168,543,22,1
455628,711,168,543,23,1
455628,71,20,51,24,1
455628,640,148,492,25,1
455628,96,29,67,39,1
455628,544,119,425,40,1
455646,48,6,42,1,4
455646,48,6,42,2,1
455646,48,6,42,3,1
455646,8,1,7,4,1
455646,40,5,35,5,1
455646,4,0,4,19,1
455646,36,5,31,20,1
455646,36,4,32,21,4
455646,36,4,32,22,1
455646,36,4,32,23,1
455646,6,0,6,24,1
455646,30,4,26,25,1
455646,4,0,4,39,1
455646,26,4,22,40,1
455646,12,2,10,41,4
455646,12,2,10,42,1
455646,12,2,10,43,1
455646,2,1,1,44,1
455646,10,1,9,45,1
455646,10,1,9,60,1
455655,446,70,376,1,4
455655,446,70,376,2,1
455655,446,70,376,3,1
455655,189,29,160,4,1
455655,257,41,216,5,1
455655,8,2,6,19,1
455655,249,39,210,20,1
455655,269,44,225,21,4
455655,269,44,225,22,1
455655,269,44,225,23,1
455655,126,17,109,24,1
455655,143,27,116,25,1
455655,4,1,3,39,1
455655,139,26,113,40,1
455655,177,26,151,41,4
455655,177,26,151,42,1
455655,177,26,151,43,1
455655,63,12,51,44,1
455655,114,14,100,45,1
455655,4,1,3,59,1
455655,110,13,97,60,1
455664,2006,421,1585,1,4
455664,2006,421,1585,12,3
455664,712,138,574,21,4
455664,712,138,574,32,3
455664,1294,283,1011,41,4
455664,1294,283,1011,52,3
455673,50,6,44,1,4
455673,50,6,44,2,1
455673,50,6,44,3,1
455673,2,0,2,4,1
455673,48,6,42,5,1
455673,4,0,4,19,1
455673,44,6,38,20,1
455673,42,6,36,21,4
455673,42,6,36,22,1
455673,42,6,36,23,1
455673,2,0,2,24,1
455673,40,6,34,25,1
455673,4,0,4,39,1
455673,36,6,30,40,1
455673,8,0,8,41,4
455673,8,0,8,42,1
455673,8,0,8,43,1
455673,8,0,8,45,1
455673,8,0,8,60,1
455682,267,50,217,1,4
455682,267,50,217,12,3
455682,79,17,62,21,4
455682,79,17,62,32,3
455682,188,33,155,41,4
455682,188,33,155,52,3
455707,38,7,31,1,4
455707,38,7,31,2,1
455707,38,7,31,3,1
455707,38,7,31,5,1
455707,38,7,31,20,1
455707,38,7,31,21,4
455707,38,7,31,22,1
455707,38,7,31,23,1
455707,38,7,31,25,1
455707,38,7,31,40,1
455716,629,173,456,1,4
455716,629,173,456,2,1
455716,629,173,456,3,1
455716,300,87,213,4,1
455716,329,86,243,5,1
455716,329,86,243,20,1
455716,467,140,327,21,4
455716,467,140,327,22,1
455716,467,140,327,23,1
455716,234,69,165,24,1
455716,233,71,162,25,1
455716,233,71,162,40,1
455716,162,33,129,41,4
455716,162,33,129,42,1
455716,162,33,129,43,1
455716,66,18,48,44,1
455716,96,15,81,45,1
455716,96,15,81,60,1
455725,363,18,345,1,4
455725,363,18,345,2,1
455725,363,18,345,3,1
455725,227,11,216,4,1
455725,136,7,129,5,1
455725,136,7,129,20,1
455725,363,18,345,21,4
455725,363,18,345,22,1
455725,363,18,345,23,1
455725,227,11,216,24,1
455725,136,7,129,25,1
455725,136,7,129,40,1
455734,223,39,184,1,4
455734,223,39,184,2,1
455734,223,39,184,3,1
455734,78,10,68,4,1
455734,145,29,116,5,1
455734,145,29,116,20,1
455734,223,39,184,21,4
455734,223,39,184,22,1
455734,223,39,184,23,1
455734,78,10,68,24,1
455734,145,29,116,25,1
455734,145,29,116,40,1
455743,33,12,21,1,4
455743,33,12,21,2,1
455743,33,12,21,3,1
455743,21,8,13,4,1
455743,12,4,8,5,1
455743,12,4,8,20,1
455743,33,12,21,21,4
455743,33,12,21,22,1
455743,33,12,21,23,1
455743,21,8,13,24,1
455743,12,4,8,25,1
455743,12,4,8,40,1
455752,73,73,0,1,4
455752,73,73,0,2,1
455752,73,73,0,3,1
455752,28,28,0,4,1
455752,45,45,0,5,1
455752,45,45,0,20,1
455752,73,73,0,21,4
455752,73,73,0,22,1
455752,73,73,0,23,1
455752,28,28,0,24,1
455752,45,45,0,25,1
455752,45,45,0,40,1
455761,348,21,327,1,4
455761,348,21,327,2,1
455761,348,21,327,3,1
455761,15,0,15,4,1
455761,333,21,312,5,1
455761,333,21,312,20,1
455761,247,17,230,21,4
455761,247,17,230,22,1
455761,247,17,230,23,1
455761,14,0,14,24,1
455761,233,17,216,25,1
455761,233,17,216,40,1
455761,101,4,97,41,4
455761,101,4,97,42,1
455761,101,4,97,43,1
455761,1,0,1,44,1
455761,100,4,96,45,1
455761,100,4,96,60,1
455770,66,32,34,1,4
455770,66,32,34,2,1
455770,66,32,34,3,1
455770,20,7,13,4,1
455770,46,25,21,5,1
455770,10,9,1,19,1
455770,36,16,20,20,1
455770,66,32,34,21,4
455770,66,32,34,22,1
455770,66,32,34,23,1
455770,20,7,13,24,1
455770,46,25,21,25,1
455770,10,9,1,39,1
455770,36,16,20,40,1
455789,13,2,11,1,4
455789,13,2,11,2,1
455789,13,2,11,3,1
455789,12,1,11,4,1
455789,1,1,0,5,1
455789,1,1,0,20,1
455789,13,2,11,21,4
455789,13,2,11,22,1
455789,13,2,11,23,1
455789,12,1,11,24,1
455789,1,1,0,25,1
455789,1,1,0,40,1
455798,107,8,99,1,4
455798,107,8,99,2,1
455798,107,8,99,3,1
455798,22,4,18,4,1
455798,85,4,81,5,1
455798,85,4,81,20,1
455798,56,3,53,21,4
455798,56,3,53,22,1
455798,56,3,53,23,1
455798,17,3,14,24,1
455798,39,0,39,25,1
455798,39,0,39,40,1
455798,51,5,46,41,4
455798,51,5,46,42,1
455798,51,5,46,43,1
455798,5,1,4,44,1
455798,46,4,42,45,1
455798,46,4,42,60,1
455804,135,85,50,1,4
455804,135,85,50,12,3
455804,79,52,27,21,4
455804,79,52,27,32,3
455804,56,33,23,41,4
455804,56,33,23,52,3
455813,85,49,36,1,4
455813,85,49,36,12,3
455813,52,28,24,21,4
455813,52,28,24,32,3
455813,33,21,12,41,4
455813,33,21,12,52,3
455831,122,20,102,1,4
455831,122,20,102,2,1
455831,122,20,102,3,1
455831,32,12,20,4,1
455831,90,8,82,5,1
455831,90,8,82,20,1
455831,122,20,102,21,4
455831,122,20,102,22,1
455831,122,20,102,23,1
455831,32,12,20,24,1
455831,90,8,82,25,1
455831,90,8,82,40,1
455840,155,12,143,1,4
455840,155,12,143,2,1
455840,155,12,143,3,1
455840,45,7,38,4,1
455840,110,5,105,5,1
455840,110,5,105,20,1
455840,155,12,143,21,4
455840,155,12,143,22,1
455840,155,12,143,23,1
455840,45,7,38,24,1
455840,110,5,105,25,1
455840,110,5,105,40,1
455859,192,11,181,1,4
455859,192,11,181,2,1
455859,192,11,181,3,1
455859,34,0,34,4,1
455859,158,11,147,5,1
455859,158,11,147,20,1
455859,192,11,181,21,4
455859,192,11,181,22,1
455859,192,11,181,23,1
455859,34,0,34,24,1
455859,158,11,147,25,1
455859,158,11,147,40,1
455868,43,12,31,1,4
455868,43,12,31,2,1
455868,43,12,31,3,1
455868,25,6,19,4,1
455868,18,6,12,5,1
455868,18,6,12,20,1
455868,43,12,31,21,4
455868,43,12,31,22,1
455868,43,12,31,23,1
455868,25,6,19,24,1
455868,18,6,12,25,1
455868,18,6,12,40,1
455877,183,12,171,1,4
455877,183,12,171,2,1
455877,183,12,171,3,1
455877,106,8,98,4,1
455877,77,4,73,5,1
455877,77,4,73,20,1
455877,183,12,171,21,4
455877,183,12,171,22,1
455877,183,12,171,23,1
455877,106,8,98,24,1
455877,77,4,73,25,1
455877,77,4,73,40,1
455886,150,7,143,1,4
455886,150,7,143,2,1
455886,150,7,143,3,1
455886,19,0,19,4,1
455886,131,7,124,5,1
455886,131,7,124,20,1
455886,95,5,90,21,4
455886,95,5,90,22,1
455886,95,5,90,23,1
455886,15,0,15,24,1
455886,80,5,75,25,1
455886,80,5,75,40,1
455886,55,2,53,41,4
455886,55,2,53,42,1
455886,55,2,53,43,1
455886,4,0,4,44,1
455886,51,2,49,45,1
455886,51,2,49,60,1
455895,165,2,163,1,4
455895,165,2,163,2,1
455895,165,2,163,3,1
455895,14,0,14,4,1
455895,151,2,149,5,1
455895,151,2,149,20,1
455895,107,2,105,21,4
455895,107,2,105,22,1
455895,107,2,105,23,1
455895,11,0,11,24,1
455895,96,2,94,25,1
455895,96,2,94,40,1
455895,58,0,58,41,4
455895,58,0,58,42,1
455895,58,0,58,43,1
455895,3,0,3,44,1
455895,55,0,55,45,1
455895,55,0,55,60,1
455901,216,12,204,1,4
455901,216,12,204,2,1
455901,216,12,204,3,1
455901,31,2,29,4,1
455901,185,10,175,5,1
455901,185,10,175,20,1
455901,216,12,204,21,4
455901,216,12,204,22,1
455901,216,12,204,23,1
455901,31,2,29,24,1
455901,185,10,175,25,1
455901,185,10,175,40,1
455910,58,13,45,1,4
455910,58,13,45,2,1
455910,58,13,45,3,1
455910,26,6,20,4,1
455910,32,7,25,5,1
455910,32,7,25,20,1
455910,58,13,45,21,4
455910,58,13,45,22,1
455910,58,13,45,23,1
455910,26,6,20,24,1
455910,32,7,25,25,1
455910,32,7,25,40,1
455929,55,4,51,1,4
455929,55,4,51,2,1
455929,55,4,51,3,1
455929,23,0,23,4,1
455929,32,4,28,5,1
455929,32,4,28,20,1
455929,28,4,24,21,4
455929,28,4,24,22,1
455929,28,4,24,23,1
455929,12,0,12,24,1
455929,16,4,12,25,1
455929,16,4,12,40,1
455929,27,0,27,41,4
455929,27,0,27,42,1
455929,27,0,27,43,1
455929,11,0,11,44,1
455929,16,0,16,45,1
455929,16,0,16,60,1
455938,15,0,15,1,4
455938,15,0,15,2,1
455938,15,0,15,3,1
455938,5,0,5,4,1
455938,10,0,10,5,1
455938,10,0,10,20,1
455938,15,0,15,21,4
455938,15,0,15,22,1
455938,15,0,15,23,1
455938,5,0,5,24,1
455938,10,0,10,25,1
455938,10,0,10,40,1
455947,138,9,129,1,4
455947,138,9,129,2,1
455947,138,9,129,3,1
455947,129,7,122,4,1
455947,9,2,7,5,1
455947,9,2,7,20,1
455947,118,7,111,21,4
455947,118,7,111,22,1
455947,118,7,111,23,1
455947,113,5,108,24,1
455947,5,2,3,25,1
455947,5,2,3,40,1
455947,20,2,18,41,4
455947,20,2,18,42,1
455947,20,2,18,43,1
455947,16,2,14,44,1
455947,4,0,4,45,1
455947,4,0,4,60,1
455956,109,27,82,1,4
455956,109,27,82,2,1
455956,109,27,82,3,1
455956,65,17,48,4,1
455956,44,10,34,5,1
455956,44,10,34,20,1
455956,109,27,82,21,4
455956,109,27,82,22,1
455956,109,27,82,23,1
455956,65,17,48,24,1
455956,44,10,34,25,1
455956,44,10,34,40,1
455965,139,9,130,1,4
455965,139,9,130,2,1
455965,139,9,130,3,1
455965,36,2,34,4,1
455965,103,7,96,5,1
455965,103,7,96,20,1
455965,139,9,130,21,4
455965,139,9,130,22,1
455965,139,9,130,23,1
455965,36,2,34,24,1
455965,103,7,96,25,1
455965,103,7,96,40,1
455974,136,16,120,1,4
455974,136,16,120,2,1
455974,136,16,120,3,1
455974,101,9,92,4,1
455974,35,7,28,5,1
455974,35,7,28,20,1
455974,136,16,120,21,4
455974,136,16,120,22,1
455974,136,16,120,23,1
455974,101,9,92,24,1
455974,35,7,28,25,1
455974,35,7,28,40,1
455983,310,131,179,1,4
455983,310,131,179,2,1
455983,297,126,171,3,1
455983,196,79,117,4,1
455983,101,47,54,5,1
455983,13,5,8,11,1
455983,17,10,7,19,1
455983,84,37,47,20,1
455983,266,114,152,21,4
455983,266,114,152,22,1
455983,253,109,144,23,1
455983,168,68,100,24,1
455983,85,41,44,25,1
455983,13,5,8,31,1
455983,17,10,7,39,1
455983,68,31,37,40,1
455983,44,17,27,41,4
455983,44,17,27,42,1
455983,44,17,27,43,1
455983,28,11,17,44,1
455983,16,6,10,45,1
455983,16,6,10,60,1
455992,359,110,249,1,4
455992,359,110,249,12,3
455992,359,110,249,21,4
455992,359,110,249,32,3
456001,53,51,2,1,4
456001,53,51,2,2,1
456001,53,51,2,3,1
456001,41,40,1,4,1
456001,12,11,1,5,1
456001,12,11,1,20,1
456001,53,51,2,21,4
456001,53,51,2,22,1
456001,53,51,2,23,1
456001,41,40,1,24,1
456001,12,11,1,25,1
456001,12,11,1,40,1
456010,244,110,134,1,4
456010,244,110,134,2,1
456010,243,110,133,3,1
456010,24,14,10,4,1
456010,219,96,123,5,1
456010,1,0,1,11,1
456010,42,17,25,19,1
456010,177,79,98,20,1
456010,185,87,98,21,4
456010,185,87,98,22,1
456010,185,87,98,23,1
456010,18,12,6,24,1
456010,167,75,92,25,1
456010,30,12,18,39,1
456010,137,63,74,40,1
456010,59,23,36,41,4
456010,59,23,36,42,1
456010,58,23,35,43,1
456010,6,2,4,44,1
456010,52,21,31,45,1
456010,1,0,1,51,1
456010,12,5,7,59,1
456010,40,16,24,60,1
456029,143,12,131,1,4
456029,143,12,131,2,1
456029,143,12,131,3,1
456029,18,0,18,4,1
456029,125,12,113,5,1
456029,125,12,113,20,1
456029,143,12,131,21,4
456029,143,12,131,22,1
456029,143,12,131,23,1
456029,18,0,18,24,1
456029,125,12,113,25,1
456029,125,12,113,40,1
456038,511,65,446,1,4
456038,511,65,446,2,1
456038,511,65,446,3,1
456038,230,28,202,4,1
456038,281,37,244,5,1
456038,281,37,244,20,1
456038,511,65,446,21,4
456038,511,65,446,22,1
456038,511,65,446,23,1
456038,230,28,202,24,1
456038,281,37,244,25,1
456038,281,37,244,40,1
456056,425,55,370,1,4
456056,425,55,370,2,1
456056,425,55,370,3,1
456056,206,21,185,4,1
456056,219,34,185,5,1
456056,219,34,185,20,1
456056,316,46,270,21,4
456056,316,46,270,22,1
456056,316,46,270,23,1
456056,173,20,153,24,1
456056,143,26,117,25,1
456056,143,26,117,40,1
456056,109,9,100,41,4
456056,109,9,100,42,1
456056,109,9,100,43,1
456056,33,1,32,44,1
456056,76,8,68,45,1
456056,76,8,68,60,1
456065,181,6,175,1,4
456065,181,6,175,2,1
456065,181,6,175,3,1
456065,30,2,28,4,1
456065,151,4,147,5,1
456065,151,4,147,20,1
456065,131,6,125,21,4
456065,131,6,125,22,1
456065,131,6,125,23,1
456065,26,2,24,24,1
456065,105,4,101,25,1
456065,105,4,101,40,1
456065,50,0,50,41,4
456065,50,0,50,42,1
456065,50,0,50,43,1
456065,4,0,4,44,1
456065,46,0,46,45,1
456065,46,0,46,60,1
456074,216,7,209,1,4
456074,216,7,209,2,1
456074,216,7,209,3,1
456074,28,3,25,4,1
456074,188,4,184,5,1
456074,188,4,184,20,1
456074,164,2,162,21,4
456074,164,2,162,22,1
456074,164,2,162,23,1
456074,20,1,19,24,1
456074,144,1,143,25,1
456074,144,1,143,40,1
456074,52,5,47,41,4
456074,52,5,47,42,1
456074,52,5,47,43,1
456074,8,2,6,44,1
456074,44,3,41,45,1
456074,44,3,41,60,1
456092,131,10,121,1,4
456092,131,10,121,2,1
456092,131,10,121,3,1
456092,24,1,23,4,1
456092,107,9,98,5,1
456092,107,9,98,20,1
456092,80,5,75,21,4
456092,80,5,75,22,1
456092,80,5,75,23,1
456092,12,1,11,24,1
456092,68,4,64,25,1
456092,68,4,64,40,1
456092,51,5,46,41,4
456092,51,5,46,42,1
456092,51,5,46,43,1
456092,12,0,12,44,1
456092,39,5,34,45,1
456092,39,5,34,60,1
456117,106,21,85,1,4
456117,106,21,85,2,1
456117,106,21,85,3,1
456117,28,7,21,4,1
456117,78,14,64,5,1
456117,78,14,64,20,1
456117,64,15,49,21,4
456117,64,15,49,22,1
456117,64,15,49,23,1
456117,15,4,11,24,1
456117,49,11,38,25,1
456117,49,11,38,40,1
456117,42,6,36,41,4
456117,42,6,36,42,1
456117,42,6,36,43,1
456117,13,3,10,44,1
456117,29,3,26,45,1
456117,29,3,26,60,1
456126,101,6,95,1,4
456126,101,6,95,2,1
456126,101,6,95,3,1
456126,44,4,40,4,1
456126,57,2,55,5,1
456126,57,2,55,20,1
456126,78,5,73,21,4
456126,78,5,73,22,1
456126,78,5,73,23,1
456126,33,3,30,24,1
456126,45,2,43,25,1
456126,45,2,43,40,1
456126,23,1,22,41,4
456126,23,1,22,42,1
456126,23,1,22,43,1
456126,11,1,10,44,1
456126,12,0,12,45,1
456126,12,0,12,60,1
456135,110,4,106,1,4
456135,110,4,106,2,1
456135,110,4,106,3,1
456135,27,0,27,4,1
456135,83,4,79,5,1
456135,83,4,79,20,1
456135,78,2,76,21,4
456135,78,2,76,22,1
456135,78,2,76,23,1
456135,22,0,22,24,1
456135,56,2,54,25,1
456135,56,2,54,40,1
456135,32,2,30,41,4
456135,32,2,30,42,1
456135,32,2,30,43,1
456135,5,0,5,44,1
456135,27,2,25,45,1
456135,27,2,25,60,1
456144,87,77,10,1,4
456144,87,77,10,2,1
456144,87,77,10,3,1
456144,77,67,10,4,1
456144,10,10,0,5,1
456144,10,10,0,20,1
456144,87,77,10,21,4
456144,87,77,10,22,1
456144,87,77,10,23,1
456144,77,67,10,24,1
456144,10,10,0,25,1
456144,10,10,0,40,1
456153,126,115,11,1,4
456153,126,115,11,2,1
456153,126,115,11,3,1
456153,120,110,10,4,1
456153,6,5,1,5,1
456153,6,5,1,20,1
456153,126,115,11,21,4
456153,126,115,11,22,1
456153,126,115,11,23,1
456153,120,110,10,24,1
456153,6,5,1,25,1
456153,6,5,1,40,1
456180,271,46,225,1,4
456180,271,46,225,2,1
456180,271,46,225,3,1
456180,22,2,20,4,1
456180,249,44,205,5,1
456180,29,2,27,19,1
456180,220,42,178,20,1
456180,271,46,225,21,4
456180,271,46,225,22,1
456180,271,46,225,23,1
456180,22,2,20,24,1
456180,249,44,205,25,1
456180,29,2,27,39,1
456180,220,42,178,40,1
456205,459,42,417,1,4
456205,459,42,417,2,1
456205,459,42,417,3,1
456205,115,13,102,4,1
456205,344,29,315,5,1
456205,54,6,48,19,1
456205,290,23,267,20,1
456205,285,25,260,21,4
456205,285,25,260,22,1
456205,285,25,260,23,1
456205,87,11,76,24,1
456205,198,14,184,25,1
456205,29,4,25,39,1
456205,169,10,159,40,1
456205,174,17,157,41,4
456205,174,17,157,42,1
456205,174,17,157,43,1
456205,28,2,26,44,1
456205,146,15,131,45,1
456205,25,2,23,59,1
456205,121,13,108,60,1
456214,169,71,98,1,4
456214,169,71,98,2,1
456214,169,71,98,3,1
456214,145,60,85,4,1
456214,24,11,13,5,1
456214,24,11,13,20,1
456214,169,71,98,21,4
456214,169,71,98,22,1
456214,169,71,98,23,1
456214,145,60,85,24,1
456214,24,11,13,25,1
456214,24,11,13,40,1
456250,149,7,142,1,4
456250,149,7,142,2,1
456250,149,7,142,3,1
456250,26,1,25,4,1
456250,123,6,117,5,1
456250,123,6,117,20,1
456250,104,5,99,21,4
456250,104,5,99,22,1
456250,104,5,99,23,1
456250,22,1,21,24,1
456250,82,4,78,25,1
456250,82,4,78,40,1
456250,45,2,43,41,4
456250,45,2,43,42,1
456250,45,2,43,43,1
456250,4,0,4,44,1
456250,41,2,39,45,1
456250,41,2,39,60,1
456278,60,10,50,1,4
456278,60,10,50,2,1
456278,60,10,50,3,1
456278,60,10,50,5,1
456278,60,10,50,20,1
456278,60,10,50,21,4
456278,60,10,50,22,1
456278,60,10,50,23,1
456278,60,10,50,25,1
456278,60,10,50,40,1
456287,114,2,112,1,4
456287,114,2,112,2,1
456287,114,2,112,3,1
456287,24,1,23,4,1
456287,90,1,89,5,1
456287,90,1,89,20,1
456287,114,2,112,21,4
456287,114,2,112,22,1
456287,114,2,112,23,1
456287,24,1,23,24,1
456287,90,1,89,25,1
456287,90,1,89,40,1
456296,1251,648,603,1,4
456296,1251,648,603,2,1
456296,1251,648,603,3,1
456296,136,86,50,4,1
456296,1115,562,553,5,1
456296,154,74,80,19,1
456296,961,488,473,20,1
456296,1112,572,540,21,4
456296,1112,572,540,22,1
456296,1112,572,540,23,1
456296,125,78,47,24,1
456296,987,494,493,25,1
456296,143,69,74,39,1
456296,844,425,419,40,1
456296,139,76,63,41,4
456296,139,76,63,42,1
456296,139,76,63,43,1
456296,11,8,3,44,1
456296,128,68,60,45,1
456296,11,5,6,59,1
456296,117,63,54,60,1
456302,302,151,151,1,4
456302,302,151,151,2,1
456302,302,151,151,3,1
456302,73,33,40,4,1
456302,229,118,111,5,1
456302,229,118,111,20,1
456302,302,151,151,21,4
456302,302,151,151,22,1
456302,302,151,151,23,1
456302,73,33,40,24,1
456302,229,118,111,25,1
456302,229,118,111,40,1
456311,274,59,215,1,4
456311,274,59,215,2,1
456311,274,59,215,3,1
456311,66,16,50,4,1
456311,208,43,165,5,1
456311,33,7,26,19,1
456311,175,36,139,20,1
456311,266,57,209,21,4
456311,266,57,209,22,1
456311,266,57,209,23,1
456311,66,16,50,24,1
456311,200,41,159,25,1
456311,33,7,26,39,1
456311,167,34,133,40,1
456311,8,2,6,41,4
456311,8,2,6,42,1
456311,8,2,6,43,1
456311,8,2,6,45,1
456311,8,2,6,60,1
456320,390,69,321,1,4
456320,390,69,321,2,1
456320,390,69,321,3,1
456320,81,15,66,4,1
456320,309,54,255,5,1
456320,21,3,18,19,1
456320,288,51,237,20,1
456320,390,69,321,21,4
456320,390,69,321,22,1
456320,390,69,321,23,1
456320,81,15,66,24,1
456320,309,54,255,25,1
456320,21,3,18,39,1
456320,288,51,237,40,1
456339,413,84,329,1,4
456339,413,84,329,2,1
456339,413,84,329,3,1
456339,102,27,75,4,1
456339,311,57,254,5,1
456339,311,57,254,20,1
456339,413,84,329,21,4
456339,413,84,329,22,1
456339,413,84,329,23,1
456339,102,27,75,24,1
456339,311,57,254,25,1
456339,311,57,254,40,1
456348,11746,2987,8759,1,4
456348,8938,2212,6726,2,1
456348,8917,2204,6713,3,1
456348,867,335,532,4,1
456348,8050,1869,6181,5,1
456348,21,8,13,11,1
456348,2808,775,2033,12,3
456348,976,262,714,19,1
456348,7074,1607,5467,20,1
456348,11746,2987,8759,21,4
456348,8938,2212,6726,22,1
456348,8917,2204,6713,23,1
456348,867,335,532,24,1
456348,8050,1869,6181,25,1
456348,21,8,13,31,1
456348,2808,775,2033,32,3
456348,976,262,714,39,1
456348,7074,1607,5467,40,1
456357,551,30,521,1,4
456357,551,30,521,2,1
456357,551,30,521,3,1
456357,79,6,73,4,1
456357,472,24,448,5,1
456357,472,24,448,20,1
456357,551,30,521,21,4
456357,551,30,521,22,1
456357,551,30,521,23,1
456357,79,6,73,24,1
456357,472,24,448,25,1
456357,472,24,448,40,1
456366,357,23,334,1,4
456366,357,23,334,2,1
456366,357,23,334,3,1
456366,62,4,58,4,1
456366,295,19,276,5,1
456366,2,0,2,19,1
456366,293,19,274,20,1
456366,357,23,334,21,4
456366,357,23,334,22,1
456366,357,23,334,23,1
456366,62,4,58,24,1
456366,295,19,276,25,1
456366,2,0,2,39,1
456366,293,19,274,40,1
456375,180,18,162,1,4
456375,180,18,162,2,1
456375,180,18,162,3,1
456375,52,4,48,4,1
456375,128,14,114,5,1
456375,128,14,114,20,1
456375,180,18,162,21,4
456375,180,18,162,22,1
456375,180,18,162,23,1
456375,52,4,48,24,1
456375,128,14,114,25,1
456375,128,14,114,40,1
456393,231,169,62,1,4
456393,231,169,62,2,1
456393,231,169,62,3,1
456393,85,60,25,4,1
456393,146,109,37,5,1
456393,2,0,2,19,1
456393,144,109,35,20,1
456393,185,135,50,21,4
456393,185,135,50,22,1
456393,185,135,50,23,1
456393,81,56,25,24,1
456393,104,79,25,25,1
456393,2,0,2,39,1
456393,102,79,23,40,1
456393,46,34,12,41,4
456393,46,34,12,42,1
456393,46,34,12,43,1
456393,4,4,0,44,1
456393,42,30,12,45,1
456393,42,30,12,60,1
456409,206,167,39,1,4
456409,206,167,39,2,1
456409,206,167,39,3,1
456409,46,37,9,4,1
456409,160,130,30,5,1
456409,5,3,2,19,1
456409,155,127,28,20,1
456409,158,128,30,21,4
456409,158,128,30,22,1
456409,158,128,30,23,1
456409,41,33,8,24,1
456409,117,95,22,25,1
456409,3,1,2,39,1
456409,114,94,20,40,1
456409,48,39,9,41,4
456409,48,39,9,42,1
456409,48,39,9,43,1
456409,5,4,1,44,1
456409,43,35,8,45,1
456409,2,2,0,59,1
456409,41,33,8,60,1
456418,263,136,127,1,4
456418,263,136,127,2,1
456418,263,136,127,3,1
456418,34,29,5,4,1
456418,229,107,122,5,1
456418,2,1,1,19,1
456418,227,106,121,20,1
456418,202,113,89,21,4
456418,202,113,89,22,1
456418,202,113,89,23,1
456418,32,27,5,24,1
456418,170,86,84,25,1
456418,2,1,1,39,1
456418,168,85,83,40,1
456418,61,23,38,41,4
456418,61,23,38,42,1
456418,61,23,38,43,1
456418,2,2,0,44,1
456418,59,21,38,45,1
456418,59,21,38,60,1
456427,258,237,21,1,4
456427,258,237,21,2,1
456427,258,237,21,3,1
456427,24,23,1,4,1
456427,234,214,20,5,1
456427,2,2,0,19,1
456427,232,212,20,20,1
456427,208,190,18,21,4
456427,208,190,18,22,1
456427,208,190,18,23,1
456427,21,20,1,24,1
456427,187,170,17,25,1
456427,2,2,0,39,1
456427,185,168,17,40,1
456427,50,47,3,41,4
456427,50,47,3,42,1
456427,50,47,3,43,1
456427,3,3,0,44,1
456427,47,44,3,45,1
456427,47,44,3,60,1
456436,339,187,152,1,4
456436,339,187,152,2,1
456436,339,187,152,3,1
456436,49,34,15,4,1
456436,290,153,137,5,1
456436,8,2,6,19,1
456436,282,151,131,20,1
456436,224,132,92,21,4
456436,224,132,92,22,1
456436,224,132,92,23,1
456436,44,30,14,24,1
456436,180,102,78,25,1
456436,2,0,2,39,1
456436,178,102,76,40,1
456436,115,55,60,41,4
456436,115,55,60,42,1
456436,115,55,60,43,1
456436,5,4,1,44,1
456436,110,51,59,45,1
456436,6,2,4,59,1
456436,104,49,55,60,1
456445,416,304,112,1,4
456445,416,304,112,2,1
456445,416,304,112,3,1
456445,78,55,23,4,1
456445,338,249,89,5,1
456445,5,3,2,19,1
456445,333,246,87,20,1
456445,321,244,77,21,4
456445,321,244,77,22,1
456445,321,244,77,23,1
456445,65,48,17,24,1
456445,256,196,60,25,1
456445,3,2,1,39,1
456445,253,194,59,40,1
456445,95,60,35,41,4
456445,95,60,35,42,1
456445,95,60,35,43,1
456445,13,7,6,44,1
456445,82,53,29,45,1
456445,2,1,1,59,1
456445,80,52,28,60,1
456454,333,91,242,1,4
456454,333,91,242,2,1
456454,333,91,242,3,1
456454,28,16,12,4,1
456454,305,75,230,5,1
456454,39,9,30,19,1
456454,266,66,200,20,1
456454,333,91,242,21,4
456454,333,91,242,22,1
456454,333,91,242,23,1
456454,28,16,12,24,1
456454,305,75,230,25,1
456454,39,9,30,39,1
456454,266,66,200,40,1
456481,120,58,62,1,4
456481,63,26,37,2,1
456481,63,26,37,3,1
456481,3,0,3,4,1
456481,60,26,34,5,1
456481,57,32,25,12,3
456481,5,1,4,19,1
456481,55,25,30,20,1
456481,59,26,33,21,4
456481,19,4,15,22,1
456481,19,4,15,23,1
456481,2,0,2,24,1
456481,17,4,13,25,1
456481,40,22,18,32,3
456481,1,0,1,39,1
456481,16,4,12,40,1
456481,61,32,29,41,4
456481,44,22,22,42,1
456481,44,22,22,43,1
456481,1,0,1,44,1
456481,43,22,21,45,1
456481,17,10,7,52,3
456481,4,1,3,59,1
456481,39,21,18,60,1
456490,125,82,43,1,4
456490,82,53,29,2,1
456490,82,53,29,3,1
456490,1,1,0,4,1
456490,81,52,29,5,1
456490,43,29,14,12,3
456490,4,2,2,19,1
456490,77,50,27,20,1
456490,32,20,12,21,4
456490,17,10,7,22,1
456490,17,10,7,23,1
456490,1,1,0,24,1
456490,16,9,7,25,1
456490,15,10,5,32,3
456490,1,1,0,39,1
456490,15,8,7,40,1
456490,93,62,31,41,4
456490,65,43,22,42,1
456490,65,43,22,43,1
456490,65,43,22,45,1
456490,28,19,9,52,3
456490,3,1,2,59,1
456490,62,42,20,60,1
456506,138,8,130,1,4
456506,138,8,130,2,1
456506,138,8,130,3,1
456506,40,1,39,4,1
456506,98,7,91,5,1
456506,98,7,91,20,1
456506,138,8,130,21,4
456506,138,8,130,22,1
456506,138,8,130,23,1
456506,40,1,39,24,1
456506,98,7,91,25,1
456506,98,7,91,40,1
456515,136,7,129,1,4
456515,136,7,129,2,1
456515,136,7,129,3,1
456515,57,5,52,4,1
456515,79,2,77,5,1
456515,79,2,77,20,1
456515,136,7,129,21,4
456515,136,7,129,22,1
456515,136,7,129,23,1
456515,57,5,52,24,1
456515,79,2,77,25,1
456515,79,2,77,40,1
456542,364,195,169,1,4
456542,364,195,169,12,3
456542,364,195,169,21,4
456542,364,195,169,32,3
456551,42,0,42,1,4
456551,42,0,42,2,1
456551,42,0,42,3,1
456551,18,0,18,4,1
456551,24,0,24,5,1
456551,24,0,24,20,1
456551,42,0,42,21,4
456551,42,0,42,22,1
456551,42,0,42,23,1
456551,18,0,18,24,1
456551,24,0,24,25,1
456551,24,0,24,40,1
456560,183,119,64,1,4
456560,183,119,64,2,1
456560,57,33,24,3,1
456560,30,22,8,4,1
456560,27,11,16,5,1
456560,126,86,40,11,1
456560,27,11,16,20,1
456560,41,18,23,21,4
456560,41,18,23,22,1
456560,41,18,23,23,1
456560,19,12,7,24,1
456560,22,6,16,25,1
456560,22,6,16,40,1
456560,142,101,41,41,4
456560,142,101,41,42,1
456560,16,15,1,43,1
456560,11,10,1,44,1
456560,5,5,0,45,1
456560,126,86,40,51,1
456560,5,5,0,60,1
456588,54,2,52,1,4
456588,54,2,52,2,1
456588,54,2,52,3,1
456588,6,0,6,4,1
456588,48,2,46,5,1
456588,48,2,46,20,1
456588,54,2,52,21,4
456588,54,2,52,22,1
456588,54,2,52,23,1
456588,6,0,6,24,1
456588,48,2,46,25,1
456588,48,2,46,40,1
456597,93,1,92,1,4
456597,93,1,92,2,1
456597,93,1,92,3,1
456597,32,0,32,4,1
456597,61,1,60,5,1
456597,61,1,60,20,1
456597,93,1,92,21,4
456597,93,1,92,22,1
456597,93,1,92,23,1
456597,32,0,32,24,1
456597,61,1,60,25,1
456597,61,1,60,40,1
456612,637,193,444,1,4
456612,637,193,444,2,1
456612,637,193,444,3,1
456612,102,25,77,4,1
456612,535,168,367,5,1
456612,125,34,91,19,1
456612,410,134,276,20,1
456612,637,193,444,21,4
456612,637,193,444,22,1
456612,637,193,444,23,1
456612,102,25,77,24,1
456612,535,168,367,25,1
456612,125,34,91,39,1
456612,410,134,276,40,1
456621,210,75,135,1,4
456621,177,64,113,2,1
456621,177,64,113,3,1
456621,22,7,15,4,1
456621,155,57,98,5,1
456621,33,11,22,12,3
456621,17,6,11,19,1
456621,138,51,87,20,1
456621,15,9,6,21,4
456621,13,9,4,22,1
456621,13,9,4,23,1
456621,13,9,4,25,1
456621,2,0,2,32,3
456621,1,1,0,39,1
456621,12,8,4,40,1
456621,195,66,129,41,4
456621,164,55,109,42,1
456621,164,55,109,43,1
456621,22,7,15,44,1
456621,142,48,94,45,1
456621,31,11,20,52,3
456621,16,5,11,59,1
456621,126,43,83,60,1
456630,103,47,56,1,4
456630,71,32,39,2,1
456630,70,31,39,3,1
456630,11,5,6,4,1
456630,59,26,33,5,1
456630,1,1,0,11,1
456630,32,15,17,12,3
456630,2,1,1,19,1
456630,57,25,32,20,1
456630,22,14,8,21,4
456630,14,9,5,22,1
456630,14,9,5,23,1
456630,1,0,1,24,1
456630,13,9,4,25,1
456630,8,5,3,32,3
456630,1,1,0,39,1
456630,12,8,4,40,1
456630,81,33,48,41,4
456630,57,23,34,42,1
456630,56,22,34,43,1
456630,10,5,5,44,1
456630,46,17,29,45,1
456630,1,1,0,51,1
456630,24,10,14,52,3
456630,1,0,1,59,1
456630,45,17,28,60,1
456667,950,309,641,1,4
456667,727,246,481,2,1
456667,724,244,480,3,1
456667,123,41,82,4,1
456667,601,203,398,5,1
456667,3,2,1,11,1
456667,223,63,160,12,3
456667,104,24,80,19,1
456667,497,179,318,20,1
456667,76,29,47,21,4
456667,39,21,18,22,1
456667,39,21,18,23,1
456667,1,1,0,24,1
456667,38,20,18,25,1
456667,37,8,29,32,3
456667,3,1,2,39,1
456667,35,19,16,40,1
456667,874,280,594,41,4
456667,688,225,463,42,1
456667,685,223,462,43,1
456667,122,40,82,44,1
456667,563,183,380,45,1
456667,3,2,1,51,1
456667,186,55,131,52,3
456667,101,23,78,59,1
456667,462,160,302,60,1
456719,85,1,84,1,4
456719,85,1,84,2,1
456719,85,1,84,3,1
456719,24,0,24,4,1
456719,61,1,60,5,1
456719,61,1,60,20,1
456719,85,1,84,21,4
456719,85,1,84,22,1
456719,85,1,84,23,1
456719,24,0,24,24,1
456719,61,1,60,25,1
456719,61,1,60,40,1
456728,39,3,36,1,4
456728,39,3,36,2,1
456728,39,3,36,3,1
456728,11,0,11,4,1
456728,28,3,25,5,1
456728,28,3,25,20,1
456728,27,2,25,21,4
456728,27,2,25,22,1
456728,27,2,25,23,1
456728,8,0,8,24,1
456728,19,2,17,25,1
456728,19,2,17,40,1
456728,12,1,11,41,4
456728,12,1,11,42,1
456728,12,1,11,43,1
456728,3,0,3,44,1
456728,9,1,8,45,1
456728,9,1,8,60,1
456737,102,7,95,1,4
456737,102,7,95,2,1
456737,102,7,95,3,1
456737,43,2,41,4,1
456737,59,5,54,5,1
456737,59,5,54,20,1
456737,102,7,95,21,4
456737,102,7,95,22,1
456737,102,7,95,23,1
456737,43,2,41,24,1
456737,59,5,54,25,1
456737,59,5,54,40,1
456746,102,6,96,1,4
456746,102,6,96,2,1
456746,102,6,96,3,1
456746,32,2,30,4,1
456746,70,4,66,5,1
456746,70,4,66,20,1
456746,72,4,68,21,4
456746,72,4,68,22,1
456746,72,4,68,23,1
456746,25,1,24,24,1
456746,47,3,44,25,1
456746,47,3,44,40,1
456746,30,2,28,41,4
456746,30,2,28,42,1
456746,30,2,28,43,1
456746,7,1,6,44,1
456746,23,1,22,45,1
456746,23,1,22,60,1
456755,40,2,38,1,4
456755,40,2,38,2,1
456755,40,2,38,3,1
456755,14,1,13,4,1
456755,26,1,25,5,1
456755,26,1,25,20,1
456755,28,2,26,21,4
456755,28,2,26,22,1
456755,28,2,26,23,1
456755,11,1,10,24,1
456755,17,1,16,25,1
456755,17,1,16,40,1
456755,12,0,12,41,4
456755,12,0,12,42,1
456755,12,0,12,43,1
456755,3,0,3,44,1
456755,9,0,9,45,1
456755,9,0,9,60,1
456764,96,4,92,1,4
456764,96,4,92,2,1
456764,96,4,92,3,1
456764,38,1,37,4,1
456764,58,3,55,5,1
456764,58,3,55,20,1
456764,68,3,65,21,4
456764,68,3,65,22,1
456764,68,3,65,23,1
456764,31,1,30,24,1
456764,37,2,35,25,1
456764,37,2,35,40,1
456764,28,1,27,41,4
456764,28,1,27,42,1
456764,28,1,27,43,1
456764,7,0,7,44,1
456764,21,1,20,45,1
456764,21,1,20,60,1
456773,54,3,51,1,4
456773,54,3,51,2,1
456773,54,3,51,3,1
456773,16,1,15,4,1
456773,38,2,36,5,1
456773,38,2,36,20,1
456773,54,3,51,21,4
456773,54,3,51,22,1
456773,54,3,51,23,1
456773,16,1,15,24,1
456773,38,2,36,25,1
456773,38,2,36,40,1
456782,291,77,214,1,4
456782,291,77,214,2,1
456782,285,76,209,3,1
456782,21,4,17,4,1
456782,264,72,192,5,1
456782,6,1,5,11,1
456782,49,12,37,19,1
456782,215,60,155,20,1
456782,196,59,137,21,4
456782,196,59,137,22,1
456782,196,59,137,23,1
456782,18,4,14,24,1
456782,178,55,123,25,1
456782,41,12,29,39,1
456782,137,43,94,40,1
456782,95,18,77,41,4
456782,95,18,77,42,1
456782,89,17,72,43,1
456782,3,0,3,44,1
456782,86,17,69,45,1
456782,6,1,5,51,1
456782,8,0,8,59,1
456782,78,17,61,60,1
456791,845,147,698,1,4
456791,845,147,698,2,1
456791,845,147,698,3,1
456791,112,24,88,4,1
456791,733,123,610,5,1
456791,145,21,124,19,1
456791,588,102,486,20,1
456791,845,147,698,21,4
456791,845,147,698,22,1
456791,845,147,698,23,1
456791,112,24,88,24,1
456791,733,123,610,25,1
456791,145,21,124,39,1
456791,588,102,486,40,1
456807,171,35,136,1,4
456807,171,35,136,2,1
456807,165,35,130,3,1
456807,23,2,21,4,1
456807,142,33,109,5,1
456807,6,0,6,11,1
456807,34,7,27,19,1
456807,108,26,82,20,1
456807,139,30,109,21,4
456807,139,30,109,22,1
456807,137,30,107,23,1
456807,23,2,21,24,1
456807,114,28,86,25,1
456807,2,0,2,31,1
456807,32,6,26,39,1
456807,82,22,60,40,1
456807,32,5,27,41,4
456807,32,5,27,42,1
456807,28,5,23,43,1
456807,28,5,23,45,1
456807,4,0,4,51,1
456807,2,1,1,59,1
456807,26,4,22,60,1
456816,221,43,178,1,4
456816,221,43,178,2,1
456816,215,42,173,3,1
456816,31,7,24,4,1
456816,184,35,149,5,1
456816,6,1,5,11,1
456816,32,10,22,19,1
456816,152,25,127,20,1
456816,161,35,126,21,4
456816,161,35,126,22,1
456816,159,35,124,23,1
456816,30,6,24,24,1
456816,129,29,100,25,1
456816,2,0,2,31,1
456816,31,9,22,39,1
456816,98,20,78,40,1
456816,60,8,52,41,4
456816,60,8,52,42,1
456816,56,7,49,43,1
456816,1,1,0,44,1
456816,55,6,49,45,1
456816,4,1,3,51,1
456816,1,1,0,59,1
456816,54,5,49,60,1
456825,106,8,98,1,4
456825,106,8,98,2,1
456825,106,8,98,3,1
456825,24,1,23,4,1
456825,82,7,75,5,1
456825,82,7,75,20,1
456825,106,8,98,21,4
456825,106,8,98,22,1
456825,106,8,98,23,1
456825,24,1,23,24,1
456825,82,7,75,25,1
456825,82,7,75,40,1
456834,237,127,110,1,4
456834,126,64,62,2,1
456834,126,64,62,3,1
456834,8,6,2,4,1
456834,118,58,60,5,1
456834,111,63,48,12,3
456834,35,17,18,19,1
456834,83,41,42,20,1
456834,158,82,76,21,4
456834,102,53,49,22,1
456834,102,53,49,23,1
456834,7,5,2,24,1
456834,95,48,47,25,1
456834,56,29,27,32,3
456834,33,15,18,39,1
456834,62,33,29,40,1
456834,79,45,34,41,4
456834,24,11,13,42,1
456834,24,11,13,43,1
456834,1,1,0,44,1
456834,23,10,13,45,1
456834,55,34,21,52,3
456834,2,2,0,59,1
456834,21,8,13,60,1
456852,578,193,385,1,4
456852,578,193,385,2,1
456852,578,193,385,3,1
456852,74,21,53,4,1
456852,504,172,332,5,1
456852,57,17,40,19,1
456852,447,155,292,20,1
456852,578,193,385,21,4
456852,578,193,385,22,1
456852,578,193,385,23,1
456852,74,21,53,24,1
456852,504,172,332,25,1
456852,57,17,40,39,1
456852,447,155,292,40,1
456861,655,110,545,1,4
456861,655,110,545,2,1
456861,655,110,545,3,1
456861,196,32,164,4,1
456861,459,78,381,5,1
456861,459,78,381,20,1
456861,655,110,545,21,4
456861,655,110,545,22,1
456861,655,110,545,23,1
456861,196,32,164,24,1
456861,459,78,381,25,1
456861,459,78,381,40,1
456922,278,75,203,1,4
456922,278,75,203,2,1
456922,278,75,203,3,1
456922,103,26,77,4,1
456922,175,49,126,5,1
456922,175,49,126,20,1
456922,278,75,203,21,4
456922,278,75,203,22,1
456922,278,75,203,23,1
456922,103,26,77,24,1
456922,175,49,126,25,1
456922,175,49,126,40,1
456931,268,125,143,1,4
456931,268,125,143,2,1
456931,268,125,143,3,1
456931,104,48,56,4,1
456931,164,77,87,5,1
456931,164,77,87,20,1
456931,268,125,143,21,4
456931,268,125,143,22,1
456931,268,125,143,23,1
456931,104,48,56,24,1
456931,164,77,87,25,1
456931,164,77,87,40,1
456940,441,226,215,1,4
456940,441,226,215,2,1
456940,441,226,215,3,1
456940,43,28,15,4,1
456940,398,198,200,5,1
456940,46,19,27,19,1
456940,352,179,173,20,1
456940,441,226,215,21,4
456940,441,226,215,22,1
456940,441,226,215,23,1
456940,43,28,15,24,1
456940,398,198,200,25,1
456940,46,19,27,39,1
456940,352,179,173,40,1
456959,495,143,352,1,4
456959,495,143,352,2,1
456959,477,132,345,3,1
456959,155,42,113,4,1
456959,322,90,232,5,1
456959,18,11,7,11,1
456959,39,5,34,19,1
456959,283,85,198,20,1
456959,467,130,337,21,4
456959,467,130,337,22,1
456959,466,129,337,23,1
456959,155,42,113,24,1
456959,311,87,224,25,1
456959,1,1,0,31,1
456959,39,5,34,39,1
456959,272,82,190,40,1
456959,28,13,15,41,4
456959,28,13,15,42,1
456959,11,3,8,43,1
456959,11,3,8,45,1
456959,17,10,7,51,1
456959,11,3,8,60,1
456968,179,5,174,1,4
456968,179,5,174,2,1
456968,179,5,174,3,1
456968,15,2,13,4,1
456968,164,3,161,5,1
456968,164,3,161,20,1
456968,151,3,148,21,4
456968,151,3,148,22,1
456968,151,3,148,23,1
456968,11,1,10,24,1
456968,140,2,138,25,1
456968,140,2,138,40,1
456968,28,2,26,41,4
456968,28,2,26,42,1
456968,28,2,26,43,1
456968,4,1,3,44,1
456968,24,1,23,45,1
456968,24,1,23,60,1
456977,174,34,140,1,4
456977,174,34,140,2,1
456977,174,34,140,3,1
456977,44,9,35,4,1
456977,130,25,105,5,1
456977,130,25,105,20,1
456977,174,34,140,21,4
456977,174,34,140,22,1
456977,174,34,140,23,1
456977,44,9,35,24,1
456977,130,25,105,25,1
456977,130,25,105,40,1
457004,99,33,66,1,4
457004,99,33,66,2,1
457004,99,33,66,3,1
457004,6,4,2,4,1
457004,93,29,64,5,1
457004,14,2,12,19,1
457004,79,27,52,20,1
457004,67,21,46,21,4
457004,67,21,46,22,1
457004,67,21,46,23,1
457004,4,3,1,24,1
457004,63,18,45,25,1
457004,12,2,10,39,1
457004,51,16,35,40,1
457004,32,12,20,41,4
457004,32,12,20,42,1
457004,32,12,20,43,1
457004,2,1,1,44,1
457004,30,11,19,45,1
457004,2,0,2,59,1
457004,28,11,17,60,1
457022,205,44,161,1,4
457022,205,44,161,2,1
457022,205,44,161,3,1
457022,40,10,30,4,1
457022,165,34,131,5,1
457022,165,34,131,20,1
457022,137,32,105,21,4
457022,137,32,105,22,1
457022,137,32,105,23,1
457022,31,8,23,24,1
457022,106,24,82,25,1
457022,106,24,82,40,1
457022,68,12,56,41,4
457022,68,12,56,42,1
457022,68,12,56,43,1
457022,9,2,7,44,1
457022,59,10,49,45,1
457022,59,10,49,60,1
457031,49,0,49,1,4
457031,49,0,49,2,1
457031,49,0,49,3,1
457031,7,0,7,4,1
457031,42,0,42,5,1
457031,42,0,42,20,1
457031,49,0,49,21,4
457031,49,0,49,22,1
457031,49,0,49,23,1
457031,7,0,7,24,1
457031,42,0,42,25,1
457031,42,0,42,40,1
457077,411,21,390,1,4
457077,411,21,390,2,1
457077,411,21,390,3,1
457077,118,7,111,4,1
457077,293,14,279,5,1
457077,293,14,279,20,1
457077,411,21,390,21,4
457077,411,21,390,22,1
457077,411,21,390,23,1
457077,118,7,111,24,1
457077,293,14,279,25,1
457077,293,14,279,40,1
457086,166,35,131,1,4
457086,166,35,131,2,1
457086,166,35,131,3,1
457086,14,6,8,4,1
457086,152,29,123,5,1
457086,152,29,123,20,1
457086,117,31,86,21,4
457086,117,31,86,22,1
457086,117,31,86,23,1
457086,12,6,6,24,1
457086,105,25,80,25,1
457086,105,25,80,40,1
457086,49,4,45,41,4
457086,49,4,45,42,1
457086,49,4,45,43,1
457086,2,0,2,44,1
457086,47,4,43,45,1
457086,47,4,43,60,1
457101,255,94,161,1,4
457101,255,94,161,2,1
457101,255,94,161,3,1
457101,28,10,18,4,1
457101,227,84,143,5,1
457101,56,23,33,19,1
457101,171,61,110,20,1
457101,224,77,147,21,4
457101,224,77,147,22,1
457101,224,77,147,23,1
457101,28,10,18,24,1
457101,196,67,129,25,1
457101,36,13,23,39,1
457101,160,54,106,40,1
457101,31,17,14,41,4
457101,31,17,14,42,1
457101,31,17,14,43,1
457101,31,17,14,45,1
457101,20,10,10,59,1
457101,11,7,4,60,1
457110,333,55,278,1,4
457110,333,55,278,2,1
457110,333,55,278,3,1
457110,9,0,9,4,1
457110,324,55,269,5,1
457110,46,12,34,19,1
457110,278,43,235,20,1
457110,254,40,214,21,4
457110,254,40,214,22,1
457110,254,40,214,23,1
457110,8,0,8,24,1
457110,246,40,206,25,1
457110,19,4,15,39,1
457110,227,36,191,40,1
457110,79,15,64,41,4
457110,79,15,64,42,1
457110,79,15,64,43,1
457110,1,0,1,44,1
457110,78,15,63,45,1
457110,27,8,19,59,1
457110,51,7,44,60,1
457129,649,88,561,1,4
457129,649,88,561,2,1
457129,649,88,561,3,1
457129,2,1,1,4,1
457129,647,87,560,5,1
457129,246,33,213,19,1
457129,401,54,347,20,1
457129,339,46,293,21,4
457129,339,46,293,22,1
457129,339,46,293,23,1
457129,2,1,1,24,1
457129,337,45,292,25,1
457129,110,14,96,39,1
457129,227,31,196,40,1
457129,310,42,268,41,4
457129,310,42,268,42,1
457129,310,42,268,43,1
457129,310,42,268,45,1
457129,136,19,117,59,1
457129,174,23,151,60,1
457174,336,26,310,1,4
457174,336,26,310,2,1
457174,336,26,310,3,1
457174,126,9,117,4,1
457174,210,17,193,5,1
457174,210,17,193,20,1
457174,336,26,310,21,4
457174,336,26,310,22,1
457174,336,26,310,23,1
457174,126,9,117,24,1
457174,210,17,193,25,1
457174,210,17,193,40,1
457183,100,17,83,1,4
457183,100,17,83,2,1
457183,100,17,83,3,1
457183,100,17,83,5,1
457183,100,17,83,20,1
457183,100,17,83,21,4
457183,100,17,83,22,1
457183,100,17,83,23,1
457183,100,17,83,25,1
457183,100,17,83,40,1
457192,126,86,40,1,4
457192,126,86,40,2,1
457192,126,86,40,3,1
457192,31,25,6,4,1
457192,95,61,34,5,1
457192,95,61,34,20,1
457192,126,86,40,21,4
457192,126,86,40,22,1
457192,126,86,40,23,1
457192,31,25,6,24,1
457192,95,61,34,25,1
457192,95,61,34,40,1
457208,28,15,13,1,4
457208,28,15,13,2,1
457208,28,15,13,3,1
457208,6,3,3,4,1
457208,22,12,10,5,1
457208,22,12,10,20,1
457208,28,15,13,21,4
457208,28,15,13,22,1
457208,28,15,13,23,1
457208,6,3,3,24,1
457208,22,12,10,25,1
457208,22,12,10,40,1
457226,58,48,10,1,4
457226,58,48,10,2,1
457226,58,48,10,3,1
457226,3,3,0,4,1
457226,55,45,10,5,1
457226,55,45,10,20,1
457226,16,13,3,21,4
457226,16,13,3,22,1
457226,16,13,3,23,1
457226,2,2,0,24,1
457226,14,11,3,25,1
457226,14,11,3,40,1
457226,42,35,7,41,4
457226,42,35,7,42,1
457226,42,35,7,43,1
457226,1,1,0,44,1
457226,41,34,7,45,1
457226,41,34,7,60,1
457244,54,30,24,1,4
457244,54,30,24,2,1
457244,54,30,24,3,1
457244,23,20,3,4,1
457244,31,10,21,5,1
457244,31,10,21,20,1
457244,41,26,15,21,4
457244,41,26,15,22,1
457244,41,26,15,23,1
457244,19,17,2,24,1
457244,22,9,13,25,1
457244,22,9,13,40,1
457244,13,4,9,41,4
457244,13,4,9,42,1
457244,13,4,9,43,1
457244,4,3,1,44,1
457244,9,1,8,45,1
457244,9,1,8,60,1
457253,46,1,45,1,4
457253,46,1,45,2,1
457253,46,1,45,3,1
457253,6,0,6,4,1
457253,40,1,39,5,1
457253,40,1,39,20,1
457253,15,0,15,21,4
457253,15,0,15,22,1
457253,15,0,15,23,1
457253,1,0,1,24,1
457253,14,0,14,25,1
457253,14,0,14,40,1
457253,31,1,30,41,4
457253,31,1,30,42,1
457253,31,1,30,43,1
457253,5,0,5,44,1
457253,26,1,25,45,1
457253,26,1,25,60,1
457271,63,21,42,1,4
457271,63,21,42,12,3
457271,29,9,20,21,4
457271,29,9,20,32,3
457271,34,12,22,41,4
457271,34,12,22,52,3
457280,115,4,111,1,4
457280,115,4,111,2,1
457280,115,4,111,3,1
457280,10,3,7,4,1
457280,105,1,104,5,1
457280,105,1,104,20,1
457280,82,2,80,21,4
457280,82,2,80,22,1
457280,82,2,80,23,1
457280,7,1,6,24,1
457280,75,1,74,25,1
457280,75,1,74,40,1
457280,33,2,31,41,4
457280,33,2,31,42,1
457280,33,2,31,43,1
457280,3,2,1,44,1
457280,30,0,30,45,1
457280,30,0,30,60,1
457299,145,30,115,1,4
457299,145,30,115,2,1
457299,145,30,115,3,1
457299,44,10,34,4,1
457299,101,20,81,5,1
457299,9,3,6,19,1
457299,92,17,75,20,1
457299,112,25,87,21,4
457299,112,25,87,22,1
457299,112,25,87,23,1
457299,29,8,21,24,1
457299,83,17,66,25,1
457299,9,3,6,39,1
457299,74,14,60,40,1
457299,33,5,28,41,4
457299,33,5,28,42,1
457299,33,5,28,43,1
457299,15,2,13,44,1
457299,18,3,15,45,1
457299,18,3,15,60,1
457314,105,25,80,1,4
457314,105,25,80,2,1
457314,105,25,80,3,1
457314,32,8,24,4,1
457314,73,17,56,5,1
457314,73,17,56,20,1
457314,105,25,80,21,4
457314,105,25,80,22,1
457314,105,25,80,23,1
457314,32,8,24,24,1
457314,73,17,56,25,1
457314,73,17,56,40,1
457323,275,9,266,1,4
457323,275,9,266,2,1
457323,275,9,266,3,1
457323,54,0,54,4,1
457323,221,9,212,5,1
457323,221,9,212,20,1
457323,184,7,177,21,4
457323,184,7,177,22,1
457323,184,7,177,23,1
457323,33,0,33,24,1
457323,151,7,144,25,1
457323,151,7,144,40,1
457323,91,2,89,41,4
457323,91,2,89,42,1
457323,91,2,89,43,1
457323,21,0,21,44,1
457323,70,2,68,45,1
457323,70,2,68,60,1
457332,38,5,33,1,4
457332,38,5,33,2,1
457332,38,5,33,3,1
457332,19,3,16,4,1
457332,19,2,17,5,1
457332,19,2,17,20,1
457332,13,2,11,21,4
457332,13,2,11,22,1
457332,13,2,11,23,1
457332,9,1,8,24,1
457332,4,1,3,25,1
457332,4,1,3,40,1
457332,25,3,22,41,4
457332,25,3,22,42,1
457332,25,3,22,43,1
457332,10,2,8,44,1
457332,15,1,14,45,1
457332,15,1,14,60,1
457341,132,10,122,1,4
457341,132,10,122,2,1
457341,132,10,122,3,1
457341,16,0,16,4,1
457341,116,10,106,5,1
457341,116,10,106,20,1
457341,113,9,104,21,4
457341,113,9,104,22,1
457341,113,9,104,23,1
457341,15,0,15,24,1
457341,98,9,89,25,1
457341,98,9,89,40,1
457341,19,1,18,41,4
457341,19,1,18,42,1
457341,19,1,18,43,1
457341,1,0,1,44,1
457341,18,1,17,45,1
457341,18,1,17,60,1
457350,34,0,34,1,4
457350,34,0,34,2,1
457350,34,0,34,3,1
457350,9,0,9,4,1
457350,25,0,25,5,1
457350,25,0,25,20,1
457350,34,0,34,41,4
457350,34,0,34,42,1
457350,34,0,34,43,1
457350,9,0,9,44,1
457350,25,0,25,45,1
457350,25,0,25,60,1
457378,130,40,90,1,4
457378,130,40,90,2,1
457378,130,40,90,3,1
457378,29,10,19,4,1
457378,101,30,71,5,1
457378,101,30,71,20,1
457378,120,30,90,21,4
457378,120,30,90,22,1
457378,120,30,90,23,1
457378,27,8,19,24,1
457378,93,22,71,25,1
457378,93,22,71,40,1
457378,10,10,0,41,4
457378,10,10,0,42,1
457378,10,10,0,43,1
457378,2,2,0,44,1
457378,8,8,0,45,1
457378,8,8,0,60,1
457387,386,166,220,1,4
457387,386,166,220,2,1
457387,212,87,125,3,1
457387,49,24,25,4,1
457387,163,63,100,5,1
457387,174,79,95,11,1
457387,163,63,100,20,1
457387,187,87,100,21,4
457387,187,87,100,22,1
457387,187,87,100,23,1
457387,39,24,15,24,1
457387,148,63,85,25,1
457387,148,63,85,40,1
457387,199,79,120,41,4
457387,199,79,120,42,1
457387,25,0,25,43,1
457387,10,0,10,44,1
457387,15,0,15,45,1
457387,174,79,95,51,1
457387,15,0,15,60,1
457396,120,21,99,1,4
457396,120,21,99,2,1
457396,120,21,99,3,1
457396,15,2,13,4,1
457396,105,19,86,5,1
457396,105,19,86,20,1
457396,75,9,66,21,4
457396,75,9,66,22,1
457396,75,9,66,23,1
457396,13,1,12,24,1
457396,62,8,54,25,1
457396,62,8,54,40,1
457396,45,12,33,41,4
457396,45,12,33,42,1
457396,45,12,33,43,1
457396,2,1,1,44,1
457396,43,11,32,45,1
457396,43,11,32,60,1
457402,46,14,32,1,4
457402,33,8,25,2,1
457402,33,8,25,3,1
457402,33,8,25,5,1
457402,13,6,7,12,3
457402,33,8,25,20,1
457402,7,4,3,21,4
457402,7,4,3,22,1
457402,7,4,3,23,1
457402,7,4,3,25,1
457402,7,4,3,40,1
457402,39,10,29,41,4
457402,26,4,22,42,1
457402,26,4,22,43,1
457402,26,4,22,45,1
457402,13,6,7,52,3
457402,26,4,22,60,1
457411,268,255,13,1,4
457411,268,255,13,2,1
457411,268,255,13,3,1
457411,30,28,2,4,1
457411,238,227,11,5,1
457411,238,227,11,20,1
457411,266,253,13,21,4
457411,266,253,13,22,1
457411,266,253,13,23,1
457411,30,28,2,24,1
457411,236,225,11,25,1
457411,236,225,11,40,1
457411,2,2,0,41,4
457411,2,2,0,42,1
457411,2,2,0,43,1
457411,2,2,0,45,1
457411,2,2,0,60,1
457420,99,4,95,1,4
457420,99,4,95,2,1
457420,99,4,95,3,1
457420,12,1,11,4,1
457420,87,3,84,5,1
457420,87,3,84,20,1
457420,51,4,47,21,4
457420,51,4,47,22,1
457420,51,4,47,23,1
457420,10,1,9,24,1
457420,41,3,38,25,1
457420,41,3,38,40,1
457420,48,0,48,41,4
457420,48,0,48,42,1
457420,48,0,48,43,1
457420,2,0,2,44,1
457420,46,0,46,45,1
457420,46,0,46,60,1
457439,37,1,36,1,4
457439,37,1,36,2,1
457439,37,1,36,3,1
457439,16,1,15,4,1
457439,21,0,21,5,1
457439,21,0,21,20,1
457439,24,1,23,21,4
457439,24,1,23,22,1
457439,24,1,23,23,1
457439,10,1,9,24,1
457439,14,0,14,25,1
457439,14,0,14,40,1
457439,13,0,13,41,4
457439,13,0,13,42,1
457439,13,0,13,43,1
457439,6,0,6,44,1
457439,7,0,7,45,1
457439,7,0,7,60,1
457448,148,15,133,1,4
457448,148,15,133,2,1
457448,148,15,133,3,1
457448,23,2,21,4,1
457448,125,13,112,5,1
457448,125,13,112,20,1
457448,148,15,133,21,4
457448,148,15,133,22,1
457448,148,15,133,23,1
457448,23,2,21,24,1
457448,125,13,112,25,1
457448,125,13,112,40,1
457457,44,5,39,1,4
457457,44,5,39,2,1
457457,44,5,39,3,1
457457,35,5,30,4,1
457457,9,0,9,5,1
457457,9,0,9,20,1
457457,18,3,15,21,4
457457,18,3,15,22,1
457457,18,3,15,23,1
457457,16,3,13,24,1
457457,2,0,2,25,1
457457,2,0,2,40,1
457457,26,2,24,41,4
457457,26,2,24,42,1
457457,26,2,24,43,1
457457,19,2,17,44,1
457457,7,0,7,45,1
457457,7,0,7,60,1
457466,60,50,10,1,4
457466,60,50,10,2,1
457466,60,50,10,3,1
457466,14,13,1,4,1
457466,46,37,9,5,1
457466,46,37,9,20,1
457466,60,50,10,21,4
457466,60,50,10,22,1
457466,60,50,10,23,1
457466,14,13,1,24,1
457466,46,37,9,25,1
457466,46,37,9,40,1
457475,93,4,89,1,4
457475,93,4,89,2,1
457475,93,4,89,3,1
457475,33,4,29,4,1
457475,60,0,60,5,1
457475,60,0,60,20,1
457475,93,4,89,21,4
457475,93,4,89,22,1
457475,93,4,89,23,1
457475,33,4,29,24,1
457475,60,0,60,25,1
457475,60,0,60,40,1
457484,147,79,68,1,4
457484,129,66,63,2,1
457484,126,64,62,3,1
457484,13,5,8,4,1
457484,113,59,54,5,1
457484,3,2,1,11,1
457484,18,13,5,12,3
457484,4,0,4,19,1
457484,109,59,50,20,1
457484,87,46,41,21,4
457484,81,41,40,22,1
457484,81,41,40,23,1
457484,8,3,5,24,1
457484,73,38,35,25,1
457484,6,5,1,32,3
457484,3,0,3,39,1
457484,70,38,32,40,1
457484,60,33,27,41,4
457484,48,25,23,42,1
457484,45,23,22,43,1
457484,5,2,3,44,1
457484,40,21,19,45,1
457484,3,2,1,51,1
457484,12,8,4,52,3
457484,1,0,1,59,1
457484,39,21,18,60,1
457493,25,0,25,1,4
457493,25,0,25,2,1
457493,25,0,25,3,1
457493,10,0,10,4,1
457493,15,0,15,5,1
457493,15,0,15,20,1
457493,25,0,25,21,4
457493,25,0,25,22,1
457493,25,0,25,23,1
457493,10,0,10,24,1
457493,15,0,15,25,1
457493,15,0,15,40,1
457509,33,0,33,1,4
457509,33,0,33,2,1
457509,33,0,33,3,1
457509,8,0,8,4,1
457509,25,0,25,5,1
457509,25,0,25,20,1
457509,33,0,33,21,4
457509,33,0,33,22,1
457509,33,0,33,23,1
457509,8,0,8,24,1
457509,25,0,25,25,1
457509,25,0,25,40,1
457527,344,48,296,1,4
457527,344,48,296,2,1
457527,293,44,249,3,1
457527,7,2,5,4,1
457527,286,42,244,5,1
457527,51,4,47,11,1
457527,69,16,53,19,1
457527,217,26,191,20,1
457527,254,34,220,21,4
457527,254,34,220,22,1
457527,212,30,182,23,1
457527,5,1,4,24,1
457527,207,29,178,25,1
457527,42,4,38,31,1
457527,45,10,35,39,1
457527,162,19,143,40,1
457527,90,14,76,41,4
457527,90,14,76,42,1
457527,81,14,67,43,1
457527,2,1,1,44,1
457527,79,13,66,45,1
457527,9,0,9,51,1
457527,24,6,18,59,1
457527,55,7,48,60,1
457536,45,16,29,1,4
457536,45,16,29,2,1
457536,45,16,29,3,1
457536,21,5,16,4,1
457536,24,11,13,5,1
457536,24,11,13,20,1
457536,45,16,29,21,4
457536,45,16,29,22,1
457536,45,16,29,23,1
457536,21,5,16,24,1
457536,24,11,13,25,1
457536,24,11,13,40,1
457545,131,5,126,1,4
457545,131,5,126,2,1
457545,131,5,126,3,1
457545,31,1,30,4,1
457545,100,4,96,5,1
457545,100,4,96,20,1
457545,102,4,98,21,4
457545,102,4,98,22,1
457545,102,4,98,23,1
457545,29,1,28,24,1
457545,73,3,70,25,1
457545,73,3,70,40,1
457545,29,1,28,41,4
457545,29,1,28,42,1
457545,29,1,28,43,1
457545,2,0,2,44,1
457545,27,1,26,45,1
457545,27,1,26,60,1
457554,45,0,45,1,4
457554,45,0,45,2,1
457554,45,0,45,3,1
457554,42,0,42,4,1
457554,3,0,3,5,1
457554,3,0,3,20,1
457554,42,0,42,21,4
457554,42,0,42,22,1
457554,42,0,42,23,1
457554,40,0,40,24,1
457554,2,0,2,25,1
457554,2,0,2,40,1
457554,3,0,3,41,4
457554,3,0,3,42,1
457554,3,0,3,43,1
457554,2,0,2,44,1
457554,1,0,1,45,1
457554,1,0,1,60,1
457563,208,7,201,1,4
457563,208,7,201,2,1
457563,208,7,201,3,1
457563,51,3,48,4,1
457563,157,4,153,5,1
457563,157,4,153,20,1
457563,208,7,201,21,4
457563,208,7,201,22,1
457563,208,7,201,23,1
457563,51,3,48,24,1
457563,157,4,153,25,1
457563,157,4,153,40,1
457572,106,2,104,1,4
457572,106,2,104,2,1
457572,106,2,104,3,1
457572,15,0,15,4,1
457572,91,2,89,5,1
457572,91,2,89,20,1
457572,106,2,104,21,4
457572,106,2,104,22,1
457572,106,2,104,23,1
457572,15,0,15,24,1
457572,91,2,89,25,1
457572,91,2,89,40,1
457581,152,5,147,1,4
457581,152,5,147,2,1
457581,152,5,147,3,1
457581,19,1,18,4,1
457581,133,4,129,5,1
457581,133,4,129,20,1
457581,152,5,147,21,4
457581,152,5,147,22,1
457581,152,5,147,23,1
457581,19,1,18,24,1
457581,133,4,129,25,1
457581,133,4,129,40,1
457590,48,2,46,1,4
457590,48,2,46,2,1
457590,48,2,46,3,1
457590,48,2,46,5,1
457590,48,2,46,20,1
457590,38,1,37,21,4
457590,38,1,37,22,1
457590,38,1,37,23,1
457590,38,1,37,25,1
457590,38,1,37,40,1
457590,10,1,9,41,4
457590,10,1,9,42,1
457590,10,1,9,43,1
457590,10,1,9,45,1
457590,10,1,9,60,1
457606,35,2,33,1,4
457606,35,2,33,2,1
457606,35,2,33,3,1
457606,33,2,31,4,1
457606,2,0,2,5,1
457606,2,0,2,20,1
457606,35,2,33,21,4
457606,35,2,33,22,1
457606,35,2,33,23,1
457606,33,2,31,24,1
457606,2,0,2,25,1
457606,2,0,2,40,1
457615,50,6,44,1,4
457615,50,6,44,2,1
457615,50,6,44,3,1
457615,21,3,18,4,1
457615,29,3,26,5,1
457615,29,3,26,20,1
457615,50,6,44,41,4
457615,50,6,44,42,1
457615,50,6,44,43,1
457615,21,3,18,44,1
457615,29,3,26,45,1
457615,29,3,26,60,1
457624,28,2,26,1,4
457624,28,2,26,2,1
457624,28,2,26,3,1
457624,27,2,25,4,1
457624,1,0,1,5,1
457624,1,0,1,20,1
457624,28,2,26,21,4
457624,28,2,26,22,1
457624,28,2,26,23,1
457624,27,2,25,24,1
457624,1,0,1,25,1
457624,1,0,1,40,1
457633,129,4,125,1,4
457633,129,4,125,2,1
457633,129,4,125,3,1
457633,44,0,44,4,1
457633,85,4,81,5,1
457633,85,4,81,20,1
457633,97,2,95,21,4
457633,97,2,95,22,1
457633,97,2,95,23,1
457633,34,0,34,24,1
457633,63,2,61,25,1
457633,63,2,61,40,1
457633,32,2,30,41,4
457633,32,2,30,42,1
457633,32,2,30,43,1
457633,10,0,10,44,1
457633,22,2,20,45,1
457633,22,2,20,60,1
457642,59,3,56,1,4
457642,59,3,56,2,1
457642,59,3,56,3,1
457642,20,1,19,4,1
457642,39,2,37,5,1
457642,39,2,37,20,1
457642,42,3,39,21,4
457642,42,3,39,22,1
457642,42,3,39,23,1
457642,17,1,16,24,1
457642,25,2,23,25,1
457642,25,2,23,40,1
457642,17,0,17,41,4
457642,17,0,17,42,1
457642,17,0,17,43,1
457642,3,0,3,44,1
457642,14,0,14,45,1
457642,14,0,14,60,1
457651,95,22,73,1,4
457651,95,22,73,2,1
457651,95,22,73,3,1
457651,15,3,12,4,1
457651,80,19,61,5,1
457651,80,19,61,20,1
457651,48,8,40,21,4
457651,48,8,40,22,1
457651,48,8,40,23,1
457651,10,1,9,24,1
457651,38,7,31,25,1
457651,38,7,31,40,1
457651,47,14,33,41,4
457651,47,14,33,42,1
457651,47,14,33,43,1
457651,5,2,3,44,1
457651,42,12,30,45,1
457651,42,12,30,60,1
457679,33,1,32,1,4
457679,33,1,32,2,1
457679,33,1,32,3,1
457679,19,0,19,4,1
457679,14,1,13,5,1
457679,14,1,13,20,1
457679,33,1,32,21,4
457679,33,1,32,22,1
457679,33,1,32,23,1
457679,19,0,19,24,1
457679,14,1,13,25,1
457679,14,1,13,40,1
457688,1822,1364,458,1,4
457688,1822,1364,458,2,1
457688,1819,1361,458,3,1
457688,472,338,134,4,1
457688,1347,1023,324,5,1
457688,3,3,0,11,1
457688,1059,934,125,19,1
457688,288,89,199,20,1
457688,1822,1364,458,21,4
457688,1822,1364,458,22,1
457688,1819,1361,458,23,1
457688,472,338,134,24,1
457688,1347,1023,324,25,1
457688,3,3,0,31,1
457688,1059,934,125,39,1
457688,288,89,199,40,1
457697,78,36,42,1,4
457697,78,36,42,2,1
457697,74,33,41,3,1
457697,7,3,4,4,1
457697,67,30,37,5,1
457697,4,3,1,11,1
457697,24,13,11,19,1
457697,43,17,26,20,1
457697,47,22,25,21,4
457697,47,22,25,22,1
457697,46,21,25,23,1
457697,3,1,2,24,1
457697,43,20,23,25,1
457697,1,1,0,31,1
457697,16,8,8,39,1
457697,27,12,15,40,1
457697,31,14,17,41,4
457697,31,14,17,42,1
457697,28,12,16,43,1
457697,4,2,2,44,1
457697,24,10,14,45,1
457697,3,2,1,51,1
457697,8,5,3,59,1
457697,16,5,11,60,1
457703,105,58,47,1,4
457703,105,58,47,2,1
457703,105,58,47,3,1
457703,14,7,7,4,1
457703,91,51,40,5,1
457703,91,51,40,20,1
457703,46,29,17,21,4
457703,46,29,17,22,1
457703,46,29,17,23,1
457703,3,2,1,24,1
457703,43,27,16,25,1
457703,43,27,16,40,1
457703,59,29,30,41,4
457703,59,29,30,42,1
457703,59,29,30,43,1
457703,11,5,6,44,1
457703,48,24,24,45,1
457703,48,24,24,60,1
457721,30,2,28,1,4
457721,30,2,28,2,1
457721,30,2,28,3,1
457721,12,0,12,4,1
457721,18,2,16,5,1
457721,18,2,16,20,1
457721,30,2,28,21,4
457721,30,2,28,22,1
457721,30,2,28,23,1
457721,12,0,12,24,1
457721,18,2,16,25,1
457721,18,2,16,40,1
457730,515,122,393,1,4
457730,515,122,393,2,1
457730,515,122,393,3,1
457730,154,34,120,4,1
457730,361,88,273,5,1
457730,361,88,273,20,1
457730,506,120,386,21,4
457730,506,120,386,22,1
457730,506,120,386,23,1
457730,148,33,115,24,1
457730,358,87,271,25,1
457730,358,87,271,40,1
457730,9,2,7,41,4
457730,9,2,7,42,1
457730,9,2,7,43,1
457730,6,1,5,44,1
457730,3,1,2,45,1
457730,3,1,2,60,1
457749,102,5,97,1,4
457749,102,5,97,2,1
457749,102,5,97,3,1
457749,23,2,21,4,1
457749,79,3,76,5,1
457749,79,3,76,20,1
457749,86,5,81,21,4
457749,86,5,81,22,1
457749,86,5,81,23,1
457749,17,2,15,24,1
457749,69,3,66,25,1
457749,69,3,66,40,1
457749,16,0,16,41,4
457749,16,0,16,42,1
457749,16,0,16,43,1
457749,6,0,6,44,1
457749,10,0,10,45,1
457749,10,0,10,60,1
457758,175,158,17,1,4
457758,175,158,17,2,1
457758,175,158,17,3,1
457758,61,52,9,4,1
457758,114,106,8,5,1
457758,114,106,8,20,1
457758,77,67,10,21,4
457758,77,67,10,22,1
457758,77,67,10,23,1
457758,36,30,6,24,1
457758,41,37,4,25,1
457758,41,37,4,40,1
457758,98,91,7,41,4
457758,98,91,7,42,1
457758,98,91,7,43,1
457758,25,22,3,44,1
457758,73,69,4,45,1
457758,73,69,4,60,1
457767,176,33,143,1,4
457767,176,33,143,2,1
457767,176,33,143,3,1
457767,74,13,61,4,1
457767,102,20,82,5,1
457767,102,20,82,20,1
457767,176,33,143,21,4
457767,176,33,143,22,1
457767,176,33,143,23,1
457767,74,13,61,24,1
457767,102,20,82,25,1
457767,102,20,82,40,1
457776,84,5,79,1,4
457776,84,5,79,2,1
457776,84,5,79,3,1
457776,5,1,4,4,1
457776,79,4,75,5,1
457776,79,4,75,20,1
457776,84,5,79,21,4
457776,84,5,79,22,1
457776,84,5,79,23,1
457776,5,1,4,24,1
457776,79,4,75,25,1
457776,79,4,75,40,1
457785,118,7,111,1,4
457785,118,7,111,2,1
457785,118,7,111,3,1
457785,113,7,106,4,1
457785,5,0,5,5,1
457785,5,0,5,20,1
457785,118,7,111,21,4
457785,118,7,111,22,1
457785,118,7,111,23,1
457785,113,7,106,24,1
457785,5,0,5,25,1
457785,5,0,5,40,1
457794,82,11,71,1,4
457794,82,11,71,2,1
457794,82,11,71,3,1
457794,82,11,71,5,1
457794,82,11,71,20,1
457794,75,7,68,21,4
457794,75,7,68,22,1
457794,75,7,68,23,1
457794,75,7,68,25,1
457794,75,7,68,40,1
457794,7,4,3,41,4
457794,7,4,3,42,1
457794,7,4,3,43,1
457794,7,4,3,45,1
457794,7,4,3,60,1
457800,363,84,279,1,4
457800,363,84,279,2,1
457800,363,84,279,3,1
457800,352,77,275,4,1
457800,11,7,4,5,1
457800,11,7,4,20,1
457800,90,23,67,21,4
457800,90,23,67,22,1
457800,90,23,67,23,1
457800,83,20,63,24,1
457800,7,3,4,25,1
457800,7,3,4,40,1
457800,273,61,212,41,4
457800,273,61,212,42,1
457800,273,61,212,43,1
457800,269,57,212,44,1
457800,4,4,0,45,1
457800,4,4,0,60,1
457819,614,253,361,1,4
457819,614,253,361,2,1
457819,614,253,361,3,1
457819,363,180,183,4,1
457819,251,73,178,5,1
457819,251,73,178,20,1
457819,13,8,5,21,4
457819,13,8,5,22,1
457819,13,8,5,23,1
457819,6,3,3,24,1
457819,7,5,2,25,1
457819,7,5,2,40,1
457819,601,245,356,41,4
457819,601,245,356,42,1
457819,601,245,356,43,1
457819,357,177,180,44,1
457819,244,68,176,45,1
457819,244,68,176,60,1
457828,42,13,29,1,4
457828,42,13,29,2,1
457828,42,13,29,3,1
457828,32,13,19,4,1
457828,10,0,10,5,1
457828,10,0,10,20,1
457828,42,13,29,21,4
457828,42,13,29,22,1
457828,42,13,29,23,1
457828,32,13,19,24,1
457828,10,0,10,25,1
457828,10,0,10,40,1
457837,109,3,106,1,4
457837,109,3,106,2,1
457837,109,3,106,3,1
457837,48,0,48,4,1
457837,61,3,58,5,1
457837,61,3,58,20,1
457837,55,1,54,21,4
457837,55,1,54,22,1
457837,55,1,54,23,1
457837,23,0,23,24,1
457837,32,1,31,25,1
457837,32,1,31,40,1
457837,54,2,52,41,4
457837,54,2,52,42,1
457837,54,2,52,43,1
457837,25,0,25,44,1
457837,29,2,27,45,1
457837,29,2,27,60,1
457846,74,13,61,1,4
457846,74,13,61,2,1
457846,74,13,61,3,1
457846,14,3,11,4,1
457846,60,10,50,5,1
457846,60,10,50,20,1
457846,14,1,13,21,4
457846,14,1,13,22,1
457846,14,1,13,23,1
457846,14,1,13,25,1
457846,14,1,13,40,1
457846,60,12,48,41,4
457846,60,12,48,42,1
457846,60,12,48,43,1
457846,14,3,11,44,1
457846,46,9,37,45,1
457846,46,9,37,60,1
457855,130,6,124,1,4
457855,130,6,124,2,1
457855,130,6,124,3,1
457855,23,0,23,4,1
457855,107,6,101,5,1
457855,107,6,101,20,1
457855,107,5,102,21,4
457855,107,5,102,22,1
457855,107,5,102,23,1
457855,21,0,21,24,1
457855,86,5,81,25,1
457855,86,5,81,40,1
457855,23,1,22,41,4
457855,23,1,22,42,1
457855,23,1,22,43,1
457855,2,0,2,44,1
457855,21,1,20,45,1
457855,21,1,20,60,1
457864,113,22,91,1,4
457864,113,22,91,2,1
457864,113,22,91,3,1
457864,42,20,22,4,1
457864,71,2,69,5,1
457864,71,2,69,20,1
457864,56,16,40,21,4
457864,56,16,40,22,1
457864,56,16,40,23,1
457864,30,16,14,24,1
457864,26,0,26,25,1
457864,26,0,26,40,1
457864,57,6,51,41,4
457864,57,6,51,42,1
457864,57,6,51,43,1
457864,12,4,8,44,1
457864,45,2,43,45,1
457864,45,2,43,60,1
457873,142,108,34,1,4
457873,142,108,34,2,1
457873,142,108,34,3,1
457873,16,8,8,4,1
457873,126,100,26,5,1
457873,126,100,26,20,1
457873,44,37,7,21,4
457873,44,37,7,22,1
457873,44,37,7,23,1
457873,44,37,7,25,1
457873,44,37,7,40,1
457873,98,71,27,41,4
457873,98,71,27,42,1
457873,98,71,27,43,1
457873,16,8,8,44,1
457873,82,63,19,45,1
457873,82,63,19,60,1
457891,53,1,52,1,4
457891,53,1,52,2,1
457891,53,1,52,3,1
457891,25,0,25,4,1
457891,28,1,27,5,1
457891,28,1,27,20,1
457891,53,1,52,21,4
457891,53,1,52,22,1
457891,53,1,52,23,1
457891,25,0,25,24,1
457891,28,1,27,25,1
457891,28,1,27,40,1
457916,76,4,72,1,4
457916,76,4,72,2,1
457916,76,4,72,3,1
457916,26,0,26,4,1
457916,50,4,46,5,1
457916,50,4,46,20,1
457916,48,3,45,21,4
457916,48,3,45,22,1
457916,48,3,45,23,1
457916,24,0,24,24,1
457916,24,3,21,25,1
457916,24,3,21,40,1
457916,28,1,27,41,4
457916,28,1,27,42,1
457916,28,1,27,43,1
457916,2,0,2,44,1
457916,26,1,25,45,1
457916,26,1,25,60,1
457925,22,12,10,1,4
457925,22,12,10,2,1
457925,22,12,10,3,1
457925,15,9,6,4,1
457925,7,3,4,5,1
457925,7,3,4,20,1
457925,22,12,10,21,4
457925,22,12,10,22,1
457925,22,12,10,23,1
457925,15,9,6,24,1
457925,7,3,4,25,1
457925,7,3,4,40,1
457943,100,57,43,1,4
457943,100,57,43,2,1
457943,100,57,43,3,1
457943,94,54,40,4,1
457943,6,3,3,5,1
457943,6,3,3,20,1
457943,100,57,43,21,4
457943,100,57,43,22,1
457943,100,57,43,23,1
457943,94,54,40,24,1
457943,6,3,3,25,1
457943,6,3,3,40,1
457952,206,9,197,1,4
457952,206,9,197,2,1
457952,206,9,197,3,1
457952,61,3,58,4,1
457952,145,6,139,5,1
457952,145,6,139,20,1
457952,157,5,152,21,4
457952,157,5,152,22,1
457952,157,5,152,23,1
457952,52,2,50,24,1
457952,105,3,102,25,1
457952,105,3,102,40,1
457952,49,4,45,41,4
457952,49,4,45,42,1
457952,49,4,45,43,1
457952,9,1,8,44,1
457952,40,3,37,45,1
457952,40,3,37,60,1
457961,56,5,51,1,4
457961,56,5,51,2,1
457961,56,5,51,3,1
457961,40,3,37,4,1
457961,16,2,14,5,1
457961,16,2,14,20,1
457961,56,5,51,21,4
457961,56,5,51,22,1
457961,56,5,51,23,1
457961,40,3,37,24,1
457961,16,2,14,25,1
457961,16,2,14,40,1
457989,50,2,48,1,4
457989,50,2,48,2,1
457989,50,2,48,3,1
457989,27,2,25,4,1
457989,23,0,23,5,1
457989,23,0,23,20,1
457989,50,2,48,21,4
457989,50,2,48,22,1
457989,50,2,48,23,1
457989,27,2,25,24,1
457989,23,0,23,25,1
457989,23,0,23,40,1
457998,33,0,33,1,4
457998,33,0,33,2,1
457998,33,0,33,3,1
457998,16,0,16,4,1
457998,17,0,17,5,1
457998,17,0,17,20,1
457998,28,0,28,21,4
457998,28,0,28,22,1
457998,28,0,28,23,1
457998,14,0,14,24,1
457998,14,0,14,25,1
457998,14,0,14,40,1
457998,5,0,5,41,4
457998,5,0,5,42,1
457998,5,0,5,43,1
457998,2,0,2,44,1
457998,3,0,3,45,1
457998,3,0,3,60,1
458007,53,1,52,1,4
458007,53,1,52,2,1
458007,53,1,52,3,1
458007,37,1,36,4,1
458007,16,0,16,5,1
458007,16,0,16,20,1
458007,46,1,45,21,4
458007,46,1,45,22,1
458007,46,1,45,23,1
458007,32,1,31,24,1
458007,14,0,14,25,1
458007,14,0,14,40,1
458007,7,0,7,41,4
458007,7,0,7,42,1
458007,7,0,7,43,1
458007,5,0,5,44,1
458007,2,0,2,45,1
458007,2,0,2,60,1
458016,114,99,15,1,4
458016,114,99,15,2,1
458016,114,99,15,3,1
458016,96,82,14,4,1
458016,18,17,1,5,1
458016,18,17,1,20,1
458016,114,99,15,21,4
458016,114,99,15,22,1
458016,114,99,15,23,1
458016,96,82,14,24,1
458016,18,17,1,25,1
458016,18,17,1,40,1
458025,11,5,6,1,4
458025,11,5,6,2,1
458025,11,5,6,3,1
458025,9,4,5,4,1
458025,2,1,1,5,1
458025,2,1,1,20,1
458025,11,5,6,21,4
458025,11,5,6,22,1
458025,11,5,6,23,1
458025,9,4,5,24,1
458025,2,1,1,25,1
458025,2,1,1,40,1
458034,61,16,45,1,4
458034,61,16,45,2,1
458034,61,16,45,3,1
458034,17,2,15,4,1
458034,44,14,30,5,1
458034,44,14,30,20,1
458034,52,15,37,21,4
458034,52,15,37,22,1
458034,52,15,37,23,1
458034,14,2,12,24,1
458034,38,13,25,25,1
458034,38,13,25,40,1
458034,9,1,8,41,4
458034,9,1,8,42,1
458034,9,1,8,43,1
458034,3,0,3,44,1
458034,6,1,5,45,1
458034,6,1,5,60,1
458043,91,1,90,1,4
458043,91,1,90,2,1
458043,91,1,90,3,1
458043,8,0,8,4,1
458043,83,1,82,5,1
458043,83,1,82,20,1
458043,76,1,75,21,4
458043,76,1,75,22,1
458043,76,1,75,23,1
458043,7,0,7,24,1
458043,69,1,68,25,1
458043,69,1,68,40,1
458043,15,0,15,41,4
458043,15,0,15,42,1
458043,15,0,15,43,1
458043,1,0,1,44,1
458043,14,0,14,45,1
458043,14,0,14,60,1
458052,60,1,59,1,4
458052,60,1,59,2,1
458052,60,1,59,3,1
458052,7,0,7,4,1
458052,53,1,52,5,1
458052,53,1,52,20,1
458052,60,1,59,41,4
458052,60,1,59,42,1
458052,60,1,59,43,1
458052,7,0,7,44,1
458052,53,1,52,45,1
458052,53,1,52,60,1
458061,89,16,73,1,4
458061,89,16,73,2,1
458061,89,16,73,3,1
458061,69,13,56,4,1
458061,20,3,17,5,1
458061,20,3,17,20,1
458061,15,3,12,21,4
458061,15,3,12,22,1
458061,15,3,12,23,1
458061,8,2,6,24,1
458061,7,1,6,25,1
458061,7,1,6,40,1
458061,74,13,61,41,4
458061,74,13,61,42,1
458061,74,13,61,43,1
458061,61,11,50,44,1
458061,13,2,11,45,1
458061,13,2,11,60,1
458070,241,21,220,1,4
458070,241,21,220,2,1
458070,241,21,220,3,1
458070,7,0,7,4,1
458070,234,21,213,5,1
458070,234,21,213,20,1
458070,175,17,158,21,4
458070,175,17,158,22,1
458070,175,17,158,23,1
458070,4,0,4,24,1
458070,171,17,154,25,1
458070,171,17,154,40,1
458070,66,4,62,41,4
458070,66,4,62,42,1
458070,66,4,62,43,1
458070,3,0,3,44,1
458070,63,4,59,45,1
458070,63,4,59,60,1
458098,80,7,73,1,4
458098,80,7,73,2,1
458098,80,7,73,3,1
458098,15,2,13,4,1
458098,65,5,60,5,1
458098,65,5,60,20,1
458098,80,7,73,21,4
458098,80,7,73,22,1
458098,80,7,73,23,1
458098,15,2,13,24,1
458098,65,5,60,25,1
458098,65,5,60,40,1
458104,70,2,68,1,4
458104,70,2,68,2,1
458104,70,2,68,3,1
458104,33,1,32,4,1
458104,37,1,36,5,1
458104,37,1,36,20,1
458104,36,0,36,21,4
458104,36,0,36,22,1
458104,36,0,36,23,1
458104,20,0,20,24,1
458104,16,0,16,25,1
458104,16,0,16,40,1
458104,34,2,32,41,4
458104,34,2,32,42,1
458104,34,2,32,43,1
458104,13,1,12,44,1
458104,21,1,20,45,1
458104,21,1,20,60,1
458113,54,27,27,1,4
458113,54,27,27,2,1
458113,54,27,27,3,1
458113,5,3,2,4,1
458113,49,24,25,5,1
458113,8,5,3,19,1
458113,41,19,22,20,1
458113,28,13,15,21,4
458113,28,13,15,22,1
458113,28,13,15,23,1
458113,3,2,1,24,1
458113,25,11,14,25,1
458113,4,2,2,39,1
458113,21,9,12,40,1
458113,26,14,12,41,4
458113,26,14,12,42,1
458113,26,14,12,43,1
458113,2,1,1,44,1
458113,24,13,11,45,1
458113,4,3,1,59,1
458113,20,10,10,60,1
458122,1,0,1,1,4
458122,1,0,1,2,1
458122,1,0,1,3,1
458122,1,0,1,5,1
458122,1,0,1,20,1
458122,1,0,1,21,4
458122,1,0,1,22,1
458122,1,0,1,23,1
458122,1,0,1,25,1
458122,1,0,1,40,1
458131,287,28,259,1,4
458131,287,28,259,2,1
458131,287,28,259,3,1
458131,83,6,77,4,1
458131,204,22,182,5,1
458131,204,22,182,20,1
458131,287,28,259,21,4
458131,287,28,259,22,1
458131,287,28,259,23,1
458131,83,6,77,24,1
458131,204,22,182,25,1
458131,204,22,182,40,1
458140,52,49,3,1,4
458140,52,49,3,2,1
458140,52,49,3,3,1
458140,13,13,0,4,1
458140,39,36,3,5,1
458140,39,36,3,19,1
458140,52,49,3,21,4
458140,52,49,3,22,1
458140,52,49,3,23,1
458140,13,13,0,24,1
458140,39,36,3,25,1
458140,39,36,3,39,1
458159,143,55,88,1,4
458159,143,55,88,12,3
458159,129,48,81,21,4
458159,129,48,81,32,3
458159,14,7,7,41,4
458159,14,7,7,52,3
458168,87,3,84,1,4
458168,87,3,84,2,1
458168,87,3,84,3,1
458168,51,3,48,4,1
458168,36,0,36,5,1
458168,36,0,36,20,1
458168,86,3,83,21,4
458168,86,3,83,22,1
458168,86,3,83,23,1
458168,50,3,47,24,1
458168,36,0,36,25,1
458168,36,0,36,40,1
458168,1,0,1,41,4
458168,1,0,1,42,1
458168,1,0,1,43,1
458168,1,0,1,44,1
458177,86,2,84,1,4
458177,86,2,84,2,1
458177,86,2,84,3,1
458177,25,1,24,4,1
458177,61,1,60,5,1
458177,61,1,60,20,1
458177,61,2,59,21,4
458177,61,2,59,22,1
458177,61,2,59,23,1
458177,19,1,18,24,1
458177,42,1,41,25,1
458177,42,1,41,40,1
458177,25,0,25,41,4
458177,25,0,25,42,1
458177,25,0,25,43,1
458177,6,0,6,44,1
458177,19,0,19,45,1
458177,19,0,19,60,1
458186,299,89,210,1,4
458186,299,89,210,2,1
458186,299,89,210,3,1
458186,56,13,43,4,1
458186,243,76,167,5,1
458186,23,7,16,19,1
458186,220,69,151,20,1
458186,299,89,210,21,4
458186,299,89,210,22,1
458186,299,89,210,23,1
458186,56,13,43,24,1
458186,243,76,167,25,1
458186,23,7,16,39,1
458186,220,69,151,40,1
458195,3,1,2,1,4
458195,3,1,2,2,1
458195,3,1,2,3,1
458195,1,0,1,4,1
458195,2,1,1,5,1
458195,2,1,1,20,1
458195,3,1,2,21,4
458195,3,1,2,22,1
458195,3,1,2,23,1
458195,1,0,1,24,1
458195,2,1,1,25,1
458195,2,1,1,40,1
458210,1528,351,1177,1,4
458210,1528,351,1177,2,1
458210,1528,351,1177,3,1
458210,23,9,14,4,1
458210,1505,342,1163,5,1
458210,145,27,118,19,1
458210,1360,315,1045,20,1
458210,1418,326,1092,21,4
458210,1418,326,1092,22,1
458210,1418,326,1092,23,1
458210,22,8,14,24,1
458210,1396,318,1078,25,1
458210,143,26,117,39,1
458210,1253,292,961,40,1
458210,110,25,85,41,4
458210,110,25,85,42,1
458210,110,25,85,43,1
458210,1,1,0,44,1
458210,109,24,85,45,1
458210,2,1,1,59,1
458210,107,23,84,60,1
458229,1103,282,821,1,4
458229,1103,282,821,2,1
458229,1103,282,821,3,1
458229,12,4,8,4,1
458229,1091,278,813,5,1
458229,118,29,89,19,1
458229,973,249,724,20,1
458229,1041,265,776,21,4
458229,1041,265,776,22,1
458229,1041,265,776,23,1
458229,12,4,8,24,1
458229,1029,261,768,25,1
458229,114,29,85,39,1
458229,915,232,683,40,1
458229,62,17,45,41,4
458229,62,17,45,42,1
458229,62,17,45,43,1
458229,62,17,45,45,1
458229,4,0,4,59,1
458229,58,17,41,60,1
458247,309,37,272,1,4
458247,309,37,272,2,1
458247,309,37,272,3,1
458247,79,7,72,4,1
458247,230,30,200,5,1
458247,12,5,7,19,1
458247,218,25,193,20,1
458247,309,37,272,21,4
458247,309,37,272,22,1
458247,309,37,272,23,1
458247,79,7,72,24,1
458247,230,30,200,25,1
458247,12,5,7,39,1
458247,218,25,193,40,1
458256,902,95,807,1,4
458256,902,95,807,2,1
458256,902,95,807,3,1
458256,445,51,394,4,1
458256,457,44,413,5,1
458256,457,44,413,20,1
458256,576,66,510,21,4
458256,576,66,510,22,1
458256,576,66,510,23,1
458256,298,35,263,24,1
458256,278,31,247,25,1
458256,278,31,247,40,1
458256,326,29,297,41,4
458256,326,29,297,42,1
458256,326,29,297,43,1
458256,147,16,131,44,1
458256,179,13,166,45,1
458256,179,13,166,60,1
458265,849,419,430,1,4
458265,849,419,430,2,1
458265,849,419,430,3,1
458265,323,154,169,4,1
458265,526,265,261,5,1
458265,526,265,261,20,1
458265,596,293,303,21,4
458265,596,293,303,22,1
458265,596,293,303,23,1
458265,204,94,110,24,1
458265,392,199,193,25,1
458265,392,199,193,40,1
458265,253,126,127,41,4
458265,253,126,127,42,1
458265,253,126,127,43,1
458265,119,60,59,44,1
458265,134,66,68,45,1
458265,134,66,68,60,1
458274,305,21,284,1,4
458274,305,21,284,2,1
458274,305,21,284,3,1
458274,44,2,42,4,1
458274,261,19,242,5,1
458274,261,19,242,20,1
458274,222,16,206,21,4
458274,222,16,206,22,1
458274,222,16,206,23,1
458274,35,1,34,24,1
458274,187,15,172,25,1
458274,187,15,172,40,1
458274,83,5,78,41,4
458274,83,5,78,42,1
458274,83,5,78,43,1
458274,9,1,8,44,1
458274,74,4,70,45,1
458274,74,4,70,60,1
458283,478,65,413,1,4
458283,478,65,413,2,1
458283,478,65,413,3,1
458283,94,3,91,4,1
458283,384,62,322,5,1
458283,56,7,49,19,1
458283,328,55,273,20,1
458283,478,65,413,21,4
458283,478,65,413,22,1
458283,478,65,413,23,1
458283,94,3,91,24,1
458283,384,62,322,25,1
458283,56,7,49,39,1
458283,328,55,273,40,1
458292,65,0,65,1,4
458292,65,0,65,2,1
458292,65,0,65,3,1
458292,22,0,22,4,1
458292,43,0,43,5,1
458292,43,0,43,20,1
458292,44,0,44,21,4
458292,44,0,44,22,1
458292,44,0,44,23,1
458292,18,0,18,24,1
458292,26,0,26,25,1
458292,26,0,26,40,1
458292,21,0,21,41,4
458292,21,0,21,42,1
458292,21,0,21,43,1
458292,4,0,4,44,1
458292,17,0,17,45,1
458292,17,0,17,60,1
458308,15,0,15,1,4
458308,15,0,15,2,1
458308,15,0,15,3,1
458308,4,0,4,4,1
458308,11,0,11,5,1
458308,11,0,11,20,1
458308,15,0,15,21,4
458308,15,0,15,22,1
458308,15,0,15,23,1
458308,4,0,4,24,1
458308,11,0,11,25,1
458308,11,0,11,40,1
458317,107,1,106,1,4
458317,107,1,106,2,1
458317,107,1,106,3,1
458317,37,0,37,4,1
458317,70,1,69,5,1
458317,70,1,69,20,1
458317,107,1,106,21,4
458317,107,1,106,22,1
458317,107,1,106,23,1
458317,37,0,37,24,1
458317,70,1,69,25,1
458317,70,1,69,40,1
458326,72,3,69,1,4
458326,72,3,69,2,1
458326,72,3,69,3,1
458326,24,0,24,4,1
458326,48,3,45,5,1
458326,48,3,45,20,1
458326,58,2,56,21,4
458326,58,2,56,22,1
458326,58,2,56,23,1
458326,20,0,20,24,1
458326,38,2,36,25,1
458326,38,2,36,40,1
458326,14,1,13,41,4
458326,14,1,13,42,1
458326,14,1,13,43,1
458326,4,0,4,44,1
458326,10,1,9,45,1
458326,10,1,9,60,1
458335,138,2,136,1,4
458335,138,2,136,2,1
458335,138,2,136,3,1
458335,59,0,59,4,1
458335,79,2,77,5,1
458335,79,2,77,20,1
458335,91,1,90,21,4
458335,91,1,90,22,1
458335,91,1,90,23,1
458335,40,0,40,24,1
458335,51,1,50,25,1
458335,51,1,50,40,1
458335,47,1,46,41,4
458335,47,1,46,42,1
458335,47,1,46,43,1
458335,19,0,19,44,1
458335,28,1,27,45,1
458335,28,1,27,60,1
458344,50,1,49,1,4
458344,50,1,49,2,1
458344,50,1,49,3,1
458344,13,1,12,4,1
458344,37,0,37,5,1
458344,37,0,37,20,1
458344,37,1,36,21,4
458344,37,1,36,22,1
458344,37,1,36,23,1
458344,10,1,9,24,1
458344,27,0,27,25,1
458344,27,0,27,40,1
458344,13,0,13,41,4
458344,13,0,13,42,1
458344,13,0,13,43,1
458344,3,0,3,44,1
458344,10,0,10,45,1
458344,10,0,10,60,1
458353,58,4,54,1,4
458353,58,4,54,2,1
458353,58,4,54,3,1
458353,15,1,14,4,1
458353,43,3,40,5,1
458353,43,3,40,20,1
458353,48,3,45,21,4
458353,48,3,45,22,1
458353,48,3,45,23,1
458353,11,1,10,24,1
458353,37,2,35,25,1
458353,37,2,35,40,1
458353,10,1,9,41,4
458353,10,1,9,42,1
458353,10,1,9,43,1
458353,4,0,4,44,1
458353,6,1,5,45,1
458353,6,1,5,60,1
458362,77,1,76,1,4
458362,77,1,76,2,1
458362,77,1,76,3,1
458362,27,0,27,4,1
458362,50,1,49,5,1
458362,50,1,49,20,1
458362,77,1,76,21,4
458362,77,1,76,22,1
458362,77,1,76,23,1
458362,27,0,27,24,1
458362,50,1,49,25,1
458362,50,1,49,40,1
458371,36,16,20,1,4
458371,36,16,20,2,1
458371,36,16,20,3,1
458371,36,16,20,5,1
458371,36,16,20,20,1
458371,36,16,20,21,4
458371,36,16,20,22,1
458371,36,16,20,23,1
458371,36,16,20,25,1
458371,36,16,20,40,1
458380,229,32,197,1,4
458380,229,32,197,2,1
458380,229,32,197,3,1
458380,89,16,73,4,1
458380,140,16,124,5,1
458380,140,16,124,20,1
458380,229,32,197,21,4
458380,229,32,197,22,1
458380,229,32,197,23,1
458380,89,16,73,24,1
458380,140,16,124,25,1
458380,140,16,124,40,1
458399,59,4,55,1,4
458399,59,4,55,2,1
458399,59,4,55,3,1
458399,39,4,35,4,1
458399,20,0,20,5,1
458399,20,0,20,20,1
458399,49,4,45,21,4
458399,49,4,45,22,1
458399,49,4,45,23,1
458399,34,4,30,24,1
458399,15,0,15,25,1
458399,15,0,15,40,1
458399,10,0,10,41,4
458399,10,0,10,42,1
458399,10,0,10,43,1
458399,5,0,5,44,1
458399,5,0,5,45,1
458399,5,0,5,60,1
458405,734,139,595,1,4
458405,734,139,595,2,1
458405,734,139,595,3,1
458405,220,53,167,4,1
458405,514,86,428,5,1
458405,88,10,78,19,1
458405,426,76,350,20,1
458405,573,116,457,21,4
458405,573,116,457,22,1
458405,573,116,457,23,1
458405,186,47,139,24,1
458405,387,69,318,25,1
458405,73,7,66,39,1
458405,314,62,252,40,1
458405,161,23,138,41,4
458405,161,23,138,42,1
458405,161,23,138,43,1
458405,34,6,28,44,1
458405,127,17,110,45,1
458405,15,3,12,59,1
458405,112,14,98,60,1
458414,1335,398,937,1,4
458414,1335,398,937,2,1
458414,1335,398,937,3,1
458414,1170,339,831,4,1
458414,165,59,106,5,1
458414,165,59,106,20,1
458414,1335,398,937,21,4
458414,1335,398,937,22,1
458414,1335,398,937,23,1
458414,1170,339,831,24,1
458414,165,59,106,25,1
458414,165,59,106,40,1
458423,96,26,70,1,4
458423,96,26,70,2,1
458423,96,26,70,3,1
458423,4,1,3,4,1
458423,92,25,67,5,1
458423,92,25,67,20,1
458423,96,26,70,41,4
458423,96,26,70,42,1
458423,96,26,70,43,1
458423,4,1,3,44,1
458423,92,25,67,45,1
458423,92,25,67,60,1
458432,244,43,201,1,4
458432,244,43,201,2,1
458432,244,43,201,3,1
458432,36,10,26,4,1
458432,208,33,175,5,1
458432,30,8,22,19,1
458432,178,25,153,20,1
458432,168,26,142,21,4
458432,168,26,142,22,1
458432,168,26,142,23,1
458432,28,7,21,24,1
458432,140,19,121,25,1
458432,20,3,17,39,1
458432,120,16,104,40,1
458432,76,17,59,41,4
458432,76,17,59,42,1
458432,76,17,59,43,1
458432,8,3,5,44,1
458432,68,14,54,45,1
458432,10,5,5,59,1
458432,58,9,49,60,1
458441,504,89,415,1,4
458441,504,89,415,2,1
458441,504,89,415,3,1
458441,125,24,101,4,1
458441,379,65,314,5,1
458441,44,13,31,19,1
458441,335,52,283,20,1
458441,342,63,279,21,4
458441,342,63,279,22,1
458441,342,63,279,23,1
458441,88,18,70,24,1
458441,254,45,209,25,1
458441,30,10,20,39,1
458441,224,35,189,40,1
458441,162,26,136,41,4
458441,162,26,136,42,1
458441,162,26,136,43,1
458441,37,6,31,44,1
458441,125,20,105,45,1
458441,14,3,11,59,1
458441,111,17,94,60,1
458469,1118,323,795,1,4
458469,1118,323,795,2,1
458469,1117,323,794,3,1
458469,245,78,167,4,1
458469,872,245,627,5,1
458469,1,0,1,11,1
458469,127,43,84,19,1
458469,745,202,543,20,1
458469,904,269,635,21,4
458469,904,269,635,22,1
458469,904,269,635,23,1
458469,196,64,132,24,1
458469,708,205,503,25,1
458469,92,29,63,39,1
458469,616,176,440,40,1
458469,214,54,160,41,4
458469,214,54,160,42,1
458469,213,54,159,43,1
458469,49,14,35,44,1
458469,164,40,124,45,1
458469,1,0,1,51,1
458469,35,14,21,59,1
458469,129,26,103,60,1
458478,304,37,267,1,4
458478,304,37,267,2,1
458478,304,37,267,3,1
458478,68,10,58,4,1
458478,236,27,209,5,1
458478,236,27,209,20,1
458478,304,37,267,21,4
458478,304,37,267,22,1
458478,304,37,267,23,1
458478,68,10,58,24,1
458478,236,27,209,25,1
458478,236,27,209,40,1
458487,161,11,150,1,4
458487,161,11,150,2,1
458487,161,11,150,3,1
458487,10,2,8,4,1
458487,151,9,142,5,1
458487,151,9,142,20,1
458487,107,7,100,21,4
458487,107,7,100,22,1
458487,107,7,100,23,1
458487,5,1,4,24,1
458487,102,6,96,25,1
458487,102,6,96,40,1
458487,54,4,50,41,4
458487,54,4,50,42,1
458487,54,4,50,43,1
458487,5,1,4,44,1
458487,49,3,46,45,1
458487,49,3,46,60,1
458496,663,279,384,1,4
458496,663,279,384,2,1
458496,663,279,384,3,1
458496,135,55,80,4,1
458496,528,224,304,5,1
458496,119,36,83,19,1
458496,409,188,221,20,1
458496,528,219,309,21,4
458496,528,219,309,22,1
458496,528,219,309,23,1
458496,95,37,58,24,1
458496,433,182,251,25,1
458496,95,30,65,39,1
458496,338,152,186,40,1
458496,135,60,75,41,4
458496,135,60,75,42,1
458496,135,60,75,43,1
458496,40,18,22,44,1
458496,95,42,53,45,1
458496,24,6,18,59,1
458496,71,36,35,60,1
458502,589,98,491,1,4
458502,589,98,491,2,1
458502,589,98,491,3,1
458502,95,14,81,4,1
458502,494,84,410,5,1
458502,114,14,100,19,1
458502,380,70,310,20,1
458502,334,59,275,21,4
458502,334,59,275,22,1
458502,334,59,275,23,1
458502,88,14,74,24,1
458502,246,45,201,25,1
458502,93,11,82,39,1
458502,153,34,119,40,1
458502,255,39,216,41,4
458502,255,39,216,42,1
458502,255,39,216,43,1
458502,7,0,7,44,1
458502,248,39,209,45,1
458502,21,3,18,59,1
458502,227,36,191,60,1
458557,368,29,339,1,4
458557,368,29,339,2,1
458557,368,29,339,3,1
458557,22,2,20,4,1
458557,346,27,319,5,1
458557,62,5,57,19,1
458557,284,22,262,20,1
458557,271,21,250,21,4
458557,271,21,250,22,1
458557,271,21,250,23,1
458557,17,2,15,24,1
458557,254,19,235,25,1
458557,52,3,49,39,1
458557,202,16,186,40,1
458557,97,8,89,41,4
458557,97,8,89,42,1
458557,97,8,89,43,1
458557,5,0,5,44,1
458557,92,8,84,45,1
458557,10,2,8,59,1
458557,82,6,76,60,1
458593,550,69,481,1,4
458593,550,69,481,2,1
458593,550,69,481,3,1
458593,224,28,196,4,1
458593,326,41,285,5,1
458593,326,41,285,20,1
458593,381,45,336,21,4
458593,381,45,336,22,1
458593,381,45,336,23,1
458593,168,19,149,24,1
458593,213,26,187,25,1
458593,213,26,187,40,1
458593,169,24,145,41,4
458593,169,24,145,42,1
458593,169,24,145,43,1
458593,56,9,47,44,1
458593,113,15,98,45,1
458593,113,15,98,60,1
458609,107,9,98,1,4
458609,107,9,98,2,1
458609,107,9,98,3,1
458609,107,9,98,5,1
458609,107,9,98,20,1
458609,91,9,82,21,4
458609,91,9,82,22,1
458609,91,9,82,23,1
458609,91,9,82,25,1
458609,91,9,82,40,1
458609,16,0,16,41,4
458609,16,0,16,42,1
458609,16,0,16,43,1
458609,16,0,16,45,1
458609,16,0,16,60,1
458618,57,1,56,1,4
458618,57,1,56,2,1
458618,57,1,56,3,1
458618,57,1,56,5,1
458618,57,1,56,20,1
458618,52,1,51,21,4
458618,52,1,51,22,1
458618,52,1,51,23,1
458618,52,1,51,25,1
458618,52,1,51,40,1
458618,5,0,5,41,4
458618,5,0,5,42,1
458618,5,0,5,43,1
458618,5,0,5,45,1
458618,5,0,5,60,1
458627,36,6,30,1,4
458627,36,6,30,2,1
458627,36,6,30,3,1
458627,36,6,30,5,1
458627,36,6,30,20,1
458627,36,6,30,21,4
458627,36,6,30,22,1
458627,36,6,30,23,1
458627,36,6,30,25,1
458627,36,6,30,40,1
458636,41,2,39,1,4
458636,41,2,39,2,1
458636,41,2,39,3,1
458636,41,2,39,5,1
458636,41,2,39,20,1
458636,41,2,39,21,4
458636,41,2,39,22,1
458636,41,2,39,23,1
458636,41,2,39,25,1
458636,41,2,39,40,1
458645,45,1,44,1,4
458645,45,1,44,2,1
458645,45,1,44,3,1
458645,45,1,44,5,1
458645,45,1,44,20,1
458645,45,1,44,21,4
458645,45,1,44,22,1
458645,45,1,44,23,1
458645,45,1,44,25,1
458645,45,1,44,40,1
458654,291,37,254,1,4
458654,291,37,254,2,1
458654,291,37,254,3,1
458654,40,6,34,4,1
458654,251,31,220,5,1
458654,16,3,13,19,1
458654,235,28,207,20,1
458654,288,37,251,21,4
458654,288,37,251,22,1
458654,288,37,251,23,1
458654,40,6,34,24,1
458654,248,31,217,25,1
458654,16,3,13,39,1
458654,232,28,204,40,1
458654,3,0,3,41,4
458654,3,0,3,42,1
458654,3,0,3,43,1
458654,3,0,3,45,1
458654,3,0,3,60,1
458663,107,14,93,1,4
458663,107,14,93,2,1
458663,107,14,93,3,1
458663,107,14,93,5,1
458663,107,14,93,20,1
458663,90,13,77,21,4
458663,90,13,77,22,1
458663,90,13,77,23,1
458663,90,13,77,25,1
458663,90,13,77,40,1
458663,17,1,16,41,4
458663,17,1,16,42,1
458663,17,1,16,43,1
458663,17,1,16,45,1
458663,17,1,16,60,1
458681,172,44,128,1,4
458681,172,44,128,2,1
458681,172,44,128,3,1
458681,34,8,26,4,1
458681,138,36,102,5,1
458681,11,0,11,19,1
458681,127,36,91,20,1
458681,172,44,128,21,4
458681,172,44,128,22,1
458681,172,44,128,23,1
458681,34,8,26,24,1
458681,138,36,102,25,1
458681,11,0,11,39,1
458681,127,36,91,40,1
458690,422,72,350,1,4
458690,422,72,350,2,1
458690,416,72,344,3,1
458690,135,13,122,4,1
458690,281,59,222,5,1
458690,6,0,6,11,1
458690,15,3,12,19,1
458690,266,56,210,20,1
458690,422,72,350,21,4
458690,422,72,350,22,1
458690,416,72,344,23,1
458690,135,13,122,24,1
458690,281,59,222,25,1
458690,6,0,6,31,1
458690,15,3,12,39,1
458690,266,56,210,40,1
458706,382,23,359,1,4
458706,382,23,359,2,1
458706,382,23,359,3,1
458706,48,6,42,4,1
458706,334,17,317,5,1
458706,85,6,79,19,1
458706,249,11,238,20,1
458706,382,23,359,21,4
458706,382,23,359,22,1
458706,382,23,359,23,1
458706,48,6,42,24,1
458706,334,17,317,25,1
458706,85,6,79,39,1
458706,249,11,238,40,1
458715,278,54,224,1,4
458715,278,54,224,2,1
458715,278,54,224,3,1
458715,30,3,27,4,1
458715,248,51,197,5,1
458715,39,11,28,19,1
458715,209,40,169,20,1
458715,278,54,224,21,4
458715,278,54,224,22,1
458715,278,54,224,23,1
458715,30,3,27,24,1
458715,248,51,197,25,1
458715,39,11,28,39,1
458715,209,40,169,40,1
458733,266,51,215,1,4
458733,266,51,215,2,1
458733,261,51,210,3,1
458733,27,7,20,4,1
458733,234,44,190,5,1
458733,5,0,5,11,1
458733,50,8,42,19,1
458733,184,36,148,20,1
458733,197,40,157,21,4
458733,197,40,157,22,1
458733,195,40,155,23,1
458733,27,7,20,24,1
458733,168,33,135,25,1
458733,2,0,2,31,1
458733,46,7,39,39,1
458733,122,26,96,40,1
458733,69,11,58,41,4
458733,69,11,58,42,1
458733,66,11,55,43,1
458733,66,11,55,45,1
458733,3,0,3,51,1
458733,4,1,3,59,1
458733,62,10,52,60,1
458742,203,61,142,1,4
458742,203,61,142,2,1
458742,197,60,137,3,1
458742,17,8,9,4,1
458742,180,52,128,5,1
458742,6,1,5,11,1
458742,37,7,30,19,1
458742,143,45,98,20,1
458742,148,53,95,21,4
458742,148,53,95,22,1
458742,147,52,95,23,1
458742,16,8,8,24,1
458742,131,44,87,25,1
458742,1,1,0,31,1
458742,30,6,24,39,1
458742,101,38,63,40,1
458742,55,8,47,41,4
458742,55,8,47,42,1
458742,50,8,42,43,1
458742,1,0,1,44,1
458742,49,8,41,45,1
458742,5,0,5,51,1
458742,7,1,6,59,1
458742,42,7,35,60,1
458751,243,36,207,1,4
458751,243,36,207,2,1
458751,235,33,202,3,1
458751,37,6,31,4,1
458751,198,27,171,5,1
458751,8,3,5,11,1
458751,40,8,32,19,1
458751,158,19,139,20,1
458751,171,25,146,21,4
458751,171,25,146,22,1
458751,169,24,145,23,1
458751,36,6,30,24,1
458751,133,18,115,25,1
458751,2,1,1,31,1
458751,35,6,29,39,1
458751,98,12,86,40,1
458751,72,11,61,41,4
458751,72,11,61,42,1
458751,66,9,57,43,1
458751,1,0,1,44,1
458751,65,9,56,45,1
458751,6,2,4,51,1
458751,5,2,3,59,1
458751,60,7,53,60,1
458760,216,42,174,1,4
458760,216,42,174,2,1
458760,211,40,171,3,1
458760,28,3,25,4,1
458760,183,37,146,5,1
458760,5,2,3,11,1
458760,36,5,31,19,1
458760,147,32,115,20,1
458760,162,34,128,21,4
458760,162,34,128,22,1
458760,159,33,126,23,1
458760,25,3,22,24,1
458760,134,30,104,25,1
458760,3,1,2,31,1
458760,29,5,24,39,1
458760,105,25,80,40,1
458760,54,8,46,41,4
458760,54,8,46,42,1
458760,52,7,45,43,1
458760,3,0,3,44,1
458760,49,7,42,45,1
458760,2,1,1,51,1
458760,7,0,7,59,1
458760,42,7,35,60,1
458779,194,31,163,1,4
458779,194,31,163,2,1
458779,181,28,153,3,1
458779,18,3,15,4,1
458779,163,25,138,5,1
458779,13,3,10,11,1
458779,27,3,24,19,1
458779,136,22,114,20,1
458779,137,23,114,21,4
458779,137,23,114,22,1
458779,133,21,112,23,1
458779,16,3,13,24,1
458779,117,18,99,25,1
458779,4,2,2,31,1
458779,26,2,24,39,1
458779,91,16,75,40,1
458779,57,8,49,41,4
458779,57,8,49,42,1
458779,48,7,41,43,1
458779,2,0,2,44,1
458779,46,7,39,45,1
458779,9,1,8,51,1
458779,1,1,0,59,1
458779,45,6,39,60,1
458797,303,43,260,1,4
458797,303,43,260,2,1
458797,303,43,260,3,1
458797,52,8,44,4,1
458797,251,35,216,5,1
458797,34,8,26,19,1
458797,217,27,190,20,1
458797,303,43,260,21,4
458797,303,43,260,22,1
458797,303,43,260,23,1
458797,52,8,44,24,1
458797,251,35,216,25,1
458797,34,8,26,39,1
458797,217,27,190,40,1
458803,169,5,164,1,4
458803,169,5,164,2,1
458803,169,5,164,3,1
458803,55,3,52,4,1
458803,114,2,112,5,1
458803,114,2,112,20,1
458803,129,5,124,21,4
458803,129,5,124,22,1
458803,129,5,124,23,1
458803,46,3,43,24,1
458803,83,2,81,25,1
458803,83,2,81,40,1
458803,40,0,40,41,4
458803,40,0,40,42,1
458803,40,0,40,43,1
458803,9,0,9,44,1
458803,31,0,31,45,1
458803,31,0,31,60,1
458812,65,0,65,1,4
458812,65,0,65,2,1
458812,65,0,65,3,1
458812,13,0,13,4,1
458812,52,0,52,5,1
458812,52,0,52,20,1
458812,65,0,65,21,4
458812,65,0,65,22,1
458812,65,0,65,23,1
458812,13,0,13,24,1
458812,52,0,52,25,1
458812,52,0,52,40,1
458821,94,13,81,1,4
458821,94,13,81,2,1
458821,94,13,81,3,1
458821,63,7,56,4,1
458821,31,6,25,5,1
458821,31,6,25,20,1
458821,94,13,81,21,4
458821,94,13,81,22,1
458821,94,13,81,23,1
458821,63,7,56,24,1
458821,31,6,25,25,1
458821,31,6,25,40,1
458830,197,15,182,1,4
458830,197,15,182,2,1
458830,197,15,182,3,1
458830,82,6,76,4,1
458830,115,9,106,5,1
458830,115,9,106,20,1
458830,127,9,118,21,4
458830,127,9,118,22,1
458830,127,9,118,23,1
458830,61,3,58,24,1
458830,66,6,60,25,1
458830,66,6,60,40,1
458830,70,6,64,41,4
458830,70,6,64,42,1
458830,70,6,64,43,1
458830,21,3,18,44,1
458830,49,3,46,45,1
458830,49,3,46,60,1
458849,130,13,117,1,4
458849,130,13,117,2,1
458849,130,13,117,3,1
458849,41,3,38,4,1
458849,89,10,79,5,1
458849,89,10,79,20,1
458849,99,10,89,21,4
458849,99,10,89,22,1
458849,99,10,89,23,1
458849,32,3,29,24,1
458849,67,7,60,25,1
458849,67,7,60,40,1
458849,31,3,28,41,4
458849,31,3,28,42,1
458849,31,3,28,43,1
458849,9,0,9,44,1
458849,22,3,19,45,1
458849,22,3,19,60,1
458858,170,11,159,1,4
458858,170,11,159,2,1
458858,170,11,159,3,1
458858,53,5,48,4,1
458858,117,6,111,5,1
458858,117,6,111,20,1
458858,130,11,119,21,4
458858,130,11,119,22,1
458858,130,11,119,23,1
458858,46,5,41,24,1
458858,84,6,78,25,1
458858,84,6,78,40,1
458858,40,0,40,41,4
458858,40,0,40,42,1
458858,40,0,40,43,1
458858,7,0,7,44,1
458858,33,0,33,45,1
458858,33,0,33,60,1
458867,255,3,252,1,4
458867,255,3,252,2,1
458867,255,3,252,3,1
458867,99,3,96,4,1
458867,156,0,156,5,1
458867,156,0,156,20,1
458867,194,1,193,21,4
458867,194,1,193,22,1
458867,194,1,193,23,1
458867,80,1,79,24,1
458867,114,0,114,25,1
458867,114,0,114,40,1
458867,61,2,59,41,4
458867,61,2,59,42,1
458867,61,2,59,43,1
458867,19,2,17,44,1
458867,42,0,42,45,1
458867,42,0,42,60,1
458885,207,55,152,1,4
458885,105,27,78,2,1
458885,105,27,78,3,1
458885,26,12,14,4,1
458885,79,15,64,5,1
458885,102,28,74,12,3
458885,16,0,16,19,1
458885,63,15,48,20,1
458885,22,9,13,21,4
458885,5,2,3,22,1
458885,5,2,3,23,1
458885,5,2,3,25,1
458885,17,7,10,32,3
458885,5,2,3,40,1
458885,185,46,139,41,4
458885,100,25,75,42,1
458885,100,25,75,43,1
458885,26,12,14,44,1
458885,74,13,61,45,1
458885,85,21,64,52,3
458885,16,0,16,59,1
458885,58,13,45,60,1
458919,5071,1396,3675,1,4
458919,3262,984,2278,2,1
458919,3253,979,2274,3,1
458919,463,141,322,4,1
458919,2790,838,1952,5,1
458919,9,5,4,11,1
458919,1809,412,1397,12,3
458919,382,128,254,19,1
458919,2408,710,1698,20,1
458919,623,326,297,21,4
458919,390,246,144,22,1
458919,390,246,144,23,1
458919,27,22,5,24,1
458919,363,224,139,25,1
458919,233,80,153,32,3
458919,66,47,19,39,1
458919,297,177,120,40,1
458919,4448,1070,3378,41,4
458919,2872,738,2134,42,1
458919,2863,733,2130,43,1
458919,436,119,317,44,1
458919,2427,614,1813,45,1
458919,9,5,4,51,1
458919,1576,332,1244,52,3
458919,316,81,235,59,1
458919,2111,533,1578,60,1
458937,182,60,122,1,4
458937,132,45,87,2,1
458937,132,45,87,3,1
458937,22,9,13,4,1
458937,110,36,74,5,1
458937,50,15,35,12,3
458937,15,5,10,19,1
458937,95,31,64,20,1
458937,24,12,12,21,4
458937,15,10,5,22,1
458937,15,10,5,23,1
458937,2,1,1,24,1
458937,13,9,4,25,1
458937,9,2,7,32,3
458937,1,0,1,39,1
458937,12,9,3,40,1
458937,158,48,110,41,4
458937,117,35,82,42,1
458937,117,35,82,43,1
458937,20,8,12,44,1
458937,97,27,70,45,1
458937,41,13,28,52,3
458937,14,5,9,59,1
458937,83,22,61,60,1
458955,277,67,210,1,4
458955,156,45,111,2,1
458955,156,45,111,3,1
458955,25,8,17,4,1
458955,131,37,94,5,1
458955,121,22,99,12,3
458955,15,3,12,19,1
458955,116,34,82,20,1
458955,26,12,14,21,4
458955,17,10,7,22,1
458955,17,10,7,23,1
458955,1,0,1,24,1
458955,16,10,6,25,1
458955,9,2,7,32,3
458955,1,1,0,39,1
458955,15,9,6,40,1
458955,251,55,196,41,4
458955,139,35,104,42,1
458955,139,35,104,43,1
458955,24,8,16,44,1
458955,115,27,88,45,1
458955,112,20,92,52,3
458955,14,2,12,59,1
458955,101,25,76,60,1
458964,2051,592,1459,1,4
458964,1221,407,814,2,1
458964,1219,406,813,3,1
458964,201,57,144,4,1
458964,1018,349,669,5,1
458964,2,1,1,11,1
458964,830,185,645,12,3
458964,142,42,100,19,1
458964,876,307,569,20,1
458964,269,151,118,21,4
458964,159,107,52,22,1
458964,159,107,52,23,1
458964,14,9,5,24,1
458964,145,98,47,25,1
458964,110,44,66,32,3
458964,20,11,9,39,1
458964,125,87,38,40,1
458964,1782,441,1341,41,4
458964,1062,300,762,42,1
458964,1060,299,761,43,1
458964,187,48,139,44,1
458964,873,251,622,45,1
458964,2,1,1,51,1
458964,720,141,579,52,3
458964,122,31,91,59,1
458964,751,220,531,60,1
458973,1322,507,815,1,4
458973,959,389,570,2,1
458973,954,387,567,3,1
458973,145,59,86,4,1
458973,809,328,481,5,1
458973,5,2,3,11,1
458973,363,118,245,12,3
458973,182,59,123,19,1
458973,627,269,358,20,1
458973,191,113,78,21,4
458973,138,90,48,22,1
458973,138,90,48,23,1
458973,10,6,4,24,1
458973,128,84,44,25,1
458973,53,23,30,32,3
458973,28,17,11,39,1
458973,100,67,33,40,1
458973,1131,394,737,41,4
458973,821,299,522,42,1
458973,816,297,519,43,1
458973,135,53,82,44,1
458973,681,244,437,45,1
458973,5,2,3,51,1
458973,310,95,215,52,3
458973,154,42,112,59,1
458973,527,202,325,60,1
458982,1115,574,541,1,4
458982,1115,574,541,2,1
458982,1115,574,541,3,1
458982,233,137,96,4,1
458982,882,437,445,5,1
458982,207,114,93,19,1
458982,675,323,352,20,1
458982,683,362,321,21,4
458982,683,362,321,22,1
458982,683,362,321,23,1
458982,132,75,57,24,1
458982,551,287,264,25,1
458982,118,70,48,39,1
458982,433,217,216,40,1
458982,432,212,220,41,4
458982,432,212,220,42,1
458982,432,212,220,43,1
458982,101,62,39,44,1
458982,331,150,181,45,1
458982,89,44,45,59,1
458982,242,106,136,60,1
458991,245,61,184,1,4
458991,245,61,184,2,1
458991,237,59,178,3,1
458991,30,7,23,4,1
458991,207,52,155,5,1
458991,8,2,6,11,1
458991,35,9,26,19,1
458991,172,43,129,20,1
458991,194,50,144,21,4
458991,194,50,144,22,1
458991,194,50,144,23,1
458991,29,7,22,24,1
458991,165,43,122,25,1
458991,31,7,24,39,1
458991,134,36,98,40,1
458991,51,11,40,41,4
458991,51,11,40,42,1
458991,43,9,34,43,1
458991,1,0,1,44,1
458991,42,9,33,45,1
458991,8,2,6,51,1
458991,4,2,2,59,1
458991,38,7,31,60,1
459000,117,10,107,1,4
459000,117,10,107,2,1
459000,117,10,107,3,1
459000,44,4,40,4,1
459000,73,6,67,5,1
459000,73,6,67,20,1
459000,93,8,85,21,4
459000,93,8,85,22,1
459000,93,8,85,23,1
459000,39,3,36,24,1
459000,54,5,49,25,1
459000,54,5,49,40,1
459000,24,2,22,41,4
459000,24,2,22,42,1
459000,24,2,22,43,1
459000,5,1,4,44,1
459000,19,1,18,45,1
459000,19,1,18,60,1
459019,134,7,127,1,4
459019,134,7,127,2,1
459019,134,7,127,3,1
459019,54,5,49,4,1
459019,80,2,78,5,1
459019,80,2,78,20,1
459019,106,6,100,21,4
459019,106,6,100,22,1
459019,106,6,100,23,1
459019,47,4,43,24,1
459019,59,2,57,25,1
459019,59,2,57,40,1
459019,28,1,27,41,4
459019,28,1,27,42,1
459019,28,1,27,43,1
459019,7,1,6,44,1
459019,21,0,21,45,1
459019,21,0,21,60,1
459028,65,5,60,1,4
459028,65,5,60,2,1
459028,65,5,60,3,1
459028,27,1,26,4,1
459028,38,4,34,5,1
459028,38,4,34,20,1
459028,53,4,49,21,4
459028,53,4,49,22,1
459028,53,4,49,23,1
459028,24,0,24,24,1
459028,29,4,25,25,1
459028,29,4,25,40,1
459028,12,1,11,41,4
459028,12,1,11,42,1
459028,12,1,11,43,1
459028,3,1,2,44,1
459028,9,0,9,45,1
459028,9,0,9,60,1
459037,151,12,139,1,4
459037,151,12,139,2,1
459037,151,12,139,3,1
459037,39,2,37,4,1
459037,112,10,102,5,1
459037,112,10,102,20,1
459037,107,11,96,21,4
459037,107,11,96,22,1
459037,107,11,96,23,1
459037,28,2,26,24,1
459037,79,9,70,25,1
459037,79,9,70,40,1
459037,44,1,43,41,4
459037,44,1,43,42,1
459037,44,1,43,43,1
459037,11,0,11,44,1
459037,33,1,32,45,1
459037,33,1,32,60,1
459046,121,12,109,1,4
459046,121,12,109,2,1
459046,121,12,109,3,1
459046,45,4,41,4,1
459046,76,8,68,5,1
459046,76,8,68,20,1
459046,85,7,78,21,4
459046,85,7,78,22,1
459046,85,7,78,23,1
459046,31,2,29,24,1
459046,54,5,49,25,1
459046,54,5,49,40,1
459046,36,5,31,41,4
459046,36,5,31,42,1
459046,36,5,31,43,1
459046,14,2,12,44,1
459046,22,3,19,45,1
459046,22,3,19,60,1
459055,111,4,107,1,4
459055,111,4,107,2,1
459055,111,4,107,3,1
459055,55,2,53,4,1
459055,56,2,54,5,1
459055,56,2,54,20,1
459055,79,4,75,21,4
459055,79,4,75,22,1
459055,79,4,75,23,1
459055,44,2,42,24,1
459055,35,2,33,25,1
459055,35,2,33,40,1
459055,32,0,32,41,4
459055,32,0,32,42,1
459055,32,0,32,43,1
459055,11,0,11,44,1
459055,21,0,21,45,1
459055,21,0,21,60,1
459064,105,10,95,1,4
459064,105,10,95,2,1
459064,105,10,95,3,1
459064,29,1,28,4,1
459064,76,9,67,5,1
459064,76,9,67,20,1
459064,85,7,78,21,4
459064,85,7,78,22,1
459064,85,7,78,23,1
459064,25,1,24,24,1
459064,60,6,54,25,1
459064,60,6,54,40,1
459064,20,3,17,41,4
459064,20,3,17,42,1
459064,20,3,17,43,1
459064,4,0,4,44,1
459064,16,3,13,45,1
459064,16,3,13,60,1
459073,61,2,59,1,4
459073,61,2,59,2,1
459073,61,2,59,3,1
459073,31,2,29,4,1
459073,30,0,30,5,1
459073,30,0,30,20,1
459073,61,2,59,21,4
459073,61,2,59,22,1
459073,61,2,59,23,1
459073,31,2,29,24,1
459073,30,0,30,25,1
459073,30,0,30,40,1
459091,151,100,51,1,4
459091,151,100,51,2,1
459091,145,96,49,3,1
459091,25,16,9,4,1
459091,120,80,40,5,1
459091,6,4,2,11,1
459091,20,12,8,19,1
459091,100,68,32,20,1
459091,115,79,36,21,4
459091,115,79,36,22,1
459091,114,78,36,23,1
459091,23,14,9,24,1
459091,91,64,27,25,1
459091,1,1,0,31,1
459091,16,12,4,39,1
459091,75,52,23,40,1
459091,36,21,15,41,4
459091,36,21,15,42,1
459091,31,18,13,43,1
459091,2,2,0,44,1
459091,29,16,13,45,1
459091,5,3,2,51,1
459091,4,0,4,59,1
459091,25,16,9,60,1
459107,641,140,501,1,4
459107,641,140,501,2,1
459107,641,140,501,3,1
459107,94,34,60,4,1
459107,547,106,441,5,1
459107,157,35,122,19,1
459107,390,71,319,20,1
459107,311,96,215,21,4
459107,311,96,215,22,1
459107,311,96,215,23,1
459107,74,27,47,24,1
459107,237,69,168,25,1
459107,96,25,71,39,1
459107,141,44,97,40,1
459107,330,44,286,41,4
459107,330,44,286,42,1
459107,330,44,286,43,1
459107,20,7,13,44,1
459107,310,37,273,45,1
459107,61,10,51,59,1
459107,249,27,222,60,1
459116,187,16,171,1,4
459116,187,16,171,2,1
459116,187,16,171,3,1
459116,27,1,26,4,1
459116,160,15,145,5,1
459116,160,15,145,20,1
459116,138,11,127,21,4
459116,138,11,127,22,1
459116,138,11,127,23,1
459116,19,1,18,24,1
459116,119,10,109,25,1
459116,119,10,109,40,1
459116,49,5,44,41,4
459116,49,5,44,42,1
459116,49,5,44,43,1
459116,8,0,8,44,1
459116,41,5,36,45,1
459116,41,5,36,60,1
459125,75,4,71,1,4
459125,75,4,71,2,1
459125,75,4,71,3,1
459125,35,1,34,4,1
459125,40,3,37,5,1
459125,40,3,37,20,1
459125,75,4,71,21,4
459125,75,4,71,22,1
459125,75,4,71,23,1
459125,35,1,34,24,1
459125,40,3,37,25,1
459125,40,3,37,40,1
459134,44,3,41,1,4
459134,44,3,41,2,1
459134,44,3,41,3,1
459134,31,2,29,4,1
459134,13,1,12,5,1
459134,13,1,12,20,1
459134,13,1,12,21,4
459134,13,1,12,22,1
459134,13,1,12,23,1
459134,11,1,10,24,1
459134,2,0,2,25,1
459134,2,0,2,40,1
459134,31,2,29,41,4
459134,31,2,29,42,1
459134,31,2,29,43,1
459134,20,1,19,44,1
459134,11,1,10,45,1
459134,11,1,10,60,1
459143,68,6,62,1,4
459143,68,6,62,2,1
459143,68,6,62,3,1
459143,17,1,16,4,1
459143,51,5,46,5,1
459143,51,5,46,20,1
459143,51,5,46,21,4
459143,51,5,46,22,1
459143,51,5,46,23,1
459143,11,0,11,24,1
459143,40,5,35,25,1
459143,40,5,35,40,1
459143,17,1,16,41,4
459143,17,1,16,42,1
459143,17,1,16,43,1
459143,6,1,5,44,1
459143,11,0,11,45,1
459143,11,0,11,60,1
459152,159,38,121,1,4
459152,159,38,121,2,1
459152,159,38,121,3,1
459152,20,8,12,4,1
459152,139,30,109,5,1
459152,139,30,109,20,1
459152,89,27,62,21,4
459152,89,27,62,22,1
459152,89,27,62,23,1
459152,13,7,6,24,1
459152,76,20,56,25,1
459152,76,20,56,40,1
459152,70,11,59,41,4
459152,70,11,59,42,1
459152,70,11,59,43,1
459152,7,1,6,44,1
459152,63,10,53,45,1
459152,63,10,53,60,1
459161,90,24,66,1,4
459161,90,24,66,2,1
459161,90,24,66,3,1
459161,7,2,5,4,1
459161,83,22,61,5,1
459161,83,22,61,20,1
459161,17,5,12,21,4
459161,17,5,12,22,1
459161,17,5,12,23,1
459161,1,1,0,24,1
459161,16,4,12,25,1
459161,16,4,12,40,1
459161,73,19,54,41,4
459161,73,19,54,42,1
459161,73,19,54,43,1
459161,6,1,5,44,1
459161,67,18,49,45,1
459161,67,18,49,60,1
459170,73,4,69,1,4
459170,73,4,69,2,1
459170,73,4,69,3,1
459170,45,3,42,4,1
459170,28,1,27,5,1
459170,28,1,27,20,1
459170,46,2,44,21,4
459170,46,2,44,22,1
459170,46,2,44,23,1
459170,33,2,31,24,1
459170,13,0,13,25,1
459170,13,0,13,40,1
459170,27,2,25,41,4
459170,27,2,25,42,1
459170,27,2,25,43,1
459170,12,1,11,44,1
459170,15,1,14,45,1
459170,15,1,14,60,1
459189,64,3,61,1,4
459189,64,3,61,2,1
459189,64,3,61,3,1
459189,20,0,20,4,1
459189,44,3,41,5,1
459189,44,3,41,20,1
459189,26,1,25,21,4
459189,26,1,25,22,1
459189,26,1,25,23,1
459189,11,0,11,24,1
459189,15,1,14,25,1
459189,15,1,14,40,1
459189,38,2,36,41,4
459189,38,2,36,42,1
459189,38,2,36,43,1
459189,9,0,9,44,1
459189,29,2,27,45,1
459189,29,2,27,60,1
459198,248,12,236,1,4
459198,248,12,236,2,1
459198,248,12,236,3,1
459198,37,3,34,4,1
459198,211,9,202,5,1
459198,211,9,202,20,1
459198,194,8,186,21,4
459198,194,8,186,22,1
459198,194,8,186,23,1
459198,32,2,30,24,1
459198,162,6,156,25,1
459198,162,6,156,40,1
459198,54,4,50,41,4
459198,54,4,50,42,1
459198,54,4,50,43,1
459198,5,1,4,44,1
459198,49,3,46,45,1
459198,49,3,46,60,1
459204,904,174,730,1,4
459204,904,174,730,2,1
459204,904,174,730,3,1
459204,216,45,171,4,1
459204,688,129,559,5,1
459204,15,1,14,19,1
459204,673,128,545,20,1
459204,904,174,730,21,4
459204,904,174,730,22,1
459204,904,174,730,23,1
459204,216,45,171,24,1
459204,688,129,559,25,1
459204,15,1,14,39,1
459204,673,128,545,40,1
459213,843,163,680,1,4
459213,843,163,680,2,1
459213,843,163,680,3,1
459213,59,15,44,4,1
459213,784,148,636,5,1
459213,784,148,636,20,1
459213,794,152,642,21,4
459213,794,152,642,22,1
459213,794,152,642,23,1
459213,36,8,28,24,1
459213,758,144,614,25,1
459213,758,144,614,40,1
459213,49,11,38,41,4
459213,49,11,38,42,1
459213,49,11,38,43,1
459213,23,7,16,44,1
459213,26,4,22,45,1
459213,26,4,22,60,1
459222,116,59,57,1,4
459222,48,22,26,2,1
459222,48,22,26,3,1
459222,48,22,26,5,1
459222,68,37,31,12,3
459222,48,22,26,20,1
459222,108,54,54,21,4
459222,46,20,26,22,1
459222,46,20,26,23,1
459222,46,20,26,25,1
459222,62,34,28,32,3
459222,46,20,26,40,1
459222,8,5,3,41,4
459222,2,2,0,42,1
459222,2,2,0,43,1
459222,2,2,0,45,1
459222,6,3,3,52,3
459222,2,2,0,60,1
459231,259,10,249,1,4
459231,259,10,249,2,1
459231,259,10,249,3,1
459231,95,4,91,4,1
459231,164,6,158,5,1
459231,164,6,158,20,1
459231,205,9,196,21,4
459231,205,9,196,22,1
459231,205,9,196,23,1
459231,64,4,60,24,1
459231,141,5,136,25,1
459231,141,5,136,40,1
459231,54,1,53,41,4
459231,54,1,53,42,1
459231,54,1,53,43,1
459231,31,0,31,44,1
459231,23,1,22,45,1
459231,23,1,22,60,1
459259,699,94,605,1,4
459259,637,85,552,2,1
459259,634,84,550,3,1
459259,35,7,28,4,1
459259,599,77,522,5,1
459259,3,1,2,11,1
459259,62,9,53,12,3
459259,154,18,136,19,1
459259,445,59,386,20,1
459259,270,30,240,21,4
459259,249,27,222,22,1
459259,249,27,222,23,1
459259,19,5,14,24,1
459259,230,22,208,25,1
459259,21,3,18,32,3
459259,40,3,37,39,1
459259,190,19,171,40,1
459259,429,64,365,41,4
459259,388,58,330,42,1
459259,385,57,328,43,1
459259,16,2,14,44,1
459259,369,55,314,45,1
459259,3,1,2,51,1
459259,41,6,35,52,3
459259,114,15,99,59,1
459259,255,40,215,60,1
459268,790,172,618,1,4
459268,685,157,528,2,1
459268,685,157,528,3,1
459268,31,13,18,4,1
459268,654,144,510,5,1
459268,105,15,90,12,3
459268,211,40,171,19,1
459268,443,104,339,20,1
459268,376,93,283,21,4
459268,340,87,253,22,1
459268,340,87,253,23,1
459268,16,6,10,24,1
459268,324,81,243,25,1
459268,36,6,30,32,3
459268,102,24,78,39,1
459268,222,57,165,40,1
459268,414,79,335,41,4
459268,345,70,275,42,1
459268,345,70,275,43,1
459268,15,7,8,44,1
459268,330,63,267,45,1
459268,69,9,60,52,3
459268,109,16,93,59,1
459268,221,47,174,60,1
459277,485,14,471,1,4
459277,485,14,471,2,1
459277,485,14,471,3,1
459277,103,3,100,4,1
459277,382,11,371,5,1
459277,382,11,371,20,1
459277,485,14,471,21,4
459277,485,14,471,22,1
459277,485,14,471,23,1
459277,103,3,100,24,1
459277,382,11,371,25,1
459277,382,11,371,40,1
459286,231,12,219,1,4
459286,231,12,219,2,1
459286,231,12,219,3,1
459286,44,1,43,4,1
459286,187,11,176,5,1
459286,187,11,176,20,1
459286,152,7,145,21,4
459286,152,7,145,22,1
459286,152,7,145,23,1
459286,36,1,35,24,1
459286,116,6,110,25,1
459286,116,6,110,40,1
459286,79,5,74,41,4
459286,79,5,74,42,1
459286,79,5,74,43,1
459286,8,0,8,44,1
459286,71,5,66,45,1
459286,71,5,66,60,1
459295,86,2,84,1,4
459295,86,2,84,2,1
459295,86,2,84,3,1
459295,24,1,23,4,1
459295,62,1,61,5,1
459295,62,1,61,20,1
459295,57,2,55,21,4
459295,57,2,55,22,1
459295,57,2,55,23,1
459295,11,1,10,24,1
459295,46,1,45,25,1
459295,46,1,45,40,1
459295,29,0,29,41,4
459295,29,0,29,42,1
459295,29,0,29,43,1
459295,13,0,13,44,1
459295,16,0,16,45,1
459295,16,0,16,60,1
459301,129,3,126,1,4
459301,129,3,126,2,1
459301,129,3,126,3,1
459301,27,1,26,4,1
459301,102,2,100,5,1
459301,102,2,100,20,1
459301,88,3,85,21,4
459301,88,3,85,22,1
459301,88,3,85,23,1
459301,24,1,23,24,1
459301,64,2,62,25,1
459301,64,2,62,40,1
459301,41,0,41,41,4
459301,41,0,41,42,1
459301,41,0,41,43,1
459301,3,0,3,44,1
459301,38,0,38,45,1
459301,38,0,38,60,1
459310,35,2,33,1,4
459310,35,2,33,2,1
459310,35,2,33,3,1
459310,31,2,29,4,1
459310,4,0,4,5,1
459310,4,0,4,20,1
459310,35,2,33,21,4
459310,35,2,33,22,1
459310,35,2,33,23,1
459310,31,2,29,24,1
459310,4,0,4,25,1
459310,4,0,4,40,1
459329,161,105,56,1,4
459329,161,105,56,2,1
459329,161,105,56,3,1
459329,97,59,38,4,1
459329,64,46,18,5,1
459329,64,46,18,20,1
459329,157,104,53,21,4
459329,157,104,53,22,1
459329,157,104,53,23,1
459329,94,58,36,24,1
459329,63,46,17,25,1
459329,63,46,17,40,1
459329,4,1,3,41,4
459329,4,1,3,42,1
459329,4,1,3,43,1
459329,3,1,2,44,1
459329,1,0,1,45,1
459329,1,0,1,60,1
459338,75,16,59,1,4
459338,75,16,59,2,1
459338,75,16,59,3,1
459338,18,3,15,4,1
459338,57,13,44,5,1
459338,57,13,44,20,1
459338,75,16,59,21,4
459338,75,16,59,22,1
459338,75,16,59,23,1
459338,18,3,15,24,1
459338,57,13,44,25,1
459338,57,13,44,40,1
459347,36,2,34,1,4
459347,36,2,34,2,1
459347,36,2,34,3,1
459347,11,1,10,4,1
459347,25,1,24,5,1
459347,25,1,24,20,1
459347,25,1,24,21,4
459347,25,1,24,22,1
459347,25,1,24,23,1
459347,5,0,5,24,1
459347,20,1,19,25,1
459347,20,1,19,40,1
459347,11,1,10,41,4
459347,11,1,10,42,1
459347,11,1,10,43,1
459347,6,1,5,44,1
459347,5,0,5,45,1
459347,5,0,5,60,1
459356,84,35,49,1,4
459356,84,35,49,2,1
459356,84,35,49,3,1
459356,4,0,4,4,1
459356,80,35,45,5,1
459356,4,1,3,19,1
459356,76,34,42,20,1
459356,59,25,34,21,4
459356,59,25,34,22,1
459356,59,25,34,23,1
459356,1,0,1,24,1
459356,58,25,33,25,1
459356,4,1,3,39,1
459356,54,24,30,40,1
459356,25,10,15,41,4
459356,25,10,15,42,1
459356,25,10,15,43,1
459356,3,0,3,44,1
459356,22,10,12,45,1
459356,22,10,12,60,1
459365,77,1,76,1,4
459365,77,1,76,2,1
459365,77,1,76,3,1
459365,40,1,39,4,1
459365,37,0,37,5,1
459365,37,0,37,20,1
459365,46,1,45,21,4
459365,46,1,45,22,1
459365,46,1,45,23,1
459365,35,1,34,24,1
459365,11,0,11,25,1
459365,11,0,11,40,1
459365,31,0,31,41,4
459365,31,0,31,42,1
459365,31,0,31,43,1
459365,5,0,5,44,1
459365,26,0,26,45,1
459365,26,0,26,60,1
459374,58,5,53,1,4
459374,58,5,53,2,1
459374,58,5,53,3,1
459374,37,4,33,4,1
459374,21,1,20,5,1
459374,21,1,20,20,1
459374,42,3,39,21,4
459374,42,3,39,22,1
459374,42,3,39,23,1
459374,29,2,27,24,1
459374,13,1,12,25,1
459374,13,1,12,40,1
459374,16,2,14,41,4
459374,16,2,14,42,1
459374,16,2,14,43,1
459374,8,2,6,44,1
459374,8,0,8,45,1
459374,8,0,8,60,1
459392,105,5,100,1,4
459392,105,5,100,2,1
459392,105,5,100,3,1
459392,16,0,16,4,1
459392,89,5,84,5,1
459392,89,5,84,20,1
459392,105,5,100,21,4
459392,105,5,100,22,1
459392,105,5,100,23,1
459392,16,0,16,24,1
459392,89,5,84,25,1
459392,89,5,84,40,1
459408,51,6,45,1,4
459408,51,6,45,2,1
459408,51,6,45,3,1
459408,16,2,14,4,1
459408,35,4,31,5,1
459408,35,4,31,20,1
459408,38,4,34,21,4
459408,38,4,34,22,1
459408,38,4,34,23,1
459408,12,2,10,24,1
459408,26,2,24,25,1
459408,26,2,24,40,1
459408,13,2,11,41,4
459408,13,2,11,42,1
459408,13,2,11,43,1
459408,4,0,4,44,1
459408,9,2,7,45,1
459408,9,2,7,60,1
459417,81,63,18,1,4
459417,81,63,18,2,1
459417,80,62,18,3,1
459417,40,33,7,4,1
459417,40,29,11,5,1
459417,1,1,0,11,1
459417,29,21,8,19,1
459417,11,8,3,20,1
459417,81,63,18,21,4
459417,81,63,18,22,1
459417,80,62,18,23,1
459417,40,33,7,24,1
459417,40,29,11,25,1
459417,1,1,0,31,1
459417,29,21,8,39,1
459417,11,8,3,40,1
459426,84,1,83,1,4
459426,84,1,83,2,1
459426,84,1,83,3,1
459426,68,1,67,4,1
459426,16,0,16,5,1
459426,16,0,16,20,1
459426,74,1,73,21,4
459426,74,1,73,22,1
459426,74,1,73,23,1
459426,61,1,60,24,1
459426,13,0,13,25,1
459426,13,0,13,40,1
459426,10,0,10,41,4
459426,10,0,10,42,1
459426,10,0,10,43,1
459426,7,0,7,44,1
459426,3,0,3,45,1
459426,3,0,3,60,1
459435,27,27,0,1,4
459435,27,27,0,2,1
459435,27,27,0,3,1
459435,12,12,0,4,1
459435,15,15,0,5,1
459435,15,15,0,20,1
459435,27,27,0,21,4
459435,27,27,0,22,1
459435,27,27,0,23,1
459435,12,12,0,24,1
459435,15,15,0,25,1
459435,15,15,0,40,1
459444,45,1,44,1,4
459444,45,1,44,2,1
459444,45,1,44,3,1
459444,10,0,10,4,1
459444,35,1,34,5,1
459444,35,1,34,20,1
459444,23,1,22,21,4
459444,23,1,22,22,1
459444,23,1,22,23,1
459444,6,0,6,24,1
459444,17,1,16,25,1
459444,17,1,16,40,1
459444,22,0,22,41,4
459444,22,0,22,42,1
459444,22,0,22,43,1
459444,4,0,4,44,1
459444,18,0,18,45,1
459444,18,0,18,60,1
459453,138,10,128,1,4
459453,138,10,128,2,1
459453,138,10,128,3,1
459453,23,1,22,4,1
459453,115,9,106,5,1
459453,115,9,106,20,1
459453,106,9,97,21,4
459453,106,9,97,22,1
459453,106,9,97,23,1
459453,19,1,18,24,1
459453,87,8,79,25,1
459453,87,8,79,40,1
459453,32,1,31,41,4
459453,32,1,31,42,1
459453,32,1,31,43,1
459453,4,0,4,44,1
459453,28,1,27,45,1
459453,28,1,27,60,1
459462,218,203,15,1,4
459462,218,203,15,2,1
459462,218,203,15,3,1
459462,203,188,15,4,1
459462,15,15,0,5,1
459462,15,15,0,20,1
459462,149,141,8,21,4
459462,149,141,8,22,1
459462,149,141,8,23,1
459462,141,133,8,24,1
459462,8,8,0,25,1
459462,8,8,0,40,1
459462,69,62,7,41,4
459462,69,62,7,42,1
459462,69,62,7,43,1
459462,62,55,7,44,1
459462,7,7,0,45,1
459462,7,7,0,60,1
459471,27,0,27,1,4
459471,27,0,27,2,1
459471,27,0,27,3,1
459471,15,0,15,4,1
459471,12,0,12,5,1
459471,12,0,12,20,1
459471,7,0,7,21,4
459471,7,0,7,22,1
459471,7,0,7,23,1
459471,5,0,5,24,1
459471,2,0,2,25,1
459471,2,0,2,40,1
459471,20,0,20,41,4
459471,20,0,20,42,1
459471,20,0,20,43,1
459471,10,0,10,44,1
459471,10,0,10,45,1
459471,10,0,10,60,1
459480,30,3,27,1,4
459480,30,3,27,2,1
459480,30,3,27,3,1
459480,11,1,10,4,1
459480,19,2,17,5,1
459480,19,2,17,20,1
459480,30,3,27,21,4
459480,30,3,27,22,1
459480,30,3,27,23,1
459480,11,1,10,24,1
459480,19,2,17,25,1
459480,19,2,17,40,1
459499,28,3,25,1,4
459499,28,3,25,2,1
459499,28,3,25,3,1
459499,17,1,16,4,1
459499,11,2,9,5,1
459499,11,2,9,20,1
459499,28,3,25,21,4
459499,28,3,25,22,1
459499,28,3,25,23,1
459499,17,1,16,24,1
459499,11,2,9,25,1
459499,11,2,9,40,1
459514,48,23,25,1,4
459514,48,23,25,2,1
459514,48,23,25,3,1
459514,28,15,13,4,1
459514,20,8,12,5,1
459514,20,8,12,20,1
459514,48,23,25,21,4
459514,48,23,25,22,1
459514,48,23,25,23,1
459514,28,15,13,24,1
459514,20,8,12,25,1
459514,20,8,12,40,1
459523,35,2,33,1,4
459523,35,2,33,2,1
459523,35,2,33,3,1
459523,12,0,12,4,1
459523,23,2,21,5,1
459523,23,2,21,20,1
459523,26,1,25,21,4
459523,26,1,25,22,1
459523,26,1,25,23,1
459523,8,0,8,24,1
459523,18,1,17,25,1
459523,18,1,17,40,1
459523,9,1,8,41,4
459523,9,1,8,42,1
459523,9,1,8,43,1
459523,4,0,4,44,1
459523,5,1,4,45,1
459523,5,1,4,60,1
459532,105,5,100,1,4
459532,105,5,100,2,1
459532,105,5,100,3,1
459532,45,2,43,4,1
459532,60,3,57,5,1
459532,60,3,57,20,1
459532,105,5,100,21,4
459532,105,5,100,22,1
459532,105,5,100,23,1
459532,45,2,43,24,1
459532,60,3,57,25,1
459532,60,3,57,40,1
459541,32,3,29,1,4
459541,32,3,29,2,1
459541,32,3,29,3,1
459541,3,0,3,4,1
459541,29,3,26,5,1
459541,29,3,26,20,1
459541,22,2,20,21,4
459541,22,2,20,22,1
459541,22,2,20,23,1
459541,2,0,2,24,1
459541,20,2,18,25,1
459541,20,2,18,40,1
459541,10,1,9,41,4
459541,10,1,9,42,1
459541,10,1,9,43,1
459541,1,0,1,44,1
459541,9,1,8,45,1
459541,9,1,8,60,1
459550,152,2,150,1,4
459550,152,2,150,2,1
459550,152,2,150,3,1
459550,71,0,71,4,1
459550,81,2,79,5,1
459550,81,2,79,20,1
459550,143,2,141,21,4
459550,143,2,141,22,1
459550,143,2,141,23,1
459550,67,0,67,24,1
459550,76,2,74,25,1
459550,76,2,74,40,1
459550,9,0,9,41,4
459550,9,0,9,42,1
459550,9,0,9,43,1
459550,4,0,4,44,1
459550,5,0,5,45,1
459550,5,0,5,60,1
459569,19,0,19,1,4
459569,19,0,19,2,1
459569,19,0,19,3,1
459569,5,0,5,4,1
459569,14,0,14,5,1
459569,14,0,14,20,1
459569,19,0,19,21,4
459569,19,0,19,22,1
459569,19,0,19,23,1
459569,5,0,5,24,1
459569,14,0,14,25,1
459569,14,0,14,40,1
459578,161,6,155,1,4
459578,161,6,155,2,1
459578,161,6,155,3,1
459578,22,1,21,4,1
459578,139,5,134,5,1
459578,139,5,134,20,1
459578,121,5,116,21,4
459578,121,5,116,22,1
459578,121,5,116,23,1
459578,16,1,15,24,1
459578,105,4,101,25,1
459578,105,4,101,40,1
459578,40,1,39,41,4
459578,40,1,39,42,1
459578,40,1,39,43,1
459578,6,0,6,44,1
459578,34,1,33,45,1
459578,34,1,33,60,1
459587,357,148,209,1,4
459587,357,148,209,2,1
459587,357,148,209,3,1
459587,41,24,17,4,1
459587,316,124,192,5,1
459587,316,124,192,20,1
459587,243,102,141,21,4
459587,243,102,141,22,1
459587,243,102,141,23,1
459587,40,23,17,24,1
459587,203,79,124,25,1
459587,203,79,124,40,1
459587,114,46,68,41,4
459587,114,46,68,42,1
459587,114,46,68,43,1
459587,1,1,0,44,1
459587,113,45,68,45,1
459587,113,45,68,60,1
459596,368,162,206,1,4
459596,368,162,206,2,1
459596,368,162,206,3,1
459596,35,21,14,4,1
459596,333,141,192,5,1
459596,6,3,3,19,1
459596,327,138,189,20,1
459596,252,126,126,21,4
459596,252,126,126,22,1
459596,252,126,126,23,1
459596,30,17,13,24,1
459596,222,109,113,25,1
459596,1,1,0,39,1
459596,221,108,113,40,1
459596,116,36,80,41,4
459596,116,36,80,42,1
459596,116,36,80,43,1
459596,5,4,1,44,1
459596,111,32,79,45,1
459596,5,2,3,59,1
459596,106,30,76,60,1
459602,250,135,115,1,4
459602,250,135,115,2,1
459602,250,135,115,3,1
459602,53,32,21,4,1
459602,197,103,94,5,1
459602,3,3,0,19,1
459602,194,100,94,20,1
459602,177,109,68,21,4
459602,177,109,68,22,1
459602,177,109,68,23,1
459602,48,30,18,24,1
459602,129,79,50,25,1
459602,1,1,0,39,1
459602,128,78,50,40,1
459602,73,26,47,41,4
459602,73,26,47,42,1
459602,73,26,47,43,1
459602,5,2,3,44,1
459602,68,24,44,45,1
459602,2,2,0,59,1
459602,66,22,44,60,1
459611,249,174,75,1,4
459611,249,174,75,2,1
459611,249,174,75,3,1
459611,51,38,13,4,1
459611,198,136,62,5,1
459611,3,0,3,19,1
459611,195,136,59,20,1
459611,201,138,63,21,4
459611,201,138,63,22,1
459611,201,138,63,23,1
459611,48,36,12,24,1
459611,153,102,51,25,1
459611,3,0,3,39,1
459611,150,102,48,40,1
459611,48,36,12,41,4
459611,48,36,12,42,1
459611,48,36,12,43,1
459611,3,2,1,44,1
459611,45,34,11,45,1
459611,45,34,11,60,1
459620,37,34,3,1,4
459620,37,34,3,2,1
459620,37,34,3,3,1
459620,37,34,3,5,1
459620,37,34,3,20,1
459620,23,20,3,21,4
459620,23,20,3,22,1
459620,23,20,3,23,1
459620,23,20,3,25,1
459620,23,20,3,40,1
459620,14,14,0,41,4
459620,14,14,0,42,1
459620,14,14,0,43,1
459620,14,14,0,45,1
459620,14,14,0,60,1
459639,479,429,50,1,4
459639,479,429,50,2,1
459639,479,429,50,3,1
459639,68,58,10,4,1
459639,411,371,40,5,1
459639,8,7,1,19,1
459639,403,364,39,20,1
459639,407,365,42,21,4
459639,407,365,42,22,1
459639,407,365,42,23,1
459639,64,54,10,24,1
459639,343,311,32,25,1
459639,6,5,1,39,1
459639,337,306,31,40,1
459639,72,64,8,41,4
459639,72,64,8,42,1
459639,72,64,8,43,1
459639,4,4,0,44,1
459639,68,60,8,45,1
459639,2,2,0,59,1
459639,66,58,8,60,1
459648,139,111,28,1,4
459648,139,111,28,2,1
459648,139,111,28,3,1
459648,50,39,11,4,1
459648,89,72,17,5,1
459648,1,0,1,19,1
459648,88,72,16,20,1
459648,112,92,20,21,4
459648,112,92,20,22,1
459648,112,92,20,23,1
459648,47,37,10,24,1
459648,65,55,10,25,1
459648,65,55,10,40,1
459648,27,19,8,41,4
459648,27,19,8,42,1
459648,27,19,8,43,1
459648,3,2,1,44,1
459648,24,17,7,45,1
459648,1,0,1,59,1
459648,23,17,6,60,1
459657,187,132,55,1,4
459657,187,132,55,2,1
459657,187,132,55,3,1
459657,42,31,11,4,1
459657,145,101,44,5,1
459657,3,1,2,19,1
459657,142,100,42,20,1
459657,154,111,43,21,4
459657,154,111,43,22,1
459657,154,111,43,23,1
459657,37,27,10,24,1
459657,117,84,33,25,1
459657,1,0,1,39,1
459657,116,84,32,40,1
459657,33,21,12,41,4
459657,33,21,12,42,1
459657,33,21,12,43,1
459657,5,4,1,44,1
459657,28,17,11,45,1
459657,2,1,1,59,1
459657,26,16,10,60,1
459666,265,222,43,1,4
459666,265,222,43,2,1
459666,265,222,43,3,1
459666,64,50,14,4,1
459666,201,172,29,5,1
459666,6,4,2,19,1
459666,195,168,27,20,1
459666,221,187,34,21,4
459666,221,187,34,22,1
459666,221,187,34,23,1
459666,58,46,12,24,1
459666,163,141,22,25,1
459666,6,4,2,39,1
459666,157,137,20,40,1
459666,44,35,9,41,4
459666,44,35,9,42,1
459666,44,35,9,43,1
459666,6,4,2,44,1
459666,38,31,7,45,1
459666,38,31,7,60,1
459675,247,201,46,1,4
459675,247,201,46,2,1
459675,247,201,46,3,1
459675,24,18,6,4,1
459675,223,183,40,5,1
459675,6,5,1,19,1
459675,217,178,39,20,1
459675,198,159,39,21,4
459675,198,159,39,22,1
459675,198,159,39,23,1
459675,24,18,6,24,1
459675,174,141,33,25,1
459675,5,4,1,39,1
459675,169,137,32,40,1
459675,49,42,7,41,4
459675,49,42,7,42,1
459675,49,42,7,43,1
459675,49,42,7,45,1
459675,1,1,0,59,1
459675,48,41,7,60,1
459684,148,123,25,1,4
459684,148,123,25,2,1
459684,148,123,25,3,1
459684,148,123,25,5,1
459684,1,1,0,19,1
459684,147,122,25,20,1
459684,117,97,20,21,4
459684,117,97,20,22,1
459684,117,97,20,23,1
459684,117,97,20,25,1
459684,1,1,0,39,1
459684,116,96,20,40,1
459684,31,26,5,41,4
459684,31,26,5,42,1
459684,31,26,5,43,1
459684,31,26,5,45,1
459684,31,26,5,60,1
459693,319,248,71,1,4
459693,319,248,71,2,1
459693,319,248,71,3,1
459693,52,38,14,4,1
459693,267,210,57,5,1
459693,5,3,2,19,1
459693,262,207,55,20,1
459693,245,191,54,21,4
459693,245,191,54,22,1
459693,245,191,54,23,1
459693,42,31,11,24,1
459693,203,160,43,25,1
459693,4,2,2,39,1
459693,199,158,41,40,1
459693,74,57,17,41,4
459693,74,57,17,42,1
459693,74,57,17,43,1
459693,10,7,3,44,1
459693,64,50,14,45,1
459693,1,1,0,59,1
459693,63,49,14,60,1
459709,438,329,109,1,4
459709,438,329,109,2,1
459709,438,329,109,3,1
459709,77,57,20,4,1
459709,361,272,89,5,1
459709,6,5,1,19,1
459709,355,267,88,20,1
459709,309,240,69,21,4
459709,309,240,69,22,1
459709,309,240,69,23,1
459709,60,46,14,24,1
459709,249,194,55,25,1
459709,4,4,0,39,1
459709,245,190,55,40,1
459709,129,89,40,41,4
459709,129,89,40,42,1
459709,129,89,40,43,1
459709,17,11,6,44,1
459709,112,78,34,45,1
459709,2,1,1,59,1
459709,110,77,33,60,1
459718,569,464,105,1,4
459718,569,464,105,2,1
459718,569,464,105,3,1
459718,84,71,13,4,1
459718,485,393,92,5,1
459718,3,1,2,19,1
459718,482,392,90,20,1
459718,438,356,82,21,4
459718,438,356,82,22,1
459718,438,356,82,23,1
459718,78,65,13,24,1
459718,360,291,69,25,1
459718,2,1,1,39,1
459718,358,290,68,40,1
459718,131,108,23,41,4
459718,131,108,23,42,1
459718,131,108,23,43,1
459718,6,6,0,44,1
459718,125,102,23,45,1
459718,1,0,1,59,1
459718,124,102,22,60,1
459727,363,150,213,1,4
459727,161,81,80,2,1
459727,150,71,79,3,1
459727,18,8,10,4,1
459727,132,63,69,5,1
459727,11,10,1,11,1
459727,202,69,133,12,3
459727,79,38,41,19,1
459727,53,25,28,20,1
459727,267,100,167,21,4
459727,103,45,58,22,1
459727,97,40,57,23,1
459727,6,2,4,24,1
459727,91,38,53,25,1
459727,6,5,1,31,1
459727,164,55,109,32,3
459727,47,22,25,39,1
459727,44,16,28,40,1
459727,96,50,46,41,4
459727,58,36,22,42,1
459727,53,31,22,43,1
459727,12,6,6,44,1
459727,41,25,16,45,1
459727,5,5,0,51,1
459727,38,14,24,52,3
459727,32,16,16,59,1
459727,9,9,0,60,1
459736,1357,544,813,1,4
459736,1357,544,813,12,3
459736,1178,501,677,21,4
459736,1178,501,677,32,3
459736,179,43,136,41,4
459736,179,43,136,52,3
459745,373,67,306,1,4
459745,373,67,306,12,3
459745,216,37,179,21,4
459745,216,37,179,32,3
459745,157,30,127,41,4
459745,157,30,127,52,3
459815,96,13,83,1,4
459815,96,13,83,2,1
459815,96,13,83,3,1
459815,15,0,15,4,1
459815,81,13,68,5,1
459815,81,13,68,20,1
459815,96,13,83,21,4
459815,96,13,83,22,1
459815,96,13,83,23,1
459815,15,0,15,24,1
459815,81,13,68,25,1
459815,81,13,68,40,1
459824,1248,582,666,1,4
459824,5,2,3,2,1
459824,4,1,3,3,1
459824,4,1,3,5,1
459824,1,1,0,11,1
459824,1243,580,663,12,3
459824,4,1,3,20,1
459824,1015,523,492,21,4
459824,1,0,1,22,1
459824,1,0,1,23,1
459824,1,0,1,25,1
459824,1014,523,491,32,3
459824,1,0,1,40,1
459824,233,59,174,41,4
459824,4,2,2,42,1
459824,3,1,2,43,1
459824,3,1,2,45,1
459824,1,1,0,51,1
459824,229,57,172,52,3
459824,3,1,2,60,1
459833,66,18,48,1,4
459833,66,18,48,2,1
459833,66,18,48,3,1
459833,9,1,8,4,1
459833,57,17,40,5,1
459833,17,3,14,19,1
459833,40,14,26,20,1
459833,43,11,32,21,4
459833,43,11,32,22,1
459833,43,11,32,23,1
459833,7,1,6,24,1
459833,36,10,26,25,1
459833,14,2,12,39,1
459833,22,8,14,40,1
459833,23,7,16,41,4
459833,23,7,16,42,1
459833,23,7,16,43,1
459833,2,0,2,44,1
459833,21,7,14,45,1
459833,3,1,2,59,1
459833,18,6,12,60,1
459842,435,84,351,1,4
459842,428,83,345,2,1
459842,427,83,344,3,1
459842,54,13,41,4,1
459842,373,70,303,5,1
459842,1,0,1,11,1
459842,7,1,6,12,3
459842,17,4,13,19,1
459842,356,66,290,20,1
459842,234,56,178,21,4
459842,231,55,176,22,1
459842,231,55,176,23,1
459842,34,8,26,24,1
459842,197,47,150,25,1
459842,3,1,2,32,3
459842,11,4,7,39,1
459842,186,43,143,40,1
459842,201,28,173,41,4
459842,197,28,169,42,1
459842,196,28,168,43,1
459842,20,5,15,44,1
459842,176,23,153,45,1
459842,1,0,1,51,1
459842,4,0,4,52,3
459842,6,0,6,59,1
459842,170,23,147,60,1
459851,343,83,260,1,4
459851,337,81,256,2,1
459851,336,81,255,3,1
459851,53,6,47,4,1
459851,283,75,208,5,1
459851,1,0,1,11,1
459851,6,2,4,12,3
459851,40,10,30,19,1
459851,243,65,178,20,1
459851,261,57,204,21,4
459851,259,57,202,22,1
459851,259,57,202,23,1
459851,48,5,43,24,1
459851,211,52,159,25,1
459851,2,0,2,32,3
459851,35,8,27,39,1
459851,176,44,132,40,1
459851,82,26,56,41,4
459851,78,24,54,42,1
459851,77,24,53,43,1
459851,5,1,4,44,1
459851,72,23,49,45,1
459851,1,0,1,51,1
459851,4,2,2,52,3
459851,5,2,3,59,1
459851,67,21,46,60,1
459930,1091,215,876,1,4
459930,1091,215,876,2,1
459930,1091,215,876,3,1
459930,173,24,149,4,1
459930,918,191,727,5,1
459930,78,17,61,19,1
459930,840,174,666,20,1
459930,920,182,738,21,4
459930,920,182,738,22,1
459930,920,182,738,23,1
459930,115,13,102,24,1
459930,805,169,636,25,1
459930,45,10,35,39,1
459930,760,159,601,40,1
459930,171,33,138,41,4
459930,171,33,138,42,1
459930,171,33,138,43,1
459930,58,11,47,44,1
459930,113,22,91,45,1
459930,33,7,26,59,1
459930,80,15,65,60,1
459958,333,99,234,1,4
459958,333,99,234,2,1
459958,333,99,234,3,1
459958,55,17,38,4,1
459958,278,82,196,5,1
459958,278,82,196,20,1
459958,333,99,234,21,4
459958,333,99,234,22,1
459958,333,99,234,23,1
459958,55,17,38,24,1
459958,278,82,196,25,1
459958,278,82,196,40,1
459967,313,88,225,1,4
459967,313,88,225,2,1
459967,313,88,225,3,1
459967,283,81,202,4,1
459967,30,7,23,5,1
459967,30,7,23,20,1
459967,313,88,225,21,4
459967,313,88,225,22,1
459967,313,88,225,23,1
459967,283,81,202,24,1
459967,30,7,23,25,1
459967,30,7,23,40,1
459985,331,64,267,1,4
459985,331,64,267,2,1
459985,331,64,267,3,1
459985,293,56,237,4,1
459985,38,8,30,5,1
459985,38,8,30,20,1
459985,331,64,267,21,4
459985,331,64,267,22,1
459985,331,64,267,23,1
459985,293,56,237,24,1
459985,38,8,30,25,1
459985,38,8,30,40,1
459994,2796,989,1807,1,4
459994,1506,508,998,2,1
459994,1429,479,950,3,1
459994,304,103,201,4,1
459994,1125,376,749,5,1
459994,77,29,48,11,1
459994,1290,481,809,12,3
459994,165,58,107,19,1
459994,960,318,642,20,1
459994,253,123,130,21,4
459994,84,44,40,22,1
459994,82,42,40,23,1
459994,5,3,2,24,1
459994,77,39,38,25,1
459994,2,2,0,31,1
459994,169,79,90,32,3
459994,15,9,6,39,1
459994,62,30,32,40,1
459994,2543,866,1677,41,4
459994,1422,464,958,42,1
459994,1347,437,910,43,1
459994,299,100,199,44,1
459994,1048,337,711,45,1
459994,75,27,48,51,1
459994,1121,402,719,52,3
459994,150,49,101,59,1
459994,898,288,610,60,1
460002,102,13,89,1,4
460002,102,13,89,2,1
460002,102,13,89,3,1
460002,77,6,71,4,1
460002,25,7,18,5,1
460002,25,7,18,20,1
460002,51,6,45,21,4
460002,51,6,45,22,1
460002,51,6,45,23,1
460002,40,3,37,24,1
460002,11,3,8,25,1
460002,11,3,8,40,1
460002,51,7,44,41,4
460002,51,7,44,42,1
460002,51,7,44,43,1
460002,37,3,34,44,1
460002,14,4,10,45,1
460002,14,4,10,60,1
460011,146,7,139,1,4
460011,146,7,139,2,1
460011,146,7,139,3,1
460011,11,1,10,4,1
460011,135,6,129,5,1
460011,135,6,129,20,1
460011,114,7,107,21,4
460011,114,7,107,22,1
460011,114,7,107,23,1
460011,11,1,10,24,1
460011,103,6,97,25,1
460011,103,6,97,40,1
460011,32,0,32,41,4
460011,32,0,32,42,1
460011,32,0,32,43,1
460011,32,0,32,45,1
460011,32,0,32,60,1
460020,543,148,395,1,4
460020,543,148,395,2,1
460020,543,148,395,3,1
460020,47,23,24,4,1
460020,496,125,371,5,1
460020,76,18,58,19,1
460020,420,107,313,20,1
460020,543,148,395,21,4
460020,543,148,395,22,1
460020,543,148,395,23,1
460020,47,23,24,24,1
460020,496,125,371,25,1
460020,76,18,58,39,1
460020,420,107,313,40,1
460039,780,256,524,1,4
460039,780,256,524,2,1
460039,780,256,524,3,1
460039,178,61,117,4,1
460039,602,195,407,5,1
460039,17,6,11,19,1
460039,585,189,396,20,1
460039,780,256,524,21,4
460039,780,256,524,22,1
460039,780,256,524,23,1
460039,178,61,117,24,1
460039,602,195,407,25,1
460039,17,6,11,39,1
460039,585,189,396,40,1
460048,634,127,507,1,4
460048,634,127,507,2,1
460048,634,127,507,3,1
460048,72,13,59,4,1
460048,562,114,448,5,1
460048,138,25,113,19,1
460048,424,89,335,20,1
460048,634,127,507,21,4
460048,634,127,507,22,1
460048,634,127,507,23,1
460048,72,13,59,24,1
460048,562,114,448,25,1
460048,138,25,113,39,1
460048,424,89,335,40,1
460057,47,1,46,1,4
460057,47,1,46,2,1
460057,47,1,46,3,1
460057,14,1,13,4,1
460057,33,0,33,5,1
460057,33,0,33,20,1
460057,47,1,46,21,4
460057,47,1,46,22,1
460057,47,1,46,23,1
460057,14,1,13,24,1
460057,33,0,33,25,1
460057,33,0,33,40,1
460066,75,5,70,1,4
460066,75,5,70,2,1
460066,75,5,70,3,1
460066,22,2,20,4,1
460066,53,3,50,5,1
460066,53,3,50,20,1
460066,75,5,70,21,4
460066,75,5,70,22,1
460066,75,5,70,23,1
460066,22,2,20,24,1
460066,53,3,50,25,1
460066,53,3,50,40,1
460075,405,274,131,1,4
460075,54,41,13,2,1
460075,54,41,13,3,1
460075,16,8,8,4,1
460075,38,33,5,5,1
460075,351,233,118,12,3
460075,38,33,5,20,1
460075,405,274,131,21,4
460075,54,41,13,22,1
460075,54,41,13,23,1
460075,16,8,8,24,1
460075,38,33,5,25,1
460075,351,233,118,32,3
460075,38,33,5,40,1
460093,181,13,168,1,4
460093,181,13,168,2,1
460093,181,13,168,3,1
460093,73,4,69,4,1
460093,108,9,99,5,1
460093,108,9,99,20,1
460093,181,13,168,21,4
460093,181,13,168,22,1
460093,181,13,168,23,1
460093,73,4,69,24,1
460093,108,9,99,25,1
460093,108,9,99,40,1
460109,174,13,161,1,4
460109,174,13,161,2,1
460109,174,13,161,3,1
460109,61,6,55,4,1
460109,113,7,106,5,1
460109,113,7,106,20,1
460109,174,13,161,21,4
460109,174,13,161,22,1
460109,174,13,161,23,1
460109,61,6,55,24,1
460109,113,7,106,25,1
460109,113,7,106,40,1
460118,151,5,146,1,4
460118,151,5,146,2,1
460118,151,5,146,3,1
460118,52,2,50,4,1
460118,99,3,96,5,1
460118,99,3,96,20,1
460118,151,5,146,21,4
460118,151,5,146,22,1
460118,151,5,146,23,1
460118,52,2,50,24,1
460118,99,3,96,25,1
460118,99,3,96,40,1
460127,131,4,127,1,4
460127,131,4,127,2,1
460127,131,4,127,3,1
460127,36,2,34,4,1
460127,95,2,93,5,1
460127,95,2,93,20,1
460127,131,4,127,21,4
460127,131,4,127,22,1
460127,131,4,127,23,1
460127,36,2,34,24,1
460127,95,2,93,25,1
460127,95,2,93,40,1
460136,898,178,720,1,4
460136,898,178,720,2,1
460136,898,178,720,3,1
460136,318,52,266,4,1
460136,580,126,454,5,1
460136,580,126,454,20,1
460136,898,178,720,21,4
460136,898,178,720,22,1
460136,898,178,720,23,1
460136,318,52,266,24,1
460136,580,126,454,25,1
460136,580,126,454,40,1
460145,220,143,77,1,4
460145,220,143,77,2,1
460145,220,143,77,3,1
460145,92,65,27,4,1
460145,128,78,50,5,1
460145,128,78,50,20,1
460145,220,143,77,21,4
460145,220,143,77,22,1
460145,220,143,77,23,1
460145,92,65,27,24,1
460145,128,78,50,25,1
460145,128,78,50,40,1
460172,170,161,9,1,4
460172,170,161,9,2,1
460172,170,161,9,3,1
460172,80,75,5,4,1
460172,90,86,4,5,1
460172,90,86,4,20,1
460172,170,161,9,21,4
460172,170,161,9,22,1
460172,170,161,9,23,1
460172,80,75,5,24,1
460172,90,86,4,25,1
460172,90,86,4,40,1
460181,703,133,570,1,4
460181,703,133,570,2,1
460181,703,133,570,3,1
460181,204,36,168,4,1
460181,499,97,402,5,1
460181,499,97,402,20,1
460181,703,133,570,21,4
460181,703,133,570,22,1
460181,703,133,570,23,1
460181,204,36,168,24,1
460181,499,97,402,25,1
460181,499,97,402,40,1
460190,521,71,450,1,4
460190,521,71,450,2,1
460190,521,71,450,3,1
460190,124,11,113,4,1
460190,397,60,337,5,1
460190,397,60,337,20,1
460190,521,71,450,21,4
460190,521,71,450,22,1
460190,521,71,450,23,1
460190,124,11,113,24,1
460190,397,60,337,25,1
460190,397,60,337,40,1
460206,681,120,561,1,4
460206,681,120,561,2,1
460206,681,120,561,3,1
460206,164,30,134,4,1
460206,517,90,427,5,1
460206,517,90,427,20,1
460206,681,120,561,21,4
460206,681,120,561,22,1
460206,681,120,561,23,1
460206,164,30,134,24,1
460206,517,90,427,25,1
460206,517,90,427,40,1
460215,476,444,32,1,4
460215,476,444,32,2,1
460215,476,444,32,3,1
460215,196,184,12,4,1
460215,280,260,20,5,1
460215,280,260,20,20,1
460215,414,385,29,21,4
460215,414,385,29,22,1
460215,414,385,29,23,1
460215,178,166,12,24,1
460215,236,219,17,25,1
460215,236,219,17,40,1
460215,62,59,3,41,4
460215,62,59,3,42,1
460215,62,59,3,43,1
460215,18,18,0,44,1
460215,44,41,3,45,1
460215,44,41,3,60,1
460349,135,48,87,1,4
460349,118,45,73,2,1
460349,118,45,73,3,1
460349,118,45,73,5,1
460349,17,3,14,12,3
460349,24,13,11,19,1
460349,94,32,62,20,1
460349,57,13,44,21,4
460349,43,10,33,22,1
460349,43,10,33,23,1
460349,43,10,33,25,1
460349,14,3,11,32,3
460349,12,6,6,39,1
460349,31,4,27,40,1
460349,78,35,43,41,4
460349,75,35,40,42,1
460349,75,35,40,43,1
460349,75,35,40,45,1
460349,3,0,3,52,3
460349,12,7,5,59,1
460349,63,28,35,60,1
460358,535,119,416,1,4
460358,535,119,416,2,1
460358,535,119,416,3,1
460358,68,12,56,4,1
460358,467,107,360,5,1
460358,80,13,67,19,1
460358,387,94,293,20,1
460358,471,84,387,21,4
460358,471,84,387,22,1
460358,471,84,387,23,1
460358,67,11,56,24,1
460358,404,73,331,25,1
460358,60,3,57,39,1
460358,344,70,274,40,1
460358,64,35,29,41,4
460358,64,35,29,42,1
460358,64,35,29,43,1
460358,1,1,0,44,1
460358,63,34,29,45,1
460358,20,10,10,59,1
460358,43,24,19,60,1
460367,433,108,325,1,4
460367,433,108,325,2,1
460367,433,108,325,3,1
460367,84,16,68,4,1
460367,349,92,257,5,1
460367,349,92,257,20,1
460367,433,108,325,21,4
460367,433,108,325,22,1
460367,433,108,325,23,1
460367,84,16,68,24,1
460367,349,92,257,25,1
460367,349,92,257,40,1
460385,55,5,50,1,4
460385,55,5,50,2,1
460385,55,5,50,3,1
460385,17,1,16,4,1
460385,38,4,34,5,1
460385,38,4,34,20,1
460385,44,2,42,21,4
460385,44,2,42,22,1
460385,44,2,42,23,1
460385,15,1,14,24,1
460385,29,1,28,25,1
460385,29,1,28,40,1
460385,11,3,8,41,4
460385,11,3,8,42,1
460385,11,3,8,43,1
460385,2,0,2,44,1
460385,9,3,6,45,1
460385,9,3,6,60,1
460394,8420,3719,4701,1,4
460394,8420,3719,4701,2,1
460394,7101,3176,3925,3,1
460394,1204,580,624,4,1
460394,5897,2596,3301,5,1
460394,1319,543,776,11,1
460394,1492,687,805,19,1
460394,4405,1909,2496,20,1
460394,1976,915,1061,21,4
460394,1976,915,1061,22,1
460394,1906,888,1018,23,1
460394,396,191,205,24,1
460394,1510,697,813,25,1
460394,70,27,43,31,1
460394,340,202,138,39,1
460394,1170,495,675,40,1
460394,6444,2804,3640,41,4
460394,6444,2804,3640,42,1
460394,5195,2288,2907,43,1
460394,808,389,419,44,1
460394,4387,1899,2488,45,1
460394,1249,516,733,51,1
460394,1152,485,667,59,1
460394,3235,1414,1821,60,1
460446,224,25,199,1,4
460446,224,25,199,2,1
460446,224,25,199,3,1
460446,34,1,33,4,1
460446,190,24,166,5,1
460446,190,24,166,20,1
460446,157,18,139,21,4
460446,157,18,139,22,1
460446,157,18,139,23,1
460446,31,1,30,24,1
460446,126,17,109,25,1
460446,126,17,109,40,1
460446,67,7,60,41,4
460446,67,7,60,42,1
460446,67,7,60,43,1
460446,3,0,3,44,1
460446,64,7,57,45,1
460446,64,7,57,60,1
460455,61,13,48,1,4
460455,61,13,48,2,1
460455,61,13,48,3,1
460455,11,1,10,4,1
460455,50,12,38,5,1
460455,50,12,38,20,1
460455,9,2,7,21,4
460455,9,2,7,22,1
460455,9,2,7,23,1
460455,1,0,1,24,1
460455,8,2,6,25,1
460455,8,2,6,40,1
460455,52,11,41,41,4
460455,52,11,41,42,1
460455,52,11,41,43,1
460455,10,1,9,44,1
460455,42,10,32,45,1
460455,42,10,32,60,1
460464,9648,4413,5235,1,4
460464,9648,4413,5235,2,1
460464,8321,3833,4488,3,1
460464,1526,761,765,4,1
460464,6795,3072,3723,5,1
460464,1327,580,747,11,1
460464,1401,617,784,19,1
460464,5394,2455,2939,20,1
460464,2270,1068,1202,21,4
460464,2270,1068,1202,22,1
460464,2224,1046,1178,23,1
460464,631,311,320,24,1
460464,1593,735,858,25,1
460464,46,22,24,31,1
460464,205,94,111,39,1
460464,1388,641,747,40,1
460464,7378,3345,4033,41,4
460464,7378,3345,4033,42,1
460464,6097,2787,3310,43,1
460464,895,450,445,44,1
460464,5202,2337,2865,45,1
460464,1281,558,723,51,1
460464,1196,523,673,59,1
460464,4006,1814,2192,60,1
460473,15,1,14,1,4
460473,15,1,14,2,1
460473,15,1,14,3,1
460473,15,1,14,5,1
460473,15,1,14,20,1
460473,10,1,9,21,4
460473,10,1,9,22,1
460473,10,1,9,23,1
460473,10,1,9,25,1
460473,10,1,9,40,1
460473,5,0,5,41,4
460473,5,0,5,42,1
460473,5,0,5,43,1
460473,5,0,5,45,1
460473,5,0,5,60,1
460482,223,23,200,1,4
460482,223,23,200,2,1
460482,223,23,200,3,1
460482,88,12,76,4,1
460482,135,11,124,5,1
460482,135,11,124,20,1
460482,223,23,200,21,4
460482,223,23,200,22,1
460482,223,23,200,23,1
460482,88,12,76,24,1
460482,135,11,124,25,1
460482,135,11,124,40,1
460516,162,7,155,1,4
460516,162,7,155,2,1
460516,162,7,155,3,1
460516,45,0,45,4,1
460516,117,7,110,5,1
460516,117,7,110,20,1
460516,162,7,155,21,4
460516,162,7,155,22,1
460516,162,7,155,23,1
460516,45,0,45,24,1
460516,117,7,110,25,1
460516,117,7,110,40,1
460525,255,22,233,1,4
460525,255,22,233,2,1
460525,255,22,233,3,1
460525,55,6,49,4,1
460525,200,16,184,5,1
460525,200,16,184,20,1
460525,255,22,233,21,4
460525,255,22,233,22,1
460525,255,22,233,23,1
460525,55,6,49,24,1
460525,200,16,184,25,1
460525,200,16,184,40,1
460534,458,23,435,1,4
460534,458,23,435,2,1
460534,458,23,435,3,1
460534,141,10,131,4,1
460534,317,13,304,5,1
460534,317,13,304,20,1
460534,458,23,435,21,4
460534,458,23,435,22,1
460534,458,23,435,23,1
460534,141,10,131,24,1
460534,317,13,304,25,1
460534,317,13,304,40,1
460543,1006,979,27,1,4
460543,1006,979,27,2,1
460543,1006,979,27,3,1
460543,205,202,3,4,1
460543,801,777,24,5,1
460543,801,777,24,20,1
460543,1006,979,27,21,4
460543,1006,979,27,22,1
460543,1006,979,27,23,1
460543,205,202,3,24,1
460543,801,777,24,25,1
460543,801,777,24,40,1
460552,56,14,42,1,4
460552,56,14,42,2,1
460552,56,14,42,3,1
460552,20,7,13,4,1
460552,36,7,29,5,1
460552,36,7,29,20,1
460552,44,9,35,21,4
460552,44,9,35,22,1
460552,44,9,35,23,1
460552,16,5,11,24,1
460552,28,4,24,25,1
460552,28,4,24,40,1
460552,12,5,7,41,4
460552,12,5,7,42,1
460552,12,5,7,43,1
460552,4,2,2,44,1
460552,8,3,5,45,1
460552,8,3,5,60,1
460561,53,0,53,1,4
460561,53,0,53,2,1
460561,53,0,53,3,1
460561,46,0,46,4,1
460561,7,0,7,5,1
460561,7,0,7,20,1
460561,53,0,53,21,4
460561,53,0,53,22,1
460561,53,0,53,23,1
460561,46,0,46,24,1
460561,7,0,7,25,1
460561,7,0,7,40,1
460570,257,36,221,1,4
460570,257,36,221,2,1
460570,257,36,221,3,1
460570,135,18,117,4,1
460570,122,18,104,5,1
460570,122,18,104,20,1
460570,220,30,190,21,4
460570,220,30,190,22,1
460570,220,30,190,23,1
460570,114,14,100,24,1
460570,106,16,90,25,1
460570,106,16,90,40,1
460570,37,6,31,41,4
460570,37,6,31,42,1
460570,37,6,31,43,1
460570,21,4,17,44,1
460570,16,2,14,45,1
460570,16,2,14,60,1
460589,317,29,288,1,4
460589,317,29,288,2,1
460589,317,29,288,3,1
460589,243,22,221,4,1
460589,74,7,67,5,1
460589,74,7,67,20,1
460589,226,18,208,21,4
460589,226,18,208,22,1
460589,226,18,208,23,1
460589,170,16,154,24,1
460589,56,2,54,25,1
460589,56,2,54,40,1
460589,91,11,80,41,4
460589,91,11,80,42,1
460589,91,11,80,43,1
460589,73,6,67,44,1
460589,18,5,13,45,1
460589,18,5,13,60,1
460598,594,121,473,1,4
460598,594,121,473,2,1
460598,594,121,473,3,1
460598,591,119,472,4,1
460598,3,2,1,5,1
460598,3,2,1,20,1
460598,475,107,368,21,4
460598,475,107,368,22,1
460598,475,107,368,23,1
460598,474,107,367,24,1
460598,1,0,1,25,1
460598,1,0,1,40,1
460598,119,14,105,41,4
460598,119,14,105,42,1
460598,119,14,105,43,1
460598,117,12,105,44,1
460598,2,2,0,45,1
460598,2,2,0,60,1
460604,41,40,1,1,4
460604,41,40,1,2,1
460604,41,40,1,3,1
460604,19,19,0,4,1
460604,22,21,1,5,1
460604,22,21,1,20,1
460604,41,40,1,21,4
460604,41,40,1,22,1
460604,41,40,1,23,1
460604,19,19,0,24,1
460604,22,21,1,25,1
460604,22,21,1,40,1
460613,785,312,473,1,4
460613,785,312,473,2,1
460613,785,312,473,3,1
460613,169,68,101,4,1
460613,616,244,372,5,1
460613,85,37,48,19,1
460613,531,207,324,20,1
460613,785,312,473,21,4
460613,785,312,473,22,1
460613,785,312,473,23,1
460613,169,68,101,24,1
460613,616,244,372,25,1
460613,85,37,48,39,1
460613,531,207,324,40,1
460631,53,4,49,1,4
460631,53,4,49,2,1
460631,53,4,49,3,1
460631,16,1,15,4,1
460631,37,3,34,5,1
460631,37,3,34,20,1
460631,53,4,49,21,4
460631,53,4,49,22,1
460631,53,4,49,23,1
460631,16,1,15,24,1
460631,37,3,34,25,1
460631,37,3,34,40,1
460640,66,19,47,1,4
460640,66,19,47,2,1
460640,66,19,47,3,1
460640,21,8,13,4,1
460640,45,11,34,5,1
460640,45,11,34,20,1
460640,36,12,24,21,4
460640,36,12,24,22,1
460640,36,12,24,23,1
460640,14,5,9,24,1
460640,22,7,15,25,1
460640,22,7,15,40,1
460640,30,7,23,41,4
460640,30,7,23,42,1
460640,30,7,23,43,1
460640,7,3,4,44,1
460640,23,4,19,45,1
460640,23,4,19,60,1
460659,96,8,88,1,4
460659,96,8,88,2,1
460659,96,8,88,3,1
460659,53,5,48,4,1
460659,43,3,40,5,1
460659,43,3,40,20,1
460659,96,8,88,21,4
460659,96,8,88,22,1
460659,96,8,88,23,1
460659,53,5,48,24,1
460659,43,3,40,25,1
460659,43,3,40,40,1
460668,356,81,275,1,4
460668,356,81,275,2,1
460668,356,81,275,3,1
460668,151,44,107,4,1
460668,205,37,168,5,1
460668,205,37,168,20,1
460668,356,81,275,21,4
460668,356,81,275,22,1
460668,356,81,275,23,1
460668,151,44,107,24,1
460668,205,37,168,25,1
460668,205,37,168,40,1
460677,613,131,482,1,4
460677,613,131,482,2,1
460677,613,131,482,3,1
460677,271,65,206,4,1
460677,342,66,276,5,1
460677,12,1,11,19,1
460677,330,65,265,20,1
460677,493,109,384,21,4
460677,493,109,384,22,1
460677,493,109,384,23,1
460677,257,60,197,24,1
460677,236,49,187,25,1
460677,9,1,8,39,1
460677,227,48,179,40,1
460677,120,22,98,41,4
460677,120,22,98,42,1
460677,120,22,98,43,1
460677,14,5,9,44,1
460677,106,17,89,45,1
460677,3,0,3,59,1
460677,103,17,86,60,1
460686,143,46,97,1,4
460686,143,46,97,2,1
460686,143,46,97,3,1
460686,52,17,35,4,1
460686,91,29,62,5,1
460686,91,29,62,20,1
460686,129,42,87,21,4
460686,129,42,87,22,1
460686,129,42,87,23,1
460686,50,16,34,24,1
460686,79,26,53,25,1
460686,79,26,53,40,1
460686,14,4,10,41,4
460686,14,4,10,42,1
460686,14,4,10,43,1
460686,2,1,1,44,1
460686,12,3,9,45,1
460686,12,3,9,60,1
460695,49,7,42,1,4
460695,49,7,42,2,1
460695,49,7,42,3,1
460695,22,4,18,4,1
460695,27,3,24,5,1
460695,27,3,24,20,1
460695,48,6,42,21,4
460695,48,6,42,22,1
460695,48,6,42,23,1
460695,22,4,18,24,1
460695,26,2,24,25,1
460695,26,2,24,40,1
460695,1,1,0,41,4
460695,1,1,0,42,1
460695,1,1,0,43,1
460695,1,1,0,45,1
460695,1,1,0,60,1
460701,220,70,150,1,4
460701,220,70,150,2,1
460701,220,70,150,3,1
460701,40,15,25,4,1
460701,180,55,125,5,1
460701,180,55,125,20,1
460701,75,28,47,21,4
460701,75,28,47,22,1
460701,75,28,47,23,1
460701,18,10,8,24,1
460701,57,18,39,25,1
460701,57,18,39,40,1
460701,145,42,103,41,4
460701,145,42,103,42,1
460701,145,42,103,43,1
460701,22,5,17,44,1
460701,123,37,86,45,1
460701,123,37,86,60,1
460710,180,12,168,1,4
460710,180,12,168,2,1
460710,180,12,168,3,1
460710,6,2,4,4,1
460710,174,10,164,5,1
460710,174,10,164,20,1
460710,110,8,102,21,4
460710,110,8,102,22,1
460710,110,8,102,23,1
460710,4,1,3,24,1
460710,106,7,99,25,1
460710,106,7,99,40,1
460710,70,4,66,41,4
460710,70,4,66,42,1
460710,70,4,66,43,1
460710,2,1,1,44,1
460710,68,3,65,45,1
460710,68,3,65,60,1
460729,2628,1677,951,1,4
460729,2628,1677,951,2,1
460729,2527,1606,921,3,1
460729,907,559,348,4,1
460729,1620,1047,573,5,1
460729,101,71,30,11,1
460729,461,317,144,19,1
460729,1159,730,429,20,1
460729,668,427,241,21,4
460729,668,427,241,22,1
460729,653,415,238,23,1
460729,195,122,73,24,1
460729,458,293,165,25,1
460729,15,12,3,31,1
460729,120,80,40,39,1
460729,338,213,125,40,1
460729,1960,1250,710,41,4
460729,1960,1250,710,42,1
460729,1874,1191,683,43,1
460729,712,437,275,44,1
460729,1162,754,408,45,1
460729,86,59,27,51,1
460729,341,237,104,59,1
460729,821,517,304,60,1
460738,3676,555,3121,1,4
460738,2346,366,1980,2,1
460738,2328,360,1968,3,1
460738,2328,360,1968,5,1
460738,18,6,12,11,1
460738,1330,189,1141,12,3
460738,1206,144,1062,19,1
460738,1122,216,906,20,1
460738,484,111,373,21,4
460738,138,60,78,22,1
460738,124,55,69,23,1
460738,124,55,69,25,1
460738,14,5,9,31,1
460738,346,51,295,32,3
460738,50,15,35,39,1
460738,74,40,34,40,1
460738,3192,444,2748,41,4
460738,2208,306,1902,42,1
460738,2204,305,1899,43,1
460738,2204,305,1899,45,1
460738,4,1,3,51,1
460738,984,138,846,52,3
460738,1156,129,1027,59,1
460738,1048,176,872,60,1
460747,386,334,52,1,4
460747,386,334,52,2,1
460747,386,334,52,3,1
460747,107,88,19,4,1
460747,279,246,33,5,1
460747,60,55,5,19,1
460747,219,191,28,20,1
460747,386,334,52,21,4
460747,386,334,52,22,1
460747,386,334,52,23,1
460747,107,88,19,24,1
460747,279,246,33,25,1
460747,60,55,5,39,1
460747,219,191,28,40,1
460756,426,27,399,1,4
460756,426,27,399,2,1
460756,22,1,21,3,1
460756,3,0,3,4,1
460756,19,1,18,5,1
460756,404,26,378,11,1
460756,19,1,18,20,1
460756,426,27,399,21,4
460756,426,27,399,22,1
460756,22,1,21,23,1
460756,3,0,3,24,1
460756,19,1,18,25,1
460756,404,26,378,31,1
460756,19,1,18,40,1
460765,59,2,57,1,4
460765,59,2,57,2,1
460765,59,2,57,3,1
460765,54,2,52,4,1
460765,5,0,5,5,1
460765,5,0,5,20,1
460765,59,2,57,21,4
460765,59,2,57,22,1
460765,59,2,57,23,1
460765,54,2,52,24,1
460765,5,0,5,25,1
460765,5,0,5,40,1
460774,600,58,542,1,4
460774,600,58,542,2,1
460774,600,58,542,3,1
460774,226,28,198,4,1
460774,374,30,344,5,1
460774,374,30,344,20,1
460774,416,47,369,21,4
460774,416,47,369,22,1
460774,416,47,369,23,1
460774,154,26,128,24,1
460774,262,21,241,25,1
460774,262,21,241,40,1
460774,184,11,173,41,4
460774,184,11,173,42,1
460774,184,11,173,43,1
460774,72,2,70,44,1
460774,112,9,103,45,1
460774,112,9,103,60,1
460783,235,42,193,1,4
460783,235,42,193,2,1
460783,235,42,193,3,1
460783,48,11,37,4,1
460783,187,31,156,5,1
460783,187,31,156,20,1
460783,235,42,193,21,4
460783,235,42,193,22,1
460783,235,42,193,23,1
460783,48,11,37,24,1
460783,187,31,156,25,1
460783,187,31,156,40,1
460808,12,2,10,1,4
460808,12,2,10,2,1
460808,12,2,10,3,1
460808,12,2,10,4,1
460808,12,2,10,21,4
460808,12,2,10,22,1
460808,12,2,10,23,1
460808,12,2,10,24,1
460817,475,57,418,1,4
460817,475,57,418,2,1
460817,475,57,418,3,1
460817,116,12,104,4,1
460817,359,45,314,5,1
460817,37,1,36,19,1
460817,322,44,278,20,1
460817,316,40,276,21,4
460817,316,40,276,22,1
460817,316,40,276,23,1
460817,95,11,84,24,1
460817,221,29,192,25,1
460817,31,1,30,39,1
460817,190,28,162,40,1
460817,159,17,142,41,4
460817,159,17,142,42,1
460817,159,17,142,43,1
460817,21,1,20,44,1
460817,138,16,122,45,1
460817,6,0,6,59,1
460817,132,16,116,60,1
460826,485,56,429,1,4
460826,485,56,429,2,1
460826,485,56,429,3,1
460826,49,7,42,4,1
460826,436,49,387,5,1
460826,116,15,101,19,1
460826,320,34,286,20,1
460826,283,34,249,21,4
460826,283,34,249,22,1
460826,283,34,249,23,1
460826,35,5,30,24,1
460826,248,29,219,25,1
460826,79,10,69,39,1
460826,169,19,150,40,1
460826,202,22,180,41,4
460826,202,22,180,42,1
460826,202,22,180,43,1
460826,14,2,12,44,1
460826,188,20,168,45,1
460826,37,5,32,59,1
460826,151,15,136,60,1
460835,752,53,699,1,4
460835,752,53,699,2,1
460835,752,53,699,3,1
460835,142,13,129,4,1
460835,610,40,570,5,1
460835,141,10,131,19,1
460835,469,30,439,20,1
460835,495,36,459,21,4
460835,495,36,459,22,1
460835,495,36,459,23,1
460835,102,11,91,24,1
460835,393,25,368,25,1
460835,94,9,85,39,1
460835,299,16,283,40,1
460835,257,17,240,41,4
460835,257,17,240,42,1
460835,257,17,240,43,1
460835,40,2,38,44,1
460835,217,15,202,45,1
460835,47,1,46,59,1
460835,170,14,156,60,1
460844,451,79,372,1,4
460844,451,79,372,2,1
460844,451,79,372,3,1
460844,108,31,77,4,1
460844,343,48,295,5,1
460844,343,48,295,20,1
460844,330,62,268,21,4
460844,330,62,268,22,1
460844,330,62,268,23,1
460844,83,25,58,24,1
460844,247,37,210,25,1
460844,247,37,210,40,1
460844,121,17,104,41,4
460844,121,17,104,42,1
460844,121,17,104,43,1
460844,25,6,19,44,1
460844,96,11,85,45,1
460844,96,11,85,60,1
460853,495,41,454,1,4
460853,495,41,454,2,1
460853,495,41,454,3,1
460853,204,23,181,4,1
460853,291,18,273,5,1
460853,291,18,273,20,1
460853,315,33,282,21,4
460853,315,33,282,22,1
460853,315,33,282,23,1
460853,143,21,122,24,1
460853,172,12,160,25,1
460853,172,12,160,40,1
460853,180,8,172,41,4
460853,180,8,172,42,1
460853,180,8,172,43,1
460853,61,2,59,44,1
460853,119,6,113,45,1
460853,119,6,113,60,1
460862,348,25,323,1,4
460862,348,25,323,2,1
460862,348,25,323,3,1
460862,57,5,52,4,1
460862,291,20,271,5,1
460862,291,20,271,20,1
460862,202,15,187,21,4
460862,202,15,187,22,1
460862,202,15,187,23,1
460862,31,3,28,24,1
460862,171,12,159,25,1
460862,171,12,159,40,1
460862,146,10,136,41,4
460862,146,10,136,42,1
460862,146,10,136,43,1
460862,26,2,24,44,1
460862,120,8,112,45,1
460862,120,8,112,60,1
460871,364,44,320,1,4
460871,364,44,320,2,1
460871,363,44,319,3,1
460871,2,0,2,4,1
460871,361,44,317,5,1
460871,1,0,1,11,1
460871,119,15,104,19,1
460871,242,29,213,20,1
460871,229,28,201,21,4
460871,229,28,201,22,1
460871,229,28,201,23,1
460871,2,0,2,24,1
460871,227,28,199,25,1
460871,99,13,86,39,1
460871,128,15,113,40,1
460871,135,16,119,41,4
460871,135,16,119,42,1
460871,134,16,118,43,1
460871,134,16,118,45,1
460871,1,0,1,51,1
460871,20,2,18,59,1
460871,114,14,100,60,1
460899,422,163,259,1,4
460899,422,163,259,2,1
460899,422,163,259,3,1
460899,269,100,169,4,1
460899,153,63,90,5,1
460899,153,63,90,20,1
460899,422,163,259,21,4
460899,422,163,259,22,1
460899,422,163,259,23,1
460899,269,100,169,24,1
460899,153,63,90,25,1
460899,153,63,90,40,1
460905,58,1,57,1,4
460905,58,1,57,2,1
460905,58,1,57,3,1
460905,7,0,7,4,1
460905,51,1,50,5,1
460905,51,1,50,20,1
460905,58,1,57,21,4
460905,58,1,57,22,1
460905,58,1,57,23,1
460905,7,0,7,24,1
460905,51,1,50,25,1
460905,51,1,50,40,1
460914,177,2,175,1,4
460914,177,2,175,2,1
460914,177,2,175,3,1
460914,17,0,17,4,1
460914,160,2,158,5,1
460914,160,2,158,20,1
460914,177,2,175,21,4
460914,177,2,175,22,1
460914,177,2,175,23,1
460914,17,0,17,24,1
460914,160,2,158,25,1
460914,160,2,158,40,1
460923,506,102,404,1,4
460923,506,102,404,2,1
460923,506,102,404,3,1
460923,284,68,216,4,1
460923,222,34,188,5,1
460923,222,34,188,20,1
460923,408,95,313,21,4
460923,408,95,313,22,1
460923,408,95,313,23,1
460923,236,64,172,24,1
460923,172,31,141,25,1
460923,172,31,141,40,1
460923,98,7,91,41,4
460923,98,7,91,42,1
460923,98,7,91,43,1
460923,48,4,44,44,1
460923,50,3,47,45,1
460923,50,3,47,60,1
460932,55,0,55,1,4
460932,55,0,55,2,1
460932,55,0,55,3,1
460932,39,0,39,4,1
460932,16,0,16,5,1
460932,16,0,16,20,1
460932,55,0,55,21,4
460932,55,0,55,22,1
460932,55,0,55,23,1
460932,39,0,39,24,1
460932,16,0,16,25,1
460932,16,0,16,40,1
460941,42,6,36,1,4
460941,42,6,36,12,3
460941,37,4,33,21,4
460941,37,4,33,32,3
460941,5,2,3,41,4
460941,5,2,3,52,3
460950,64,19,45,1,4
460950,64,19,45,2,1
460950,64,19,45,3,1
460950,33,6,27,4,1
460950,31,13,18,5,1
460950,31,13,18,20,1
460950,64,19,45,21,4
460950,64,19,45,22,1
460950,64,19,45,23,1
460950,33,6,27,24,1
460950,31,13,18,25,1
460950,31,13,18,40,1
460969,114,32,82,1,4
460969,114,32,82,2,1
460969,114,32,82,3,1
460969,94,26,68,4,1
460969,20,6,14,5,1
460969,20,6,14,20,1
460969,114,32,82,21,4
460969,114,32,82,22,1
460969,114,32,82,23,1
460969,94,26,68,24,1
460969,20,6,14,25,1
460969,20,6,14,40,1
460978,154,8,146,1,4
460978,154,8,146,2,1
460978,154,8,146,3,1
460978,60,2,58,4,1
460978,94,6,88,5,1
460978,94,6,88,20,1
460978,109,3,106,21,4
460978,109,3,106,22,1
460978,109,3,106,23,1
460978,44,0,44,24,1
460978,65,3,62,25,1
460978,65,3,62,40,1
460978,45,5,40,41,4
460978,45,5,40,42,1
460978,45,5,40,43,1
460978,16,2,14,44,1
460978,29,3,26,45,1
460978,29,3,26,60,1
460987,64,2,62,1,4
460987,64,2,62,2,1
460987,64,2,62,3,1
460987,23,0,23,4,1
460987,41,2,39,5,1
460987,41,2,39,20,1
460987,55,2,53,21,4
460987,55,2,53,22,1
460987,55,2,53,23,1
460987,22,0,22,24,1
460987,33,2,31,25,1
460987,33,2,31,40,1
460987,9,0,9,41,4
460987,9,0,9,42,1
460987,9,0,9,43,1
460987,1,0,1,44,1
460987,8,0,8,45,1
460987,8,0,8,60,1
460996,100,2,98,1,4
460996,100,2,98,2,1
460996,100,2,98,3,1
460996,42,0,42,4,1
460996,58,2,56,5,1
460996,58,2,56,20,1
460996,84,2,82,21,4
460996,84,2,82,22,1
460996,84,2,82,23,1
460996,35,0,35,24,1
460996,49,2,47,25,1
460996,49,2,47,40,1
460996,16,0,16,41,4
460996,16,0,16,42,1
460996,16,0,16,43,1
460996,7,0,7,44,1
460996,9,0,9,45,1
460996,9,0,9,60,1
461005,269,36,233,1,4
461005,269,36,233,2,1
461005,252,34,218,3,1
461005,181,27,154,4,1
461005,71,7,64,5,1
461005,17,2,15,11,1
461005,71,7,64,20,1
461005,233,33,200,21,4
461005,233,33,200,22,1
461005,216,31,185,23,1
461005,156,24,132,24,1
461005,60,7,53,25,1
461005,17,2,15,31,1
461005,60,7,53,40,1
461005,36,3,33,41,4
461005,36,3,33,42,1
461005,36,3,33,43,1
461005,25,3,22,44,1
461005,11,0,11,45,1
461005,11,0,11,60,1
461014,617,38,579,1,4
461014,617,38,579,2,1
461014,609,38,571,3,1
461014,160,17,143,4,1
461014,449,21,428,5,1
461014,8,0,8,11,1
461014,3,0,3,19,1
461014,446,21,425,20,1
461014,612,38,574,21,4
461014,612,38,574,22,1
461014,604,38,566,23,1
461014,160,17,143,24,1
461014,444,21,423,25,1
461014,8,0,8,31,1
461014,3,0,3,39,1
461014,441,21,420,40,1
461014,5,0,5,41,4
461014,5,0,5,42,1
461014,5,0,5,43,1
461014,5,0,5,45,1
461014,5,0,5,60,1
461023,1089,172,917,1,4
461023,1089,172,917,2,1
461023,1089,172,917,3,1
461023,107,14,93,4,1
461023,982,158,824,5,1
461023,258,38,220,19,1
461023,724,120,604,20,1
461023,1063,170,893,21,4
461023,1063,170,893,22,1
461023,1063,170,893,23,1
461023,105,14,91,24,1
461023,958,156,802,25,1
461023,245,38,207,39,1
461023,713,118,595,40,1
461023,26,2,24,41,4
461023,26,2,24,42,1
461023,26,2,24,43,1
461023,2,0,2,44,1
461023,24,2,22,45,1
461023,13,0,13,59,1
461023,11,2,9,60,1
461032,113,60,53,1,4
461032,113,60,53,2,1
461032,113,60,53,3,1
461032,13,6,7,4,1
461032,100,54,46,5,1
461032,16,11,5,19,1
461032,84,43,41,20,1
461032,45,26,19,21,4
461032,45,26,19,22,1
461032,45,26,19,23,1
461032,6,2,4,24,1
461032,39,24,15,25,1
461032,10,6,4,39,1
461032,29,18,11,40,1
461032,68,34,34,41,4
461032,68,34,34,42,1
461032,68,34,34,43,1
461032,7,4,3,44,1
461032,61,30,31,45,1
461032,6,5,1,59,1
461032,55,25,30,60,1
461041,469,48,421,1,4
461041,469,48,421,2,1
461041,469,48,421,3,1
461041,381,36,345,4,1
461041,88,12,76,5,1
461041,88,12,76,20,1
461041,373,41,332,21,4
461041,373,41,332,22,1
461041,373,41,332,23,1
461041,307,33,274,24,1
461041,66,8,58,25,1
461041,66,8,58,40,1
461041,96,7,89,41,4
461041,96,7,89,42,1
461041,96,7,89,43,1
461041,74,3,71,44,1
461041,22,4,18,45,1
461041,22,4,18,60,1
461111,35,29,6,1,4
461111,35,29,6,2,1
461111,35,29,6,3,1
461111,22,19,3,4,1
461111,13,10,3,5,1
461111,13,10,3,20,1
461111,28,23,5,21,4
461111,28,23,5,22,1
461111,28,23,5,23,1
461111,18,15,3,24,1
461111,10,8,2,25,1
461111,10,8,2,40,1
461111,7,6,1,41,4
461111,7,6,1,42,1
461111,7,6,1,43,1
461111,4,4,0,44,1
461111,3,2,1,45,1
461111,3,2,1,60,1
461120,113,70,43,1,4
461120,113,70,43,12,3
461120,113,70,43,21,4
461120,113,70,43,32,3
461139,72,19,53,1,4
461139,72,19,53,12,3
461139,72,19,53,21,4
461139,72,19,53,32,3
461148,1717,981,736,1,4
461148,1344,752,592,2,1
461148,1344,752,592,3,1
461148,1291,725,566,4,1
461148,53,27,26,5,1
461148,373,229,144,12,3
461148,53,27,26,20,1
461148,1717,981,736,21,4
461148,1344,752,592,22,1
461148,1344,752,592,23,1
461148,1291,725,566,24,1
461148,53,27,26,25,1
461148,373,229,144,32,3
461148,53,27,26,40,1
461157,50,46,4,1,4
461157,50,46,4,2,1
461157,50,46,4,3,1
461157,19,17,2,4,1
461157,31,29,2,5,1
461157,31,29,2,20,1
461157,50,46,4,21,4
461157,50,46,4,22,1
461157,50,46,4,23,1
461157,19,17,2,24,1
461157,31,29,2,25,1
461157,31,29,2,40,1
461175,179,33,146,1,4
461175,179,33,146,2,1
461175,179,33,146,3,1
461175,65,11,54,4,1
461175,114,22,92,5,1
461175,114,22,92,20,1
461175,104,23,81,21,4
461175,104,23,81,22,1
461175,104,23,81,23,1
461175,38,10,28,24,1
461175,66,13,53,25,1
461175,66,13,53,40,1
461175,75,10,65,41,4
461175,75,10,65,42,1
461175,75,10,65,43,1
461175,27,1,26,44,1
461175,48,9,39,45,1
461175,48,9,39,60,1
461193,89,2,87,1,4
461193,89,2,87,2,1
461193,89,2,87,3,1
461193,59,2,57,4,1
461193,30,0,30,5,1
461193,30,0,30,20,1
461193,71,2,69,21,4
461193,71,2,69,22,1
461193,71,2,69,23,1
461193,57,2,55,24,1
461193,14,0,14,25,1
461193,14,0,14,40,1
461193,18,0,18,41,4
461193,18,0,18,42,1
461193,18,0,18,43,1
461193,2,0,2,44,1
461193,16,0,16,45,1
461193,16,0,16,60,1
461218,54,4,50,1,4
461218,54,4,50,2,1
461218,54,4,50,3,1
461218,37,4,33,4,1
461218,17,0,17,5,1
461218,17,0,17,20,1
461218,52,3,49,21,4
461218,52,3,49,22,1
461218,52,3,49,23,1
461218,36,3,33,24,1
461218,16,0,16,25,1
461218,16,0,16,40,1
461218,2,1,1,41,4
461218,2,1,1,42,1
461218,2,1,1,43,1
461218,1,1,0,44,1
461218,1,0,1,45,1
461218,1,0,1,60,1
461227,47,2,45,1,4
461227,47,2,45,2,1
461227,47,2,45,3,1
461227,30,2,28,4,1
461227,17,0,17,5,1
461227,17,0,17,20,1
461227,43,1,42,21,4
461227,43,1,42,22,1
461227,43,1,42,23,1
461227,27,1,26,24,1
461227,16,0,16,25,1
461227,16,0,16,40,1
461227,4,1,3,41,4
461227,4,1,3,42,1
461227,4,1,3,43,1
461227,3,1,2,44,1
461227,1,0,1,45,1
461227,1,0,1,60,1
461236,251,120,131,1,4
461236,156,74,82,2,1
461236,156,74,82,3,1
461236,13,3,10,4,1
461236,143,71,72,5,1
461236,95,46,49,12,3
461236,29,12,17,19,1
461236,114,59,55,20,1
461236,248,119,129,21,4
461236,155,74,81,22,1
461236,155,74,81,23,1
461236,13,3,10,24,1
461236,142,71,71,25,1
461236,93,45,48,32,3
461236,29,12,17,39,1
461236,113,59,54,40,1
461236,3,1,2,41,4
461236,1,0,1,42,1
461236,1,0,1,43,1
461236,1,0,1,45,1
461236,2,1,1,52,3
461236,1,0,1,60,1
461245,338,91,247,1,4
461245,338,91,247,2,1
461245,338,91,247,3,1
461245,159,67,92,4,1
461245,179,24,155,5,1
461245,179,24,155,20,1
461245,76,21,55,21,4
461245,76,21,55,22,1
461245,76,21,55,23,1
461245,53,18,35,24,1
461245,23,3,20,25,1
461245,23,3,20,40,1
461245,262,70,192,41,4
461245,262,70,192,42,1
461245,262,70,192,43,1
461245,106,49,57,44,1
461245,156,21,135,45,1
461245,156,21,135,60,1
461254,31,9,22,1,4
461254,31,9,22,2,1
461254,31,9,22,3,1
461254,29,8,21,4,1
461254,2,1,1,5,1
461254,2,1,1,20,1
461254,31,9,22,21,4
461254,31,9,22,22,1
461254,31,9,22,23,1
461254,29,8,21,24,1
461254,2,1,1,25,1
461254,2,1,1,40,1
461263,77,20,57,1,4
461263,77,20,57,2,1
461263,77,20,57,3,1
461263,8,1,7,4,1
461263,69,19,50,5,1
461263,69,19,50,20,1
461263,77,20,57,21,4
461263,77,20,57,22,1
461263,77,20,57,23,1
461263,8,1,7,24,1
461263,69,19,50,25,1
461263,69,19,50,40,1
461272,65,0,65,1,4
461272,65,0,65,2,1
461272,65,0,65,3,1
461272,6,0,6,4,1
461272,59,0,59,5,1
461272,59,0,59,20,1
461272,36,0,36,21,4
461272,36,0,36,22,1
461272,36,0,36,23,1
461272,2,0,2,24,1
461272,34,0,34,25,1
461272,34,0,34,40,1
461272,29,0,29,41,4
461272,29,0,29,42,1
461272,29,0,29,43,1
461272,4,0,4,44,1
461272,25,0,25,45,1
461272,25,0,25,60,1
461281,159,8,151,1,4
461281,154,8,146,2,1
461281,34,7,27,3,1
461281,2,1,1,4,1
461281,32,6,26,5,1
461281,120,1,119,11,1
461281,5,0,5,12,3
461281,32,6,26,20,1
461281,9,3,6,21,4
461281,9,3,6,22,1
461281,9,3,6,23,1
461281,9,3,6,25,1
461281,9,3,6,40,1
461281,150,5,145,41,4
461281,145,5,140,42,1
461281,25,4,21,43,1
461281,2,1,1,44,1
461281,23,3,20,45,1
461281,120,1,119,51,1
461281,5,0,5,52,3
461281,23,3,20,60,1
461290,50,1,49,1,4
461290,50,1,49,2,1
461290,50,1,49,3,1
461290,10,0,10,4,1
461290,40,1,39,5,1
461290,40,1,39,20,1
461290,15,0,15,21,4
461290,15,0,15,22,1
461290,15,0,15,23,1
461290,6,0,6,24,1
461290,9,0,9,25,1
461290,9,0,9,40,1
461290,35,1,34,41,4
461290,35,1,34,42,1
461290,35,1,34,43,1
461290,4,0,4,44,1
461290,31,1,30,45,1
461290,31,1,30,60,1
461306,138,54,84,1,4
461306,138,54,84,2,1
461306,85,34,51,3,1
461306,85,34,51,4,1
461306,53,20,33,11,1
461306,67,30,37,21,4
461306,67,30,37,22,1
461306,41,17,24,23,1
461306,41,17,24,24,1
461306,26,13,13,31,1
461306,71,24,47,41,4
461306,71,24,47,42,1
461306,44,17,27,43,1
461306,44,17,27,44,1
461306,27,7,20,51,1
461315,106,28,78,1,4
461315,106,28,78,2,1
461315,105,27,78,3,1
461315,36,13,23,4,1
461315,69,14,55,5,1
461315,1,1,0,11,1
461315,69,14,55,20,1
461315,64,20,44,21,4
461315,64,20,44,22,1
461315,64,20,44,23,1
461315,21,7,14,24,1
461315,43,13,30,25,1
461315,43,13,30,40,1
461315,42,8,34,41,4
461315,42,8,34,42,1
461315,41,7,34,43,1
461315,15,6,9,44,1
461315,26,1,25,45,1
461315,1,1,0,51,1
461315,26,1,25,60,1
461324,249,72,177,1,4
461324,249,72,177,2,1
461324,249,72,177,3,1
461324,249,72,177,5,1
461324,249,72,177,20,1
461324,249,72,177,21,4
461324,249,72,177,22,1
461324,249,72,177,23,1
461324,249,72,177,25,1
461324,249,72,177,40,1
461333,19,19,0,1,4
461333,19,19,0,2,1
461333,19,19,0,3,1
461333,12,12,0,4,1
461333,7,7,0,5,1
461333,7,7,0,20,1
461333,19,19,0,41,4
461333,19,19,0,42,1
461333,19,19,0,43,1
461333,12,12,0,44,1
461333,7,7,0,45,1
461333,7,7,0,60,1
461342,13,0,13,1,4
461342,13,0,13,2,1
461342,13,0,13,3,1
461342,2,0,2,4,1
461342,11,0,11,5,1
461342,11,0,11,20,1
461342,12,0,12,21,4
461342,12,0,12,22,1
461342,12,0,12,23,1
461342,2,0,2,24,1
461342,10,0,10,25,1
461342,10,0,10,40,1
461342,1,0,1,41,4
461342,1,0,1,42,1
461342,1,0,1,43,1
461342,1,0,1,45,1
461342,1,0,1,60,1
461351,1135,213,922,1,4
461351,1135,213,922,2,1
461351,1135,213,922,3,1
461351,766,159,607,4,1
461351,369,54,315,5,1
461351,369,54,315,20,1
461351,53,8,45,21,4
461351,53,8,45,22,1
461351,53,8,45,23,1
461351,41,7,34,24,1
461351,12,1,11,25,1
461351,12,1,11,40,1
461351,1082,205,877,41,4
461351,1082,205,877,42,1
461351,1082,205,877,43,1
461351,725,152,573,44,1
461351,357,53,304,45,1
461351,357,53,304,60,1
461360,34,2,32,1,4
461360,34,2,32,2,1
461360,34,2,32,3,1
461360,17,2,15,4,1
461360,17,0,17,5,1
461360,17,0,17,20,1
461360,33,2,31,21,4
461360,33,2,31,22,1
461360,33,2,31,23,1
461360,17,2,15,24,1
461360,16,0,16,25,1
461360,16,0,16,40,1
461360,1,0,1,41,4
461360,1,0,1,42,1
461360,1,0,1,43,1
461360,1,0,1,45,1
461360,1,0,1,60,1
461379,18,1,17,1,4
461379,18,1,17,2,1
461379,18,1,17,3,1
461379,7,1,6,4,1
461379,11,0,11,5,1
461379,11,0,11,20,1
461379,18,1,17,41,4
461379,18,1,17,42,1
461379,18,1,17,43,1
461379,7,1,6,44,1
461379,11,0,11,45,1
461379,11,0,11,60,1
461388,41,5,36,1,4
461388,41,5,36,2,1
461388,41,5,36,3,1
461388,1,0,1,4,1
461388,40,5,35,5,1
461388,40,5,35,20,1
461388,41,5,36,21,4
461388,41,5,36,22,1
461388,41,5,36,23,1
461388,1,0,1,24,1
461388,40,5,35,25,1
461388,40,5,35,40,1
461397,270,38,232,1,4
461397,270,38,232,2,1
461397,270,38,232,3,1
461397,63,10,53,4,1
461397,207,28,179,5,1
461397,207,28,179,20,1
461397,139,28,111,21,4
461397,139,28,111,22,1
461397,139,28,111,23,1
461397,45,9,36,24,1
461397,94,19,75,25,1
461397,94,19,75,40,1
461397,131,10,121,41,4
461397,131,10,121,42,1
461397,131,10,121,43,1
461397,18,1,17,44,1
461397,113,9,104,45,1
461397,113,9,104,60,1
461403,30,2,28,1,4
461403,30,2,28,2,1
461403,30,2,28,3,1
461403,3,0,3,4,1
461403,27,2,25,5,1
461403,27,2,25,20,1
461403,30,2,28,21,4
461403,30,2,28,22,1
461403,30,2,28,23,1
461403,3,0,3,24,1
461403,27,2,25,25,1
461403,27,2,25,40,1
461412,96,31,65,1,4
461412,96,31,65,2,1
461412,96,31,65,3,1
461412,30,9,21,4,1
461412,66,22,44,5,1
461412,66,22,44,20,1
461412,96,31,65,41,4
461412,96,31,65,42,1
461412,96,31,65,43,1
461412,30,9,21,44,1
461412,66,22,44,45,1
461412,66,22,44,60,1
461421,225,13,212,1,4
461421,225,13,212,2,1
461421,225,13,212,3,1
461421,64,1,63,4,1
461421,161,12,149,5,1
461421,161,12,149,20,1
461421,190,9,181,21,4
461421,190,9,181,22,1
461421,190,9,181,23,1
461421,64,1,63,24,1
461421,126,8,118,25,1
461421,126,8,118,40,1
461421,35,4,31,41,4
461421,35,4,31,42,1
461421,35,4,31,43,1
461421,35,4,31,45,1
461421,35,4,31,60,1
461430,308,303,5,1,4
461430,308,303,5,2,1
461430,308,303,5,3,1
461430,143,142,1,4,1
461430,165,161,4,5,1
461430,165,161,4,20,1
461430,308,303,5,41,4
461430,308,303,5,42,1
461430,308,303,5,43,1
461430,143,142,1,44,1
461430,165,161,4,45,1
461430,165,161,4,60,1
461449,110,16,94,1,4
461449,110,16,94,2,1
461449,110,16,94,3,1
461449,107,15,92,4,1
461449,3,1,2,5,1
461449,3,1,2,20,1
461449,75,12,63,21,4
461449,75,12,63,22,1
461449,75,12,63,23,1
461449,73,12,61,24,1
461449,2,0,2,25,1
461449,2,0,2,40,1
461449,35,4,31,41,4
461449,35,4,31,42,1
461449,35,4,31,43,1
461449,34,3,31,44,1
461449,1,1,0,45,1
461449,1,1,0,60,1
461458,33,1,32,1,4
461458,33,1,32,2,1
461458,33,1,32,3,1
461458,30,1,29,4,1
461458,3,0,3,5,1
461458,3,0,3,20,1
461458,13,0,13,21,4
461458,13,0,13,22,1
461458,13,0,13,23,1
461458,11,0,11,24,1
461458,2,0,2,25,1
461458,2,0,2,40,1
461458,20,1,19,41,4
461458,20,1,19,42,1
461458,20,1,19,43,1
461458,19,1,18,44,1
461458,1,0,1,45,1
461458,1,0,1,60,1
461476,30,17,13,1,4
461476,30,17,13,2,1
461476,30,17,13,3,1
461476,12,10,2,4,1
461476,18,7,11,5,1
461476,18,7,11,20,1
461476,25,14,11,21,4
461476,25,14,11,22,1
461476,25,14,11,23,1
461476,9,7,2,24,1
461476,16,7,9,25,1
461476,16,7,9,40,1
461476,5,3,2,41,4
461476,5,3,2,42,1
461476,5,3,2,43,1
461476,3,3,0,44,1
461476,2,0,2,45,1
461476,2,0,2,60,1
461485,76,69,7,1,4
461485,4,4,0,2,1
461485,4,4,0,3,1
461485,2,2,0,4,1
461485,2,2,0,5,1
461485,72,65,7,12,3
461485,2,2,0,20,1
461485,33,31,2,21,4
461485,33,31,2,32,3
461485,43,38,5,41,4
461485,4,4,0,42,1
461485,4,4,0,43,1
461485,2,2,0,44,1
461485,2,2,0,45,1
461485,39,34,5,52,3
461485,2,2,0,60,1
461494,175,8,167,1,4
461494,175,8,167,2,1
461494,175,8,167,3,1
461494,24,1,23,4,1
461494,151,7,144,5,1
461494,151,7,144,20,1
461494,110,5,105,21,4
461494,110,5,105,22,1
461494,110,5,105,23,1
461494,17,1,16,24,1
461494,93,4,89,25,1
461494,93,4,89,40,1
461494,65,3,62,41,4
461494,65,3,62,42,1
461494,65,3,62,43,1
461494,7,0,7,44,1
461494,58,3,55,45,1
461494,58,3,55,60,1
461500,43,6,37,1,4
461500,43,6,37,2,1
461500,43,6,37,3,1
461500,13,2,11,4,1
461500,30,4,26,5,1
461500,30,4,26,20,1
461500,4,0,4,21,4
461500,4,0,4,22,1
461500,4,0,4,23,1
461500,1,0,1,24,1
461500,3,0,3,25,1
461500,3,0,3,40,1
461500,39,6,33,41,4
461500,39,6,33,42,1
461500,39,6,33,43,1
461500,12,2,10,44,1
461500,27,4,23,45,1
461500,27,4,23,60,1
461528,110,50,60,1,4
461528,110,50,60,2,1
461528,95,46,49,3,1
461528,55,24,31,4,1
461528,40,22,18,5,1
461528,15,4,11,11,1
461528,4,3,1,19,1
461528,36,19,17,20,1
461528,38,17,21,21,4
461528,38,17,21,22,1
461528,38,17,21,23,1
461528,19,8,11,24,1
461528,19,9,10,25,1
461528,1,1,0,39,1
461528,18,8,10,40,1
461528,72,33,39,41,4
461528,72,33,39,42,1
461528,57,29,28,43,1
461528,36,16,20,44,1
461528,21,13,8,45,1
461528,15,4,11,51,1
461528,3,2,1,59,1
461528,18,11,7,60,1
461537,25,0,25,1,4
461537,25,0,25,2,1
461537,25,0,25,3,1
461537,15,0,15,4,1
461537,10,0,10,5,1
461537,10,0,10,20,1
461537,25,0,25,21,4
461537,25,0,25,22,1
461537,25,0,25,23,1
461537,15,0,15,24,1
461537,10,0,10,25,1
461537,10,0,10,40,1
461546,35,2,33,1,4
461546,35,2,33,2,1
461546,35,2,33,3,1
461546,12,1,11,4,1
461546,23,1,22,5,1
461546,23,1,22,20,1
461546,27,2,25,21,4
461546,27,2,25,22,1
461546,27,2,25,23,1
461546,9,1,8,24,1
461546,18,1,17,25,1
461546,18,1,17,40,1
461546,8,0,8,41,4
461546,8,0,8,42,1
461546,8,0,8,43,1
461546,3,0,3,44,1
461546,5,0,5,45,1
461546,5,0,5,60,1
461555,132,7,125,1,4
461555,132,7,125,2,1
461555,132,7,125,3,1
461555,132,7,125,5,1
461555,132,7,125,20,1
461555,132,7,125,21,4
461555,132,7,125,22,1
461555,132,7,125,23,1
461555,132,7,125,25,1
461555,132,7,125,40,1
461564,59,38,21,1,4
461564,59,38,21,2,1
461564,59,38,21,3,1
461564,14,9,5,4,1
461564,45,29,16,5,1
461564,45,29,16,20,1
461564,13,8,5,21,4
461564,13,8,5,22,1
461564,13,8,5,23,1
461564,5,3,2,24,1
461564,8,5,3,25,1
461564,8,5,3,40,1
461564,46,30,16,41,4
461564,46,30,16,42,1
461564,46,30,16,43,1
461564,9,6,3,44,1
461564,37,24,13,45,1
461564,37,24,13,60,1
461573,97,94,3,1,4
461573,97,94,3,2,1
461573,97,94,3,3,1
461573,57,55,2,4,1
461573,40,39,1,5,1
461573,40,39,1,20,1
461573,97,94,3,21,4
461573,97,94,3,22,1
461573,97,94,3,23,1
461573,57,55,2,24,1
461573,40,39,1,25,1
461573,40,39,1,40,1
461582,95,0,95,1,4
461582,95,0,95,2,1
461582,95,0,95,3,1
461582,19,0,19,4,1
461582,76,0,76,5,1
461582,76,0,76,20,1
461582,34,0,34,21,4
461582,34,0,34,22,1
461582,34,0,34,23,1
461582,8,0,8,24,1
461582,26,0,26,25,1
461582,26,0,26,40,1
461582,61,0,61,41,4
461582,61,0,61,42,1
461582,61,0,61,43,1
461582,11,0,11,44,1
461582,50,0,50,45,1
461582,50,0,50,60,1
461591,134,15,119,1,4
461591,134,15,119,2,1
461591,134,15,119,3,1
461591,7,1,6,4,1
461591,127,14,113,5,1
461591,127,14,113,20,1
461591,127,15,112,21,4
461591,127,15,112,22,1
461591,127,15,112,23,1
461591,6,1,5,24,1
461591,121,14,107,25,1
461591,121,14,107,40,1
461591,7,0,7,41,4
461591,7,0,7,42,1
461591,7,0,7,43,1
461591,1,0,1,44,1
461591,6,0,6,45,1
461591,6,0,6,60,1
461607,90,5,85,1,4
461607,90,5,85,2,1
461607,90,5,85,3,1
461607,14,1,13,4,1
461607,76,4,72,5,1
461607,76,4,72,20,1
461607,82,5,77,21,4
461607,82,5,77,22,1
461607,82,5,77,23,1
461607,8,1,7,24,1
461607,74,4,70,25,1
461607,74,4,70,40,1
461607,8,0,8,41,4
461607,8,0,8,42,1
461607,8,0,8,43,1
461607,6,0,6,44,1
461607,2,0,2,45,1
461607,2,0,2,60,1
461616,29,1,28,1,4
461616,29,1,28,2,1
461616,29,1,28,3,1
461616,7,0,7,4,1
461616,22,1,21,5,1
461616,22,1,21,20,1
461616,14,0,14,21,4
461616,14,0,14,22,1
461616,14,0,14,23,1
461616,2,0,2,24,1
461616,12,0,12,25,1
461616,12,0,12,40,1
461616,15,1,14,41,4
461616,15,1,14,42,1
461616,15,1,14,43,1
461616,5,0,5,44,1
461616,10,1,9,45,1
461616,10,1,9,60,1
461625,6,6,0,1,4
461625,6,6,0,2,1
461625,6,6,0,3,1
461625,4,4,0,4,1
461625,2,2,0,5,1
461625,2,2,0,20,1
461625,6,6,0,21,4
461625,6,6,0,22,1
461625,6,6,0,23,1
461625,4,4,0,24,1
461625,2,2,0,25,1
461625,2,2,0,40,1
461634,51,19,32,1,4
461634,51,19,32,2,1
461634,51,19,32,3,1
461634,46,18,28,4,1
461634,5,1,4,5,1
461634,5,1,4,20,1
461634,31,17,14,21,4
461634,31,17,14,22,1
461634,31,17,14,23,1
461634,29,16,13,24,1
461634,2,1,1,25,1
461634,2,1,1,40,1
461634,20,2,18,41,4
461634,20,2,18,42,1
461634,20,2,18,43,1
461634,17,2,15,44,1
461634,3,0,3,45,1
461634,3,0,3,60,1
461643,50,8,42,1,4
461643,32,6,26,2,1
461643,32,6,26,3,1
461643,32,6,26,5,1
461643,18,2,16,12,3
461643,22,3,19,19,1
461643,10,3,7,20,1
461643,50,8,42,21,4
461643,32,6,26,22,1
461643,32,6,26,23,1
461643,32,6,26,25,1
461643,18,2,16,32,3
461643,22,3,19,39,1
461643,10,3,7,40,1
461652,67,6,61,1,4
461652,67,6,61,2,1
461652,67,6,61,3,1
461652,24,2,22,4,1
461652,43,4,39,5,1
461652,43,4,39,20,1
461652,56,4,52,21,4
461652,56,4,52,22,1
461652,56,4,52,23,1
461652,24,2,22,24,1
461652,32,2,30,25,1
461652,32,2,30,40,1
461652,11,2,9,41,4
461652,11,2,9,42,1
461652,11,2,9,43,1
461652,11,2,9,45,1
461652,11,2,9,60,1
461661,6,0,6,1,4
461661,6,0,6,2,1
461661,6,0,6,3,1
461661,6,0,6,5,1
461661,6,0,6,20,1
461661,6,0,6,21,4
461661,6,0,6,22,1
461661,6,0,6,23,1
461661,6,0,6,25,1
461661,6,0,6,40,1
461670,68,7,61,1,4
461670,68,7,61,2,1
461670,68,7,61,3,1
461670,50,5,45,4,1
461670,18,2,16,5,1
461670,18,2,16,20,1
461670,67,7,60,21,4
461670,67,7,60,22,1
461670,67,7,60,23,1
461670,49,5,44,24,1
461670,18,2,16,25,1
461670,18,2,16,40,1
461670,1,0,1,41,4
461670,1,0,1,42,1
461670,1,0,1,43,1
461670,1,0,1,44,1
461689,211,8,203,1,4
461689,211,8,203,2,1
461689,211,8,203,3,1
461689,95,4,91,4,1
461689,116,4,112,5,1
461689,116,4,112,20,1
461689,211,8,203,21,4
461689,211,8,203,22,1
461689,211,8,203,23,1
461689,95,4,91,24,1
461689,116,4,112,25,1
461689,116,4,112,40,1
461698,116,94,22,1,4
461698,116,94,22,2,1
461698,116,94,22,3,1
461698,37,33,4,4,1
461698,79,61,18,5,1
461698,79,61,18,20,1
461698,102,85,17,21,4
461698,102,85,17,22,1
461698,102,85,17,23,1
461698,36,32,4,24,1
461698,66,53,13,25,1
461698,66,53,13,40,1
461698,14,9,5,41,4
461698,14,9,5,42,1
461698,14,9,5,43,1
461698,1,1,0,44,1
461698,13,8,5,45,1
461698,13,8,5,60,1
461704,176,15,161,1,4
461704,176,15,161,2,1
461704,176,15,161,3,1
461704,78,9,69,4,1
461704,98,6,92,5,1
461704,98,6,92,20,1
461704,176,15,161,21,4
461704,176,15,161,22,1
461704,176,15,161,23,1
461704,78,9,69,24,1
461704,98,6,92,25,1
461704,98,6,92,40,1
461713,37,2,35,1,4
461713,37,2,35,2,1
461713,37,2,35,3,1
461713,3,1,2,4,1
461713,34,1,33,5,1
461713,34,1,33,20,1
461713,19,2,17,21,4
461713,19,2,17,22,1
461713,19,2,17,23,1
461713,3,1,2,24,1
461713,16,1,15,25,1
461713,16,1,15,40,1
461713,18,0,18,41,4
461713,18,0,18,42,1
461713,18,0,18,43,1
461713,18,0,18,45,1
461713,18,0,18,60,1
461722,71,2,69,1,4
461722,71,2,69,2,1
461722,71,2,69,3,1
461722,60,2,58,4,1
461722,11,0,11,5,1
461722,11,0,11,20,1
461722,66,2,64,21,4
461722,66,2,64,22,1
461722,66,2,64,23,1
461722,57,2,55,24,1
461722,9,0,9,25,1
461722,9,0,9,40,1
461722,5,0,5,41,4
461722,5,0,5,42,1
461722,5,0,5,43,1
461722,3,0,3,44,1
461722,2,0,2,45,1
461722,2,0,2,60,1
461731,39,0,39,1,4
461731,39,0,39,2,1
461731,39,0,39,3,1
461731,8,0,8,4,1
461731,31,0,31,5,1
461731,31,0,31,20,1
461731,36,0,36,21,4
461731,36,0,36,22,1
461731,36,0,36,23,1
461731,7,0,7,24,1
461731,29,0,29,25,1
461731,29,0,29,40,1
461731,3,0,3,41,4
461731,3,0,3,42,1
461731,3,0,3,43,1
461731,1,0,1,44,1
461731,2,0,2,45,1
461731,2,0,2,60,1
461740,28,23,5,1,4
461740,28,23,5,2,1
461740,28,23,5,3,1
461740,22,18,4,4,1
461740,6,5,1,5,1
461740,6,5,1,20,1
461740,28,23,5,21,4
461740,28,23,5,22,1
461740,28,23,5,23,1
461740,22,18,4,24,1
461740,6,5,1,25,1
461740,6,5,1,40,1
461759,124,61,63,1,4
461759,124,61,63,2,1
461759,120,60,60,3,1
461759,19,9,10,4,1
461759,101,51,50,5,1
461759,4,1,3,11,1
461759,11,4,7,19,1
461759,90,47,43,20,1
461759,28,10,18,21,4
461759,28,10,18,22,1
461759,24,9,15,23,1
461759,3,1,2,24,1
461759,21,8,13,25,1
461759,4,1,3,31,1
461759,3,1,2,39,1
461759,18,7,11,40,1
461759,96,51,45,41,4
461759,96,51,45,42,1
461759,96,51,45,43,1
461759,16,8,8,44,1
461759,80,43,37,45,1
461759,8,3,5,59,1
461759,72,40,32,60,1
461768,128,2,126,1,4
461768,128,2,126,2,1
461768,128,2,126,3,1
461768,73,1,72,4,1
461768,55,1,54,5,1
461768,55,1,54,20,1
461768,74,2,72,21,4
461768,74,2,72,22,1
461768,74,2,72,23,1
461768,40,1,39,24,1
461768,34,1,33,25,1
461768,34,1,33,40,1
461768,54,0,54,41,4
461768,54,0,54,42,1
461768,54,0,54,43,1
461768,33,0,33,44,1
461768,21,0,21,45,1
461768,21,0,21,60,1
461777,41,13,28,1,4
461777,41,13,28,2,1
461777,41,13,28,3,1
461777,9,4,5,4,1
461777,32,9,23,5,1
461777,32,9,23,20,1
461777,41,13,28,21,4
461777,41,13,28,22,1
461777,41,13,28,23,1
461777,9,4,5,24,1
461777,32,9,23,25,1
461777,32,9,23,40,1
461786,51,2,49,1,4
461786,51,2,49,2,1
461786,51,2,49,3,1
461786,34,2,32,4,1
461786,17,0,17,5,1
461786,17,0,17,20,1
461786,51,2,49,21,4
461786,51,2,49,22,1
461786,51,2,49,23,1
461786,34,2,32,24,1
461786,17,0,17,25,1
461786,17,0,17,40,1
461795,378,235,143,1,4
461795,350,215,135,2,1
461795,350,215,135,3,1
461795,80,54,26,4,1
461795,270,161,109,5,1
461795,28,20,8,12,3
461795,41,22,19,19,1
461795,229,139,90,20,1
461795,338,212,126,21,4
461795,338,212,126,22,1
461795,338,212,126,23,1
461795,80,54,26,24,1
461795,258,158,100,25,1
461795,41,22,19,39,1
461795,217,136,81,40,1
461795,40,23,17,41,4
461795,12,3,9,42,1
461795,12,3,9,43,1
461795,12,3,9,45,1
461795,28,20,8,52,3
461795,12,3,9,60,1
461801,51,5,46,1,4
461801,51,5,46,2,1
461801,51,5,46,3,1
461801,3,0,3,4,1
461801,48,5,43,5,1
461801,48,5,43,20,1
461801,51,5,46,21,4
461801,51,5,46,22,1
461801,51,5,46,23,1
461801,3,0,3,24,1
461801,48,5,43,25,1
461801,48,5,43,40,1
461810,59,10,49,1,4
461810,59,10,49,2,1
461810,59,10,49,3,1
461810,26,4,22,4,1
461810,33,6,27,5,1
461810,33,6,27,20,1
461810,36,6,30,21,4
461810,36,6,30,22,1
461810,36,6,30,23,1
461810,19,3,16,24,1
461810,17,3,14,25,1
461810,17,3,14,40,1
461810,23,4,19,41,4
461810,23,4,19,42,1
461810,23,4,19,43,1
461810,7,1,6,44,1
461810,16,3,13,45,1
461810,16,3,13,60,1
461829,221,24,197,1,4
461829,221,24,197,2,1
461829,221,24,197,3,1
461829,123,11,112,4,1
461829,98,13,85,5,1
461829,98,13,85,20,1
461829,221,24,197,21,4
461829,221,24,197,22,1
461829,221,24,197,23,1
461829,123,11,112,24,1
461829,98,13,85,25,1
461829,98,13,85,40,1
461838,139,2,137,1,4
461838,139,2,137,2,1
461838,139,2,137,3,1
461838,34,0,34,4,1
461838,105,2,103,5,1
461838,105,2,103,20,1
461838,51,1,50,21,4
461838,51,1,50,22,1
461838,51,1,50,23,1
461838,13,0,13,24,1
461838,38,1,37,25,1
461838,38,1,37,40,1
461838,88,1,87,41,4
461838,88,1,87,42,1
461838,88,1,87,43,1
461838,21,0,21,44,1
461838,67,1,66,45,1
461838,67,1,66,60,1
461847,33,33,0,1,4
461847,33,33,0,2,1
461847,33,33,0,3,1
461847,7,7,0,4,1
461847,26,26,0,5,1
461847,1,1,0,19,1
461847,25,25,0,20,1
461847,33,33,0,21,4
461847,33,33,0,22,1
461847,33,33,0,23,1
461847,7,7,0,24,1
461847,26,26,0,25,1
461847,1,1,0,39,1
461847,25,25,0,40,1
461856,272,117,155,1,4
461856,272,117,155,2,1
461856,272,117,155,3,1
461856,171,83,88,4,1
461856,101,34,67,5,1
461856,101,34,67,20,1
461856,272,117,155,21,4
461856,272,117,155,22,1
461856,272,117,155,23,1
461856,171,83,88,24,1
461856,101,34,67,25,1
461856,101,34,67,40,1
461865,78,9,69,1,4
461865,78,9,69,2,1
461865,78,9,69,3,1
461865,50,5,45,4,1
461865,28,4,24,5,1
461865,28,4,24,20,1
461865,78,9,69,21,4
461865,78,9,69,22,1
461865,78,9,69,23,1
461865,50,5,45,24,1
461865,28,4,24,25,1
461865,28,4,24,40,1
461874,66,10,56,1,4
461874,66,10,56,2,1
461874,66,10,56,3,1
461874,19,1,18,4,1
461874,47,9,38,5,1
461874,47,9,38,20,1
461874,66,10,56,21,4
461874,66,10,56,22,1
461874,66,10,56,23,1
461874,19,1,18,24,1
461874,47,9,38,25,1
461874,47,9,38,40,1
461883,112,47,65,1,4
461883,60,26,34,2,1
461883,60,26,34,3,1
461883,8,4,4,4,1
461883,52,22,30,5,1
461883,52,21,31,12,3
461883,52,22,30,20,1
461883,60,25,35,21,4
461883,30,13,17,22,1
461883,30,13,17,23,1
461883,3,3,0,24,1
461883,27,10,17,25,1
461883,30,12,18,32,3
461883,27,10,17,40,1
461883,52,22,30,41,4
461883,30,13,17,42,1
461883,30,13,17,43,1
461883,5,1,4,44,1
461883,25,12,13,45,1
461883,22,9,13,52,3
461883,25,12,13,60,1
461892,151,12,139,1,4
461892,151,12,139,2,1
461892,151,12,139,3,1
461892,66,8,58,4,1
461892,85,4,81,5,1
461892,85,4,81,20,1
461892,136,11,125,21,4
461892,136,11,125,22,1
461892,136,11,125,23,1
461892,60,8,52,24,1
461892,76,3,73,25,1
461892,76,3,73,40,1
461892,15,1,14,41,4
461892,15,1,14,42,1
461892,15,1,14,43,1
461892,6,0,6,44,1
461892,9,1,8,45,1
461892,9,1,8,60,1
461908,113,4,109,1,4
461908,113,4,109,2,1
461908,113,4,109,3,1
461908,11,1,10,4,1
461908,102,3,99,5,1
461908,102,3,99,20,1
461908,73,3,70,21,4
461908,73,3,70,22,1
461908,73,3,70,23,1
461908,10,1,9,24,1
461908,63,2,61,25,1
461908,63,2,61,40,1
461908,40,1,39,41,4
461908,40,1,39,42,1
461908,40,1,39,43,1
461908,1,0,1,44,1
461908,39,1,38,45,1
461908,39,1,38,60,1
461917,174,9,165,1,4
461917,174,9,165,2,1
461917,174,9,165,3,1
461917,41,2,39,4,1
461917,133,7,126,5,1
461917,133,7,126,20,1
461917,125,7,118,21,4
461917,125,7,118,22,1
461917,125,7,118,23,1
461917,32,1,31,24,1
461917,93,6,87,25,1
461917,93,6,87,40,1
461917,49,2,47,41,4
461917,49,2,47,42,1
461917,49,2,47,43,1
461917,9,1,8,44,1
461917,40,1,39,45,1
461917,40,1,39,60,1
461926,120,4,116,1,4
461926,120,4,116,2,1
461926,120,4,116,3,1
461926,54,3,51,4,1
461926,66,1,65,5,1
461926,66,1,65,20,1
461926,73,1,72,21,4
461926,73,1,72,22,1
461926,73,1,72,23,1
461926,38,1,37,24,1
461926,35,0,35,25,1
461926,35,0,35,40,1
461926,47,3,44,41,4
461926,47,3,44,42,1
461926,47,3,44,43,1
461926,16,2,14,44,1
461926,31,1,30,45,1
461926,31,1,30,60,1
461935,28,1,27,1,4
461935,28,1,27,2,1
461935,28,1,27,3,1
461935,20,1,19,4,1
461935,8,0,8,5,1
461935,8,0,8,20,1
461935,26,1,25,21,4
461935,26,1,25,22,1
461935,26,1,25,23,1
461935,19,1,18,24,1
461935,7,0,7,25,1
461935,7,0,7,40,1
461935,2,0,2,41,4
461935,2,0,2,42,1
461935,2,0,2,43,1
461935,1,0,1,44,1
461935,1,0,1,45,1
461935,1,0,1,60,1
461944,74,3,71,1,4
461944,74,3,71,2,1
461944,74,3,71,3,1
461944,29,1,28,4,1
461944,45,2,43,5,1
461944,45,2,43,20,1
461944,74,3,71,21,4
461944,74,3,71,22,1
461944,74,3,71,23,1
461944,29,1,28,24,1
461944,45,2,43,25,1
461944,45,2,43,40,1
461953,92,12,80,1,4
461953,92,12,80,2,1
461953,86,10,76,3,1
461953,13,1,12,4,1
461953,73,9,64,5,1
461953,6,2,4,11,1
461953,1,0,1,19,1
461953,72,9,63,20,1
461953,91,12,79,21,4
461953,91,12,79,22,1
461953,85,10,75,23,1
461953,13,1,12,24,1
461953,72,9,63,25,1
461953,6,2,4,31,1
461953,72,9,63,40,1
461953,1,0,1,41,4
461953,1,0,1,42,1
461953,1,0,1,43,1
461953,1,0,1,45,1
461953,1,0,1,59,1
461962,462,217,245,1,4
461962,462,217,245,2,1
461962,462,217,245,3,1
461962,384,183,201,4,1
461962,78,34,44,5,1
461962,78,34,44,20,1
461962,274,142,132,21,4
461962,274,142,132,22,1
461962,274,142,132,23,1
461962,223,122,101,24,1
461962,51,20,31,25,1
461962,51,20,31,40,1
461962,188,75,113,41,4
461962,188,75,113,42,1
461962,188,75,113,43,1
461962,161,61,100,44,1
461962,27,14,13,45,1
461962,27,14,13,60,1
461971,66,3,63,1,4
461971,66,3,63,2,1
461971,66,3,63,3,1
461971,9,0,9,4,1
461971,57,3,54,5,1
461971,57,3,54,20,1
461971,35,1,34,21,4
461971,35,1,34,22,1
461971,35,1,34,23,1
461971,1,0,1,24,1
461971,34,1,33,25,1
461971,34,1,33,40,1
461971,31,2,29,41,4
461971,31,2,29,42,1
461971,31,2,29,43,1
461971,8,0,8,44,1
461971,23,2,21,45,1
461971,23,2,21,60,1
461980,228,9,219,1,4
461980,228,9,219,2,1
461980,228,9,219,3,1
461980,163,4,159,4,1
461980,65,5,60,5,1
461980,65,5,60,20,1
461980,169,5,164,21,4
461980,169,5,164,22,1
461980,169,5,164,23,1
461980,117,1,116,24,1
461980,52,4,48,25,1
461980,52,4,48,40,1
461980,59,4,55,41,4
461980,59,4,55,42,1
461980,59,4,55,43,1
461980,46,3,43,44,1
461980,13,1,12,45,1
461980,13,1,12,60,1
461999,34,0,34,1,4
461999,34,0,34,2,1
461999,34,0,34,3,1
461999,29,0,29,4,1
461999,5,0,5,5,1
461999,5,0,5,20,1
461999,34,0,34,21,4
461999,34,0,34,22,1
461999,34,0,34,23,1
461999,29,0,29,24,1
461999,5,0,5,25,1
461999,5,0,5,40,1
462008,255,19,236,1,4
462008,255,19,236,2,1
462008,255,19,236,3,1
462008,63,5,58,4,1
462008,192,14,178,5,1
462008,192,14,178,20,1
462008,182,11,171,21,4
462008,182,11,171,22,1
462008,182,11,171,23,1
462008,41,4,37,24,1
462008,141,7,134,25,1
462008,141,7,134,40,1
462008,73,8,65,41,4
462008,73,8,65,42,1
462008,73,8,65,43,1
462008,22,1,21,44,1
462008,51,7,44,45,1
462008,51,7,44,60,1
462017,68,0,68,1,4
462017,68,0,68,2,1
462017,68,0,68,3,1
462017,7,0,7,4,1
462017,61,0,61,5,1
462017,61,0,61,20,1
462017,68,0,68,21,4
462017,68,0,68,22,1
462017,68,0,68,23,1
462017,7,0,7,24,1
462017,61,0,61,25,1
462017,61,0,61,40,1
462026,13,0,13,1,4
462026,13,0,13,2,1
462026,13,0,13,3,1
462026,4,0,4,4,1
462026,9,0,9,5,1
462026,9,0,9,20,1
462026,13,0,13,21,4
462026,13,0,13,22,1
462026,13,0,13,23,1
462026,4,0,4,24,1
462026,9,0,9,25,1
462026,9,0,9,40,1
462035,65,12,53,1,4
462035,65,12,53,2,1
462035,65,12,53,3,1
462035,60,12,48,4,1
462035,5,0,5,5,1
462035,5,0,5,20,1
462035,52,11,41,21,4
462035,52,11,41,22,1
462035,52,11,41,23,1
462035,48,11,37,24,1
462035,4,0,4,25,1
462035,4,0,4,40,1
462035,13,1,12,41,4
462035,13,1,12,42,1
462035,13,1,12,43,1
462035,12,1,11,44,1
462035,1,0,1,45,1
462035,1,0,1,60,1
462044,46,9,37,1,4
462044,46,9,37,12,3
462044,32,5,27,21,4
462044,32,5,27,32,3
462044,14,4,10,41,4
462044,14,4,10,52,3
462053,86,4,82,1,4
462053,86,4,82,2,1
462053,86,4,82,3,1
462053,25,1,24,4,1
462053,61,3,58,5,1
462053,61,3,58,20,1
462053,86,4,82,21,4
462053,86,4,82,22,1
462053,86,4,82,23,1
462053,25,1,24,24,1
462053,61,3,58,25,1
462053,61,3,58,40,1
462062,83,2,81,1,4
462062,83,2,81,2,1
462062,83,2,81,3,1
462062,18,0,18,4,1
462062,65,2,63,5,1
462062,65,2,63,20,1
462062,51,0,51,21,4
462062,51,0,51,22,1
462062,51,0,51,23,1
462062,11,0,11,24,1
462062,40,0,40,25,1
462062,40,0,40,40,1
462062,32,2,30,41,4
462062,32,2,30,42,1
462062,32,2,30,43,1
462062,7,0,7,44,1
462062,25,2,23,45,1
462062,25,2,23,60,1
462071,239,13,226,1,4
462071,239,13,226,2,1
462071,239,13,226,3,1
462071,22,1,21,4,1
462071,217,12,205,5,1
462071,217,12,205,20,1
462071,170,10,160,21,4
462071,170,10,160,22,1
462071,170,10,160,23,1
462071,19,1,18,24,1
462071,151,9,142,25,1
462071,151,9,142,40,1
462071,69,3,66,41,4
462071,69,3,66,42,1
462071,69,3,66,43,1
462071,3,0,3,44,1
462071,66,3,63,45,1
462071,66,3,63,60,1
462266,79,27,52,1,4
462266,79,27,52,2,1
462266,67,15,52,3,1
462266,67,15,52,5,1
462266,12,12,0,11,1
462266,67,15,52,20,1
462266,79,27,52,21,4
462266,79,27,52,22,1
462266,67,15,52,23,1
462266,67,15,52,25,1
462266,12,12,0,31,1
462266,67,15,52,40,1
462309,110,7,103,1,4
462309,110,7,103,2,1
462309,110,7,103,3,1
462309,19,0,19,4,1
462309,91,7,84,5,1
462309,91,7,84,20,1
462309,90,6,84,21,4
462309,90,6,84,22,1
462309,90,6,84,23,1
462309,14,0,14,24,1
462309,76,6,70,25,1
462309,76,6,70,40,1
462309,20,1,19,41,4
462309,20,1,19,42,1
462309,20,1,19,43,1
462309,5,0,5,44,1
462309,15,1,14,45,1
462309,15,1,14,60,1
462318,115,70,45,1,4
462318,115,70,45,2,1
462318,115,70,45,3,1
462318,63,37,26,4,1
462318,52,33,19,5,1
462318,52,33,19,20,1
462318,115,70,45,21,4
462318,115,70,45,22,1
462318,115,70,45,23,1
462318,63,37,26,24,1
462318,52,33,19,25,1
462318,52,33,19,40,1
462327,78,37,41,1,4
462327,78,37,41,2,1
462327,78,37,41,3,1
462327,31,16,15,4,1
462327,47,21,26,5,1
462327,47,21,26,20,1
462327,78,37,41,21,4
462327,78,37,41,22,1
462327,78,37,41,23,1
462327,31,16,15,24,1
462327,47,21,26,25,1
462327,47,21,26,40,1
462336,35,2,33,1,4
462336,35,2,33,2,1
462336,35,2,33,3,1
462336,6,0,6,4,1
462336,29,2,27,5,1
462336,29,2,27,20,1
462336,9,0,9,21,4
462336,9,0,9,22,1
462336,9,0,9,23,1
462336,1,0,1,24,1
462336,8,0,8,25,1
462336,8,0,8,40,1
462336,26,2,24,41,4
462336,26,2,24,42,1
462336,26,2,24,43,1
462336,5,0,5,44,1
462336,21,2,19,45,1
462336,21,2,19,60,1
462345,162,0,162,1,4
462345,162,0,162,2,1
462345,162,0,162,3,1
462345,108,0,108,4,1
462345,54,0,54,5,1
462345,54,0,54,20,1
462345,137,0,137,21,4
462345,137,0,137,22,1
462345,137,0,137,23,1
462345,87,0,87,24,1
462345,50,0,50,25,1
462345,50,0,50,40,1
462345,25,0,25,41,4
462345,25,0,25,42,1
462345,25,0,25,43,1
462345,21,0,21,44,1
462345,4,0,4,45,1
462345,4,0,4,60,1
462354,263,145,118,1,4
462354,140,74,66,2,1
462354,140,74,66,3,1
462354,49,26,23,4,1
462354,91,48,43,5,1
462354,123,71,52,12,3
462354,13,7,6,19,1
462354,78,41,37,20,1
462354,170,92,78,21,4
462354,129,69,60,22,1
462354,129,69,60,23,1
462354,47,25,22,24,1
462354,82,44,38,25,1
462354,41,23,18,32,3
462354,12,6,6,39,1
462354,70,38,32,40,1
462354,93,53,40,41,4
462354,11,5,6,42,1
462354,11,5,6,43,1
462354,2,1,1,44,1
462354,9,4,5,45,1
462354,82,48,34,52,3
462354,1,1,0,59,1
462354,8,3,5,60,1
462363,168,123,45,1,4
462363,168,123,45,2,1
462363,168,123,45,3,1
462363,40,26,14,4,1
462363,128,97,31,5,1
462363,3,3,0,19,1
462363,125,94,31,20,1
462363,111,88,23,21,4
462363,111,88,23,22,1
462363,111,88,23,23,1
462363,30,21,9,24,1
462363,81,67,14,25,1
462363,2,2,0,39,1
462363,79,65,14,40,1
462363,57,35,22,41,4
462363,57,35,22,42,1
462363,57,35,22,43,1
462363,10,5,5,44,1
462363,47,30,17,45,1
462363,1,1,0,59,1
462363,46,29,17,60,1
462372,313,257,56,1,4
462372,313,257,56,2,1
462372,313,257,56,3,1
462372,67,48,19,4,1
462372,246,209,37,5,1
462372,246,209,37,20,1
462372,264,216,48,21,4
462372,264,216,48,22,1
462372,264,216,48,23,1
462372,60,45,15,24,1
462372,204,171,33,25,1
462372,204,171,33,40,1
462372,49,41,8,41,4
462372,49,41,8,42,1
462372,49,41,8,43,1
462372,7,3,4,44,1
462372,42,38,4,45,1
462372,42,38,4,60,1
462390,66,15,51,1,4
462390,66,15,51,2,1
462390,66,15,51,3,1
462390,1,0,1,4,1
462390,65,15,50,5,1
462390,7,0,7,19,1
462390,58,15,43,20,1
462390,66,15,51,21,4
462390,66,15,51,22,1
462390,66,15,51,23,1
462390,1,0,1,24,1
462390,65,15,50,25,1
462390,7,0,7,39,1
462390,58,15,43,40,1
462406,31,11,20,1,4
462406,31,11,20,2,1
462406,31,11,20,3,1
462406,31,11,20,5,1
462406,31,11,20,20,1
462406,31,11,20,21,4
462406,31,11,20,22,1
462406,31,11,20,23,1
462406,31,11,20,25,1
462406,31,11,20,40,1
465812,1280,353,927,1,4
465812,1215,323,892,2,1
465812,1215,323,892,3,1
465812,340,138,202,4,1
465812,875,185,690,5,1
465812,65,30,35,12,3
465812,875,185,690,20,1
465812,1280,353,927,21,4
465812,1215,323,892,22,1
465812,1215,323,892,23,1
465812,340,138,202,24,1
465812,875,185,690,25,1
465812,65,30,35,32,3
465812,875,185,690,40,1
466152,251,48,203,1,4
466152,251,48,203,2,1
466152,251,48,203,3,1
466152,37,12,25,4,1
466152,214,36,178,5,1
466152,73,13,60,19,1
466152,141,23,118,20,1
466152,5,2,3,21,4
466152,5,2,3,22,1
466152,5,2,3,23,1
466152,5,2,3,25,1
466152,5,2,3,40,1
466152,246,46,200,41,4
466152,246,46,200,42,1
466152,246,46,200,43,1
466152,37,12,25,44,1
466152,209,34,175,45,1
466152,73,13,60,59,1
466152,136,21,115,60,1
466161,139,37,102,1,4
466161,139,37,102,2,1
466161,139,37,102,3,1
466161,12,6,6,4,1
466161,127,31,96,5,1
466161,31,7,24,19,1
466161,96,24,72,20,1
466161,8,3,5,21,4
466161,8,3,5,22,1
466161,8,3,5,23,1
466161,8,3,5,25,1
466161,1,0,1,39,1
466161,7,3,4,40,1
466161,131,34,97,41,4
466161,131,34,97,42,1
466161,131,34,97,43,1
466161,12,6,6,44,1
466161,119,28,91,45,1
466161,30,7,23,59,1
466161,89,21,68,60,1
466170,360,83,277,1,4
466170,360,83,277,2,1
466170,360,83,277,3,1
466170,37,13,24,4,1
466170,323,70,253,5,1
466170,73,18,55,19,1
466170,250,52,198,20,1
466170,7,1,6,21,4
466170,7,1,6,22,1
466170,7,1,6,23,1
466170,7,1,6,25,1
466170,3,0,3,39,1
466170,4,1,3,40,1
466170,353,82,271,41,4
466170,353,82,271,42,1
466170,353,82,271,43,1
466170,37,13,24,44,1
466170,316,69,247,45,1
466170,70,18,52,59,1
466170,246,51,195,60,1
466189,262,97,165,1,4
466189,262,97,165,2,1
466189,262,97,165,3,1
466189,17,8,9,4,1
466189,245,89,156,5,1
466189,91,37,54,19,1
466189,154,52,102,20,1
466189,63,33,30,21,4
466189,63,33,30,22,1
466189,63,33,30,23,1
466189,4,2,2,24,1
466189,59,31,28,25,1
466189,19,11,8,39,1
466189,40,20,20,40,1
466189,199,64,135,41,4
466189,199,64,135,42,1
466189,199,64,135,43,1
466189,13,6,7,44,1
466189,186,58,128,45,1
466189,72,26,46,59,1
466189,114,32,82,60,1
466514,269,37,232,1,4
466514,269,37,232,2,1
466514,261,36,225,3,1
466514,43,4,39,4,1
466514,218,32,186,5,1
466514,8,1,7,11,1
466514,39,6,33,19,1
466514,179,26,153,20,1
466514,189,31,158,21,4
466514,189,31,158,22,1
466514,189,31,158,23,1
466514,39,4,35,24,1
466514,150,27,123,25,1
466514,34,6,28,39,1
466514,116,21,95,40,1
466514,80,6,74,41,4
466514,80,6,74,42,1
466514,72,5,67,43,1
466514,4,0,4,44,1
466514,68,5,63,45,1
466514,8,1,7,51,1
466514,5,0,5,59,1
466514,63,5,58,60,1
466523,70,8,62,1,4
466523,70,8,62,2,1
466523,70,8,62,3,1
466523,36,7,29,4,1
466523,34,1,33,5,1
466523,34,1,33,20,1
466523,54,7,47,21,4
466523,54,7,47,22,1
466523,54,7,47,23,1
466523,28,6,22,24,1
466523,26,1,25,25,1
466523,26,1,25,40,1
466523,16,1,15,41,4
466523,16,1,15,42,1
466523,16,1,15,43,1
466523,8,1,7,44,1
466523,8,0,8,45,1
466523,8,0,8,60,1
466921,488,53,435,1,4
466921,488,53,435,2,1
466921,488,53,435,3,1
466921,2,0,2,4,1
466921,486,53,433,5,1
466921,139,21,118,19,1
466921,347,32,315,20,1
466921,278,32,246,21,4
466921,278,32,246,22,1
466921,278,32,246,23,1
466921,2,0,2,24,1
466921,276,32,244,25,1
466921,97,16,81,39,1
466921,179,16,163,40,1
466921,210,21,189,41,4
466921,210,21,189,42,1
466921,210,21,189,43,1
466921,210,21,189,45,1
466921,42,5,37,59,1
466921,168,16,152,60,1
466930,258,33,225,1,4
466930,258,33,225,2,1
466930,258,33,225,3,1
466930,258,33,225,5,1
466930,75,16,59,19,1
466930,183,17,166,20,1
466930,165,25,140,21,4
466930,165,25,140,22,1
466930,165,25,140,23,1
466930,165,25,140,25,1
466930,60,14,46,39,1
466930,105,11,94,40,1
466930,93,8,85,41,4
466930,93,8,85,42,1
466930,93,8,85,43,1
466930,93,8,85,45,1
466930,15,2,13,59,1
466930,78,6,72,60,1
467058,169,140,29,1,4
467058,169,140,29,2,1
467058,169,140,29,3,1
467058,54,47,7,4,1
467058,115,93,22,5,1
467058,6,6,0,19,1
467058,109,87,22,20,1
467058,132,112,20,21,4
467058,132,112,20,22,1
467058,132,112,20,23,1
467058,43,40,3,24,1
467058,89,72,17,25,1
467058,5,5,0,39,1
467058,84,67,17,40,1
467058,37,28,9,41,4
467058,37,28,9,42,1
467058,37,28,9,43,1
467058,11,7,4,44,1
467058,26,21,5,45,1
467058,1,1,0,59,1
467058,25,20,5,60,1
467094,272,9,263,1,4
467094,272,9,263,2,1
467094,272,9,263,3,1
467094,22,1,21,4,1
467094,250,8,242,5,1
467094,250,8,242,20,1
467094,136,5,131,21,4
467094,136,5,131,22,1
467094,136,5,131,23,1
467094,14,0,14,24,1
467094,122,5,117,25,1
467094,122,5,117,40,1
467094,136,4,132,41,4
467094,136,4,132,42,1
467094,136,4,132,43,1
467094,8,1,7,44,1
467094,128,3,125,45,1
467094,128,3,125,60,1
467155,705,83,622,1,4
467155,705,83,622,2,1
467155,705,83,622,3,1
467155,158,13,145,4,1
467155,547,70,477,5,1
467155,547,70,477,20,1
467155,705,83,622,21,4
467155,705,83,622,22,1
467155,705,83,622,23,1
467155,158,13,145,24,1
467155,547,70,477,25,1
467155,547,70,477,40,1
467340,144,140,4,1,4
467340,144,140,4,2,1
467340,144,140,4,3,1
467340,18,18,0,4,1
467340,126,122,4,5,1
467340,126,122,4,20,1
467340,144,140,4,21,4
467340,144,140,4,22,1
467340,144,140,4,23,1
467340,18,18,0,24,1
467340,126,122,4,25,1
467340,126,122,4,40,1
467368,301,34,267,1,4
467368,301,34,267,2,1
467368,301,34,267,3,1
467368,33,3,30,4,1
467368,268,31,237,5,1
467368,41,4,37,19,1
467368,227,27,200,20,1
467368,240,26,214,21,4
467368,240,26,214,22,1
467368,240,26,214,23,1
467368,29,2,27,24,1
467368,211,24,187,25,1
467368,34,2,32,39,1
467368,177,22,155,40,1
467368,61,8,53,41,4
467368,61,8,53,42,1
467368,61,8,53,43,1
467368,4,1,3,44,1
467368,57,7,50,45,1
467368,7,2,5,59,1
467368,50,5,45,60,1
467508,89,5,84,1,4
467508,89,5,84,2,1
467508,89,5,84,3,1
467508,28,3,25,4,1
467508,61,2,59,5,1
467508,61,2,59,20,1
467508,52,5,47,21,4
467508,52,5,47,22,1
467508,52,5,47,23,1
467508,20,3,17,24,1
467508,32,2,30,25,1
467508,32,2,30,40,1
467508,37,0,37,41,4
467508,37,0,37,42,1
467508,37,0,37,43,1
467508,8,0,8,44,1
467508,29,0,29,45,1
467508,29,0,29,60,1
467517,86,1,85,1,4
467517,86,1,85,2,1
467517,86,1,85,3,1
467517,30,1,29,4,1
467517,56,0,56,5,1
467517,56,0,56,20,1
467517,71,0,71,21,4
467517,71,0,71,22,1
467517,71,0,71,23,1
467517,23,0,23,24,1
467517,48,0,48,25,1
467517,48,0,48,40,1
467517,15,1,14,41,4
467517,15,1,14,42,1
467517,15,1,14,43,1
467517,7,1,6,44,1
467517,8,0,8,45,1
467517,8,0,8,60,1
467526,68,1,67,1,4
467526,68,1,67,2,1
467526,68,1,67,3,1
467526,29,0,29,4,1
467526,39,1,38,5,1
467526,39,1,38,20,1
467526,68,1,67,21,4
467526,68,1,67,22,1
467526,68,1,67,23,1
467526,29,0,29,24,1
467526,39,1,38,25,1
467526,39,1,38,40,1
467535,128,7,121,1,4
467535,128,7,121,2,1
467535,128,7,121,3,1
467535,38,0,38,4,1
467535,90,7,83,5,1
467535,90,7,83,20,1
467535,97,5,92,21,4
467535,97,5,92,22,1
467535,97,5,92,23,1
467535,33,0,33,24,1
467535,64,5,59,25,1
467535,64,5,59,40,1
467535,31,2,29,41,4
467535,31,2,29,42,1
467535,31,2,29,43,1
467535,5,0,5,44,1
467535,26,2,24,45,1
467535,26,2,24,60,1
467544,41,1,40,1,4
467544,41,1,40,2,1
467544,41,1,40,3,1
467544,13,0,13,4,1
467544,28,1,27,5,1
467544,28,1,27,20,1
467544,41,1,40,21,4
467544,41,1,40,22,1
467544,41,1,40,23,1
467544,13,0,13,24,1
467544,28,1,27,25,1
467544,28,1,27,40,1
467553,52,4,48,1,4
467553,52,4,48,2,1
467553,52,4,48,3,1
467553,18,1,17,4,1
467553,34,3,31,5,1
467553,34,3,31,20,1
467553,52,4,48,21,4
467553,52,4,48,22,1
467553,52,4,48,23,1
467553,18,1,17,24,1
467553,34,3,31,25,1
467553,34,3,31,40,1
467562,65,5,60,1,4
467562,65,5,60,2,1
467562,65,5,60,3,1
467562,20,2,18,4,1
467562,45,3,42,5,1
467562,45,3,42,20,1
467562,47,5,42,21,4
467562,47,5,42,22,1
467562,47,5,42,23,1
467562,14,2,12,24,1
467562,33,3,30,25,1
467562,33,3,30,40,1
467562,18,0,18,41,4
467562,18,0,18,42,1
467562,18,0,18,43,1
467562,6,0,6,44,1
467562,12,0,12,45,1
467562,12,0,12,60,1
467571,80,6,74,1,4
467571,80,6,74,2,1
467571,80,6,74,3,1
467571,28,2,26,4,1
467571,52,4,48,5,1
467571,52,4,48,20,1
467571,65,4,61,21,4
467571,65,4,61,22,1
467571,65,4,61,23,1
467571,21,1,20,24,1
467571,44,3,41,25,1
467571,44,3,41,40,1
467571,15,2,13,41,4
467571,15,2,13,42,1
467571,15,2,13,43,1
467571,7,1,6,44,1
467571,8,1,7,45,1
467571,8,1,7,60,1
467580,37,2,35,1,4
467580,37,2,35,2,1
467580,37,2,35,3,1
467580,16,2,14,4,1
467580,21,0,21,5,1
467580,21,0,21,20,1
467580,37,2,35,21,4
467580,37,2,35,22,1
467580,37,2,35,23,1
467580,16,2,14,24,1
467580,21,0,21,25,1
467580,21,0,21,40,1
467599,86,5,81,1,4
467599,86,5,81,2,1
467599,86,5,81,3,1
467599,27,1,26,4,1
467599,59,4,55,5,1
467599,59,4,55,20,1
467599,69,4,65,21,4
467599,69,4,65,22,1
467599,69,4,65,23,1
467599,26,1,25,24,1
467599,43,3,40,25,1
467599,43,3,40,40,1
467599,17,1,16,41,4
467599,17,1,16,42,1
467599,17,1,16,43,1
467599,1,0,1,44,1
467599,16,1,15,45,1
467599,16,1,15,60,1
467605,90,5,85,1,4
467605,90,5,85,2,1
467605,90,5,85,3,1
467605,26,0,26,4,1
467605,64,5,59,5,1
467605,64,5,59,20,1
467605,63,2,61,21,4
467605,63,2,61,22,1
467605,63,2,61,23,1
467605,21,0,21,24,1
467605,42,2,40,25,1
467605,42,2,40,40,1
467605,27,3,24,41,4
467605,27,3,24,42,1
467605,27,3,24,43,1
467605,5,0,5,44,1
467605,22,3,19,45,1
467605,22,3,19,60,1
467614,75,4,71,1,4
467614,75,4,71,2,1
467614,75,4,71,3,1
467614,34,1,33,4,1
467614,41,3,38,5,1
467614,41,3,38,20,1
467614,56,3,53,21,4
467614,56,3,53,22,1
467614,56,3,53,23,1
467614,26,1,25,24,1
467614,30,2,28,25,1
467614,30,2,28,40,1
467614,19,1,18,41,4
467614,19,1,18,42,1
467614,19,1,18,43,1
467614,8,0,8,44,1
467614,11,1,10,45,1
467614,11,1,10,60,1
467623,70,3,67,1,4
467623,70,3,67,2,1
467623,70,3,67,3,1
467623,21,2,19,4,1
467623,49,1,48,5,1
467623,49,1,48,20,1
467623,57,3,54,21,4
467623,57,3,54,22,1
467623,57,3,54,23,1
467623,16,2,14,24,1
467623,41,1,40,25,1
467623,41,1,40,40,1
467623,13,0,13,41,4
467623,13,0,13,42,1
467623,13,0,13,43,1
467623,5,0,5,44,1
467623,8,0,8,45,1
467623,8,0,8,60,1
467632,119,8,111,1,4
467632,119,8,111,2,1
467632,119,8,111,3,1
467632,39,2,37,4,1
467632,80,6,74,5,1
467632,80,6,74,20,1
467632,77,5,72,21,4
467632,77,5,72,22,1
467632,77,5,72,23,1
467632,25,0,25,24,1
467632,52,5,47,25,1
467632,52,5,47,40,1
467632,42,3,39,41,4
467632,42,3,39,42,1
467632,42,3,39,43,1
467632,14,2,12,44,1
467632,28,1,27,45,1
467632,28,1,27,60,1
467641,146,4,142,1,4
467641,146,4,142,2,1
467641,146,4,142,3,1
467641,44,2,42,4,1
467641,102,2,100,5,1
467641,102,2,100,20,1
467641,104,3,101,21,4
467641,104,3,101,22,1
467641,104,3,101,23,1
467641,34,1,33,24,1
467641,70,2,68,25,1
467641,70,2,68,40,1
467641,42,1,41,41,4
467641,42,1,41,42,1
467641,42,1,41,43,1
467641,10,1,9,44,1
467641,32,0,32,45,1
467641,32,0,32,60,1
467650,58,3,55,1,4
467650,58,3,55,2,1
467650,58,3,55,3,1
467650,19,1,18,4,1
467650,39,2,37,5,1
467650,39,2,37,20,1
467650,44,2,42,21,4
467650,44,2,42,22,1
467650,44,2,42,23,1
467650,12,0,12,24,1
467650,32,2,30,25,1
467650,32,2,30,40,1
467650,14,1,13,41,4
467650,14,1,13,42,1
467650,14,1,13,43,1
467650,7,1,6,44,1
467650,7,0,7,45,1
467650,7,0,7,60,1
467669,83,5,78,1,4
467669,83,5,78,2,1
467669,83,5,78,3,1
467669,31,0,31,4,1
467669,52,5,47,5,1
467669,52,5,47,20,1
467669,83,5,78,21,4
467669,83,5,78,22,1
467669,83,5,78,23,1
467669,31,0,31,24,1
467669,52,5,47,25,1
467669,52,5,47,40,1
467678,89,6,83,1,4
467678,89,6,83,2,1
467678,89,6,83,3,1
467678,29,3,26,4,1
467678,60,3,57,5,1
467678,60,3,57,20,1
467678,89,6,83,21,4
467678,89,6,83,22,1
467678,89,6,83,23,1
467678,29,3,26,24,1
467678,60,3,57,25,1
467678,60,3,57,40,1
467784,634,81,553,1,4
467784,634,81,553,2,1
467784,634,81,553,3,1
467784,119,18,101,4,1
467784,515,63,452,5,1
467784,515,63,452,20,1
467784,634,81,553,21,4
467784,634,81,553,22,1
467784,634,81,553,23,1
467784,119,18,101,24,1
467784,515,63,452,25,1
467784,515,63,452,40,1
467793,142,37,105,1,4
467793,142,37,105,2,1
467793,136,36,100,3,1
467793,20,4,16,4,1
467793,116,32,84,5,1
467793,6,1,5,11,1
467793,24,6,18,19,1
467793,92,26,66,20,1
467793,107,32,75,21,4
467793,107,32,75,22,1
467793,107,32,75,23,1
467793,18,4,14,24,1
467793,89,28,61,25,1
467793,20,5,15,39,1
467793,69,23,46,40,1
467793,35,5,30,41,4
467793,35,5,30,42,1
467793,29,4,25,43,1
467793,2,0,2,44,1
467793,27,4,23,45,1
467793,6,1,5,51,1
467793,4,1,3,59,1
467793,23,3,20,60,1
467809,98,5,93,1,4
467809,98,5,93,2,1
467809,98,5,93,3,1
467809,19,1,18,4,1
467809,79,4,75,5,1
467809,79,4,75,20,1
467809,98,5,93,21,4
467809,98,5,93,22,1
467809,98,5,93,23,1
467809,19,1,18,24,1
467809,79,4,75,25,1
467809,79,4,75,40,1
467863,179,9,170,1,4
467863,179,9,170,2,1
467863,179,9,170,3,1
467863,46,4,42,4,1
467863,133,5,128,5,1
467863,133,5,128,20,1
467863,141,7,134,21,4
467863,141,7,134,22,1
467863,141,7,134,23,1
467863,40,3,37,24,1
467863,101,4,97,25,1
467863,101,4,97,40,1
467863,38,2,36,41,4
467863,38,2,36,42,1
467863,38,2,36,43,1
467863,6,1,5,44,1
467863,32,1,31,45,1
467863,32,1,31,60,1
467872,196,7,189,1,4
467872,196,7,189,2,1
467872,196,7,189,3,1
467872,30,1,29,4,1
467872,166,6,160,5,1
467872,166,6,160,20,1
467872,147,6,141,21,4
467872,147,6,141,22,1
467872,147,6,141,23,1
467872,26,1,25,24,1
467872,121,5,116,25,1
467872,121,5,116,40,1
467872,49,1,48,41,4
467872,49,1,48,42,1
467872,49,1,48,43,1
467872,4,0,4,44,1
467872,45,1,44,45,1
467872,45,1,44,60,1
467881,545,69,476,1,4
467881,545,69,476,2,1
467881,545,69,476,3,1
467881,102,13,89,4,1
467881,443,56,387,5,1
467881,443,56,387,20,1
467881,545,69,476,21,4
467881,545,69,476,22,1
467881,545,69,476,23,1
467881,102,13,89,24,1
467881,443,56,387,25,1
467881,443,56,387,40,1
467906,175,9,166,1,4
467906,175,9,166,2,1
467906,175,9,166,3,1
467906,17,1,16,4,1
467906,158,8,150,5,1
467906,158,8,150,20,1
467906,132,6,126,21,4
467906,132,6,126,22,1
467906,132,6,126,23,1
467906,14,1,13,24,1
467906,118,5,113,25,1
467906,118,5,113,40,1
467906,43,3,40,41,4
467906,43,3,40,42,1
467906,43,3,40,43,1
467906,3,0,3,44,1
467906,40,3,37,45,1
467906,40,3,37,60,1
468006,80,28,52,1,4
468006,80,28,52,12,3
468006,57,18,39,21,4
468006,57,18,39,32,3
468006,23,10,13,41,4
468006,23,10,13,52,3
468015,346,191,155,1,4
468015,346,191,155,2,1
468015,346,191,155,3,1
468015,56,28,28,4,1
468015,290,163,127,5,1
468015,40,24,16,19,1
468015,250,139,111,20,1
468015,284,157,127,21,4
468015,284,157,127,22,1
468015,284,157,127,23,1
468015,52,26,26,24,1
468015,232,131,101,25,1
468015,33,18,15,39,1
468015,199,113,86,40,1
468015,62,34,28,41,4
468015,62,34,28,42,1
468015,62,34,28,43,1
468015,4,2,2,44,1
468015,58,32,26,45,1
468015,7,6,1,59,1
468015,51,26,25,60,1
468024,503,99,404,1,4
468024,354,74,280,2,1
468024,354,74,280,3,1
468024,12,4,8,4,1
468024,342,70,272,5,1
468024,149,25,124,12,3
468024,134,18,116,19,1
468024,208,52,156,20,1
468024,132,32,100,21,4
468024,117,30,87,22,1
468024,117,30,87,23,1
468024,2,1,1,24,1
468024,115,29,86,25,1
468024,15,2,13,32,3
468024,26,6,20,39,1
468024,89,23,66,40,1
468024,371,67,304,41,4
468024,237,44,193,42,1
468024,237,44,193,43,1
468024,10,3,7,44,1
468024,227,41,186,45,1
468024,134,23,111,52,3
468024,108,12,96,59,1
468024,119,29,90,60,1
468246,224,19,205,1,4
468246,224,19,205,2,1
468246,224,19,205,3,1
468246,35,3,32,4,1
468246,189,16,173,5,1
468246,189,16,173,20,1
468246,224,19,205,21,4
468246,224,19,205,22,1
468246,224,19,205,23,1
468246,35,3,32,24,1
468246,189,16,173,25,1
468246,189,16,173,40,1
468255,152,7,145,1,4
468255,152,7,145,2,1
468255,152,7,145,3,1
468255,38,2,36,4,1
468255,114,5,109,5,1
468255,114,5,109,20,1
468255,152,7,145,21,4
468255,152,7,145,22,1
468255,152,7,145,23,1
468255,38,2,36,24,1
468255,114,5,109,25,1
468255,114,5,109,40,1
468398,203,104,99,1,4
468398,203,104,99,2,1
468398,203,104,99,3,1
468398,20,11,9,4,1
468398,183,93,90,5,1
468398,30,17,13,19,1
468398,153,76,77,20,1
468398,161,87,74,21,4
468398,161,87,74,22,1
468398,161,87,74,23,1
468398,9,8,1,24,1
468398,152,79,73,25,1
468398,19,12,7,39,1
468398,133,67,66,40,1
468398,42,17,25,41,4
468398,42,17,25,42,1
468398,42,17,25,43,1
468398,11,3,8,44,1
468398,31,14,17,45,1
468398,11,5,6,59,1
468398,20,9,11,60,1
468705,194,8,186,1,4
468705,194,8,186,2,1
468705,194,8,186,3,1
468705,114,8,106,4,1
468705,80,0,80,5,1
468705,80,0,80,20,1
468705,149,7,142,21,4
468705,149,7,142,22,1
468705,149,7,142,23,1
468705,86,7,79,24,1
468705,63,0,63,25,1
468705,63,0,63,40,1
468705,45,1,44,41,4
468705,45,1,44,42,1
468705,45,1,44,43,1
468705,28,1,27,44,1
468705,17,0,17,45,1
468705,17,0,17,60,1
468723,920,276,644,1,4
468723,920,276,644,2,1
468723,920,276,644,3,1
468723,197,65,132,4,1
468723,723,211,512,5,1
468723,203,63,140,19,1
468723,520,148,372,20,1
468723,711,213,498,21,4
468723,711,213,498,22,1
468723,711,213,498,23,1
468723,180,58,122,24,1
468723,531,155,376,25,1
468723,157,51,106,39,1
468723,374,104,270,40,1
468723,209,63,146,41,4
468723,209,63,146,42,1
468723,209,63,146,43,1
468723,17,7,10,44,1
468723,192,56,136,45,1
468723,46,12,34,59,1
468723,146,44,102,60,1
468732,380,71,309,1,4
468732,380,71,309,2,1
468732,380,71,309,3,1
468732,127,31,96,4,1
468732,253,40,213,5,1
468732,253,40,213,20,1
468732,380,71,309,21,4
468732,380,71,309,22,1
468732,380,71,309,23,1
468732,127,31,96,24,1
468732,253,40,213,25,1
468732,253,40,213,40,1
468769,97,30,67,1,4
468769,97,30,67,2,1
468769,97,30,67,3,1
468769,40,13,27,4,1
468769,57,17,40,5,1
468769,57,17,40,20,1
468769,97,30,67,21,4
468769,97,30,67,22,1
468769,97,30,67,23,1
468769,40,13,27,24,1
468769,57,17,40,25,1
468769,57,17,40,40,1
468866,65,4,61,1,4
468866,65,4,61,2,1
468866,65,4,61,3,1
468866,7,0,7,4,1
468866,58,4,54,5,1
468866,58,4,54,20,1
468866,65,4,61,21,4
468866,65,4,61,22,1
468866,65,4,61,23,1
468866,7,0,7,24,1
468866,58,4,54,25,1
468866,58,4,54,40,1
468875,205,5,200,1,4
468875,205,5,200,2,1
468875,205,5,200,3,1
468875,111,3,108,4,1
468875,94,2,92,5,1
468875,94,2,92,20,1
468875,205,5,200,21,4
468875,205,5,200,22,1
468875,205,5,200,23,1
468875,111,3,108,24,1
468875,94,2,92,25,1
468875,94,2,92,40,1
468893,123,1,122,1,4
468893,123,1,122,2,1
468893,123,1,122,3,1
468893,25,0,25,4,1
468893,98,1,97,5,1
468893,98,1,97,20,1
468893,123,1,122,21,4
468893,123,1,122,22,1
468893,123,1,122,23,1
468893,25,0,25,24,1
468893,98,1,97,25,1
468893,98,1,97,40,1
468963,219,208,11,1,4
468963,219,208,11,2,1
468963,219,208,11,3,1
468963,203,192,11,4,1
468963,16,16,0,5,1
468963,16,16,0,20,1
468963,219,208,11,21,4
468963,219,208,11,22,1
468963,219,208,11,23,1
468963,203,192,11,24,1
468963,16,16,0,25,1
468963,16,16,0,40,1
469054,520,80,440,1,4
469054,520,80,440,2,1
469054,520,80,440,3,1
469054,134,22,112,4,1
469054,386,58,328,5,1
469054,386,58,328,20,1
469054,520,80,440,21,4
469054,520,80,440,22,1
469054,520,80,440,23,1
469054,134,22,112,24,1
469054,386,58,328,25,1
469054,386,58,328,40,1
469124,453,130,323,1,4
469124,453,130,323,2,1
469124,453,130,323,3,1
469124,190,57,133,4,1
469124,263,73,190,5,1
469124,263,73,190,20,1
469124,234,75,159,21,4
469124,234,75,159,22,1
469124,234,75,159,23,1
469124,112,34,78,24,1
469124,122,41,81,25,1
469124,122,41,81,40,1
469124,219,55,164,41,4
469124,219,55,164,42,1
469124,219,55,164,43,1
469124,78,23,55,44,1
469124,141,32,109,45,1
469124,141,32,109,60,1
469133,326,77,249,1,4
469133,326,77,249,2,1
469133,326,77,249,3,1
469133,147,36,111,4,1
469133,179,41,138,5,1
469133,179,41,138,20,1
469133,185,45,140,21,4
469133,185,45,140,22,1
469133,185,45,140,23,1
469133,96,23,73,24,1
469133,89,22,67,25,1
469133,89,22,67,40,1
469133,141,32,109,41,4
469133,141,32,109,42,1
469133,141,32,109,43,1
469133,51,13,38,44,1
469133,90,19,71,45,1
469133,90,19,71,60,1
469142,459,98,361,1,4
469142,459,98,361,2,1
469142,459,98,361,3,1
469142,169,34,135,4,1
469142,290,64,226,5,1
469142,290,64,226,20,1
469142,238,49,189,21,4
469142,238,49,189,22,1
469142,238,49,189,23,1
469142,98,24,74,24,1
469142,140,25,115,25,1
469142,140,25,115,40,1
469142,221,49,172,41,4
469142,221,49,172,42,1
469142,221,49,172,43,1
469142,71,10,61,44,1
469142,150,39,111,45,1
469142,150,39,111,60,1
469151,191,45,146,1,4
469151,191,45,146,2,1
469151,191,45,146,3,1
469151,82,21,61,4,1
469151,109,24,85,5,1
469151,109,24,85,20,1
469151,98,29,69,21,4
469151,98,29,69,22,1
469151,98,29,69,23,1
469151,47,14,33,24,1
469151,51,15,36,25,1
469151,51,15,36,40,1
469151,93,16,77,41,4
469151,93,16,77,42,1
469151,93,16,77,43,1
469151,35,7,28,44,1
469151,58,9,49,45,1
469151,58,9,49,60,1
469160,248,60,188,1,4
469160,248,60,188,2,1
469160,248,60,188,3,1
469160,111,24,87,4,1
469160,137,36,101,5,1
469160,137,36,101,20,1
469160,132,30,102,21,4
469160,132,30,102,22,1
469160,132,30,102,23,1
469160,57,9,48,24,1
469160,75,21,54,25,1
469160,75,21,54,40,1
469160,116,30,86,41,4
469160,116,30,86,42,1
469160,116,30,86,43,1
469160,54,15,39,44,1
469160,62,15,47,45,1
469160,62,15,47,60,1
469188,50,9,41,1,4
469188,50,9,41,2,1
469188,50,9,41,3,1
469188,50,9,41,5,1
469188,50,9,41,20,1
469188,36,5,31,21,4
469188,36,5,31,22,1
469188,36,5,31,23,1
469188,36,5,31,25,1
469188,36,5,31,40,1
469188,14,4,10,41,4
469188,14,4,10,42,1
469188,14,4,10,43,1
469188,14,4,10,45,1
469188,14,4,10,60,1
469197,140,4,136,1,4
469197,140,4,136,2,1
469197,140,4,136,3,1
469197,132,2,130,4,1
469197,8,2,6,5,1
469197,8,2,6,20,1
469197,140,4,136,21,4
469197,140,4,136,22,1
469197,140,4,136,23,1
469197,132,2,130,24,1
469197,8,2,6,25,1
469197,8,2,6,40,1
469391,2,0,2,1,4
469391,2,0,2,2,1
469391,2,0,2,3,1
469391,1,0,1,4,1
469391,1,0,1,5,1
469391,1,0,1,20,1
469391,2,0,2,21,4
469391,2,0,2,22,1
469391,2,0,2,23,1
469391,1,0,1,24,1
469391,1,0,1,25,1
469391,1,0,1,40,1
469407,270,100,170,1,4
469407,270,100,170,2,1
469407,270,100,170,3,1
469407,170,68,102,4,1
469407,100,32,68,5,1
469407,100,32,68,20,1
469407,270,100,170,21,4
469407,270,100,170,22,1
469407,270,100,170,23,1
469407,170,68,102,24,1
469407,100,32,68,25,1
469407,100,32,68,40,1
469416,274,96,178,1,4
469416,274,96,178,2,1
469416,274,96,178,3,1
469416,154,52,102,4,1
469416,120,44,76,5,1
469416,120,44,76,20,1
469416,274,96,178,21,4
469416,274,96,178,22,1
469416,274,96,178,23,1
469416,154,52,102,24,1
469416,120,44,76,25,1
469416,120,44,76,40,1
469568,105,12,93,1,4
469568,105,12,93,2,1
469568,105,12,93,3,1
469568,105,12,93,5,1
469568,105,12,93,20,1
469568,105,12,93,21,4
469568,105,12,93,22,1
469568,105,12,93,23,1
469568,105,12,93,25,1
469568,105,12,93,40,1
469586,45,9,36,1,4
469586,45,9,36,2,1
469586,45,9,36,3,1
469586,17,4,13,4,1
469586,28,5,23,5,1
469586,28,5,23,20,1
469586,32,6,26,21,4
469586,32,6,26,22,1
469586,32,6,26,23,1
469586,13,3,10,24,1
469586,19,3,16,25,1
469586,19,3,16,40,1
469586,13,3,10,41,4
469586,13,3,10,42,1
469586,13,3,10,43,1
469586,4,1,3,44,1
469586,9,2,7,45,1
469586,9,2,7,60,1
469610,823,56,767,1,4
469610,823,56,767,2,1
469610,823,56,767,3,1
469610,242,9,233,4,1
469610,581,47,534,5,1
469610,581,47,534,20,1
469610,823,56,767,21,4
469610,823,56,767,22,1
469610,823,56,767,23,1
469610,242,9,233,24,1
469610,581,47,534,25,1
469610,581,47,534,40,1
469629,182,159,23,1,4
469629,182,159,23,2,1
469629,182,159,23,3,1
469629,58,49,9,4,1
469629,124,110,14,5,1
469629,124,110,14,20,1
469629,182,159,23,21,4
469629,182,159,23,22,1
469629,182,159,23,23,1
469629,58,49,9,24,1
469629,124,110,14,25,1
469629,124,110,14,40,1
469638,313,177,136,1,4
469638,313,177,136,2,1
469638,313,177,136,3,1
469638,310,176,134,4,1
469638,3,1,2,5,1
469638,3,1,2,20,1
469638,313,177,136,21,4
469638,313,177,136,22,1
469638,313,177,136,23,1
469638,310,176,134,24,1
469638,3,1,2,25,1
469638,3,1,2,40,1
469647,229,27,202,1,4
469647,229,27,202,2,1
469647,229,27,202,3,1
469647,180,22,158,4,1
469647,49,5,44,5,1
469647,49,5,44,20,1
469647,120,13,107,21,4
469647,120,13,107,22,1
469647,120,13,107,23,1
469647,100,11,89,24,1
469647,20,2,18,25,1
469647,20,2,18,40,1
469647,109,14,95,41,4
469647,109,14,95,42,1
469647,109,14,95,43,1
469647,80,11,69,44,1
469647,29,3,26,45,1
469647,29,3,26,60,1
469911,78,6,72,1,4
469911,78,6,72,2,1
469911,78,6,72,3,1
469911,46,4,42,4,1
469911,32,2,30,5,1
469911,32,2,30,20,1
469911,78,6,72,21,4
469911,78,6,72,22,1
469911,78,6,72,23,1
469911,46,4,42,24,1
469911,32,2,30,25,1
469911,32,2,30,40,1
469920,92,9,83,1,4
469920,92,9,83,2,1
469920,92,9,83,3,1
469920,87,8,79,4,1
469920,5,1,4,5,1
469920,5,1,4,20,1
469920,92,9,83,21,4
469920,92,9,83,22,1
469920,92,9,83,23,1
469920,87,8,79,24,1
469920,5,1,4,25,1
469920,5,1,4,40,1
469957,175,15,160,1,4
469957,175,15,160,2,1
469957,175,15,160,3,1
469957,68,5,63,4,1
469957,107,10,97,5,1
469957,107,10,97,20,1
469957,175,15,160,21,4
469957,175,15,160,22,1
469957,175,15,160,23,1
469957,68,5,63,24,1
469957,107,10,97,25,1
469957,107,10,97,40,1
469975,99,22,77,1,4
469975,99,22,77,2,1
469975,99,22,77,3,1
469975,45,10,35,4,1
469975,54,12,42,5,1
469975,54,12,42,20,1
469975,99,22,77,21,4
469975,99,22,77,22,1
469975,99,22,77,23,1
469975,45,10,35,24,1
469975,54,12,42,25,1
469975,54,12,42,40,1
469993,19,0,19,1,4
469993,19,0,19,2,1
469993,19,0,19,3,1
469993,5,0,5,4,1
469993,14,0,14,5,1
469993,14,0,14,20,1
469993,13,0,13,21,4
469993,13,0,13,22,1
469993,13,0,13,23,1
469993,4,0,4,24,1
469993,9,0,9,25,1
469993,9,0,9,40,1
469993,6,0,6,41,4
469993,6,0,6,42,1
469993,6,0,6,43,1
469993,1,0,1,44,1
469993,5,0,5,45,1
469993,5,0,5,60,1
470047,28,13,15,1,4
470047,28,13,15,2,1
470047,28,13,15,3,1
470047,15,9,6,4,1
470047,13,4,9,5,1
470047,13,4,9,20,1
470047,28,13,15,21,4
470047,28,13,15,22,1
470047,28,13,15,23,1
470047,15,9,6,24,1
470047,13,4,9,25,1
470047,13,4,9,40,1
470092,535,283,252,1,4
470092,535,283,252,2,1
470092,535,283,252,3,1
470092,139,86,53,4,1
470092,396,197,199,5,1
470092,89,46,43,19,1
470092,307,151,156,20,1
470092,355,177,178,21,4
470092,355,177,178,22,1
470092,355,177,178,23,1
470092,97,61,36,24,1
470092,258,116,142,25,1
470092,58,25,33,39,1
470092,200,91,109,40,1
470092,180,106,74,41,4
470092,180,106,74,42,1
470092,180,106,74,43,1
470092,42,25,17,44,1
470092,138,81,57,45,1
470092,31,21,10,59,1
470092,107,60,47,60,1
470162,954,221,733,1,4
470162,954,221,733,2,1
470162,954,221,733,3,1
470162,233,63,170,4,1
470162,721,158,563,5,1
470162,108,19,89,19,1
470162,613,139,474,20,1
470162,954,221,733,21,4
470162,954,221,733,22,1
470162,954,221,733,23,1
470162,233,63,170,24,1
470162,721,158,563,25,1
470162,108,19,89,39,1
470162,613,139,474,40,1
470223,23,2,21,1,4
470223,23,2,21,2,1
470223,23,2,21,3,1
470223,15,1,14,4,1
470223,8,1,7,5,1
470223,8,1,7,20,1
470223,20,2,18,21,4
470223,20,2,18,22,1
470223,20,2,18,23,1
470223,13,1,12,24,1
470223,7,1,6,25,1
470223,7,1,6,40,1
470223,3,0,3,41,4
470223,3,0,3,42,1
470223,3,0,3,43,1
470223,2,0,2,44,1
470223,1,0,1,45,1
470223,1,0,1,60,1
470296,23,3,20,1,4
470296,23,3,20,2,1
470296,23,3,20,3,1
470296,20,2,18,4,1
470296,3,1,2,5,1
470296,3,1,2,20,1
470296,23,3,20,21,4
470296,23,3,20,22,1
470296,23,3,20,23,1
470296,20,2,18,24,1
470296,3,1,2,25,1
470296,3,1,2,40,1
470302,92,42,50,1,4
470302,92,42,50,2,1
470302,92,42,50,3,1
470302,28,10,18,4,1
470302,64,32,32,5,1
470302,64,32,32,20,1
470302,92,42,50,21,4
470302,92,42,50,22,1
470302,92,42,50,23,1
470302,28,10,18,24,1
470302,64,32,32,25,1
470302,64,32,32,40,1
470393,84,5,79,1,4
470393,84,5,79,2,1
470393,84,5,79,3,1
470393,7,1,6,4,1
470393,77,4,73,5,1
470393,77,4,73,20,1
470393,64,5,59,21,4
470393,64,5,59,22,1
470393,64,5,59,23,1
470393,7,1,6,24,1
470393,57,4,53,25,1
470393,57,4,53,40,1
470393,20,0,20,41,4
470393,20,0,20,42,1
470393,20,0,20,43,1
470393,20,0,20,45,1
470393,20,0,20,60,1
470852,66,57,9,1,4
470852,66,57,9,2,1
470852,66,57,9,3,1
470852,66,57,9,5,1
470852,66,57,9,20,1
470852,47,40,7,21,4
470852,47,40,7,22,1
470852,47,40,7,23,1
470852,47,40,7,25,1
470852,47,40,7,40,1
470852,19,17,2,41,4
470852,19,17,2,42,1
470852,19,17,2,43,1
470852,19,17,2,45,1
470852,19,17,2,60,1
470861,262,214,48,1,4
470861,262,214,48,2,1
470861,262,214,48,3,1
470861,54,46,8,4,1
470861,208,168,40,5,1
470861,5,3,2,19,1
470861,203,165,38,20,1
470861,214,179,35,21,4
470861,214,179,35,22,1
470861,214,179,35,23,1
470861,50,45,5,24,1
470861,164,134,30,25,1
470861,3,2,1,39,1
470861,161,132,29,40,1
470861,48,35,13,41,4
470861,48,35,13,42,1
470861,48,35,13,43,1
470861,4,1,3,44,1
470861,44,34,10,45,1
470861,2,1,1,59,1
470861,42,33,9,60,1
470870,159,141,18,1,4
470870,159,141,18,2,1
470870,159,141,18,3,1
470870,51,48,3,4,1
470870,108,93,15,5,1
470870,6,4,2,19,1
470870,102,89,13,20,1
470870,132,118,14,21,4
470870,132,118,14,22,1
470870,132,118,14,23,1
470870,47,44,3,24,1
470870,85,74,11,25,1
470870,6,4,2,39,1
470870,79,70,9,40,1
470870,27,23,4,41,4
470870,27,23,4,42,1
470870,27,23,4,43,1
470870,4,4,0,44,1
470870,23,19,4,45,1
470870,23,19,4,60,1
470889,377,282,95,1,4
470889,377,282,95,2,1
470889,377,282,95,3,1
470889,72,53,19,4,1
470889,305,229,76,5,1
470889,8,7,1,19,1
470889,297,222,75,20,1
470889,280,221,59,21,4
470889,280,221,59,22,1
470889,280,221,59,23,1
470889,56,40,16,24,1
470889,224,181,43,25,1
470889,6,6,0,39,1
470889,218,175,43,40,1
470889,97,61,36,41,4
470889,97,61,36,42,1
470889,97,61,36,43,1
470889,16,13,3,44,1
470889,81,48,33,45,1
470889,2,1,1,59,1
470889,79,47,32,60,1
470898,231,167,64,1,4
470898,231,167,64,2,1
470898,231,167,64,3,1
470898,43,33,10,4,1
470898,188,134,54,5,1
470898,7,5,2,19,1
470898,181,129,52,20,1
470898,198,141,57,21,4
470898,198,141,57,22,1
470898,198,141,57,23,1
470898,37,29,8,24,1
470898,161,112,49,25,1
470898,7,5,2,39,1
470898,154,107,47,40,1
470898,33,26,7,41,4
470898,33,26,7,42,1
470898,33,26,7,43,1
470898,6,4,2,44,1
470898,27,22,5,45,1
470898,27,22,5,60,1
470904,216,168,48,1,4
470904,216,168,48,2,1
470904,216,168,48,3,1
470904,58,37,21,4,1
470904,158,131,27,5,1
470904,158,131,27,20,1
470904,179,136,43,21,4
470904,179,136,43,22,1
470904,179,136,43,23,1
470904,47,29,18,24,1
470904,132,107,25,25,1
470904,132,107,25,40,1
470904,37,32,5,41,4
470904,37,32,5,42,1
470904,37,32,5,43,1
470904,11,8,3,44,1
470904,26,24,2,45,1
470904,26,24,2,60,1
474702,98,38,60,1,4
474702,88,31,57,2,1
474702,88,31,57,3,1
474702,88,31,57,5,1
474702,10,7,3,12,3
474702,88,31,57,20,1
474702,98,38,60,21,4
474702,88,31,57,22,1
474702,88,31,57,23,1
474702,88,31,57,25,1
474702,10,7,3,32,3
474702,88,31,57,40,1
474863,726,188,538,1,4
474863,726,188,538,2,1
474863,650,162,488,3,1
474863,31,7,24,4,1
474863,619,155,464,5,1
474863,76,26,50,11,1
474863,130,33,97,19,1
474863,489,122,367,20,1
474863,210,68,142,21,4
474863,210,68,142,22,1
474863,191,57,134,23,1
474863,4,1,3,24,1
474863,187,56,131,25,1
474863,19,11,8,31,1
474863,41,9,32,39,1
474863,146,47,99,40,1
474863,516,120,396,41,4
474863,516,120,396,42,1
474863,459,105,354,43,1
474863,27,6,21,44,1
474863,432,99,333,45,1
474863,57,15,42,51,1
474863,89,24,65,59,1
474863,343,75,268,60,1
474881,147,117,30,1,4
474881,147,117,30,2,1
474881,147,117,30,3,1
474881,30,28,2,4,1
474881,117,89,28,5,1
474881,18,15,3,19,1
474881,99,74,25,20,1
474881,103,84,19,21,4
474881,103,84,19,22,1
474881,103,84,19,23,1
474881,22,21,1,24,1
474881,81,63,18,25,1
474881,12,11,1,39,1
474881,69,52,17,40,1
474881,44,33,11,41,4
474881,44,33,11,42,1
474881,44,33,11,43,1
474881,8,7,1,44,1
474881,36,26,10,45,1
474881,6,4,2,59,1
474881,30,22,8,60,1
474890,451,146,305,1,4
474890,451,146,305,2,1
474890,451,146,305,3,1
474890,236,83,153,4,1
474890,215,63,152,5,1
474890,215,63,152,20,1
474890,451,146,305,21,4
474890,451,146,305,22,1
474890,451,146,305,23,1
474890,236,83,153,24,1
474890,215,63,152,25,1
474890,215,63,152,40,1
474906,95,27,68,1,4
474906,95,27,68,2,1
474906,95,27,68,3,1
474906,46,14,32,4,1
474906,49,13,36,5,1
474906,14,3,11,19,1
474906,35,10,25,20,1
474906,95,27,68,21,4
474906,95,27,68,22,1
474906,95,27,68,23,1
474906,46,14,32,24,1
474906,49,13,36,25,1
474906,14,3,11,39,1
474906,35,10,25,40,1
474915,233,14,219,1,4
474915,233,14,219,2,1
474915,233,14,219,3,1
474915,188,12,176,4,1
474915,45,2,43,5,1
474915,45,2,43,20,1
474915,138,10,128,21,4
474915,138,10,128,22,1
474915,138,10,128,23,1
474915,113,8,105,24,1
474915,25,2,23,25,1
474915,25,2,23,40,1
474915,95,4,91,41,4
474915,95,4,91,42,1
474915,95,4,91,43,1
474915,75,4,71,44,1
474915,20,0,20,45,1
474915,20,0,20,60,1
474924,172,7,165,1,4
474924,172,7,165,2,1
474924,172,7,165,3,1
474924,91,5,86,4,1
474924,81,2,79,5,1
474924,81,2,79,20,1
474924,72,4,68,21,4
474924,72,4,68,22,1
474924,72,4,68,23,1
474924,57,3,54,24,1
474924,15,1,14,25,1
474924,15,1,14,40,1
474924,100,3,97,41,4
474924,100,3,97,42,1
474924,100,3,97,43,1
474924,34,2,32,44,1
474924,66,1,65,45,1
474924,66,1,65,60,1
474933,67,7,60,1,4
474933,67,7,60,2,1
474933,67,7,60,3,1
474933,15,0,15,4,1
474933,52,7,45,5,1
474933,52,7,45,20,1
474933,34,4,30,21,4
474933,34,4,30,22,1
474933,34,4,30,23,1
474933,11,0,11,24,1
474933,23,4,19,25,1
474933,23,4,19,40,1
474933,33,3,30,41,4
474933,33,3,30,42,1
474933,33,3,30,43,1
474933,4,0,4,44,1
474933,29,3,26,45,1
474933,29,3,26,60,1
474942,122,5,117,1,4
474942,122,5,117,2,1
474942,122,5,117,3,1
474942,20,0,20,4,1
474942,102,5,97,5,1
474942,102,5,97,20,1
474942,86,4,82,21,4
474942,86,4,82,22,1
474942,86,4,82,23,1
474942,15,0,15,24,1
474942,71,4,67,25,1
474942,71,4,67,40,1
474942,36,1,35,41,4
474942,36,1,35,42,1
474942,36,1,35,43,1
474942,5,0,5,44,1
474942,31,1,30,45,1
474942,31,1,30,60,1
474951,1094,280,814,1,4
474951,893,233,660,2,1
474951,892,233,659,3,1
474951,46,10,36,4,1
474951,846,223,623,5,1
474951,1,0,1,11,1
474951,201,47,154,12,3
474951,46,19,27,19,1
474951,800,204,596,20,1
474951,1094,280,814,21,4
474951,893,233,660,22,1
474951,892,233,659,23,1
474951,46,10,36,24,1
474951,846,223,623,25,1
474951,1,0,1,31,1
474951,201,47,154,32,3
474951,46,19,27,39,1
474951,800,204,596,40,1
474960,91,21,70,1,4
474960,85,19,66,2,1
474960,85,19,66,3,1
474960,85,19,66,5,1
474960,6,2,4,12,3
474960,85,19,66,20,1
474960,91,21,70,21,4
474960,85,19,66,22,1
474960,85,19,66,23,1
474960,85,19,66,25,1
474960,6,2,4,32,3
474960,85,19,66,40,1
474979,136,36,100,1,4
474979,131,35,96,2,1
474979,131,35,96,3,1
474979,131,35,96,5,1
474979,5,1,4,12,3
474979,131,35,96,20,1
474979,136,36,100,21,4
474979,131,35,96,22,1
474979,131,35,96,23,1
474979,131,35,96,25,1
474979,5,1,4,32,3
474979,131,35,96,40,1
474997,350,169,181,1,4
474997,350,169,181,2,1
474997,350,169,181,3,1
474997,60,34,26,4,1
474997,290,135,155,5,1
474997,9,2,7,19,1
474997,281,133,148,20,1
474997,350,169,181,21,4
474997,350,169,181,22,1
474997,350,169,181,23,1
474997,60,34,26,24,1
474997,290,135,155,25,1
474997,9,2,7,39,1
474997,281,133,148,40,1
475015,213,6,207,1,4
475015,213,6,207,2,1
475015,213,6,207,3,1
475015,20,0,20,4,1
475015,193,6,187,5,1
475015,193,6,187,20,1
475015,213,6,207,21,4
475015,213,6,207,22,1
475015,213,6,207,23,1
475015,20,0,20,24,1
475015,193,6,187,25,1
475015,193,6,187,40,1
475024,270,118,152,1,4
475024,270,118,152,2,1
475024,270,118,152,3,1
475024,77,36,41,4,1
475024,193,82,111,5,1
475024,193,82,111,20,1
475024,270,118,152,21,4
475024,270,118,152,22,1
475024,270,118,152,23,1
475024,77,36,41,24,1
475024,193,82,111,25,1
475024,193,82,111,40,1
475033,721,219,502,1,4
475033,721,219,502,12,3
475033,721,219,502,41,4
475033,721,219,502,52,3
475042,355,75,280,1,4
475042,355,75,280,2,1
475042,355,75,280,3,1
475042,39,5,34,4,1
475042,316,70,246,5,1
475042,92,24,68,19,1
475042,224,46,178,20,1
475042,355,75,280,21,4
475042,355,75,280,22,1
475042,355,75,280,23,1
475042,39,5,34,24,1
475042,316,70,246,25,1
475042,92,24,68,39,1
475042,224,46,178,40,1
475051,17,1,16,1,4
475051,17,1,16,2,1
475051,17,1,16,3,1
475051,17,1,16,5,1
475051,17,1,16,20,1
475051,17,1,16,21,4
475051,17,1,16,22,1
475051,17,1,16,23,1
475051,17,1,16,25,1
475051,17,1,16,40,1
475060,350,76,274,1,4
475060,350,76,274,2,1
475060,350,76,274,3,1
475060,82,18,64,4,1
475060,268,58,210,5,1
475060,56,12,44,19,1
475060,212,46,166,20,1
475060,184,42,142,21,4
475060,184,42,142,22,1
475060,184,42,142,23,1
475060,49,11,38,24,1
475060,135,31,104,25,1
475060,31,8,23,39,1
475060,104,23,81,40,1
475060,166,34,132,41,4
475060,166,34,132,42,1
475060,166,34,132,43,1
475060,33,7,26,44,1
475060,133,27,106,45,1
475060,25,4,21,59,1
475060,108,23,85,60,1
475079,237,28,209,1,4
475079,237,28,209,2,1
475079,237,28,209,3,1
475079,66,9,57,4,1
475079,171,19,152,5,1
475079,26,5,21,19,1
475079,145,14,131,20,1
475079,143,14,129,21,4
475079,143,14,129,22,1
475079,143,14,129,23,1
475079,48,6,42,24,1
475079,95,8,87,25,1
475079,13,1,12,39,1
475079,82,7,75,40,1
475079,94,14,80,41,4
475079,94,14,80,42,1
475079,94,14,80,43,1
475079,18,3,15,44,1
475079,76,11,65,45,1
475079,13,4,9,59,1
475079,63,7,56,60,1
475097,124,64,60,1,4
475097,124,64,60,2,1
475097,124,64,60,3,1
475097,63,40,23,4,1
475097,61,24,37,5,1
475097,61,24,37,20,1
475097,78,38,40,21,4
475097,78,38,40,22,1
475097,78,38,40,23,1
475097,36,24,12,24,1
475097,42,14,28,25,1
475097,42,14,28,40,1
475097,46,26,20,41,4
475097,46,26,20,42,1
475097,46,26,20,43,1
475097,27,16,11,44,1
475097,19,10,9,45,1
475097,19,10,9,60,1
475121,11143,2425,8718,1,4
475121,9610,2138,7472,2,1
475121,9592,2131,7461,3,1
475121,826,192,634,4,1
475121,8766,1939,6827,5,1
475121,18,7,11,11,1
475121,1533,287,1246,12,3
475121,1120,210,910,19,1
475121,7646,1729,5917,20,1
475121,11140,2425,8715,21,4
475121,9610,2138,7472,22,1
475121,9592,2131,7461,23,1
475121,826,192,634,24,1
475121,8766,1939,6827,25,1
475121,18,7,11,31,1
475121,1530,287,1243,32,3
475121,1120,210,910,39,1
475121,7646,1729,5917,40,1
475121,3,0,3,41,4
475121,3,0,3,52,3
475130,192,17,175,1,4
475130,192,17,175,2,1
475130,192,17,175,3,1
475130,11,1,10,4,1
475130,181,16,165,5,1
475130,35,1,34,19,1
475130,146,15,131,20,1
475130,192,17,175,21,4
475130,192,17,175,22,1
475130,192,17,175,23,1
475130,11,1,10,24,1
475130,181,16,165,25,1
475130,35,1,34,39,1
475130,146,15,131,40,1
475176,393,101,292,1,4
475176,393,101,292,2,1
475176,393,101,292,3,1
475176,32,5,27,4,1
475176,361,96,265,5,1
475176,47,10,37,19,1
475176,314,86,228,20,1
475176,393,101,292,21,4
475176,393,101,292,22,1
475176,393,101,292,23,1
475176,32,5,27,24,1
475176,361,96,265,25,1
475176,47,10,37,39,1
475176,314,86,228,40,1
475185,108,58,50,1,4
475185,108,58,50,2,1
475185,108,58,50,3,1
475185,4,2,2,4,1
475185,104,56,48,5,1
475185,20,12,8,19,1
475185,84,44,40,20,1
475185,97,53,44,21,4
475185,97,53,44,22,1
475185,97,53,44,23,1
475185,4,2,2,24,1
475185,93,51,42,25,1
475185,18,10,8,39,1
475185,75,41,34,40,1
475185,11,5,6,41,4
475185,11,5,6,42,1
475185,11,5,6,43,1
475185,11,5,6,45,1
475185,2,2,0,59,1
475185,9,3,6,60,1
475194,297,19,278,1,4
475194,297,19,278,2,1
475194,297,19,278,3,1
475194,80,6,74,4,1
475194,217,13,204,5,1
475194,12,0,12,19,1
475194,205,13,192,20,1
475194,196,13,183,21,4
475194,196,13,183,22,1
475194,196,13,183,23,1
475194,49,4,45,24,1
475194,147,9,138,25,1
475194,9,0,9,39,1
475194,138,9,129,40,1
475194,101,6,95,41,4
475194,101,6,95,42,1
475194,101,6,95,43,1
475194,31,2,29,44,1
475194,70,4,66,45,1
475194,3,0,3,59,1
475194,67,4,63,60,1
475200,313,93,220,1,4
475200,310,93,217,2,1
475200,310,93,217,3,1
475200,310,93,217,5,1
475200,3,0,3,12,3
475200,50,11,39,19,1
475200,260,82,178,20,1
475200,28,6,22,21,4
475200,26,6,20,22,1
475200,26,6,20,23,1
475200,26,6,20,25,1
475200,2,0,2,32,3
475200,26,6,20,40,1
475200,285,87,198,41,4
475200,284,87,197,42,1
475200,284,87,197,43,1
475200,284,87,197,45,1
475200,1,0,1,52,3
475200,50,11,39,59,1
475200,234,76,158,60,1
475228,107,53,54,1,4
475228,107,53,54,12,3
475228,107,53,54,41,4
475228,107,53,54,52,3
475255,81,51,30,1,4
475255,81,51,30,2,1
475255,81,51,30,3,1
475255,25,20,5,4,1
475255,56,31,25,5,1
475255,56,31,25,20,1
475255,81,51,30,21,4
475255,81,51,30,22,1
475255,81,51,30,23,1
475255,25,20,5,24,1
475255,56,31,25,25,1
475255,56,31,25,40,1
475273,1763,404,1359,1,4
475273,1319,284,1035,2,1
475273,1319,284,1035,3,1
475273,1319,284,1035,5,1
475273,444,120,324,12,3
475273,1319,284,1035,20,1
475273,1268,290,978,21,4
475273,938,196,742,22,1
475273,938,196,742,23,1
475273,938,196,742,25,1
475273,330,94,236,32,3
475273,938,196,742,40,1
475273,495,114,381,41,4
475273,381,88,293,42,1
475273,381,88,293,43,1
475273,381,88,293,45,1
475273,114,26,88,52,3
475273,381,88,293,60,1
475282,94,16,78,1,4
475282,94,16,78,2,1
475282,94,16,78,3,1
475282,20,2,18,4,1
475282,74,14,60,5,1
475282,74,14,60,20,1
475282,94,16,78,21,4
475282,94,16,78,22,1
475282,94,16,78,23,1
475282,20,2,18,24,1
475282,74,14,60,25,1
475282,74,14,60,40,1
475291,144,38,106,1,4
475291,144,38,106,2,1
475291,144,38,106,3,1
475291,13,5,8,4,1
475291,131,33,98,5,1
475291,15,2,13,19,1
475291,116,31,85,20,1
475291,37,16,21,21,4
475291,37,16,21,22,1
475291,37,16,21,23,1
475291,6,4,2,24,1
475291,31,12,19,25,1
475291,5,1,4,39,1
475291,26,11,15,40,1
475291,107,22,85,41,4
475291,107,22,85,42,1
475291,107,22,85,43,1
475291,7,1,6,44,1
475291,100,21,79,45,1
475291,10,1,9,59,1
475291,90,20,70,60,1
475325,402,68,334,1,4
475325,402,68,334,2,1
475325,402,68,334,3,1
475325,162,24,138,4,1
475325,240,44,196,5,1
475325,240,44,196,20,1
475325,402,68,334,21,4
475325,402,68,334,22,1
475325,402,68,334,23,1
475325,162,24,138,24,1
475325,240,44,196,25,1
475325,240,44,196,40,1
475352,620,89,531,1,4
475352,620,89,531,2,1
475352,620,89,531,3,1
475352,283,50,233,4,1
475352,337,39,298,5,1
475352,337,39,298,20,1
475352,453,78,375,21,4
475352,453,78,375,22,1
475352,453,78,375,23,1
475352,214,42,172,24,1
475352,239,36,203,25,1
475352,239,36,203,40,1
475352,167,11,156,41,4
475352,167,11,156,42,1
475352,167,11,156,43,1
475352,69,8,61,44,1
475352,98,3,95,45,1
475352,98,3,95,60,1
475370,741,143,598,1,4
475370,741,143,598,2,1
475370,741,143,598,3,1
475370,243,52,191,4,1
475370,498,91,407,5,1
475370,498,91,407,20,1
475370,566,109,457,21,4
475370,566,109,457,22,1
475370,566,109,457,23,1
475370,185,37,148,24,1
475370,381,72,309,25,1
475370,381,72,309,40,1
475370,175,34,141,41,4
475370,175,34,141,42,1
475370,175,34,141,43,1
475370,58,15,43,44,1
475370,117,19,98,45,1
475370,117,19,98,60,1
475389,42,0,42,1,4
475389,42,0,42,2,1
475389,42,0,42,3,1
475389,15,0,15,4,1
475389,27,0,27,5,1
475389,27,0,27,20,1
475389,42,0,42,21,4
475389,42,0,42,22,1
475389,42,0,42,23,1
475389,15,0,15,24,1
475389,27,0,27,25,1
475389,27,0,27,40,1
475404,80,2,78,1,4
475404,80,2,78,2,1
475404,80,2,78,3,1
475404,8,0,8,4,1
475404,72,2,70,5,1
475404,72,2,70,20,1
475404,43,1,42,21,4
475404,43,1,42,22,1
475404,43,1,42,23,1
475404,5,0,5,24,1
475404,38,1,37,25,1
475404,38,1,37,40,1
475404,37,1,36,41,4
475404,37,1,36,42,1
475404,37,1,36,43,1
475404,3,0,3,44,1
475404,34,1,33,45,1
475404,34,1,33,60,1
475413,45,1,44,1,4
475413,45,1,44,2,1
475413,45,1,44,3,1
475413,29,1,28,4,1
475413,16,0,16,5,1
475413,16,0,16,20,1
475413,39,1,38,21,4
475413,39,1,38,22,1
475413,39,1,38,23,1
475413,28,1,27,24,1
475413,11,0,11,25,1
475413,11,0,11,40,1
475413,6,0,6,41,4
475413,6,0,6,42,1
475413,6,0,6,43,1
475413,1,0,1,44,1
475413,5,0,5,45,1
475413,5,0,5,60,1
475422,119,11,108,1,4
475422,119,11,108,2,1
475422,119,11,108,3,1
475422,3,1,2,4,1
475422,116,10,106,5,1
475422,50,6,44,19,1
475422,66,4,62,20,1
475422,21,2,19,21,4
475422,21,2,19,22,1
475422,21,2,19,23,1
475422,2,1,1,24,1
475422,19,1,18,25,1
475422,7,0,7,39,1
475422,12,1,11,40,1
475422,98,9,89,41,4
475422,98,9,89,42,1
475422,98,9,89,43,1
475422,1,0,1,44,1
475422,97,9,88,45,1
475422,43,6,37,59,1
475422,54,3,51,60,1
475431,11,1,10,1,4
475431,11,1,10,2,1
475431,11,1,10,3,1
475431,11,1,10,4,1
475431,11,1,10,21,4
475431,11,1,10,22,1
475431,11,1,10,23,1
475431,11,1,10,24,1
475440,9,8,1,1,4
475440,9,8,1,2,1
475440,9,8,1,3,1
475440,5,4,1,4,1
475440,4,4,0,5,1
475440,4,4,0,20,1
475440,9,8,1,21,4
475440,9,8,1,22,1
475440,9,8,1,23,1
475440,5,4,1,24,1
475440,4,4,0,25,1
475440,4,4,0,40,1
475459,428,167,261,1,4
475459,428,167,261,2,1
475459,428,167,261,3,1
475459,281,119,162,4,1
475459,147,48,99,5,1
475459,147,48,99,20,1
475459,428,167,261,21,4
475459,428,167,261,22,1
475459,428,167,261,23,1
475459,281,119,162,24,1
475459,147,48,99,25,1
475459,147,48,99,40,1
475468,135,12,123,1,4
475468,135,12,123,2,1
475468,135,12,123,3,1
475468,20,2,18,4,1
475468,115,10,105,5,1
475468,115,10,105,20,1
475468,100,6,94,21,4
475468,100,6,94,22,1
475468,100,6,94,23,1
475468,19,2,17,24,1
475468,81,4,77,25,1
475468,81,4,77,40,1
475468,35,6,29,41,4
475468,35,6,29,42,1
475468,35,6,29,43,1
475468,1,0,1,44,1
475468,34,6,28,45,1
475468,34,6,28,60,1
475477,126,36,90,1,4
475477,126,36,90,2,1
475477,126,36,90,3,1
475477,20,8,12,4,1
475477,106,28,78,5,1
475477,11,1,10,19,1
475477,95,27,68,20,1
475477,68,23,45,21,4
475477,68,23,45,22,1
475477,68,23,45,23,1
475477,13,7,6,24,1
475477,55,16,39,25,1
475477,3,0,3,39,1
475477,52,16,36,40,1
475477,58,13,45,41,4
475477,58,13,45,42,1
475477,58,13,45,43,1
475477,7,1,6,44,1
475477,51,12,39,45,1
475477,8,1,7,59,1
475477,43,11,32,60,1
475486,237,14,223,1,4
475486,237,14,223,2,1
475486,237,14,223,3,1
475486,208,6,202,4,1
475486,29,8,21,5,1
475486,29,8,21,20,1
475486,237,14,223,21,4
475486,237,14,223,22,1
475486,237,14,223,23,1
475486,208,6,202,24,1
475486,29,8,21,25,1
475486,29,8,21,40,1
475495,461,173,288,1,4
475495,461,173,288,12,3
475495,458,173,285,21,4
475495,458,173,285,32,3
475495,3,0,3,41,4
475495,3,0,3,52,3
475501,51,42,9,1,4
475501,51,42,9,2,1
475501,51,42,9,3,1
475501,48,40,8,4,1
475501,3,2,1,5,1
475501,3,2,1,20,1
475501,51,42,9,21,4
475501,51,42,9,22,1
475501,51,42,9,23,1
475501,48,40,8,24,1
475501,3,2,1,25,1
475501,3,2,1,40,1
475510,73,5,68,1,4
475510,73,5,68,12,3
475510,28,3,25,21,4
475510,28,3,25,32,3
475510,45,2,43,41,4
475510,45,2,43,52,3
475529,57,5,52,1,4
475529,57,5,52,2,1
475529,57,5,52,3,1
475529,31,2,29,4,1
475529,26,3,23,5,1
475529,26,3,23,20,1
475529,54,4,50,21,4
475529,54,4,50,22,1
475529,54,4,50,23,1
475529,30,2,28,24,1
475529,24,2,22,25,1
475529,24,2,22,40,1
475529,3,1,2,41,4
475529,3,1,2,42,1
475529,3,1,2,43,1
475529,1,0,1,44,1
475529,2,1,1,45,1
475529,2,1,1,60,1
475538,65,3,62,1,4
475538,65,3,62,2,1
475538,65,3,62,3,1
475538,52,3,49,4,1
475538,13,0,13,5,1
475538,13,0,13,20,1
475538,60,3,57,21,4
475538,60,3,57,22,1
475538,60,3,57,23,1
475538,48,3,45,24,1
475538,12,0,12,25,1
475538,12,0,12,40,1
475538,5,0,5,41,4
475538,5,0,5,42,1
475538,5,0,5,43,1
475538,4,0,4,44,1
475538,1,0,1,45,1
475538,1,0,1,60,1
475547,110,5,105,1,4
475547,110,5,105,2,1
475547,110,5,105,3,1
475547,13,1,12,4,1
475547,97,4,93,5,1
475547,97,4,93,20,1
475547,70,4,66,21,4
475547,70,4,66,22,1
475547,70,4,66,23,1
475547,11,1,10,24,1
475547,59,3,56,25,1
475547,59,3,56,40,1
475547,40,1,39,41,4
475547,40,1,39,42,1
475547,40,1,39,43,1
475547,2,0,2,44,1
475547,38,1,37,45,1
475547,38,1,37,60,1
475556,147,8,139,1,4
475556,147,8,139,2,1
475556,147,8,139,3,1
475556,24,0,24,4,1
475556,123,8,115,5,1
475556,123,8,115,20,1
475556,102,4,98,21,4
475556,102,4,98,22,1
475556,102,4,98,23,1
475556,18,0,18,24,1
475556,84,4,80,25,1
475556,84,4,80,40,1
475556,45,4,41,41,4
475556,45,4,41,42,1
475556,45,4,41,43,1
475556,6,0,6,44,1
475556,39,4,35,45,1
475556,39,4,35,60,1
475565,493,205,288,1,4
475565,493,205,288,2,1
475565,493,205,288,3,1
475565,278,109,169,4,1
475565,215,96,119,5,1
475565,215,96,119,20,1
475565,480,196,284,21,4
475565,480,196,284,22,1
475565,480,196,284,23,1
475565,278,109,169,24,1
475565,202,87,115,25,1
475565,202,87,115,40,1
475565,13,9,4,41,4
475565,13,9,4,42,1
475565,13,9,4,43,1
475565,13,9,4,45,1
475565,13,9,4,60,1
475574,62,49,13,1,4
475574,62,49,13,2,1
475574,62,49,13,3,1
475574,6,4,2,4,1
475574,56,45,11,5,1
475574,56,45,11,20,1
475574,47,38,9,21,4
475574,47,38,9,22,1
475574,47,38,9,23,1
475574,2,1,1,24,1
475574,45,37,8,25,1
475574,45,37,8,40,1
475574,15,11,4,41,4
475574,15,11,4,42,1
475574,15,11,4,43,1
475574,4,3,1,44,1
475574,11,8,3,45,1
475574,11,8,3,60,1
475583,111,22,89,1,4
475583,111,22,89,2,1
475583,111,22,89,3,1
475583,51,15,36,4,1
475583,60,7,53,5,1
475583,60,7,53,20,1
475583,111,22,89,21,4
475583,111,22,89,22,1
475583,111,22,89,23,1
475583,51,15,36,24,1
475583,60,7,53,25,1
475583,60,7,53,40,1
475592,121,22,99,1,4
475592,121,22,99,2,1
475592,121,22,99,3,1
475592,57,13,44,4,1
475592,64,9,55,5,1
475592,64,9,55,20,1
475592,90,19,71,21,4
475592,90,19,71,22,1
475592,90,19,71,23,1
475592,39,10,29,24,1
475592,51,9,42,25,1
475592,51,9,42,40,1
475592,31,3,28,41,4
475592,31,3,28,42,1
475592,31,3,28,43,1
475592,18,3,15,44,1
475592,13,0,13,45,1
475592,13,0,13,60,1
475608,323,238,85,1,4
475608,235,177,58,2,1
475608,225,170,55,3,1
475608,20,15,5,4,1
475608,205,155,50,5,1
475608,10,7,3,11,1
475608,88,61,27,12,3
475608,33,25,8,19,1
475608,172,130,42,20,1
475608,173,129,44,21,4
475608,138,104,34,22,1
475608,138,104,34,23,1
475608,14,11,3,24,1
475608,124,93,31,25,1
475608,35,25,10,32,3
475608,25,17,8,39,1
475608,99,76,23,40,1
475608,150,109,41,41,4
475608,97,73,24,42,1
475608,87,66,21,43,1
475608,6,4,2,44,1
475608,81,62,19,45,1
475608,10,7,3,51,1
475608,53,36,17,52,3
475608,8,8,0,59,1
475608,73,54,19,60,1
475617,602,85,517,1,4
475617,602,85,517,2,1
475617,602,85,517,3,1
475617,365,60,305,4,1
475617,237,25,212,5,1
475617,237,25,212,20,1
475617,393,59,334,21,4
475617,393,59,334,22,1
475617,393,59,334,23,1
475617,243,43,200,24,1
475617,150,16,134,25,1
475617,150,16,134,40,1
475617,209,26,183,41,4
475617,209,26,183,42,1
475617,209,26,183,43,1
475617,122,17,105,44,1
475617,87,9,78,45,1
475617,87,9,78,60,1
475626,37,2,35,1,4
475626,37,2,35,2,1
475626,37,2,35,3,1
475626,2,0,2,4,1
475626,35,2,33,5,1
475626,35,2,33,20,1
475626,34,1,33,21,4
475626,34,1,33,22,1
475626,34,1,33,23,1
475626,1,0,1,24,1
475626,33,1,32,25,1
475626,33,1,32,40,1
475626,3,1,2,41,4
475626,3,1,2,42,1
475626,3,1,2,43,1
475626,1,0,1,44,1
475626,2,1,1,45,1
475626,2,1,1,60,1
475635,21,4,17,1,4
475635,21,4,17,2,1
475635,21,4,17,3,1
475635,5,2,3,4,1
475635,16,2,14,5,1
475635,16,2,14,20,1
475635,14,1,13,21,4
475635,14,1,13,22,1
475635,14,1,13,23,1
475635,3,1,2,24,1
475635,11,0,11,25,1
475635,11,0,11,40,1
475635,7,3,4,41,4
475635,7,3,4,42,1
475635,7,3,4,43,1
475635,2,1,1,44,1
475635,5,2,3,45,1
475635,5,2,3,60,1
475644,24,3,21,1,4
475644,24,3,21,2,1
475644,24,3,21,3,1
475644,23,2,21,4,1
475644,1,1,0,5,1
475644,1,1,0,20,1
475644,24,3,21,21,4
475644,24,3,21,22,1
475644,24,3,21,23,1
475644,23,2,21,24,1
475644,1,1,0,25,1
475644,1,1,0,40,1
475653,21,1,20,1,4
475653,21,1,20,2,1
475653,21,1,20,3,1
475653,4,0,4,4,1
475653,17,1,16,5,1
475653,17,1,16,20,1
475653,21,1,20,21,4
475653,21,1,20,22,1
475653,21,1,20,23,1
475653,4,0,4,24,1
475653,17,1,16,25,1
475653,17,1,16,40,1
475662,103,3,100,1,4
475662,103,3,100,2,1
475662,103,3,100,3,1
475662,18,0,18,4,1
475662,85,3,82,5,1
475662,85,3,82,20,1
475662,50,1,49,21,4
475662,50,1,49,22,1
475662,50,1,49,23,1
475662,13,0,13,24,1
475662,37,1,36,25,1
475662,37,1,36,40,1
475662,53,2,51,41,4
475662,53,2,51,42,1
475662,53,2,51,43,1
475662,5,0,5,44,1
475662,48,2,46,45,1
475662,48,2,46,60,1
475680,18,4,14,1,4
475680,18,4,14,2,1
475680,18,4,14,3,1
475680,5,2,3,4,1
475680,13,2,11,5,1
475680,13,2,11,20,1
475680,18,4,14,21,4
475680,18,4,14,22,1
475680,18,4,14,23,1
475680,5,2,3,24,1
475680,13,2,11,25,1
475680,13,2,11,40,1
475699,313,32,281,1,4
475699,313,32,281,2,1
475699,313,32,281,3,1
475699,17,2,15,4,1
475699,296,30,266,5,1
475699,109,6,103,19,1
475699,187,24,163,20,1
475699,129,15,114,21,4
475699,129,15,114,22,1
475699,129,15,114,23,1
475699,15,2,13,24,1
475699,114,13,101,25,1
475699,45,3,42,39,1
475699,69,10,59,40,1
475699,184,17,167,41,4
475699,184,17,167,42,1
475699,184,17,167,43,1
475699,2,0,2,44,1
475699,182,17,165,45,1
475699,64,3,61,59,1
475699,118,14,104,60,1
475705,12,3,9,1,4
475705,12,3,9,2,1
475705,12,3,9,3,1
475705,1,1,0,4,1
475705,11,2,9,5,1
475705,11,2,9,20,1
475705,12,3,9,21,4
475705,12,3,9,22,1
475705,12,3,9,23,1
475705,1,1,0,24,1
475705,11,2,9,25,1
475705,11,2,9,40,1
475714,343,269,74,1,4
475714,343,269,74,2,1
475714,343,269,74,3,1
475714,56,40,16,4,1
475714,287,229,58,5,1
475714,50,39,11,19,1
475714,237,190,47,20,1
475714,253,204,49,21,4
475714,253,204,49,22,1
475714,253,204,49,23,1
475714,56,40,16,24,1
475714,197,164,33,25,1
475714,31,27,4,39,1
475714,166,137,29,40,1
475714,90,65,25,41,4
475714,90,65,25,42,1
475714,90,65,25,43,1
475714,90,65,25,45,1
475714,19,12,7,59,1
475714,71,53,18,60,1
475732,613,50,563,1,4
475732,613,50,563,2,1
475732,610,50,560,3,1
475732,2,0,2,4,1
475732,608,50,558,5,1
475732,3,0,3,11,1
475732,308,33,275,19,1
475732,300,17,283,20,1
475732,405,33,372,21,4
475732,405,33,372,22,1
475732,405,33,372,23,1
475732,2,0,2,24,1
475732,403,33,370,25,1
475732,236,24,212,39,1
475732,167,9,158,40,1
475732,208,17,191,41,4
475732,208,17,191,42,1
475732,205,17,188,43,1
475732,205,17,188,45,1
475732,3,0,3,51,1
475732,72,9,63,59,1
475732,133,8,125,60,1
475741,159,19,140,1,4
475741,159,19,140,2,1
475741,159,19,140,3,1
475741,4,1,3,4,1
475741,155,18,137,5,1
475741,72,6,66,19,1
475741,83,12,71,20,1
475741,114,12,102,21,4
475741,114,12,102,22,1
475741,114,12,102,23,1
475741,4,1,3,24,1
475741,110,11,99,25,1
475741,58,6,52,39,1
475741,52,5,47,40,1
475741,45,7,38,41,4
475741,45,7,38,42,1
475741,45,7,38,43,1
475741,45,7,38,45,1
475741,14,0,14,59,1
475741,31,7,24,60,1
475750,308,18,290,1,4
475750,308,18,290,2,1
475750,308,18,290,3,1
475750,51,3,48,4,1
475750,257,15,242,5,1
475750,257,15,242,20,1
475750,308,18,290,21,4
475750,308,18,290,22,1
475750,308,18,290,23,1
475750,51,3,48,24,1
475750,257,15,242,25,1
475750,257,15,242,40,1
475811,104,58,46,1,4
475811,104,58,46,12,3
475811,104,58,46,21,4
475811,104,58,46,32,3
475839,70,26,44,1,4
475839,70,26,44,2,1
475839,70,26,44,3,1
475839,12,6,6,4,1
475839,58,20,38,5,1
475839,18,3,15,19,1
475839,40,17,23,20,1
475839,59,22,37,21,4
475839,59,22,37,22,1
475839,59,22,37,23,1
475839,10,4,6,24,1
475839,49,18,31,25,1
475839,16,3,13,39,1
475839,33,15,18,40,1
475839,11,4,7,41,4
475839,11,4,7,42,1
475839,11,4,7,43,1
475839,2,2,0,44,1
475839,9,2,7,45,1
475839,2,0,2,59,1
475839,7,2,5,60,1
475866,264,25,239,1,4
475866,264,25,239,2,1
475866,264,25,239,3,1
475866,117,12,105,4,1
475866,147,13,134,5,1
475866,147,13,134,20,1
475866,211,20,191,21,4
475866,211,20,191,22,1
475866,211,20,191,23,1
475866,99,11,88,24,1
475866,112,9,103,25,1
475866,112,9,103,40,1
475866,53,5,48,41,4
475866,53,5,48,42,1
475866,53,5,48,43,1
475866,18,1,17,44,1
475866,35,4,31,45,1
475866,35,4,31,60,1
475875,154,47,107,1,4
475875,128,42,86,2,1
475875,128,42,86,3,1
475875,28,9,19,4,1
475875,100,33,67,5,1
475875,26,5,21,12,3
475875,16,3,13,19,1
475875,84,30,54,20,1
475875,9,2,7,21,4
475875,5,1,4,22,1
475875,5,1,4,23,1
475875,5,1,4,25,1
475875,4,1,3,32,3
475875,5,1,4,40,1
475875,145,45,100,41,4
475875,123,41,82,42,1
475875,123,41,82,43,1
475875,28,9,19,44,1
475875,95,32,63,45,1
475875,22,4,18,52,3
475875,16,3,13,59,1
475875,79,29,50,60,1
475884,142,64,78,1,4
475884,97,43,54,2,1
475884,96,43,53,3,1
475884,21,7,14,4,1
475884,75,36,39,5,1
475884,1,0,1,11,1
475884,45,21,24,12,3
475884,7,4,3,19,1
475884,68,32,36,20,1
475884,18,14,4,21,4
475884,9,8,1,22,1
475884,9,8,1,23,1
475884,9,8,1,25,1
475884,9,6,3,32,3
475884,9,8,1,40,1
475884,124,50,74,41,4
475884,88,35,53,42,1
475884,87,35,52,43,1
475884,21,7,14,44,1
475884,66,28,38,45,1
475884,1,0,1,51,1
475884,36,15,21,52,3
475884,7,4,3,59,1
475884,59,24,35,60,1
476063,176,174,2,1,4
476063,176,174,2,2,1
476063,176,174,2,3,1
476063,43,42,1,4,1
476063,133,132,1,5,1
476063,133,132,1,20,1
476063,176,174,2,21,4
476063,176,174,2,22,1
476063,176,174,2,23,1
476063,43,42,1,24,1
476063,133,132,1,25,1
476063,133,132,1,40,1
476090,53,1,52,1,4
476090,53,1,52,2,1
476090,53,1,52,3,1
476090,19,0,19,4,1
476090,34,1,33,5,1
476090,34,1,33,20,1
476090,53,1,52,21,4
476090,53,1,52,22,1
476090,53,1,52,23,1
476090,19,0,19,24,1
476090,34,1,33,25,1
476090,34,1,33,40,1
476106,29,1,28,1,4
476106,29,1,28,2,1
476106,29,1,28,3,1
476106,7,0,7,4,1
476106,22,1,21,5,1
476106,22,1,21,20,1
476106,29,1,28,21,4
476106,29,1,28,22,1
476106,29,1,28,23,1
476106,7,0,7,24,1
476106,22,1,21,25,1
476106,22,1,21,40,1
476115,17,0,17,1,4
476115,17,0,17,2,1
476115,17,0,17,3,1
476115,6,0,6,4,1
476115,11,0,11,5,1
476115,11,0,11,20,1
476115,17,0,17,21,4
476115,17,0,17,22,1
476115,17,0,17,23,1
476115,6,0,6,24,1
476115,11,0,11,25,1
476115,11,0,11,40,1
476124,12,1,11,1,4
476124,12,1,11,2,1
476124,12,1,11,3,1
476124,1,0,1,4,1
476124,11,1,10,5,1
476124,11,1,10,20,1
476124,12,1,11,21,4
476124,12,1,11,22,1
476124,12,1,11,23,1
476124,1,0,1,24,1
476124,11,1,10,25,1
476124,11,1,10,40,1
476133,138,8,130,1,4
476133,138,8,130,2,1
476133,138,8,130,3,1
476133,43,1,42,4,1
476133,95,7,88,5,1
476133,95,7,88,20,1
476133,138,8,130,21,4
476133,138,8,130,22,1
476133,138,8,130,23,1
476133,43,1,42,24,1
476133,95,7,88,25,1
476133,95,7,88,40,1
476142,29,0,29,1,4
476142,29,0,29,2,1
476142,29,0,29,3,1
476142,13,0,13,4,1
476142,16,0,16,5,1
476142,16,0,16,20,1
476142,29,0,29,21,4
476142,29,0,29,22,1
476142,29,0,29,23,1
476142,13,0,13,24,1
476142,16,0,16,25,1
476142,16,0,16,40,1
476151,23,3,20,1,4
476151,23,3,20,2,1
476151,23,3,20,3,1
476151,11,2,9,4,1
476151,12,1,11,5,1
476151,12,1,11,20,1
476151,23,3,20,21,4
476151,23,3,20,22,1
476151,23,3,20,23,1
476151,11,2,9,24,1
476151,12,1,11,25,1
476151,12,1,11,40,1
476160,46,4,42,1,4
476160,46,4,42,2,1
476160,46,4,42,3,1
476160,17,1,16,4,1
476160,29,3,26,5,1
476160,29,3,26,20,1
476160,46,4,42,21,4
476160,46,4,42,22,1
476160,46,4,42,23,1
476160,17,1,16,24,1
476160,29,3,26,25,1
476160,29,3,26,40,1
476179,181,6,175,1,4
476179,181,6,175,2,1
476179,181,6,175,3,1
476179,80,3,77,4,1
476179,101,3,98,5,1
476179,101,3,98,20,1
476179,136,6,130,21,4
476179,136,6,130,22,1
476179,136,6,130,23,1
476179,66,3,63,24,1
476179,70,3,67,25,1
476179,70,3,67,40,1
476179,45,0,45,41,4
476179,45,0,45,42,1
476179,45,0,45,43,1
476179,14,0,14,44,1
476179,31,0,31,45,1
476179,31,0,31,60,1
476203,31,7,24,1,4
476203,31,7,24,2,1
476203,31,7,24,3,1
476203,31,7,24,5,1
476203,31,7,24,20,1
476203,31,7,24,21,4
476203,31,7,24,22,1
476203,31,7,24,23,1
476203,31,7,24,25,1
476203,31,7,24,40,1
476230,84,11,73,1,4
476230,84,11,73,2,1
476230,84,11,73,3,1
476230,33,3,30,4,1
476230,51,8,43,5,1
476230,51,8,43,20,1
476230,84,11,73,21,4
476230,84,11,73,22,1
476230,84,11,73,23,1
476230,33,3,30,24,1
476230,51,8,43,25,1
476230,51,8,43,40,1
476294,107,7,100,1,4
476294,107,7,100,2,1
476294,107,7,100,3,1
476294,16,0,16,4,1
476294,91,7,84,5,1
476294,91,7,84,20,1
476294,69,4,65,21,4
476294,69,4,65,22,1
476294,69,4,65,23,1
476294,10,0,10,24,1
476294,59,4,55,25,1
476294,59,4,55,40,1
476294,38,3,35,41,4
476294,38,3,35,42,1
476294,38,3,35,43,1
476294,6,0,6,44,1
476294,32,3,29,45,1
476294,32,3,29,60,1
476319,31,6,25,1,4
476319,31,6,25,2,1
476319,31,6,25,3,1
476319,3,0,3,4,1
476319,28,6,22,5,1
476319,5,1,4,19,1
476319,23,5,18,20,1
476319,31,6,25,21,4
476319,31,6,25,22,1
476319,31,6,25,23,1
476319,3,0,3,24,1
476319,28,6,22,25,1
476319,5,1,4,39,1
476319,23,5,18,40,1
476328,514,98,416,1,4
476328,514,98,416,2,1
476328,514,98,416,3,1
476328,105,22,83,4,1
476328,409,76,333,5,1
476328,409,76,333,20,1
476328,514,98,416,21,4
476328,514,98,416,22,1
476328,514,98,416,23,1
476328,105,22,83,24,1
476328,409,76,333,25,1
476328,409,76,333,40,1
476337,134,133,1,1,4
476337,134,133,1,2,1
476337,134,133,1,3,1
476337,52,52,0,4,1
476337,82,81,1,5,1
476337,82,81,1,20,1
476337,126,125,1,21,4
476337,126,125,1,22,1
476337,126,125,1,23,1
476337,49,49,0,24,1
476337,77,76,1,25,1
476337,77,76,1,40,1
476337,8,8,0,41,4
476337,8,8,0,42,1
476337,8,8,0,43,1
476337,3,3,0,44,1
476337,5,5,0,45,1
476337,5,5,0,60,1
476346,310,80,230,1,4
476346,310,80,230,2,1
476346,310,80,230,3,1
476346,130,29,101,4,1
476346,180,51,129,5,1
476346,180,51,129,20,1
476346,183,47,136,21,4
476346,183,47,136,22,1
476346,183,47,136,23,1
476346,74,17,57,24,1
476346,109,30,79,25,1
476346,109,30,79,40,1
476346,127,33,94,41,4
476346,127,33,94,42,1
476346,127,33,94,43,1
476346,56,12,44,44,1
476346,71,21,50,45,1
476346,71,21,50,60,1
476355,97,59,38,1,4
476355,97,59,38,2,1
476355,97,59,38,3,1
476355,97,59,38,5,1
476355,97,59,38,20,1
476355,97,59,38,21,4
476355,97,59,38,22,1
476355,97,59,38,23,1
476355,97,59,38,25,1
476355,97,59,38,40,1
476373,9,3,6,1,4
476373,9,3,6,2,1
476373,9,3,6,3,1
476373,9,3,6,5,1
476373,9,3,6,20,1
476373,9,3,6,21,4
476373,9,3,6,22,1
476373,9,3,6,23,1
476373,9,3,6,25,1
476373,9,3,6,40,1
476382,259,35,224,1,4
476382,259,35,224,2,1
476382,259,35,224,3,1
476382,79,10,69,4,1
476382,180,25,155,5,1
476382,2,1,1,19,1
476382,178,24,154,20,1
476382,259,35,224,21,4
476382,259,35,224,22,1
476382,259,35,224,23,1
476382,79,10,69,24,1
476382,180,25,155,25,1
476382,2,1,1,39,1
476382,178,24,154,40,1
476391,191,18,173,1,4
476391,191,18,173,2,1
476391,191,18,173,3,1
476391,34,4,30,4,1
476391,157,14,143,5,1
476391,73,8,65,19,1
476391,84,6,78,20,1
476391,191,18,173,21,4
476391,191,18,173,22,1
476391,191,18,173,23,1
476391,34,4,30,24,1
476391,157,14,143,25,1
476391,73,8,65,39,1
476391,84,6,78,40,1
476470,356,160,196,1,4
476470,356,160,196,2,1
476470,356,160,196,3,1
476470,102,31,71,4,1
476470,254,129,125,5,1
476470,254,129,125,20,1
476470,356,160,196,21,4
476470,356,160,196,22,1
476470,356,160,196,23,1
476470,102,31,71,24,1
476470,254,129,125,25,1
476470,254,129,125,40,1
476489,16,14,2,1,4
476489,16,14,2,2,1
476489,16,14,2,3,1
476489,13,12,1,4,1
476489,3,2,1,5,1
476489,3,2,1,20,1
476489,16,14,2,21,4
476489,16,14,2,22,1
476489,16,14,2,23,1
476489,13,12,1,24,1
476489,3,2,1,25,1
476489,3,2,1,40,1
476498,100,68,32,1,4
476498,100,68,32,2,1
476498,100,68,32,3,1
476498,27,23,4,4,1
476498,73,45,28,5,1
476498,73,45,28,20,1
476498,100,68,32,21,4
476498,100,68,32,22,1
476498,100,68,32,23,1
476498,27,23,4,24,1
476498,73,45,28,25,1
476498,73,45,28,40,1
476504,301,49,252,1,4
476504,301,49,252,2,1
476504,301,49,252,3,1
476504,185,36,149,4,1
476504,116,13,103,5,1
476504,116,13,103,20,1
476504,91,13,78,21,4
476504,91,13,78,22,1
476504,91,13,78,23,1
476504,20,7,13,24,1
476504,71,6,65,25,1
476504,71,6,65,40,1
476504,210,36,174,41,4
476504,210,36,174,42,1
476504,210,36,174,43,1
476504,165,29,136,44,1
476504,45,7,38,45,1
476504,45,7,38,60,1
476513,60,2,58,1,4
476513,60,2,58,2,1
476513,60,2,58,3,1
476513,15,1,14,4,1
476513,45,1,44,5,1
476513,45,1,44,20,1
476513,60,2,58,21,4
476513,60,2,58,22,1
476513,60,2,58,23,1
476513,15,1,14,24,1
476513,45,1,44,25,1
476513,45,1,44,40,1
476522,205,19,186,1,4
476522,205,19,186,2,1
476522,205,19,186,3,1
476522,41,7,34,4,1
476522,164,12,152,5,1
476522,164,12,152,20,1
476522,45,3,42,21,4
476522,45,3,42,22,1
476522,45,3,42,23,1
476522,19,3,16,24,1
476522,26,0,26,25,1
476522,26,0,26,40,1
476522,160,16,144,41,4
476522,160,16,144,42,1
476522,160,16,144,43,1
476522,22,4,18,44,1
476522,138,12,126,45,1
476522,138,12,126,60,1
476531,39,23,16,1,4
476531,39,23,16,2,1
476531,39,23,16,3,1
476531,8,6,2,4,1
476531,31,17,14,5,1
476531,31,17,14,20,1
476531,32,19,13,21,4
476531,32,19,13,22,1
476531,32,19,13,23,1
476531,7,5,2,24,1
476531,25,14,11,25,1
476531,25,14,11,40,1
476531,7,4,3,41,4
476531,7,4,3,42,1
476531,7,4,3,43,1
476531,1,1,0,44,1
476531,6,3,3,45,1
476531,6,3,3,60,1
476540,118,18,100,1,4
476540,118,18,100,2,1
476540,118,18,100,3,1
476540,39,6,33,4,1
476540,79,12,67,5,1
476540,79,12,67,20,1
476540,100,12,88,21,4
476540,100,12,88,22,1
476540,100,12,88,23,1
476540,28,3,25,24,1
476540,72,9,63,25,1
476540,72,9,63,40,1
476540,18,6,12,41,4
476540,18,6,12,42,1
476540,18,6,12,43,1
476540,11,3,8,44,1
476540,7,3,4,45,1
476540,7,3,4,60,1
476559,137,11,126,1,4
476559,137,11,126,2,1
476559,137,11,126,3,1
476559,105,4,101,4,1
476559,32,7,25,5,1
476559,32,7,25,20,1
476559,104,7,97,21,4
476559,104,7,97,22,1
476559,104,7,97,23,1
476559,78,3,75,24,1
476559,26,4,22,25,1
476559,26,4,22,40,1
476559,33,4,29,41,4
476559,33,4,29,42,1
476559,33,4,29,43,1
476559,27,1,26,44,1
476559,6,3,3,45,1
476559,6,3,3,60,1
476568,18,14,4,1,4
476568,18,14,4,2,1
476568,18,14,4,3,1
476568,12,9,3,4,1
476568,6,5,1,5,1
476568,6,5,1,20,1
476568,18,14,4,21,4
476568,18,14,4,22,1
476568,18,14,4,23,1
476568,12,9,3,24,1
476568,6,5,1,25,1
476568,6,5,1,40,1
476577,80,31,49,1,4
476577,80,31,49,2,1
476577,80,31,49,3,1
476577,35,11,24,4,1
476577,45,20,25,5,1
476577,45,20,25,20,1
476577,80,31,49,21,4
476577,80,31,49,22,1
476577,80,31,49,23,1
476577,35,11,24,24,1
476577,45,20,25,25,1
476577,45,20,25,40,1
476586,75,0,75,1,4
476586,75,0,75,2,1
476586,75,0,75,3,1
476586,10,0,10,4,1
476586,65,0,65,5,1
476586,65,0,65,20,1
476586,48,0,48,21,4
476586,48,0,48,22,1
476586,48,0,48,23,1
476586,6,0,6,24,1
476586,42,0,42,25,1
476586,42,0,42,40,1
476586,27,0,27,41,4
476586,27,0,27,42,1
476586,27,0,27,43,1
476586,4,0,4,44,1
476586,23,0,23,45,1
476586,23,0,23,60,1
476595,65,16,49,1,4
476595,65,16,49,2,1
476595,65,16,49,3,1
476595,59,15,44,4,1
476595,6,1,5,5,1
476595,6,1,5,20,1
476595,25,9,16,21,4
476595,25,9,16,22,1
476595,25,9,16,23,1
476595,23,8,15,24,1
476595,2,1,1,25,1
476595,2,1,1,40,1
476595,40,7,33,41,4
476595,40,7,33,42,1
476595,40,7,33,43,1
476595,36,7,29,44,1
476595,4,0,4,45,1
476595,4,0,4,60,1
476601,49,49,0,1,4
476601,49,49,0,2,1
476601,49,49,0,3,1
476601,24,24,0,4,1
476601,25,25,0,5,1
476601,1,1,0,19,1
476601,24,24,0,20,1
476601,49,49,0,21,4
476601,49,49,0,22,1
476601,49,49,0,23,1
476601,24,24,0,24,1
476601,25,25,0,25,1
476601,1,1,0,39,1
476601,24,24,0,40,1
476610,75,65,10,1,4
476610,75,65,10,2,1
476610,75,65,10,3,1
476610,23,19,4,4,1
476610,52,46,6,5,1
476610,52,46,6,20,1
476610,75,65,10,21,4
476610,75,65,10,22,1
476610,75,65,10,23,1
476610,23,19,4,24,1
476610,52,46,6,25,1
476610,52,46,6,40,1
476629,116,4,112,1,4
476629,116,4,112,2,1
476629,116,4,112,3,1
476629,62,3,59,4,1
476629,54,1,53,5,1
476629,54,1,53,20,1
476629,116,4,112,21,4
476629,116,4,112,22,1
476629,116,4,112,23,1
476629,62,3,59,24,1
476629,54,1,53,25,1
476629,54,1,53,40,1
476638,21,1,20,1,4
476638,21,1,20,2,1
476638,21,1,20,3,1
476638,10,0,10,4,1
476638,11,1,10,5,1
476638,11,1,10,20,1
476638,21,1,20,21,4
476638,21,1,20,22,1
476638,21,1,20,23,1
476638,10,0,10,24,1
476638,11,1,10,25,1
476638,11,1,10,40,1
476656,9,2,7,1,4
476656,9,2,7,2,1
476656,9,2,7,3,1
476656,8,2,6,4,1
476656,1,0,1,5,1
476656,1,0,1,20,1
476656,9,2,7,21,4
476656,9,2,7,22,1
476656,9,2,7,23,1
476656,8,2,6,24,1
476656,1,0,1,25,1
476656,1,0,1,40,1
476674,65,5,60,1,4
476674,65,5,60,2,1
476674,65,5,60,3,1
476674,16,2,14,4,1
476674,49,3,46,5,1
476674,49,3,46,20,1
476674,65,5,60,21,4
476674,65,5,60,22,1
476674,65,5,60,23,1
476674,16,2,14,24,1
476674,49,3,46,25,1
476674,49,3,46,40,1
476683,188,9,179,1,4
476683,188,9,179,2,1
476683,188,9,179,3,1
476683,58,2,56,4,1
476683,130,7,123,5,1
476683,130,7,123,20,1
476683,188,9,179,21,4
476683,188,9,179,22,1
476683,188,9,179,23,1
476683,58,2,56,24,1
476683,130,7,123,25,1
476683,130,7,123,40,1
476692,23,23,0,1,4
476692,23,23,0,2,1
476692,23,23,0,3,1
476692,3,3,0,4,1
476692,20,20,0,5,1
476692,3,3,0,19,1
476692,17,17,0,20,1
476692,23,23,0,21,4
476692,23,23,0,22,1
476692,23,23,0,23,1
476692,3,3,0,24,1
476692,20,20,0,25,1
476692,3,3,0,39,1
476692,17,17,0,40,1
476708,101,74,27,1,4
476708,101,74,27,2,1
476708,101,74,27,3,1
476708,23,15,8,4,1
476708,78,59,19,5,1
476708,78,59,19,20,1
476708,63,47,16,21,4
476708,63,47,16,22,1
476708,63,47,16,23,1
476708,15,9,6,24,1
476708,48,38,10,25,1
476708,48,38,10,40,1
476708,38,27,11,41,4
476708,38,27,11,42,1
476708,38,27,11,43,1
476708,8,6,2,44,1
476708,30,21,9,45,1
476708,30,21,9,60,1
476717,298,298,0,1,4
476717,298,298,0,2,1
476717,298,298,0,3,1
476717,101,101,0,4,1
476717,197,197,0,5,1
476717,197,197,0,20,1
476717,298,298,0,21,4
476717,298,298,0,22,1
476717,298,298,0,23,1
476717,101,101,0,24,1
476717,197,197,0,25,1
476717,197,197,0,40,1
476726,223,47,176,1,4
476726,223,47,176,2,1
476726,223,47,176,3,1
476726,103,17,86,4,1
476726,120,30,90,5,1
476726,120,30,90,20,1
476726,223,47,176,21,4
476726,223,47,176,22,1
476726,223,47,176,23,1
476726,103,17,86,24,1
476726,120,30,90,25,1
476726,120,30,90,40,1
476735,29,1,28,1,4
476735,29,1,28,2,1
476735,29,1,28,3,1
476735,17,1,16,4,1
476735,12,0,12,5,1
476735,12,0,12,20,1
476735,29,1,28,21,4
476735,29,1,28,22,1
476735,29,1,28,23,1
476735,17,1,16,24,1
476735,12,0,12,25,1
476735,12,0,12,40,1
476744,48,2,46,1,4
476744,48,2,46,2,1
476744,48,2,46,3,1
476744,10,1,9,4,1
476744,38,1,37,5,1
476744,38,1,37,20,1
476744,17,1,16,21,4
476744,17,1,16,22,1
476744,17,1,16,23,1
476744,5,1,4,24,1
476744,12,0,12,25,1
476744,12,0,12,40,1
476744,31,1,30,41,4
476744,31,1,30,42,1
476744,31,1,30,43,1
476744,5,0,5,44,1
476744,26,1,25,45,1
476744,26,1,25,60,1
476753,118,6,112,1,4
476753,118,6,112,2,1
476753,118,6,112,3,1
476753,11,0,11,4,1
476753,107,6,101,5,1
476753,107,6,101,20,1
476753,99,5,94,21,4
476753,99,5,94,22,1
476753,99,5,94,23,1
476753,11,0,11,24,1
476753,88,5,83,25,1
476753,88,5,83,40,1
476753,19,1,18,41,4
476753,19,1,18,42,1
476753,19,1,18,43,1
476753,19,1,18,45,1
476753,19,1,18,60,1
476762,61,3,58,1,4
476762,61,3,58,2,1
476762,61,3,58,3,1
476762,13,0,13,4,1
476762,48,3,45,5,1
476762,48,3,45,20,1
476762,61,3,58,21,4
476762,61,3,58,22,1
476762,61,3,58,23,1
476762,13,0,13,24,1
476762,48,3,45,25,1
476762,48,3,45,40,1
476771,24,19,5,1,4
476771,24,19,5,2,1
476771,24,19,5,3,1
476771,9,4,5,4,1
476771,15,15,0,5,1
476771,15,15,0,20,1
476771,17,14,3,21,4
476771,17,14,3,22,1
476771,17,14,3,23,1
476771,5,2,3,24,1
476771,12,12,0,25,1
476771,12,12,0,40,1
476771,7,5,2,41,4
476771,7,5,2,42,1
476771,7,5,2,43,1
476771,4,2,2,44,1
476771,3,3,0,45,1
476771,3,3,0,60,1
476780,122,24,98,1,4
476780,122,24,98,2,1
476780,122,24,98,3,1
476780,73,16,57,4,1
476780,49,8,41,5,1
476780,49,8,41,20,1
476780,62,16,46,21,4
476780,62,16,46,22,1
476780,62,16,46,23,1
476780,47,12,35,24,1
476780,15,4,11,25,1
476780,15,4,11,40,1
476780,60,8,52,41,4
476780,60,8,52,42,1
476780,60,8,52,43,1
476780,26,4,22,44,1
476780,34,4,30,45,1
476780,34,4,30,60,1
476799,73,13,60,1,4
476799,73,13,60,2,1
476799,73,13,60,3,1
476799,73,13,60,5,1
476799,73,13,60,20,1
476799,73,13,60,21,4
476799,73,13,60,22,1
476799,73,13,60,23,1
476799,73,13,60,25,1
476799,73,13,60,40,1
476805,65,0,65,1,4
476805,65,0,65,2,1
476805,65,0,65,3,1
476805,7,0,7,4,1
476805,58,0,58,5,1
476805,58,0,58,20,1
476805,65,0,65,21,4
476805,65,0,65,22,1
476805,65,0,65,23,1
476805,7,0,7,24,1
476805,58,0,58,25,1
476805,58,0,58,40,1
476814,152,133,19,1,4
476814,152,133,19,2,1
476814,152,133,19,3,1
476814,10,9,1,4,1
476814,142,124,18,5,1
476814,142,124,18,20,1
476814,152,133,19,41,4
476814,152,133,19,42,1
476814,152,133,19,43,1
476814,10,9,1,44,1
476814,142,124,18,45,1
476814,142,124,18,60,1
476823,46,2,44,1,4
476823,46,2,44,2,1
476823,46,2,44,3,1
476823,5,1,4,4,1
476823,41,1,40,5,1
476823,41,1,40,20,1
476823,42,1,41,21,4
476823,42,1,41,22,1
476823,42,1,41,23,1
476823,5,1,4,24,1
476823,37,0,37,25,1
476823,37,0,37,40,1
476823,4,1,3,41,4
476823,4,1,3,42,1
476823,4,1,3,43,1
476823,4,1,3,45,1
476823,4,1,3,60,1
476832,41,1,40,1,4
476832,41,1,40,2,1
476832,41,1,40,3,1
476832,6,1,5,4,1
476832,35,0,35,5,1
476832,35,0,35,20,1
476832,34,0,34,21,4
476832,34,0,34,22,1
476832,34,0,34,23,1
476832,4,0,4,24,1
476832,30,0,30,25,1
476832,30,0,30,40,1
476832,7,1,6,41,4
476832,7,1,6,42,1
476832,7,1,6,43,1
476832,2,1,1,44,1
476832,5,0,5,45,1
476832,5,0,5,60,1
476841,211,24,187,1,4
476841,211,24,187,2,1
476841,211,24,187,3,1
476841,25,5,20,4,1
476841,186,19,167,5,1
476841,186,19,167,20,1
476841,154,20,134,21,4
476841,154,20,134,22,1
476841,154,20,134,23,1
476841,21,5,16,24,1
476841,133,15,118,25,1
476841,133,15,118,40,1
476841,57,4,53,41,4
476841,57,4,53,42,1
476841,57,4,53,43,1
476841,4,0,4,44,1
476841,53,4,49,45,1
476841,53,4,49,60,1
476850,91,64,27,1,4
476850,91,64,27,2,1
476850,91,64,27,3,1
476850,90,63,27,4,1
476850,1,1,0,5,1
476850,1,1,0,20,1
476850,91,64,27,21,4
476850,91,64,27,22,1
476850,91,64,27,23,1
476850,90,63,27,24,1
476850,1,1,0,25,1
476850,1,1,0,40,1
476869,193,6,187,1,4
476869,193,6,187,2,1
476869,193,6,187,3,1
476869,155,5,150,4,1
476869,38,1,37,5,1
476869,38,1,37,20,1
476869,193,6,187,21,4
476869,193,6,187,22,1
476869,193,6,187,23,1
476869,155,5,150,24,1
476869,38,1,37,25,1
476869,38,1,37,40,1
476878,79,1,78,1,4
476878,79,1,78,2,1
476878,79,1,78,3,1
476878,55,1,54,4,1
476878,24,0,24,5,1
476878,24,0,24,20,1
476878,27,0,27,21,4
476878,27,0,27,22,1
476878,27,0,27,23,1
476878,16,0,16,24,1
476878,11,0,11,25,1
476878,11,0,11,40,1
476878,52,1,51,41,4
476878,52,1,51,42,1
476878,52,1,51,43,1
476878,39,1,38,44,1
476878,13,0,13,45,1
476878,13,0,13,60,1
476887,133,0,133,1,4
476887,133,0,133,2,1
476887,133,0,133,3,1
476887,29,0,29,4,1
476887,104,0,104,5,1
476887,104,0,104,20,1
476887,62,0,62,21,4
476887,62,0,62,22,1
476887,62,0,62,23,1
476887,19,0,19,24,1
476887,43,0,43,25,1
476887,43,0,43,40,1
476887,71,0,71,41,4
476887,71,0,71,42,1
476887,71,0,71,43,1
476887,10,0,10,44,1
476887,61,0,61,45,1
476887,61,0,61,60,1
476896,99,8,91,1,4
476896,99,8,91,2,1
476896,99,8,91,3,1
476896,20,0,20,4,1
476896,79,8,71,5,1
476896,79,8,71,20,1
476896,99,8,91,21,4
476896,99,8,91,22,1
476896,99,8,91,23,1
476896,20,0,20,24,1
476896,79,8,71,25,1
476896,79,8,71,40,1
476902,36,4,32,1,4
476902,36,4,32,2,1
476902,36,4,32,3,1
476902,10,1,9,4,1
476902,26,3,23,5,1
476902,26,3,23,20,1
476902,27,2,25,21,4
476902,27,2,25,22,1
476902,27,2,25,23,1
476902,9,1,8,24,1
476902,18,1,17,25,1
476902,18,1,17,40,1
476902,9,2,7,41,4
476902,9,2,7,42,1
476902,9,2,7,43,1
476902,1,0,1,44,1
476902,8,2,6,45,1
476902,8,2,6,60,1
476911,225,204,21,1,4
476911,225,204,21,2,1
476911,225,204,21,3,1
476911,196,178,18,4,1
476911,29,26,3,5,1
476911,29,26,3,20,1
476911,143,128,15,21,4
476911,143,128,15,22,1
476911,143,128,15,23,1
476911,121,108,13,24,1
476911,22,20,2,25,1
476911,22,20,2,40,1
476911,82,76,6,41,4
476911,82,76,6,42,1
476911,82,76,6,43,1
476911,75,70,5,44,1
476911,7,6,1,45,1
476911,7,6,1,60,1
476939,87,9,78,1,4
476939,87,9,78,2,1
476939,87,9,78,3,1
476939,32,2,30,4,1
476939,55,7,48,5,1
476939,55,7,48,20,1
476939,87,9,78,41,4
476939,87,9,78,42,1
476939,87,9,78,43,1
476939,32,2,30,44,1
476939,55,7,48,45,1
476939,55,7,48,60,1
476948,218,194,24,1,4
476948,218,194,24,2,1
476948,218,194,24,3,1
476948,77,66,11,4,1
476948,141,128,13,5,1
476948,60,51,9,19,1
476948,81,77,4,20,1
476948,210,187,23,21,4
476948,210,187,23,22,1
476948,210,187,23,23,1
476948,77,66,11,24,1
476948,133,121,12,25,1
476948,60,51,9,39,1
476948,73,70,3,40,1
476948,8,7,1,41,4
476948,8,7,1,42,1
476948,8,7,1,43,1
476948,8,7,1,45,1
476948,8,7,1,60,1
476957,20,0,20,1,4
476957,20,0,20,2,1
476957,20,0,20,3,1
476957,8,0,8,4,1
476957,12,0,12,5,1
476957,12,0,12,20,1
476957,20,0,20,21,4
476957,20,0,20,22,1
476957,20,0,20,23,1
476957,8,0,8,24,1
476957,12,0,12,25,1
476957,12,0,12,40,1
476966,233,219,14,1,4
476966,233,219,14,2,1
476966,233,219,14,3,1
476966,193,184,9,4,1
476966,40,35,5,5,1
476966,40,35,5,20,1
476966,233,219,14,21,4
476966,233,219,14,22,1
476966,233,219,14,23,1
476966,193,184,9,24,1
476966,40,35,5,25,1
476966,40,35,5,40,1
476975,7402,3552,3850,1,4
476975,5578,2798,2780,2,1
476975,5282,2638,2644,3,1
476975,5282,2638,2644,5,1
476975,296,160,136,11,1
476975,1824,754,1070,12,3
476975,1930,942,988,19,1
476975,3352,1696,1656,20,1
476975,3092,1411,1681,21,4
476975,2377,1125,1252,22,1
476975,2358,1114,1244,23,1
476975,2358,1114,1244,25,1
476975,19,11,8,31,1
476975,715,286,429,32,3
476975,764,334,430,39,1
476975,1594,780,814,40,1
476975,4310,2141,2169,41,4
476975,3201,1673,1528,42,1
476975,2924,1524,1400,43,1
476975,2924,1524,1400,45,1
476975,277,149,128,51,1
476975,1109,468,641,52,3
476975,1166,608,558,59,1
476975,1758,916,842,60,1
476984,157,9,148,1,4
476984,157,9,148,2,1
476984,157,9,148,3,1
476984,8,0,8,4,1
476984,149,9,140,5,1
476984,149,9,140,20,1
476984,121,7,114,21,4
476984,121,7,114,22,1
476984,121,7,114,23,1
476984,7,0,7,24,1
476984,114,7,107,25,1
476984,114,7,107,40,1
476984,36,2,34,41,4
476984,36,2,34,42,1
476984,36,2,34,43,1
476984,1,0,1,44,1
476984,35,2,33,45,1
476984,35,2,33,60,1
476993,130,0,130,1,4
476993,130,0,130,2,1
476993,130,0,130,3,1
476993,21,0,21,4,1
476993,109,0,109,5,1
476993,109,0,109,20,1
476993,118,0,118,21,4
476993,118,0,118,22,1
476993,118,0,118,23,1
476993,20,0,20,24,1
476993,98,0,98,25,1
476993,98,0,98,40,1
476993,12,0,12,41,4
476993,12,0,12,42,1
476993,12,0,12,43,1
476993,1,0,1,44,1
476993,11,0,11,45,1
476993,11,0,11,60,1
477002,55,1,54,1,4
477002,55,1,54,2,1
477002,55,1,54,3,1
477002,25,1,24,4,1
477002,30,0,30,5,1
477002,30,0,30,20,1
477002,35,1,34,21,4
477002,35,1,34,22,1
477002,35,1,34,23,1
477002,13,1,12,24,1
477002,22,0,22,25,1
477002,22,0,22,40,1
477002,20,0,20,41,4
477002,20,0,20,42,1
477002,20,0,20,43,1
477002,12,0,12,44,1
477002,8,0,8,45,1
477002,8,0,8,60,1
477011,135,61,74,1,4
477011,110,51,59,2,1
477011,110,51,59,3,1
477011,21,7,14,4,1
477011,89,44,45,5,1
477011,25,10,15,12,3
477011,12,7,5,19,1
477011,77,37,40,20,1
477011,18,7,11,21,4
477011,9,4,5,22,1
477011,9,4,5,23,1
477011,2,2,0,24,1
477011,7,2,5,25,1
477011,9,3,6,32,3
477011,7,2,5,40,1
477011,117,54,63,41,4
477011,101,47,54,42,1
477011,101,47,54,43,1
477011,19,5,14,44,1
477011,82,42,40,45,1
477011,16,7,9,52,3
477011,12,7,5,59,1
477011,70,35,35,60,1
477020,222,92,130,1,4
477020,160,74,86,2,1
477020,160,74,86,3,1
477020,30,17,13,4,1
477020,130,57,73,5,1
477020,62,18,44,12,3
477020,20,8,12,19,1
477020,110,49,61,20,1
477020,26,13,13,21,4
477020,13,8,5,22,1
477020,13,8,5,23,1
477020,2,2,0,24,1
477020,11,6,5,25,1
477020,13,5,8,32,3
477020,2,2,0,39,1
477020,9,4,5,40,1
477020,196,79,117,41,4
477020,147,66,81,42,1
477020,147,66,81,43,1
477020,28,15,13,44,1
477020,119,51,68,45,1
477020,49,13,36,52,3
477020,18,6,12,59,1
477020,101,45,56,60,1
477039,320,42,278,1,4
477039,320,42,278,2,1
477039,320,42,278,3,1
477039,320,42,278,5,1
477039,48,6,42,19,1
477039,272,36,236,20,1
477039,294,40,254,21,4
477039,294,40,254,22,1
477039,294,40,254,23,1
477039,294,40,254,25,1
477039,43,5,38,39,1
477039,251,35,216,40,1
477039,26,2,24,41,4
477039,26,2,24,42,1
477039,26,2,24,43,1
477039,26,2,24,45,1
477039,5,1,4,59,1
477039,21,1,20,60,1
477950,168,63,105,1,4
477950,168,63,105,2,1
477950,168,63,105,3,1
477950,8,2,6,4,1
477950,160,61,99,5,1
477950,25,8,17,19,1
477950,135,53,82,20,1
477950,168,63,105,21,4
477950,168,63,105,22,1
477950,168,63,105,23,1
477950,8,2,6,24,1
477950,160,61,99,25,1
477950,25,8,17,39,1
477950,135,53,82,40,1
477996,227,75,152,1,4
477996,227,75,152,2,1
477996,217,67,150,3,1
477996,30,12,18,4,1
477996,187,55,132,5,1
477996,10,8,2,11,1
477996,55,14,41,19,1
477996,132,41,91,20,1
477996,7,3,4,21,4
477996,7,3,4,22,1
477996,6,3,3,23,1
477996,6,3,3,25,1
477996,1,0,1,31,1
477996,6,3,3,40,1
477996,220,72,148,41,4
477996,220,72,148,42,1
477996,211,64,147,43,1
477996,30,12,18,44,1
477996,181,52,129,45,1
477996,9,8,1,51,1
477996,55,14,41,59,1
477996,126,38,88,60,1
478005,161,49,112,1,4
478005,161,49,112,2,1
478005,161,49,112,3,1
478005,17,4,13,4,1
478005,144,45,99,5,1
478005,36,10,26,19,1
478005,108,35,73,20,1
478005,8,5,3,21,4
478005,8,5,3,22,1
478005,8,5,3,23,1
478005,8,5,3,25,1
478005,3,3,0,39,1
478005,5,2,3,40,1
478005,153,44,109,41,4
478005,153,44,109,42,1
478005,153,44,109,43,1
478005,17,4,13,44,1
478005,136,40,96,45,1
478005,33,7,26,59,1
478005,103,33,70,60,1
478014,189,47,142,1,4
478014,189,47,142,2,1
478014,189,47,142,3,1
478014,30,8,22,4,1
478014,159,39,120,5,1
478014,101,26,75,19,1
478014,58,13,45,20,1
478014,12,7,5,21,4
478014,12,7,5,22,1
478014,12,7,5,23,1
478014,12,7,5,25,1
478014,9,5,4,39,1
478014,3,2,1,40,1
478014,177,40,137,41,4
478014,177,40,137,42,1
478014,177,40,137,43,1
478014,30,8,22,44,1
478014,147,32,115,45,1
478014,92,21,71,59,1
478014,55,11,44,60,1
478582,164,10,154,1,4
478582,164,10,154,2,1
478582,164,10,154,3,1
478582,42,5,37,4,1
478582,122,5,117,5,1
478582,122,5,117,20,1
478582,120,7,113,21,4
478582,120,7,113,22,1
478582,120,7,113,23,1
478582,31,4,27,24,1
478582,89,3,86,25,1
478582,89,3,86,40,1
478582,44,3,41,41,4
478582,44,3,41,42,1
478582,44,3,41,43,1
478582,11,1,10,44,1
478582,33,2,31,45,1
478582,33,2,31,60,1
478591,151,4,147,1,4
478591,151,4,147,2,1
478591,151,4,147,3,1
478591,56,1,55,4,1
478591,95,3,92,5,1
478591,95,3,92,20,1
478591,90,3,87,21,4
478591,90,3,87,22,1
478591,90,3,87,23,1
478591,37,1,36,24,1
478591,53,2,51,25,1
478591,53,2,51,40,1
478591,61,1,60,41,4
478591,61,1,60,42,1
478591,61,1,60,43,1
478591,19,0,19,44,1
478591,42,1,41,45,1
478591,42,1,41,60,1
478616,111,5,106,1,4
478616,111,5,106,2,1
478616,111,5,106,3,1
478616,36,3,33,4,1
478616,75,2,73,5,1
478616,75,2,73,20,1
478616,96,5,91,21,4
478616,96,5,91,22,1
478616,96,5,91,23,1
478616,32,3,29,24,1
478616,64,2,62,25,1
478616,64,2,62,40,1
478616,15,0,15,41,4
478616,15,0,15,42,1
478616,15,0,15,43,1
478616,4,0,4,44,1
478616,11,0,11,45,1
478616,11,0,11,60,1
478625,203,77,126,1,4
478625,203,77,126,2,1
478625,203,77,126,3,1
478625,54,20,34,4,1
478625,149,57,92,5,1
478625,149,57,92,20,1
478625,203,77,126,21,4
478625,203,77,126,22,1
478625,203,77,126,23,1
478625,54,20,34,24,1
478625,149,57,92,25,1
478625,149,57,92,40,1
478634,269,115,154,1,4
478634,269,115,154,2,1
478634,269,115,154,3,1
478634,51,22,29,4,1
478634,218,93,125,5,1
478634,218,93,125,20,1
478634,269,115,154,21,4
478634,269,115,154,22,1
478634,269,115,154,23,1
478634,51,22,29,24,1
478634,218,93,125,25,1
478634,218,93,125,40,1
478643,28,24,4,1,4
478643,28,24,4,2,1
478643,28,24,4,3,1
478643,25,21,4,4,1
478643,3,3,0,5,1
478643,3,3,0,20,1
478643,28,24,4,21,4
478643,28,24,4,22,1
478643,28,24,4,23,1
478643,25,21,4,24,1
478643,3,3,0,25,1
478643,3,3,0,40,1
478661,214,23,191,1,4
478661,214,23,191,2,1
478661,214,23,191,3,1
478661,171,18,153,4,1
478661,43,5,38,5,1
478661,43,5,38,20,1
478661,133,18,115,21,4
478661,133,18,115,22,1
478661,133,18,115,23,1
478661,106,15,91,24,1
478661,27,3,24,25,1
478661,27,3,24,40,1
478661,81,5,76,41,4
478661,81,5,76,42,1
478661,81,5,76,43,1
478661,65,3,62,44,1
478661,16,2,14,45,1
478661,16,2,14,60,1
478917,63,0,63,1,4
478917,63,0,63,2,1
478917,63,0,63,3,1
478917,41,0,41,4,1
478917,22,0,22,5,1
478917,22,0,22,20,1
478917,63,0,63,21,4
478917,63,0,63,22,1
478917,63,0,63,23,1
478917,41,0,41,24,1
478917,22,0,22,25,1
478917,22,0,22,40,1
478953,216,11,205,1,4
478953,216,11,205,2,1
478953,216,11,205,3,1
478953,32,1,31,4,1
478953,184,10,174,5,1
478953,184,10,174,20,1
478953,184,8,176,21,4
478953,184,8,176,22,1
478953,184,8,176,23,1
478953,30,1,29,24,1
478953,154,7,147,25,1
478953,154,7,147,40,1
478953,32,3,29,41,4
478953,32,3,29,42,1
478953,32,3,29,43,1
478953,2,0,2,44,1
478953,30,3,27,45,1
478953,30,3,27,60,1
479053,102,14,88,1,4
479053,102,14,88,2,1
479053,102,14,88,3,1
479053,34,6,28,4,1
479053,68,8,60,5,1
479053,68,8,60,20,1
479053,46,8,38,21,4
479053,46,8,38,22,1
479053,46,8,38,23,1
479053,18,4,14,24,1
479053,28,4,24,25,1
479053,28,4,24,40,1
479053,56,6,50,41,4
479053,56,6,50,42,1
479053,56,6,50,43,1
479053,16,2,14,44,1
479053,40,4,36,45,1
479053,40,4,36,60,1
479062,10,10,0,1,4
479062,10,10,0,2,1
479062,10,10,0,3,1
479062,8,8,0,4,1
479062,2,2,0,5,1
479062,2,2,0,20,1
479062,10,10,0,21,4
479062,10,10,0,22,1
479062,10,10,0,23,1
479062,8,8,0,24,1
479062,2,2,0,25,1
479062,2,2,0,40,1
479123,19,1,18,1,4
479123,19,1,18,2,1
479123,19,1,18,3,1
479123,11,0,11,4,1
479123,8,1,7,5,1
479123,8,1,7,20,1
479123,19,1,18,21,4
479123,19,1,18,22,1
479123,19,1,18,23,1
479123,11,0,11,24,1
479123,8,1,7,25,1
479123,8,1,7,40,1
479248,147,55,92,1,4
479248,147,55,92,2,1
479248,147,55,92,3,1
479248,105,41,64,4,1
479248,42,14,28,5,1
479248,42,14,28,20,1
479248,127,49,78,21,4
479248,127,49,78,22,1
479248,127,49,78,23,1
479248,89,36,53,24,1
479248,38,13,25,25,1
479248,38,13,25,40,1
479248,20,6,14,41,4
479248,20,6,14,42,1
479248,20,6,14,43,1
479248,16,5,11,44,1
479248,4,1,3,45,1
479248,4,1,3,60,1
479424,88,12,76,1,4
479424,88,12,76,2,1
479424,88,12,76,3,1
479424,88,12,76,5,1
479424,88,12,76,20,1
479424,88,12,76,21,4
479424,88,12,76,22,1
479424,88,12,76,23,1
479424,88,12,76,25,1
479424,88,12,76,40,1
479549,559,458,101,1,4
479549,559,458,101,2,1
479549,559,458,101,3,1
479549,181,146,35,4,1
479549,378,312,66,5,1
479549,11,8,3,19,1
479549,367,304,63,20,1
479549,499,411,88,21,4
479549,499,411,88,22,1
479549,499,411,88,23,1
479549,160,131,29,24,1
479549,339,280,59,25,1
479549,8,7,1,39,1
479549,331,273,58,40,1
479549,60,47,13,41,4
479549,60,47,13,42,1
479549,60,47,13,43,1
479549,21,15,6,44,1
479549,39,32,7,45,1
479549,3,1,2,59,1
479549,36,31,5,60,1
479558,312,270,42,1,4
479558,312,270,42,2,1
479558,312,270,42,3,1
479558,79,68,11,4,1
479558,233,202,31,5,1
479558,19,17,2,19,1
479558,214,185,29,20,1
479558,269,238,31,21,4
479558,269,238,31,22,1
479558,269,238,31,23,1
479558,70,61,9,24,1
479558,199,177,22,25,1
479558,19,17,2,39,1
479558,180,160,20,40,1
479558,43,32,11,41,4
479558,43,32,11,42,1
479558,43,32,11,43,1
479558,9,7,2,44,1
479558,34,25,9,45,1
479558,34,25,9,60,1
479567,50,40,10,1,4
479567,50,40,10,2,1
479567,50,40,10,3,1
479567,50,40,10,5,1
479567,50,40,10,20,1
479567,44,36,8,21,4
479567,44,36,8,22,1
479567,44,36,8,23,1
479567,44,36,8,25,1
479567,44,36,8,40,1
479567,6,4,2,41,4
479567,6,4,2,42,1
479567,6,4,2,43,1
479567,6,4,2,45,1
479567,6,4,2,60,1
479576,51,48,3,1,4
479576,51,48,3,2,1
479576,51,48,3,3,1
479576,51,48,3,5,1
479576,51,48,3,20,1
479576,44,41,3,21,4
479576,44,41,3,22,1
479576,44,41,3,23,1
479576,44,41,3,25,1
479576,44,41,3,40,1
479576,7,7,0,41,4
479576,7,7,0,42,1
479576,7,7,0,43,1
479576,7,7,0,45,1
479576,7,7,0,60,1
479585,143,116,27,1,4
479585,143,116,27,2,1
479585,143,116,27,3,1
479585,49,40,9,4,1
479585,94,76,18,5,1
479585,2,2,0,19,1
479585,92,74,18,20,1
479585,117,96,21,21,4
479585,117,96,21,22,1
479585,117,96,21,23,1
479585,42,35,7,24,1
479585,75,61,14,25,1
479585,2,2,0,39,1
479585,73,59,14,40,1
479585,26,20,6,41,4
479585,26,20,6,42,1
479585,26,20,6,43,1
479585,7,5,2,44,1
479585,19,15,4,45,1
479585,19,15,4,60,1
479594,274,183,91,1,4
479594,274,183,91,2,1
479594,274,183,91,3,1
479594,51,36,15,4,1
479594,223,147,76,5,1
479594,6,2,4,19,1
479594,217,145,72,20,1
479594,220,156,64,21,4
479594,220,156,64,22,1
479594,220,156,64,23,1
479594,48,33,15,24,1
479594,172,123,49,25,1
479594,4,1,3,39,1
479594,168,122,46,40,1
479594,54,27,27,41,4
479594,54,27,27,42,1
479594,54,27,27,43,1
479594,3,3,0,44,1
479594,51,24,27,45,1
479594,2,1,1,59,1
479594,49,23,26,60,1
479600,191,164,27,1,4
479600,191,164,27,2,1
479600,191,164,27,3,1
479600,49,39,10,4,1
479600,142,125,17,5,1
479600,3,3,0,19,1
479600,139,122,17,20,1
479600,163,140,23,21,4
479600,163,140,23,22,1
479600,163,140,23,23,1
479600,42,32,10,24,1
479600,121,108,13,25,1
479600,3,3,0,39,1
479600,118,105,13,40,1
479600,28,24,4,41,4
479600,28,24,4,42,1
479600,28,24,4,43,1
479600,7,7,0,44,1
479600,21,17,4,45,1
479600,21,17,4,60,1
479619,72,42,30,1,4
479619,72,42,30,2,1
479619,72,42,30,3,1
479619,72,42,30,5,1
479619,2,1,1,19,1
479619,70,41,29,20,1
479619,54,38,16,21,4
479619,54,38,16,22,1
479619,54,38,16,23,1
479619,54,38,16,25,1
479619,1,1,0,39,1
479619,53,37,16,40,1
479619,18,4,14,41,4
479619,18,4,14,42,1
479619,18,4,14,43,1
479619,18,4,14,45,1
479619,1,0,1,59,1
479619,17,4,13,60,1
479628,337,250,87,1,4
479628,337,250,87,2,1
479628,337,250,87,3,1
479628,90,67,23,4,1
479628,247,183,64,5,1
479628,3,3,0,19,1
479628,244,180,64,20,1
479628,260,202,58,21,4
479628,260,202,58,22,1
479628,260,202,58,23,1
479628,77,58,19,24,1
479628,183,144,39,25,1
479628,3,3,0,39,1
479628,180,141,39,40,1
479628,77,48,29,41,4
479628,77,48,29,42,1
479628,77,48,29,43,1
479628,13,9,4,44,1
479628,64,39,25,45,1
479628,64,39,25,60,1
479637,155,115,40,1,4
479637,155,115,40,2,1
479637,155,115,40,3,1
479637,44,37,7,4,1
479637,111,78,33,5,1
479637,5,3,2,19,1
479637,106,75,31,20,1
479637,133,98,35,21,4
479637,133,98,35,22,1
479637,133,98,35,23,1
479637,41,34,7,24,1
479637,92,64,28,25,1
479637,3,2,1,39,1
479637,89,62,27,40,1
479637,22,17,5,41,4
479637,22,17,5,42,1
479637,22,17,5,43,1
479637,3,3,0,44,1
479637,19,14,5,45,1
479637,2,1,1,59,1
479637,17,13,4,60,1
479646,171,137,34,1,4
479646,171,137,34,2,1
479646,171,137,34,3,1
479646,47,36,11,4,1
479646,124,101,23,5,1
479646,4,2,2,19,1
479646,120,99,21,20,1
479646,123,107,16,21,4
479646,123,107,16,22,1
479646,123,107,16,23,1
479646,37,30,7,24,1
479646,86,77,9,25,1
479646,3,2,1,39,1
479646,83,75,8,40,1
479646,48,30,18,41,4
479646,48,30,18,42,1
479646,48,30,18,43,1
479646,10,6,4,44,1
479646,38,24,14,45,1
479646,1,0,1,59,1
479646,37,24,13,60,1
479655,202,132,70,1,4
479655,202,132,70,2,1
479655,202,132,70,3,1
479655,56,34,22,4,1
479655,146,98,48,5,1
479655,4,2,2,19,1
479655,142,96,46,20,1
479655,174,115,59,21,4
479655,174,115,59,22,1
479655,174,115,59,23,1
479655,49,31,18,24,1
479655,125,84,41,25,1
479655,4,2,2,39,1
479655,121,82,39,40,1
479655,28,17,11,41,4
479655,28,17,11,42,1
479655,28,17,11,43,1
479655,7,3,4,44,1
479655,21,14,7,45,1
479655,21,14,7,60,1
479664,61,56,5,1,4
479664,61,56,5,2,1
479664,61,56,5,3,1
479664,14,12,2,4,1
479664,47,44,3,5,1
479664,47,44,3,20,1
479664,46,42,4,21,4
479664,46,42,4,22,1
479664,46,42,4,23,1
479664,14,12,2,24,1
479664,32,30,2,25,1
479664,32,30,2,40,1
479664,15,14,1,41,4
479664,15,14,1,42,1
479664,15,14,1,43,1
479664,15,14,1,45,1
479664,15,14,1,60,1
479770,139,66,73,1,4
479770,128,62,66,2,1
479770,128,62,66,3,1
479770,6,2,4,4,1
479770,122,60,62,5,1
479770,11,4,7,12,3
479770,19,12,7,19,1
479770,103,48,55,20,1
479770,139,66,73,21,4
479770,128,62,66,22,1
479770,128,62,66,23,1
479770,6,2,4,24,1
479770,122,60,62,25,1
479770,11,4,7,32,3
479770,19,12,7,39,1
479770,103,48,55,40,1
479956,9631,4937,4694,1,4
479956,5389,2555,2834,2,1
479956,4881,2223,2658,3,1
479956,251,128,123,4,1
479956,4630,2095,2535,5,1
479956,508,332,176,11,1
479956,4242,2382,1860,12,3
479956,908,433,475,19,1
479956,3722,1662,2060,20,1
479956,1544,660,884,21,4
479956,1498,645,853,22,1
479956,1440,611,829,23,1
479956,88,33,55,24,1
479956,1352,578,774,25,1
479956,58,34,24,31,1
479956,46,15,31,32,3
479956,300,125,175,39,1
479956,1052,453,599,40,1
479956,8087,4277,3810,41,4
479956,3891,1910,1981,42,1
479956,3441,1612,1829,43,1
479956,163,95,68,44,1
479956,3278,1517,1761,45,1
479956,450,298,152,51,1
479956,4196,2367,1829,52,3
479956,608,308,300,59,1
479956,2670,1209,1461,60,1
479965,77,20,57,1,4
479965,77,20,57,2,1
479965,77,20,57,3,1
479965,25,1,24,4,1
479965,52,19,33,5,1
479965,52,19,33,20,1
479965,77,20,57,21,4
479965,77,20,57,22,1
479965,77,20,57,23,1
479965,25,1,24,24,1
479965,52,19,33,25,1
479965,52,19,33,40,1
479974,61,24,37,1,4
479974,61,24,37,2,1
479974,61,24,37,3,1
479974,20,5,15,4,1
479974,41,19,22,5,1
479974,41,19,22,20,1
479974,46,20,26,21,4
479974,46,20,26,22,1
479974,46,20,26,23,1
479974,11,4,7,24,1
479974,35,16,19,25,1
479974,35,16,19,40,1
479974,15,4,11,41,4
479974,15,4,11,42,1
479974,15,4,11,43,1
479974,9,1,8,44,1
479974,6,3,3,45,1
479974,6,3,3,60,1
479983,49,2,47,1,4
479983,49,2,47,2,1
479983,49,2,47,3,1
479983,5,0,5,4,1
479983,44,2,42,5,1
479983,44,2,42,20,1
479983,35,2,33,21,4
479983,35,2,33,22,1
479983,35,2,33,23,1
479983,5,0,5,24,1
479983,30,2,28,25,1
479983,30,2,28,40,1
479983,14,0,14,41,4
479983,14,0,14,42,1
479983,14,0,14,43,1
479983,14,0,14,45,1
479983,14,0,14,60,1
479992,14,12,2,1,4
479992,14,12,2,2,1
479992,14,12,2,3,1
479992,2,2,0,4,1
479992,12,10,2,5,1
479992,12,10,2,20,1
479992,3,2,1,21,4
479992,3,2,1,22,1
479992,3,2,1,23,1
479992,1,1,0,24,1
479992,2,1,1,25,1
479992,2,1,1,40,1
479992,11,10,1,41,4
479992,11,10,1,42,1
479992,11,10,1,43,1
479992,1,1,0,44,1
479992,10,9,1,45,1
479992,10,9,1,60,1
480000,56,49,7,1,4
480000,56,49,7,2,1
480000,56,49,7,3,1
480000,18,15,3,4,1
480000,38,34,4,5,1
480000,38,34,4,20,1
480000,44,39,5,21,4
480000,44,39,5,22,1
480000,44,39,5,23,1
480000,9,8,1,24,1
480000,35,31,4,25,1
480000,35,31,4,40,1
480000,12,10,2,41,4
480000,12,10,2,42,1
480000,12,10,2,43,1
480000,9,7,2,44,1
480000,3,3,0,45,1
480000,3,3,0,60,1
480019,241,229,12,1,4
480019,241,229,12,2,1
480019,241,229,12,3,1
480019,207,196,11,4,1
480019,34,33,1,5,1
480019,34,33,1,20,1
480019,212,203,9,21,4
480019,212,203,9,22,1
480019,212,203,9,23,1
480019,182,174,8,24,1
480019,30,29,1,25,1
480019,30,29,1,40,1
480019,29,26,3,41,4
480019,29,26,3,42,1
480019,29,26,3,43,1
480019,25,22,3,44,1
480019,4,4,0,45,1
480019,4,4,0,60,1
480028,38,31,7,1,4
480028,38,31,7,2,1
480028,38,31,7,3,1
480028,2,2,0,4,1
480028,36,29,7,5,1
480028,36,29,7,20,1
480028,38,31,7,21,4
480028,38,31,7,22,1
480028,38,31,7,23,1
480028,2,2,0,24,1
480028,36,29,7,25,1
480028,36,29,7,40,1
480037,496,451,45,1,4
480037,496,451,45,2,1
480037,496,451,45,3,1
480037,164,158,6,4,1
480037,332,293,39,5,1
480037,332,293,39,20,1
480037,496,451,45,21,4
480037,496,451,45,22,1
480037,496,451,45,23,1
480037,164,158,6,24,1
480037,332,293,39,25,1
480037,332,293,39,40,1
480064,396,72,324,1,4
480064,384,69,315,2,1
480064,379,66,313,3,1
480064,72,14,58,4,1
480064,307,52,255,5,1
480064,5,3,2,11,1
480064,12,3,9,12,3
480064,132,25,107,19,1
480064,175,27,148,20,1
480064,213,36,177,21,4
480064,203,34,169,22,1
480064,203,34,169,23,1
480064,36,5,31,24,1
480064,167,29,138,25,1
480064,10,2,8,32,3
480064,77,17,60,39,1
480064,90,12,78,40,1
480064,183,36,147,41,4
480064,181,35,146,42,1
480064,176,32,144,43,1
480064,36,9,27,44,1
480064,140,23,117,45,1
480064,5,3,2,51,1
480064,2,1,1,52,3
480064,55,8,47,59,1
480064,85,15,70,60,1
480073,156,66,90,1,4
480073,141,60,81,2,1
480073,141,60,81,3,1
480073,5,4,1,4,1
480073,136,56,80,5,1
480073,15,6,9,12,3
480073,43,15,28,19,1
480073,93,41,52,20,1
480073,55,23,32,21,4
480073,50,21,29,22,1
480073,50,21,29,23,1
480073,2,2,0,24,1
480073,48,19,29,25,1
480073,5,2,3,32,3
480073,13,4,9,39,1
480073,35,15,20,40,1
480073,101,43,58,41,4
480073,91,39,52,42,1
480073,91,39,52,43,1
480073,3,2,1,44,1
480073,88,37,51,45,1
480073,10,4,6,52,3
480073,30,11,19,59,1
480073,58,26,32,60,1
480082,254,48,206,1,4
480082,238,48,190,2,1
480082,238,48,190,3,1
480082,21,8,13,4,1
480082,217,40,177,5,1
480082,16,0,16,12,3
480082,117,16,101,19,1
480082,100,24,76,20,1
480082,107,20,87,21,4
480082,100,20,80,22,1
480082,100,20,80,23,1
480082,11,4,7,24,1
480082,89,16,73,25,1
480082,7,0,7,32,3
480082,50,4,46,39,1
480082,39,12,27,40,1
480082,147,28,119,41,4
480082,138,28,110,42,1
480082,138,28,110,43,1
480082,10,4,6,44,1
480082,128,24,104,45,1
480082,9,0,9,52,3
480082,67,12,55,59,1
480082,61,12,49,60,1
480091,2140,281,1859,1,4
480091,2140,281,1859,2,1
480091,2132,279,1853,3,1
480091,180,36,144,4,1
480091,1952,243,1709,5,1
480091,8,2,6,11,1
480091,591,81,510,19,1
480091,1361,162,1199,20,1
480091,1251,177,1074,21,4
480091,1251,177,1074,22,1
480091,1250,177,1073,23,1
480091,146,30,116,24,1
480091,1104,147,957,25,1
480091,1,0,1,31,1
480091,455,61,394,39,1
480091,649,86,563,40,1
480091,889,104,785,41,4
480091,889,104,785,42,1
480091,882,102,780,43,1
480091,34,6,28,44,1
480091,848,96,752,45,1
480091,7,2,5,51,1
480091,136,20,116,59,1
480091,712,76,636,60,1
480107,458,29,429,1,4
480107,458,29,429,2,1
480107,458,29,429,3,1
480107,158,12,146,4,1
480107,300,17,283,5,1
480107,300,17,283,20,1
480107,337,20,317,21,4
480107,337,20,317,22,1
480107,337,20,317,23,1
480107,119,9,110,24,1
480107,218,11,207,25,1
480107,218,11,207,40,1
480107,121,9,112,41,4
480107,121,9,112,42,1
480107,121,9,112,43,1
480107,39,3,36,44,1
480107,82,6,76,45,1
480107,82,6,76,60,1
480125,170,7,163,1,4
480125,170,7,163,2,1
480125,170,7,163,3,1
480125,78,1,77,4,1
480125,92,6,86,5,1
480125,92,6,86,20,1
480125,127,3,124,21,4
480125,127,3,124,22,1
480125,127,3,124,23,1
480125,60,0,60,24,1
480125,67,3,64,25,1
480125,67,3,64,40,1
480125,43,4,39,41,4
480125,43,4,39,42,1
480125,43,4,39,43,1
480125,18,1,17,44,1
480125,25,3,22,45,1
480125,25,3,22,60,1
480134,440,149,291,1,4
480134,372,119,253,2,1
480134,365,116,249,3,1
480134,365,116,249,5,1
480134,7,3,4,11,1
480134,68,30,38,12,3
480134,51,11,40,19,1
480134,314,105,209,20,1
480134,440,149,291,41,4
480134,372,119,253,42,1
480134,365,116,249,43,1
480134,365,116,249,45,1
480134,7,3,4,51,1
480134,68,30,38,52,3
480134,51,11,40,59,1
480134,314,105,209,60,1
480143,203,28,175,1,4
480143,203,28,175,2,1
480143,203,28,175,3,1
480143,27,3,24,4,1
480143,176,25,151,5,1
480143,32,3,29,19,1
480143,144,22,122,20,1
480143,203,28,175,21,4
480143,203,28,175,22,1
480143,203,28,175,23,1
480143,27,3,24,24,1
480143,176,25,151,25,1
480143,32,3,29,39,1
480143,144,22,122,40,1
480152,269,46,223,1,4
480152,269,46,223,2,1
480152,269,46,223,3,1
480152,138,27,111,4,1
480152,131,19,112,5,1
480152,131,19,112,20,1
480152,263,46,217,21,4
480152,263,46,217,22,1
480152,263,46,217,23,1
480152,138,27,111,24,1
480152,125,19,106,25,1
480152,125,19,106,40,1
480152,6,0,6,41,4
480152,6,0,6,42,1
480152,6,0,6,43,1
480152,6,0,6,45,1
480152,6,0,6,60,1
480161,9,1,8,1,4
480161,9,1,8,2,1
480161,9,1,8,3,1
480161,2,1,1,4,1
480161,7,0,7,5,1
480161,7,0,7,20,1
480161,7,1,6,21,4
480161,7,1,6,22,1
480161,7,1,6,23,1
480161,2,1,1,24,1
480161,5,0,5,25,1
480161,5,0,5,40,1
480161,2,0,2,41,4
480161,2,0,2,42,1
480161,2,0,2,43,1
480161,2,0,2,45,1
480161,2,0,2,60,1
480170,86,1,85,1,4
480170,86,1,85,2,1
480170,86,1,85,3,1
480170,20,0,20,4,1
480170,66,1,65,5,1
480170,66,1,65,20,1
480170,86,1,85,21,4
480170,86,1,85,22,1
480170,86,1,85,23,1
480170,20,0,20,24,1
480170,66,1,65,25,1
480170,66,1,65,40,1
480189,1032,356,676,1,4
480189,1032,356,676,2,1
480189,1032,356,676,3,1
480189,271,127,144,4,1
480189,761,229,532,5,1
480189,154,50,104,19,1
480189,607,179,428,20,1
480189,728,288,440,21,4
480189,728,288,440,22,1
480189,728,288,440,23,1
480189,239,122,117,24,1
480189,489,166,323,25,1
480189,101,27,74,39,1
480189,388,139,249,40,1
480189,304,68,236,41,4
480189,304,68,236,42,1
480189,304,68,236,43,1
480189,32,5,27,44,1
480189,272,63,209,45,1
480189,53,23,30,59,1
480189,219,40,179,60,1
480198,918,290,628,1,4
480198,857,268,589,2,1
480198,856,268,588,3,1
480198,17,5,12,4,1
480198,839,263,576,5,1
480198,1,0,1,11,1
480198,61,22,39,12,3
480198,8,2,6,19,1
480198,831,261,570,20,1
480198,918,290,628,21,4
480198,857,268,589,22,1
480198,856,268,588,23,1
480198,17,5,12,24,1
480198,839,263,576,25,1
480198,1,0,1,31,1
480198,61,22,39,32,3
480198,8,2,6,39,1
480198,831,261,570,40,1
480204,334,70,264,1,4
480204,334,70,264,2,1
480204,334,70,264,3,1
480204,55,14,41,4,1
480204,279,56,223,5,1
480204,26,4,22,19,1
480204,253,52,201,20,1
480204,334,70,264,21,4
480204,334,70,264,22,1
480204,334,70,264,23,1
480204,55,14,41,24,1
480204,279,56,223,25,1
480204,26,4,22,39,1
480204,253,52,201,40,1
480301,84,35,49,1,4
480301,84,35,49,12,3
480301,58,25,33,21,4
480301,58,25,33,32,3
480301,26,10,16,41,4
480301,26,10,16,52,3
480310,194,6,188,1,4
480310,194,6,188,2,1
480310,194,6,188,3,1
480310,78,1,77,4,1
480310,116,5,111,5,1
480310,116,5,111,20,1
480310,159,3,156,21,4
480310,159,3,156,22,1
480310,159,3,156,23,1
480310,66,0,66,24,1
480310,93,3,90,25,1
480310,93,3,90,40,1
480310,35,3,32,41,4
480310,35,3,32,42,1
480310,35,3,32,43,1
480310,12,1,11,44,1
480310,23,2,21,45,1
480310,23,2,21,60,1
480329,570,59,511,1,4
480329,570,59,511,2,1
480329,570,59,511,3,1
480329,106,9,97,4,1
480329,464,50,414,5,1
480329,464,50,414,20,1
480329,570,59,511,21,4
480329,570,59,511,22,1
480329,570,59,511,23,1
480329,106,9,97,24,1
480329,464,50,414,25,1
480329,464,50,414,40,1
480338,406,54,352,1,4
480338,406,54,352,2,1
480338,406,54,352,3,1
480338,61,7,54,4,1
480338,345,47,298,5,1
480338,345,47,298,20,1
480338,406,54,352,21,4
480338,406,54,352,22,1
480338,406,54,352,23,1
480338,61,7,54,24,1
480338,345,47,298,25,1
480338,345,47,298,40,1
480347,70,4,66,1,4
480347,70,4,66,2,1
480347,70,4,66,3,1
480347,19,1,18,4,1
480347,51,3,48,5,1
480347,51,3,48,20,1
480347,70,4,66,21,4
480347,70,4,66,22,1
480347,70,4,66,23,1
480347,19,1,18,24,1
480347,51,3,48,25,1
480347,51,3,48,40,1
480356,34,19,15,1,4
480356,34,19,15,2,1
480356,34,19,15,3,1
480356,16,13,3,4,1
480356,18,6,12,5,1
480356,18,6,12,20,1
480356,34,19,15,21,4
480356,34,19,15,22,1
480356,34,19,15,23,1
480356,16,13,3,24,1
480356,18,6,12,25,1
480356,18,6,12,40,1
480444,144,84,60,1,4
480444,19,11,8,2,1
480444,19,11,8,3,1
480444,1,1,0,4,1
480444,18,10,8,5,1
480444,125,73,52,12,3
480444,18,10,8,20,1
480444,144,84,60,41,4
480444,19,11,8,42,1
480444,19,11,8,43,1
480444,1,1,0,44,1
480444,18,10,8,45,1
480444,125,73,52,52,3
480444,18,10,8,60,1
480480,89,18,71,1,4
480480,89,18,71,2,1
480480,89,18,71,3,1
480480,7,2,5,4,1
480480,82,16,66,5,1
480480,26,7,19,19,1
480480,56,9,47,20,1
480480,83,16,67,21,4
480480,83,16,67,22,1
480480,83,16,67,23,1
480480,7,2,5,24,1
480480,76,14,62,25,1
480480,24,5,19,39,1
480480,52,9,43,40,1
480480,6,2,4,41,4
480480,6,2,4,42,1
480480,6,2,4,43,1
480480,6,2,4,45,1
480480,2,2,0,59,1
480480,4,0,4,60,1
480514,493,207,286,1,4
480514,493,207,286,2,1
480514,493,207,286,3,1
480514,53,20,33,4,1
480514,440,187,253,5,1
480514,440,187,253,20,1
480514,493,207,286,21,4
480514,493,207,286,22,1
480514,493,207,286,23,1
480514,53,20,33,24,1
480514,440,187,253,25,1
480514,440,187,253,40,1
480523,94,2,92,1,4
480523,94,2,92,2,1
480523,94,2,92,3,1
480523,21,0,21,4,1
480523,73,2,71,5,1
480523,73,2,71,20,1
480523,94,2,92,21,4
480523,94,2,92,22,1
480523,94,2,92,23,1
480523,21,0,21,24,1
480523,73,2,71,25,1
480523,73,2,71,40,1
480532,136,5,131,1,4
480532,136,5,131,2,1
480532,136,5,131,3,1
480532,46,2,44,4,1
480532,90,3,87,5,1
480532,90,3,87,20,1
480532,136,5,131,21,4
480532,136,5,131,22,1
480532,136,5,131,23,1
480532,46,2,44,24,1
480532,90,3,87,25,1
480532,90,3,87,40,1
480550,128,10,118,1,4
480550,128,10,118,2,1
480550,128,10,118,3,1
480550,53,5,48,4,1
480550,75,5,70,5,1
480550,75,5,70,20,1
480550,128,10,118,21,4
480550,128,10,118,22,1
480550,128,10,118,23,1
480550,53,5,48,24,1
480550,75,5,70,25,1
480550,75,5,70,40,1
480569,3466,1446,2020,1,4
480569,2308,824,1484,2,1
480569,2304,822,1482,3,1
480569,2304,822,1482,5,1
480569,4,2,2,11,1
480569,1158,622,536,12,3
480569,491,165,326,19,1
480569,1813,657,1156,20,1
480569,1365,466,899,21,4
480569,1359,461,898,22,1
480569,1359,461,898,23,1
480569,1359,461,898,25,1
480569,6,5,1,32,3
480569,320,112,208,39,1
480569,1039,349,690,40,1
480569,2101,980,1121,41,4
480569,949,363,586,42,1
480569,945,361,584,43,1
480569,945,361,584,45,1
480569,4,2,2,51,1
480569,1152,617,535,52,3
480569,171,53,118,59,1
480569,774,308,466,60,1
480657,135,31,104,1,4
480657,135,31,104,2,1
480657,135,31,104,3,1
480657,32,5,27,4,1
480657,103,26,77,5,1
480657,71,17,54,19,1
480657,32,9,23,20,1
480657,103,25,78,21,4
480657,103,25,78,22,1
480657,103,25,78,23,1
480657,19,3,16,24,1
480657,84,22,62,25,1
480657,60,16,44,39,1
480657,24,6,18,40,1
480657,32,6,26,41,4
480657,32,6,26,42,1
480657,32,6,26,43,1
480657,13,2,11,44,1
480657,19,4,15,45,1
480657,11,1,10,59,1
480657,8,3,5,60,1
480693,45,20,25,1,4
480693,45,20,25,2,1
480693,45,20,25,3,1
480693,26,15,11,4,1
480693,19,5,14,5,1
480693,19,5,14,20,1
480693,42,19,23,21,4
480693,42,19,23,22,1
480693,42,19,23,23,1
480693,24,14,10,24,1
480693,18,5,13,25,1
480693,18,5,13,40,1
480693,3,1,2,41,4
480693,3,1,2,42,1
480693,3,1,2,43,1
480693,2,1,1,44,1
480693,1,0,1,45,1
480693,1,0,1,60,1
480718,103,80,23,1,4
480718,103,80,23,2,1
480718,103,80,23,3,1
480718,46,35,11,4,1
480718,57,45,12,5,1
480718,57,45,12,20,1
480718,103,80,23,41,4
480718,103,80,23,42,1
480718,103,80,23,43,1
480718,46,35,11,44,1
480718,57,45,12,45,1
480718,57,45,12,60,1
480727,66,58,8,1,4
480727,66,58,8,2,1
480727,66,58,8,3,1
480727,47,41,6,4,1
480727,19,17,2,5,1
480727,19,17,2,20,1
480727,66,58,8,21,4
480727,66,58,8,22,1
480727,66,58,8,23,1
480727,47,41,6,24,1
480727,19,17,2,25,1
480727,19,17,2,40,1
480736,16,7,9,1,4
480736,16,7,9,2,1
480736,16,7,9,3,1
480736,12,6,6,4,1
480736,4,1,3,5,1
480736,4,1,3,20,1
480736,12,5,7,21,4
480736,12,5,7,22,1
480736,12,5,7,23,1
480736,9,4,5,24,1
480736,3,1,2,25,1
480736,3,1,2,40,1
480736,4,2,2,41,4
480736,4,2,2,42,1
480736,4,2,2,43,1
480736,3,2,1,44,1
480736,1,0,1,45,1
480736,1,0,1,60,1
480754,28,26,2,1,4
480754,28,26,2,2,1
480754,28,26,2,3,1
480754,12,11,1,4,1
480754,16,15,1,5,1
480754,4,4,0,19,1
480754,12,11,1,20,1
480754,18,17,1,21,4
480754,18,17,1,22,1
480754,18,17,1,23,1
480754,5,4,1,24,1
480754,13,13,0,25,1
480754,3,3,0,39,1
480754,10,10,0,40,1
480754,10,9,1,41,4
480754,10,9,1,42,1
480754,10,9,1,43,1
480754,7,7,0,44,1
480754,3,2,1,45,1
480754,1,1,0,59,1
480754,2,1,1,60,1
480781,317,228,89,1,4
480781,66,52,14,2,1
480781,66,52,14,3,1
480781,53,43,10,4,1
480781,13,9,4,5,1
480781,251,176,75,12,3
480781,1,1,0,19,1
480781,12,8,4,20,1
480781,308,223,85,21,4
480781,57,47,10,22,1
480781,57,47,10,23,1
480781,52,43,9,24,1
480781,5,4,1,25,1
480781,251,176,75,32,3
480781,5,4,1,40,1
480781,9,5,4,41,4
480781,9,5,4,42,1
480781,9,5,4,43,1
480781,1,0,1,44,1
480781,8,5,3,45,1
480781,1,1,0,59,1
480781,7,4,3,60,1
480790,624,349,275,1,4
480790,624,349,275,12,3
480790,624,349,275,21,4
480790,624,349,275,32,3
480815,468,84,384,1,4
480815,468,84,384,2,1
480815,468,84,384,3,1
480815,146,33,113,4,1
480815,322,51,271,5,1
480815,322,51,271,20,1
480815,370,72,298,21,4
480815,370,72,298,22,1
480815,370,72,298,23,1
480815,113,29,84,24,1
480815,257,43,214,25,1
480815,257,43,214,40,1
480815,98,12,86,41,4
480815,98,12,86,42,1
480815,98,12,86,43,1
480815,33,4,29,44,1
480815,65,8,57,45,1
480815,65,8,57,60,1
480824,134,31,103,1,4
480824,134,31,103,2,1
480824,134,31,103,3,1
480824,132,31,101,4,1
480824,2,0,2,5,1
480824,1,0,1,19,1
480824,1,0,1,20,1
480824,134,31,103,21,4
480824,134,31,103,22,1
480824,134,31,103,23,1
480824,132,31,101,24,1
480824,2,0,2,25,1
480824,1,0,1,39,1
480824,1,0,1,40,1
480833,208,37,171,1,4
480833,208,37,171,2,1
480833,208,37,171,3,1
480833,207,37,170,4,1
480833,1,0,1,5,1
480833,1,0,1,19,1
480833,208,37,171,21,4
480833,208,37,171,22,1
480833,208,37,171,23,1
480833,207,37,170,24,1
480833,1,0,1,25,1
480833,1,0,1,39,1
480842,23,3,20,1,4
480842,23,3,20,2,1
480842,23,3,20,3,1
480842,4,1,3,4,1
480842,19,2,17,5,1
480842,19,2,17,20,1
480842,21,3,18,21,4
480842,21,3,18,22,1
480842,21,3,18,23,1
480842,3,1,2,24,1
480842,18,2,16,25,1
480842,18,2,16,40,1
480842,2,0,2,41,4
480842,2,0,2,42,1
480842,2,0,2,43,1
480842,1,0,1,44,1
480842,1,0,1,45,1
480842,1,0,1,60,1
480879,26,6,20,1,4
480879,26,6,20,2,1
480879,26,6,20,3,1
480879,11,3,8,4,1
480879,15,3,12,5,1
480879,15,3,12,20,1
480879,26,6,20,21,4
480879,26,6,20,22,1
480879,26,6,20,23,1
480879,11,3,8,24,1
480879,15,3,12,25,1
480879,15,3,12,40,1
480888,217,93,124,1,4
480888,217,93,124,2,1
480888,217,93,124,3,1
480888,58,21,37,4,1
480888,159,72,87,5,1
480888,159,72,87,20,1
480888,217,93,124,21,4
480888,217,93,124,22,1
480888,217,93,124,23,1
480888,58,21,37,24,1
480888,159,72,87,25,1
480888,159,72,87,40,1
480897,131,90,41,1,4
480897,131,90,41,2,1
480897,131,90,41,3,1
480897,124,83,41,4,1
480897,7,7,0,5,1
480897,7,7,0,20,1
480897,131,90,41,21,4
480897,131,90,41,22,1
480897,131,90,41,23,1
480897,124,83,41,24,1
480897,7,7,0,25,1
480897,7,7,0,40,1
480903,259,246,13,1,4
480903,259,246,13,2,1
480903,259,246,13,3,1
480903,254,243,11,4,1
480903,5,3,2,5,1
480903,5,3,2,20,1
480903,236,225,11,21,4
480903,236,225,11,22,1
480903,236,225,11,23,1
480903,232,223,9,24,1
480903,4,2,2,25,1
480903,4,2,2,40,1
480903,23,21,2,41,4
480903,23,21,2,42,1
480903,23,21,2,43,1
480903,22,20,2,44,1
480903,1,1,0,45,1
480903,1,1,0,60,1
480912,10,4,6,1,4
480912,10,4,6,2,1
480912,10,4,6,3,1
480912,10,4,6,5,1
480912,10,4,6,20,1
480912,10,4,6,21,4
480912,10,4,6,22,1
480912,10,4,6,23,1
480912,10,4,6,25,1
480912,10,4,6,40,1
480930,121,8,113,1,4
480930,121,8,113,2,1
480930,121,8,113,3,1
480930,3,0,3,4,1
480930,118,8,110,5,1
480930,118,8,110,20,1
480930,113,8,105,21,4
480930,113,8,105,22,1
480930,113,8,105,23,1
480930,2,0,2,24,1
480930,111,8,103,25,1
480930,111,8,103,40,1
480930,8,0,8,41,4
480930,8,0,8,42,1
480930,8,0,8,43,1
480930,1,0,1,44,1
480930,7,0,7,45,1
480930,7,0,7,60,1
480967,191,76,115,1,4
480967,191,76,115,2,1
480967,182,72,110,3,1
480967,48,33,15,4,1
480967,134,39,95,5,1
480967,9,4,5,11,1
480967,25,8,17,19,1
480967,109,31,78,20,1
480967,103,38,65,21,4
480967,103,38,65,22,1
480967,103,38,65,23,1
480967,33,24,9,24,1
480967,70,14,56,25,1
480967,15,3,12,39,1
480967,55,11,44,40,1
480967,88,38,50,41,4
480967,88,38,50,42,1
480967,79,34,45,43,1
480967,15,9,6,44,1
480967,64,25,39,45,1
480967,9,4,5,51,1
480967,10,5,5,59,1
480967,54,20,34,60,1
480976,48,4,44,1,4
480976,48,4,44,2,1
480976,48,4,44,3,1
480976,10,0,10,4,1
480976,38,4,34,5,1
480976,38,4,34,20,1
480976,48,4,44,21,4
480976,48,4,44,22,1
480976,48,4,44,23,1
480976,10,0,10,24,1
480976,38,4,34,25,1
480976,38,4,34,40,1
480985,157,1,156,1,4
480985,151,1,150,2,1
480985,151,1,150,3,1
480985,11,0,11,4,1
480985,140,1,139,5,1
480985,6,0,6,12,3
480985,31,1,30,19,1
480985,109,0,109,20,1
480985,157,1,156,21,4
480985,151,1,150,22,1
480985,151,1,150,23,1
480985,11,0,11,24,1
480985,140,1,139,25,1
480985,6,0,6,32,3
480985,31,1,30,39,1
480985,109,0,109,40,1
480994,59,2,57,1,4
480994,59,2,57,2,1
480994,59,2,57,3,1
480994,16,0,16,4,1
480994,43,2,41,5,1
480994,43,2,41,20,1
480994,52,2,50,21,4
480994,52,2,50,22,1
480994,52,2,50,23,1
480994,13,0,13,24,1
480994,39,2,37,25,1
480994,39,2,37,40,1
480994,7,0,7,41,4
480994,7,0,7,42,1
480994,7,0,7,43,1
480994,3,0,3,44,1
480994,4,0,4,45,1
480994,4,0,4,60,1
481003,62,51,11,1,4
481003,62,51,11,2,1
481003,62,51,11,3,1
481003,60,50,10,4,1
481003,2,1,1,5,1
481003,2,1,1,20,1
481003,62,51,11,21,4
481003,62,51,11,22,1
481003,62,51,11,23,1
481003,60,50,10,24,1
481003,2,1,1,25,1
481003,2,1,1,40,1
481021,59,37,22,1,4
481021,59,37,22,2,1
481021,59,37,22,3,1
481021,49,31,18,4,1
481021,10,6,4,5,1
481021,10,6,4,20,1
481021,37,25,12,21,4
481021,37,25,12,22,1
481021,37,25,12,23,1
481021,29,20,9,24,1
481021,8,5,3,25,1
481021,8,5,3,40,1
481021,22,12,10,41,4
481021,22,12,10,42,1
481021,22,12,10,43,1
481021,20,11,9,44,1
481021,2,1,1,45,1
481021,2,1,1,60,1
481030,29,19,10,1,4
481030,29,19,10,12,3
481030,29,19,10,21,4
481030,29,19,10,32,3
481049,11,1,10,1,4
481049,11,1,10,2,1
481049,11,1,10,3,1
481049,4,0,4,4,1
481049,7,1,6,5,1
481049,7,1,6,20,1
481049,11,1,10,21,4
481049,11,1,10,22,1
481049,11,1,10,23,1
481049,4,0,4,24,1
481049,7,1,6,25,1
481049,7,1,6,40,1
481058,136,56,80,1,4
481058,109,47,62,2,1
481058,109,47,62,3,1
481058,76,32,44,4,1
481058,33,15,18,5,1
481058,27,9,18,12,3
481058,33,15,18,20,1
481058,101,43,58,21,4
481058,76,35,41,22,1
481058,76,35,41,23,1
481058,50,24,26,24,1
481058,26,11,15,25,1
481058,25,8,17,32,3
481058,26,11,15,40,1
481058,35,13,22,41,4
481058,33,12,21,42,1
481058,33,12,21,43,1
481058,26,8,18,44,1
481058,7,4,3,45,1
481058,2,1,1,52,3
481058,7,4,3,60,1
481067,31,21,10,1,4
481067,31,21,10,2,1
481067,31,21,10,3,1
481067,7,4,3,4,1
481067,24,17,7,5,1
481067,24,17,7,20,1
481067,22,17,5,21,4
481067,22,17,5,22,1
481067,22,17,5,23,1
481067,4,3,1,24,1
481067,18,14,4,25,1
481067,18,14,4,40,1
481067,9,4,5,41,4
481067,9,4,5,42,1
481067,9,4,5,43,1
481067,3,1,2,44,1
481067,6,3,3,45,1
481067,6,3,3,60,1
481076,9,4,5,1,4
481076,9,4,5,2,1
481076,9,4,5,3,1
481076,1,0,1,4,1
481076,8,4,4,5,1
481076,8,4,4,20,1
481076,9,4,5,41,4
481076,9,4,5,42,1
481076,9,4,5,43,1
481076,1,0,1,44,1
481076,8,4,4,45,1
481076,8,4,4,60,1
481085,233,27,206,1,4
481085,233,27,206,2,1
481085,233,27,206,3,1
481085,24,3,21,4,1
481085,209,24,185,5,1
481085,209,24,185,20,1
481085,191,21,170,21,4
481085,191,21,170,22,1
481085,191,21,170,23,1
481085,191,21,170,25,1
481085,191,21,170,40,1
481085,42,6,36,41,4
481085,42,6,36,42,1
481085,42,6,36,43,1
481085,24,3,21,44,1
481085,18,3,15,45,1
481085,18,3,15,60,1
481094,136,16,120,1,4
481094,136,16,120,12,3
481094,134,16,118,21,4
481094,134,16,118,32,3
481094,2,0,2,41,4
481094,2,0,2,52,3
481100,40,7,33,1,4
481100,40,7,33,2,1
481100,40,7,33,3,1
481100,38,7,31,4,1
481100,2,0,2,5,1
481100,2,0,2,20,1
481100,15,1,14,21,4
481100,15,1,14,22,1
481100,15,1,14,23,1
481100,14,1,13,24,1
481100,1,0,1,25,1
481100,1,0,1,40,1
481100,25,6,19,41,4
481100,25,6,19,42,1
481100,25,6,19,43,1
481100,24,6,18,44,1
481100,1,0,1,45,1
481100,1,0,1,60,1
481119,180,26,154,1,4
481119,180,26,154,2,1
481119,180,26,154,3,1
481119,87,14,73,4,1
481119,93,12,81,5,1
481119,93,12,81,20,1
481119,180,26,154,21,4
481119,180,26,154,22,1
481119,180,26,154,23,1
481119,87,14,73,24,1
481119,93,12,81,25,1
481119,93,12,81,40,1
481128,114,16,98,1,4
481128,114,16,98,2,1
481128,114,16,98,3,1
481128,88,7,81,4,1
481128,26,9,17,5,1
481128,26,9,17,20,1
481128,11,2,9,21,4
481128,11,2,9,22,1
481128,11,2,9,23,1
481128,5,1,4,24,1
481128,6,1,5,25,1
481128,6,1,5,40,1
481128,103,14,89,41,4
481128,103,14,89,42,1
481128,103,14,89,43,1
481128,83,6,77,44,1
481128,20,8,12,45,1
481128,20,8,12,60,1
481137,59,33,26,1,4
481137,59,33,26,2,1
481137,59,33,26,3,1
481137,23,15,8,4,1
481137,36,18,18,5,1
481137,36,18,18,20,1
481137,59,33,26,21,4
481137,59,33,26,22,1
481137,59,33,26,23,1
481137,23,15,8,24,1
481137,36,18,18,25,1
481137,36,18,18,40,1
481146,100,9,91,1,4
481146,100,9,91,2,1
481146,100,9,91,3,1
481146,32,3,29,4,1
481146,68,6,62,5,1
481146,68,6,62,20,1
481146,100,9,91,21,4
481146,100,9,91,22,1
481146,100,9,91,23,1
481146,32,3,29,24,1
481146,68,6,62,25,1
481146,68,6,62,40,1
481155,127,75,52,1,4
481155,127,75,52,2,1
481155,127,75,52,3,1
481155,111,65,46,4,1
481155,16,10,6,5,1
481155,16,10,6,20,1
481155,127,75,52,21,4
481155,127,75,52,22,1
481155,127,75,52,23,1
481155,111,65,46,24,1
481155,16,10,6,25,1
481155,16,10,6,40,1
481164,106,73,33,1,4
481164,106,73,33,2,1
481164,106,73,33,3,1
481164,106,73,33,4,1
481164,80,55,25,21,4
481164,80,55,25,22,1
481164,80,55,25,23,1
481164,80,55,25,24,1
481164,26,18,8,41,4
481164,26,18,8,42,1
481164,26,18,8,43,1
481164,26,18,8,44,1
481173,35,24,11,1,4
481173,35,24,11,2,1
481173,35,24,11,3,1
481173,23,17,6,4,1
481173,12,7,5,5,1
481173,12,7,5,20,1
481173,35,24,11,21,4
481173,35,24,11,22,1
481173,35,24,11,23,1
481173,23,17,6,24,1
481173,12,7,5,25,1
481173,12,7,5,40,1
481182,59,11,48,1,4
481182,59,11,48,2,1
481182,59,11,48,3,1
481182,59,11,48,5,1
481182,59,11,48,20,1
481182,59,11,48,21,4
481182,59,11,48,22,1
481182,59,11,48,23,1
481182,59,11,48,25,1
481182,59,11,48,40,1
481191,386,101,285,1,4
481191,386,101,285,2,1
481191,386,101,285,3,1
481191,353,74,279,4,1
481191,33,27,6,5,1
481191,33,27,6,20,1
481191,386,101,285,21,4
481191,386,101,285,22,1
481191,386,101,285,23,1
481191,353,74,279,24,1
481191,33,27,6,25,1
481191,33,27,6,40,1
481207,55,22,33,1,4
481207,55,22,33,2,1
481207,55,22,33,3,1
481207,28,16,12,4,1
481207,27,6,21,5,1
481207,27,6,21,20,1
481207,55,22,33,21,4
481207,55,22,33,22,1
481207,55,22,33,23,1
481207,28,16,12,24,1
481207,27,6,21,25,1
481207,27,6,21,40,1
481225,29,19,10,1,4
481225,29,19,10,2,1
481225,27,17,10,3,1
481225,7,3,4,4,1
481225,20,14,6,5,1
481225,2,2,0,11,1
481225,1,1,0,19,1
481225,19,13,6,20,1
481225,18,12,6,21,4
481225,18,12,6,22,1
481225,18,12,6,23,1
481225,2,1,1,24,1
481225,16,11,5,25,1
481225,1,1,0,39,1
481225,15,10,5,40,1
481225,11,7,4,41,4
481225,11,7,4,42,1
481225,9,5,4,43,1
481225,5,2,3,44,1
481225,4,3,1,45,1
481225,2,2,0,51,1
481225,4,3,1,60,1
481234,211,97,114,1,4
481234,211,97,114,2,1
481234,211,97,114,3,1
481234,93,43,50,4,1
481234,118,54,64,5,1
481234,118,54,64,20,1
481234,211,97,114,21,4
481234,211,97,114,22,1
481234,211,97,114,23,1
481234,93,43,50,24,1
481234,118,54,64,25,1
481234,118,54,64,40,1
481243,80,1,79,1,4
481243,80,1,79,2,1
481243,80,1,79,3,1
481243,6,0,6,4,1
481243,74,1,73,5,1
481243,74,1,73,20,1
481243,28,0,28,21,4
481243,28,0,28,22,1
481243,28,0,28,23,1
481243,3,0,3,24,1
481243,25,0,25,25,1
481243,25,0,25,40,1
481243,52,1,51,41,4
481243,52,1,51,42,1
481243,52,1,51,43,1
481243,3,0,3,44,1
481243,49,1,48,45,1
481243,49,1,48,60,1
481252,8,1,7,1,4
481252,8,1,7,2,1
481252,8,1,7,3,1
481252,1,1,0,4,1
481252,7,0,7,5,1
481252,7,0,7,19,1
481252,8,1,7,21,4
481252,8,1,7,22,1
481252,8,1,7,23,1
481252,1,1,0,24,1
481252,7,0,7,25,1
481252,7,0,7,39,1
481261,17,0,17,1,4
481261,17,0,17,2,1
481261,17,0,17,3,1
481261,11,0,11,4,1
481261,6,0,6,5,1
481261,6,0,6,20,1
481261,15,0,15,21,4
481261,15,0,15,22,1
481261,15,0,15,23,1
481261,9,0,9,24,1
481261,6,0,6,25,1
481261,6,0,6,40,1
481261,2,0,2,41,4
481261,2,0,2,42,1
481261,2,0,2,43,1
481261,2,0,2,44,1
481270,13,2,11,1,4
481270,13,2,11,2,1
481270,13,2,11,3,1
481270,7,0,7,4,1
481270,6,2,4,5,1
481270,6,2,4,20,1
481270,11,1,10,21,4
481270,11,1,10,22,1
481270,11,1,10,23,1
481270,7,0,7,24,1
481270,4,1,3,25,1
481270,4,1,3,40,1
481270,2,1,1,41,4
481270,2,1,1,42,1
481270,2,1,1,43,1
481270,2,1,1,45,1
481270,2,1,1,60,1
481289,52,8,44,1,4
481289,52,8,44,2,1
481289,52,8,44,3,1
481289,6,2,4,4,1
481289,46,6,40,5,1
481289,46,6,40,20,1
481289,52,8,44,21,4
481289,52,8,44,22,1
481289,52,8,44,23,1
481289,6,2,4,24,1
481289,46,6,40,25,1
481289,46,6,40,40,1
481298,57,0,57,1,4
481298,57,0,57,2,1
481298,57,0,57,3,1
481298,37,0,37,4,1
481298,20,0,20,5,1
481298,20,0,20,20,1
481298,57,0,57,21,4
481298,57,0,57,22,1
481298,57,0,57,23,1
481298,37,0,37,24,1
481298,20,0,20,25,1
481298,20,0,20,40,1
481304,97,3,94,1,4
481304,97,3,94,2,1
481304,97,3,94,3,1
481304,17,0,17,4,1
481304,80,3,77,5,1
481304,80,3,77,20,1
481304,65,1,64,21,4
481304,65,1,64,22,1
481304,65,1,64,23,1
481304,12,0,12,24,1
481304,53,1,52,25,1
481304,53,1,52,40,1
481304,32,2,30,41,4
481304,32,2,30,42,1
481304,32,2,30,43,1
481304,5,0,5,44,1
481304,27,2,25,45,1
481304,27,2,25,60,1
481313,34,4,30,1,4
481313,34,4,30,2,1
481313,34,4,30,3,1
481313,29,4,25,4,1
481313,5,0,5,5,1
481313,5,0,5,20,1
481313,33,4,29,21,4
481313,33,4,29,22,1
481313,33,4,29,23,1
481313,28,4,24,24,1
481313,5,0,5,25,1
481313,5,0,5,40,1
481313,1,0,1,41,4
481313,1,0,1,42,1
481313,1,0,1,43,1
481313,1,0,1,44,1
481322,35,2,33,1,4
481322,35,2,33,2,1
481322,35,2,33,3,1
481322,4,0,4,4,1
481322,31,2,29,5,1
481322,31,2,29,20,1
481322,8,1,7,21,4
481322,8,1,7,22,1
481322,8,1,7,23,1
481322,2,0,2,24,1
481322,6,1,5,25,1
481322,6,1,5,40,1
481322,27,1,26,41,4
481322,27,1,26,42,1
481322,27,1,26,43,1
481322,2,0,2,44,1
481322,25,1,24,45,1
481322,25,1,24,60,1
481331,56,48,8,1,4
481331,56,48,8,2,1
481331,56,48,8,3,1
481331,23,21,2,4,1
481331,33,27,6,5,1
481331,33,27,6,20,1
481331,48,41,7,21,4
481331,48,41,7,22,1
481331,48,41,7,23,1
481331,21,19,2,24,1
481331,27,22,5,25,1
481331,27,22,5,40,1
481331,8,7,1,41,4
481331,8,7,1,42,1
481331,8,7,1,43,1
481331,2,2,0,44,1
481331,6,5,1,45,1
481331,6,5,1,60,1
481340,69,1,68,1,4
481340,69,1,68,2,1
481340,69,1,68,3,1
481340,62,1,61,4,1
481340,7,0,7,5,1
481340,7,0,7,20,1
481340,69,1,68,21,4
481340,69,1,68,22,1
481340,69,1,68,23,1
481340,62,1,61,24,1
481340,7,0,7,25,1
481340,7,0,7,40,1
481359,45,2,43,1,4
481359,45,2,43,2,1
481359,45,2,43,3,1
481359,36,2,34,4,1
481359,9,0,9,5,1
481359,9,0,9,20,1
481359,39,2,37,21,4
481359,39,2,37,22,1
481359,39,2,37,23,1
481359,32,2,30,24,1
481359,7,0,7,25,1
481359,7,0,7,40,1
481359,6,0,6,41,4
481359,6,0,6,42,1
481359,6,0,6,43,1
481359,4,0,4,44,1
481359,2,0,2,45,1
481359,2,0,2,60,1
481368,17,1,16,1,4
481368,17,1,16,2,1
481368,17,1,16,3,1
481368,11,1,10,4,1
481368,6,0,6,5,1
481368,6,0,6,20,1
481368,17,1,16,21,4
481368,17,1,16,22,1
481368,17,1,16,23,1
481368,11,1,10,24,1
481368,6,0,6,25,1
481368,6,0,6,40,1
481377,25,21,4,1,4
481377,25,21,4,2,1
481377,25,21,4,3,1
481377,12,9,3,4,1
481377,13,12,1,5,1
481377,13,12,1,20,1
481377,25,21,4,21,4
481377,25,21,4,22,1
481377,25,21,4,23,1
481377,12,9,3,24,1
481377,13,12,1,25,1
481377,13,12,1,40,1
481386,45,5,40,1,4
481386,45,5,40,2,1
481386,45,5,40,3,1
481386,27,5,22,4,1
481386,18,0,18,5,1
481386,18,0,18,20,1
481386,14,2,12,21,4
481386,14,2,12,22,1
481386,14,2,12,23,1
481386,9,2,7,24,1
481386,5,0,5,25,1
481386,5,0,5,40,1
481386,31,3,28,41,4
481386,31,3,28,42,1
481386,31,3,28,43,1
481386,18,3,15,44,1
481386,13,0,13,45,1
481386,13,0,13,60,1
481395,30,0,30,1,4
481395,30,0,30,2,1
481395,30,0,30,3,1
481395,11,0,11,4,1
481395,19,0,19,5,1
481395,19,0,19,20,1
481395,27,0,27,21,4
481395,27,0,27,22,1
481395,27,0,27,23,1
481395,10,0,10,24,1
481395,17,0,17,25,1
481395,17,0,17,40,1
481395,3,0,3,41,4
481395,3,0,3,42,1
481395,3,0,3,43,1
481395,1,0,1,44,1
481395,2,0,2,45,1
481395,2,0,2,60,1
481401,114,86,28,1,4
481401,16,13,3,2,1
481401,16,13,3,3,1
481401,2,1,1,4,1
481401,14,12,2,5,1
481401,98,73,25,12,3
481401,2,2,0,19,1
481401,12,10,2,20,1
481401,20,15,5,21,4
481401,2,1,1,22,1
481401,2,1,1,23,1
481401,2,1,1,25,1
481401,18,14,4,32,3
481401,1,1,0,39,1
481401,1,0,1,40,1
481401,94,71,23,41,4
481401,14,12,2,42,1
481401,14,12,2,43,1
481401,2,1,1,44,1
481401,12,11,1,45,1
481401,80,59,21,52,3
481401,1,1,0,59,1
481401,11,10,1,60,1
481410,70,70,0,1,4
481410,70,70,0,2,1
481410,70,70,0,3,1
481410,12,12,0,4,1
481410,58,58,0,5,1
481410,9,9,0,19,1
481410,49,49,0,20,1
481410,70,70,0,21,4
481410,70,70,0,22,1
481410,70,70,0,23,1
481410,12,12,0,24,1
481410,58,58,0,25,1
481410,9,9,0,39,1
481410,49,49,0,40,1
481429,165,21,144,1,4
481429,165,21,144,2,1
481429,165,21,144,3,1
481429,86,11,75,4,1
481429,79,10,69,5,1
481429,79,10,69,20,1
481429,165,21,144,21,4
481429,165,21,144,22,1
481429,165,21,144,23,1
481429,86,11,75,24,1
481429,79,10,69,25,1
481429,79,10,69,40,1
481438,64,64,0,1,4
481438,64,64,0,2,1
481438,64,64,0,3,1
481438,23,23,0,4,1
481438,41,41,0,5,1
481438,41,41,0,20,1
481438,64,64,0,21,4
481438,64,64,0,22,1
481438,64,64,0,23,1
481438,23,23,0,24,1
481438,41,41,0,25,1
481438,41,41,0,40,1
481447,53,7,46,1,4
481447,53,7,46,2,1
481447,53,7,46,3,1
481447,29,5,24,4,1
481447,24,2,22,5,1
481447,24,2,22,20,1
481447,27,5,22,21,4
481447,27,5,22,22,1
481447,27,5,22,23,1
481447,15,5,10,24,1
481447,12,0,12,25,1
481447,12,0,12,40,1
481447,26,2,24,41,4
481447,26,2,24,42,1
481447,26,2,24,43,1
481447,14,0,14,44,1
481447,12,2,10,45,1
481447,12,2,10,60,1
481456,28,3,25,1,4
481456,28,3,25,2,1
481456,28,3,25,3,1
481456,22,3,19,4,1
481456,6,0,6,5,1
481456,6,0,6,20,1
481456,11,1,10,21,4
481456,11,1,10,22,1
481456,11,1,10,23,1
481456,10,1,9,24,1
481456,1,0,1,25,1
481456,1,0,1,40,1
481456,17,2,15,41,4
481456,17,2,15,42,1
481456,17,2,15,43,1
481456,12,2,10,44,1
481456,5,0,5,45,1
481456,5,0,5,60,1
481465,31,2,29,1,4
481465,31,2,29,2,1
481465,31,2,29,3,1
481465,4,1,3,4,1
481465,27,1,26,5,1
481465,27,1,26,20,1
481465,23,2,21,21,4
481465,23,2,21,22,1
481465,23,2,21,23,1
481465,3,1,2,24,1
481465,20,1,19,25,1
481465,20,1,19,40,1
481465,8,0,8,41,4
481465,8,0,8,42,1
481465,8,0,8,43,1
481465,1,0,1,44,1
481465,7,0,7,45,1
481465,7,0,7,60,1
481474,36,0,36,1,4
481474,36,0,36,2,1
481474,36,0,36,3,1
481474,4,0,4,4,1
481474,32,0,32,5,1
481474,32,0,32,20,1
481474,23,0,23,21,4
481474,23,0,23,22,1
481474,23,0,23,23,1
481474,3,0,3,24,1
481474,20,0,20,25,1
481474,20,0,20,40,1
481474,13,0,13,41,4
481474,13,0,13,42,1
481474,13,0,13,43,1
481474,1,0,1,44,1
481474,12,0,12,45,1
481474,12,0,12,60,1
481483,200,3,197,1,4
481483,200,3,197,2,1
481483,200,3,197,3,1
481483,170,3,167,4,1
481483,30,0,30,5,1
481483,30,0,30,20,1
481483,152,2,150,21,4
481483,152,2,150,22,1
481483,152,2,150,23,1
481483,129,2,127,24,1
481483,23,0,23,25,1
481483,23,0,23,40,1
481483,48,1,47,41,4
481483,48,1,47,42,1
481483,48,1,47,43,1
481483,41,1,40,44,1
481483,7,0,7,45,1
481483,7,0,7,60,1
481492,22,2,20,1,4
481492,22,2,20,2,1
481492,22,2,20,3,1
481492,13,1,12,4,1
481492,9,1,8,5,1
481492,9,1,8,20,1
481492,22,2,20,21,4
481492,22,2,20,22,1
481492,22,2,20,23,1
481492,13,1,12,24,1
481492,9,1,8,25,1
481492,9,1,8,40,1
481508,131,6,125,1,4
481508,131,6,125,2,1
481508,131,6,125,3,1
481508,43,0,43,4,1
481508,88,6,82,5,1
481508,88,6,82,20,1
481508,127,6,121,21,4
481508,127,6,121,22,1
481508,127,6,121,23,1
481508,43,0,43,24,1
481508,84,6,78,25,1
481508,84,6,78,40,1
481508,4,0,4,41,4
481508,4,0,4,42,1
481508,4,0,4,43,1
481508,4,0,4,45,1
481508,4,0,4,60,1
481517,49,2,47,1,4
481517,49,2,47,2,1
481517,49,2,47,3,1
481517,16,0,16,4,1
481517,33,2,31,5,1
481517,33,2,31,20,1
481517,49,2,47,21,4
481517,49,2,47,22,1
481517,49,2,47,23,1
481517,16,0,16,24,1
481517,33,2,31,25,1
481517,33,2,31,40,1
481526,96,1,95,1,4
481526,96,1,95,2,1
481526,96,1,95,3,1
481526,5,0,5,4,1
481526,91,1,90,5,1
481526,91,1,90,20,1
481526,51,0,51,21,4
481526,51,0,51,22,1
481526,51,0,51,23,1
481526,3,0,3,24,1
481526,48,0,48,25,1
481526,48,0,48,40,1
481526,45,1,44,41,4
481526,45,1,44,42,1
481526,45,1,44,43,1
481526,2,0,2,44,1
481526,43,1,42,45,1
481526,43,1,42,60,1
481535,32,14,18,1,4
481535,32,14,18,12,3
481535,32,14,18,21,4
481535,32,14,18,32,3
481544,75,41,34,1,4
481544,75,41,34,2,1
481544,75,41,34,3,1
481544,38,22,16,4,1
481544,37,19,18,5,1
481544,37,19,18,20,1
481544,75,41,34,41,4
481544,75,41,34,42,1
481544,75,41,34,43,1
481544,38,22,16,44,1
481544,37,19,18,45,1
481544,37,19,18,60,1
481553,96,46,50,1,4
481553,96,46,50,2,1
481553,96,46,50,3,1
481553,26,15,11,4,1
481553,70,31,39,5,1
481553,70,31,39,20,1
481553,64,30,34,21,4
481553,64,30,34,22,1
481553,64,30,34,23,1
481553,19,11,8,24,1
481553,45,19,26,25,1
481553,45,19,26,40,1
481553,32,16,16,41,4
481553,32,16,16,42,1
481553,32,16,16,43,1
481553,7,4,3,44,1
481553,25,12,13,45,1
481553,25,12,13,60,1
481562,54,3,51,1,4
481562,54,3,51,2,1
481562,54,3,51,3,1
481562,19,1,18,4,1
481562,35,2,33,5,1
481562,35,2,33,20,1
481562,52,3,49,21,4
481562,52,3,49,22,1
481562,52,3,49,23,1
481562,18,1,17,24,1
481562,34,2,32,25,1
481562,34,2,32,40,1
481562,2,0,2,41,4
481562,2,0,2,42,1
481562,2,0,2,43,1
481562,1,0,1,44,1
481562,1,0,1,45,1
481562,1,0,1,60,1
481571,6,1,5,1,4
481571,6,1,5,2,1
481571,6,1,5,3,1
481571,5,1,4,4,1
481571,1,0,1,5,1
481571,1,0,1,20,1
481571,5,1,4,21,4
481571,5,1,4,22,1
481571,5,1,4,23,1
481571,4,1,3,24,1
481571,1,0,1,25,1
481571,1,0,1,40,1
481571,1,0,1,41,4
481571,1,0,1,42,1
481571,1,0,1,43,1
481571,1,0,1,44,1
481580,94,33,61,1,4
481580,71,25,46,2,1
481580,71,25,46,3,1
481580,26,7,19,4,1
481580,45,18,27,5,1
481580,23,8,15,12,3
481580,17,7,10,19,1
481580,28,11,17,20,1
481580,9,2,7,21,4
481580,5,1,4,22,1
481580,5,1,4,23,1
481580,1,0,1,24,1
481580,4,1,3,25,1
481580,4,1,3,32,3
481580,4,1,3,40,1
481580,85,31,54,41,4
481580,66,24,42,42,1
481580,66,24,42,43,1
481580,25,7,18,44,1
481580,41,17,24,45,1
481580,19,7,12,52,3
481580,17,7,10,59,1
481580,24,10,14,60,1
481599,156,14,142,1,4
481599,156,14,142,2,1
481599,156,14,142,3,1
481599,97,8,89,4,1
481599,59,6,53,5,1
481599,59,6,53,20,1
481599,156,14,142,21,4
481599,156,14,142,22,1
481599,156,14,142,23,1
481599,97,8,89,24,1
481599,59,6,53,25,1
481599,59,6,53,40,1
481614,165,129,36,1,4
481614,165,129,36,2,1
481614,165,129,36,3,1
481614,50,38,12,4,1
481614,115,91,24,5,1
481614,5,4,1,19,1
481614,110,87,23,20,1
481614,150,117,33,21,4
481614,150,117,33,22,1
481614,150,117,33,23,1
481614,47,36,11,24,1
481614,103,81,22,25,1
481614,5,4,1,39,1
481614,98,77,21,40,1
481614,15,12,3,41,4
481614,15,12,3,42,1
481614,15,12,3,43,1
481614,3,2,1,44,1
481614,12,10,2,45,1
481614,12,10,2,60,1
481623,170,146,24,1,4
481623,170,146,24,2,1
481623,170,146,24,3,1
481623,52,46,6,4,1
481623,118,100,18,5,1
481623,4,4,0,19,1
481623,114,96,18,20,1
481623,158,135,23,21,4
481623,158,135,23,22,1
481623,158,135,23,23,1
481623,49,44,5,24,1
481623,109,91,18,25,1
481623,4,4,0,39,1
481623,105,87,18,40,1
481623,12,11,1,41,4
481623,12,11,1,42,1
481623,12,11,1,43,1
481623,3,2,1,44,1
481623,9,9,0,45,1
481623,9,9,0,60,1
481632,376,32,344,1,4
481632,376,32,344,2,1
481632,376,32,344,3,1
481632,119,10,109,4,1
481632,257,22,235,5,1
481632,257,22,235,20,1
481632,376,32,344,21,4
481632,376,32,344,22,1
481632,376,32,344,23,1
481632,119,10,109,24,1
481632,257,22,235,25,1
481632,257,22,235,40,1
481669,125,118,7,1,4
481669,125,118,7,2,1
481669,125,118,7,3,1
481669,48,46,2,4,1
481669,77,72,5,5,1
481669,77,72,5,20,1
481669,125,118,7,21,4
481669,125,118,7,22,1
481669,125,118,7,23,1
481669,48,46,2,24,1
481669,77,72,5,25,1
481669,77,72,5,40,1
481678,79,3,76,1,4
481678,79,3,76,2,1
481678,79,3,76,3,1
481678,23,0,23,4,1
481678,56,3,53,5,1
481678,56,3,53,20,1
481678,79,3,76,21,4
481678,79,3,76,22,1
481678,79,3,76,23,1
481678,23,0,23,24,1
481678,56,3,53,25,1
481678,56,3,53,40,1
481720,249,60,189,1,4
481720,203,51,152,2,1
481720,203,51,152,3,1
481720,33,13,20,4,1
481720,170,38,132,5,1
481720,46,9,37,12,3
481720,108,20,88,19,1
481720,62,18,44,20,1
481720,85,26,59,21,4
481720,66,21,45,22,1
481720,66,21,45,23,1
481720,16,7,9,24,1
481720,50,14,36,25,1
481720,19,5,14,32,3
481720,24,5,19,39,1
481720,26,9,17,40,1
481720,164,34,130,41,4
481720,137,30,107,42,1
481720,137,30,107,43,1
481720,17,6,11,44,1
481720,120,24,96,45,1
481720,27,4,23,52,3
481720,84,15,69,59,1
481720,36,9,27,60,1
481739,68,1,67,1,4
481739,68,1,67,2,1
481739,68,1,67,3,1
481739,23,0,23,4,1
481739,45,1,44,5,1
481739,45,1,44,20,1
481739,68,1,67,21,4
481739,68,1,67,22,1
481739,68,1,67,23,1
481739,23,0,23,24,1
481739,45,1,44,25,1
481739,45,1,44,40,1
481748,196,9,187,1,4
481748,196,9,187,2,1
481748,196,9,187,3,1
481748,66,4,62,4,1
481748,130,5,125,5,1
481748,130,5,125,20,1
481748,169,9,160,21,4
481748,169,9,160,22,1
481748,169,9,160,23,1
481748,59,4,55,24,1
481748,110,5,105,25,1
481748,110,5,105,40,1
481748,27,0,27,41,4
481748,27,0,27,42,1
481748,27,0,27,43,1
481748,7,0,7,44,1
481748,20,0,20,45,1
481748,20,0,20,60,1
481766,161,5,156,1,4
481766,161,5,156,2,1
481766,161,5,156,3,1
481766,45,2,43,4,1
481766,116,3,113,5,1
481766,116,3,113,20,1
481766,52,2,50,21,4
481766,52,2,50,22,1
481766,52,2,50,23,1
481766,23,1,22,24,1
481766,29,1,28,25,1
481766,29,1,28,40,1
481766,109,3,106,41,4
481766,109,3,106,42,1
481766,109,3,106,43,1
481766,22,1,21,44,1
481766,87,2,85,45,1
481766,87,2,85,60,1
481775,167,33,134,1,4
481775,167,33,134,2,1
481775,167,33,134,3,1
481775,22,1,21,4,1
481775,145,32,113,5,1
481775,27,5,22,19,1
481775,118,27,91,20,1
481775,167,33,134,21,4
481775,167,33,134,22,1
481775,167,33,134,23,1
481775,22,1,21,24,1
481775,145,32,113,25,1
481775,27,5,22,39,1
481775,118,27,91,40,1
481784,9,0,9,1,4
481784,9,0,9,2,1
481784,9,0,9,3,1
481784,9,0,9,5,1
481784,9,0,9,20,1
481784,9,0,9,21,4
481784,9,0,9,22,1
481784,9,0,9,23,1
481784,9,0,9,25,1
481784,9,0,9,40,1
481827,54,30,24,1,4
481827,54,30,24,2,1
481827,54,30,24,3,1
481827,28,25,3,4,1
481827,26,5,21,5,1
481827,26,5,21,20,1
481827,24,4,20,21,4
481827,24,4,20,22,1
481827,24,4,20,23,1
481827,3,1,2,24,1
481827,21,3,18,25,1
481827,21,3,18,40,1
481827,30,26,4,41,4
481827,30,26,4,42,1
481827,30,26,4,43,1
481827,25,24,1,44,1
481827,5,2,3,45,1
481827,5,2,3,60,1
481845,133,7,126,1,4
481845,133,7,126,2,1
481845,133,7,126,3,1
481845,50,0,50,4,1
481845,83,7,76,5,1
481845,83,7,76,20,1
481845,107,6,101,21,4
481845,107,6,101,22,1
481845,107,6,101,23,1
481845,39,0,39,24,1
481845,68,6,62,25,1
481845,68,6,62,40,1
481845,26,1,25,41,4
481845,26,1,25,42,1
481845,26,1,25,43,1
481845,11,0,11,44,1
481845,15,1,14,45,1
481845,15,1,14,60,1
481854,401,53,348,1,4
481854,401,53,348,2,1
481854,401,53,348,3,1
481854,56,10,46,4,1
481854,345,43,302,5,1
481854,345,43,302,20,1
481854,401,53,348,21,4
481854,401,53,348,22,1
481854,401,53,348,23,1
481854,56,10,46,24,1
481854,345,43,302,25,1
481854,345,43,302,40,1
481863,115,2,113,1,4
481863,115,2,113,2,1
481863,115,2,113,3,1
481863,28,0,28,4,1
481863,87,2,85,5,1
481863,87,2,85,20,1
481863,115,2,113,21,4
481863,115,2,113,22,1
481863,115,2,113,23,1
481863,28,0,28,24,1
481863,87,2,85,25,1
481863,87,2,85,40,1
481890,25,2,23,1,4
481890,25,2,23,2,1
481890,25,2,23,3,1
481890,6,0,6,4,1
481890,19,2,17,5,1
481890,19,2,17,20,1
481890,25,2,23,21,4
481890,25,2,23,22,1
481890,25,2,23,23,1
481890,6,0,6,24,1
481890,19,2,17,25,1
481890,19,2,17,40,1
481906,66,7,59,1,4
481906,66,7,59,2,1
481906,66,7,59,3,1
481906,40,6,34,4,1
481906,26,1,25,5,1
481906,26,1,25,20,1
481906,66,7,59,21,4
481906,66,7,59,22,1
481906,66,7,59,23,1
481906,40,6,34,24,1
481906,26,1,25,25,1
481906,26,1,25,40,1
481915,73,33,40,1,4
481915,73,33,40,2,1
481915,73,33,40,3,1
481915,22,7,15,4,1
481915,51,26,25,5,1
481915,23,11,12,19,1
481915,28,15,13,20,1
481915,73,33,40,21,4
481915,73,33,40,22,1
481915,73,33,40,23,1
481915,22,7,15,24,1
481915,51,26,25,25,1
481915,23,11,12,39,1
481915,28,15,13,40,1
481942,350,84,266,1,4
481942,350,84,266,2,1
481942,350,84,266,3,1
481942,113,29,84,4,1
481942,237,55,182,5,1
481942,237,55,182,20,1
481942,208,52,156,21,4
481942,208,52,156,22,1
481942,208,52,156,23,1
481942,68,17,51,24,1
481942,140,35,105,25,1
481942,140,35,105,40,1
481942,142,32,110,41,4
481942,142,32,110,42,1
481942,142,32,110,43,1
481942,45,12,33,44,1
481942,97,20,77,45,1
481942,97,20,77,60,1
481960,118,22,96,1,4
481960,118,22,96,2,1
481960,7,3,4,3,1
481960,7,3,4,4,1
481960,111,19,92,11,1
481960,118,22,96,21,4
481960,118,22,96,22,1
481960,7,3,4,23,1
481960,7,3,4,24,1
481960,111,19,92,31,1
481988,402,331,71,1,4
481988,402,331,71,2,1
481988,402,331,71,3,1
481988,53,43,10,4,1
481988,349,288,61,5,1
481988,76,64,12,19,1
481988,273,224,49,20,1
481988,402,331,71,21,4
481988,402,331,71,22,1
481988,402,331,71,23,1
481988,53,43,10,24,1
481988,349,288,61,25,1
481988,76,64,12,39,1
481988,273,224,49,40,1
482015,279,94,185,1,4
482015,279,94,185,2,1
482015,279,94,185,3,1
482015,276,93,183,4,1
482015,3,1,2,5,1
482015,3,1,2,20,1
482015,279,94,185,21,4
482015,279,94,185,22,1
482015,279,94,185,23,1
482015,276,93,183,24,1
482015,3,1,2,25,1
482015,3,1,2,40,1
482024,54,16,38,1,4
482024,54,16,38,2,1
482024,50,16,34,3,1
482024,10,1,9,4,1
482024,40,15,25,5,1
482024,4,0,4,11,1
482024,40,15,25,20,1
482024,54,16,38,21,4
482024,54,16,38,22,1
482024,50,16,34,23,1
482024,10,1,9,24,1
482024,40,15,25,25,1
482024,4,0,4,31,1
482024,40,15,25,40,1
482033,112,3,109,1,4
482033,112,3,109,2,1
482033,112,3,109,3,1
482033,111,3,108,4,1
482033,1,0,1,5,1
482033,1,0,1,20,1
482033,112,3,109,21,4
482033,112,3,109,22,1
482033,112,3,109,23,1
482033,111,3,108,24,1
482033,1,0,1,25,1
482033,1,0,1,40,1
482060,148,7,141,1,4
482060,148,7,141,2,1
482060,148,7,141,3,1
482060,75,5,70,4,1
482060,73,2,71,5,1
482060,73,2,71,20,1
482060,148,7,141,21,4
482060,148,7,141,22,1
482060,148,7,141,23,1
482060,75,5,70,24,1
482060,73,2,71,25,1
482060,73,2,71,40,1
482097,228,137,91,1,4
482097,228,137,91,2,1
482097,228,137,91,3,1
482097,227,136,91,4,1
482097,1,1,0,5,1
482097,1,1,0,20,1
482097,228,137,91,21,4
482097,228,137,91,22,1
482097,228,137,91,23,1
482097,227,136,91,24,1
482097,1,1,0,25,1
482097,1,1,0,40,1
482103,57,13,44,1,4
482103,57,13,44,2,1
482103,57,13,44,3,1
482103,13,5,8,4,1
482103,44,8,36,5,1
482103,44,8,36,20,1
482103,57,13,44,41,4
482103,57,13,44,42,1
482103,57,13,44,43,1
482103,13,5,8,44,1
482103,44,8,36,45,1
482103,44,8,36,60,1
482149,8468,3120,5348,1,4
482149,5654,2023,3631,2,1
482149,5456,1945,3511,3,1
482149,744,291,453,4,1
482149,4712,1654,3058,5,1
482149,198,78,120,11,1
482149,2814,1097,1717,12,3
482149,591,168,423,19,1
482149,4121,1486,2635,20,1
482149,6628,2466,4162,21,4
482149,4333,1506,2827,22,1
482149,4302,1493,2809,23,1
482149,726,284,442,24,1
482149,3576,1209,2367,25,1
482149,31,13,18,31,1
482149,2295,960,1335,32,3
482149,508,147,361,39,1
482149,3068,1062,2006,40,1
482149,1840,654,1186,41,4
482149,1321,517,804,42,1
482149,1154,452,702,43,1
482149,18,7,11,44,1
482149,1136,445,691,45,1
482149,167,65,102,51,1
482149,519,137,382,52,3
482149,83,21,62,59,1
482149,1053,424,629,60,1
482158,7989,3251,4738,1,4
482158,7989,3251,4738,2,1
482158,7164,2897,4267,3,1
482158,1141,506,635,4,1
482158,6023,2391,3632,5,1
482158,825,354,471,11,1
482158,732,294,438,19,1
482158,5291,2097,3194,20,1
482158,4960,2161,2799,21,4
482158,4960,2161,2799,22,1
482158,4515,1960,2555,23,1
482158,1008,442,566,24,1
482158,3507,1518,1989,25,1
482158,445,201,244,31,1
482158,462,208,254,39,1
482158,3045,1310,1735,40,1
482158,3029,1090,1939,41,4
482158,3029,1090,1939,42,1
482158,2649,937,1712,43,1
482158,133,64,69,44,1
482158,2516,873,1643,45,1
482158,380,153,227,51,1
482158,270,86,184,59,1
482158,2246,787,1459,60,1
482167,34,0,34,1,4
482167,34,0,34,2,1
482167,34,0,34,3,1
482167,17,0,17,4,1
482167,17,0,17,5,1
482167,17,0,17,20,1
482167,12,0,12,21,4
482167,12,0,12,22,1
482167,12,0,12,23,1
482167,11,0,11,24,1
482167,1,0,1,25,1
482167,1,0,1,40,1
482167,22,0,22,41,4
482167,22,0,22,42,1
482167,22,0,22,43,1
482167,6,0,6,44,1
482167,16,0,16,45,1
482167,16,0,16,60,1
482176,111,10,101,1,4
482176,111,10,101,2,1
482176,111,10,101,3,1
482176,30,2,28,4,1
482176,81,8,73,5,1
482176,81,8,73,20,1
482176,94,9,85,21,4
482176,94,9,85,22,1
482176,94,9,85,23,1
482176,26,2,24,24,1
482176,68,7,61,25,1
482176,68,7,61,40,1
482176,17,1,16,41,4
482176,17,1,16,42,1
482176,17,1,16,43,1
482176,4,0,4,44,1
482176,13,1,12,45,1
482176,13,1,12,60,1
482185,43,32,11,1,4
482185,43,32,11,2,1
482185,43,32,11,3,1
482185,23,19,4,4,1
482185,20,13,7,5,1
482185,20,13,7,20,1
482185,43,32,11,21,4
482185,43,32,11,22,1
482185,43,32,11,23,1
482185,23,19,4,24,1
482185,20,13,7,25,1
482185,20,13,7,40,1
482194,85,5,80,1,4
482194,85,5,80,2,1
482194,85,5,80,3,1
482194,37,0,37,4,1
482194,48,5,43,5,1
482194,48,5,43,20,1
482194,74,5,69,21,4
482194,74,5,69,22,1
482194,74,5,69,23,1
482194,30,0,30,24,1
482194,44,5,39,25,1
482194,44,5,39,40,1
482194,11,0,11,41,4
482194,11,0,11,42,1
482194,11,0,11,43,1
482194,7,0,7,44,1
482194,4,0,4,45,1
482194,4,0,4,60,1
482200,20,0,20,1,4
482200,20,0,20,2,1
482200,20,0,20,3,1
482200,10,0,10,4,1
482200,10,0,10,5,1
482200,10,0,10,20,1
482200,20,0,20,21,4
482200,20,0,20,22,1
482200,20,0,20,23,1
482200,10,0,10,24,1
482200,10,0,10,25,1
482200,10,0,10,40,1
482228,108,68,40,1,4
482228,91,56,35,2,1
482228,66,38,28,3,1
482228,18,9,9,4,1
482228,48,29,19,5,1
482228,25,18,7,11,1
482228,17,12,5,12,3
482228,48,29,19,20,1
482228,28,14,14,21,4
482228,24,10,14,22,1
482228,24,10,14,23,1
482228,7,3,4,24,1
482228,17,7,10,25,1
482228,4,4,0,32,3
482228,17,7,10,40,1
482228,80,54,26,41,4
482228,67,46,21,42,1
482228,42,28,14,43,1
482228,11,6,5,44,1
482228,31,22,9,45,1
482228,25,18,7,51,1
482228,13,8,5,52,3
482228,31,22,9,60,1
482246,25,22,3,1,4
482246,25,22,3,2,1
482246,25,22,3,3,1
482246,23,20,3,4,1
482246,2,2,0,5,1
482246,2,2,0,20,1
482246,25,22,3,21,4
482246,25,22,3,22,1
482246,25,22,3,23,1
482246,23,20,3,24,1
482246,2,2,0,25,1
482246,2,2,0,40,1
482255,42,39,3,1,4
482255,42,39,3,2,1
482255,42,39,3,3,1
482255,21,20,1,4,1
482255,21,19,2,5,1
482255,21,19,2,20,1
482255,40,37,3,21,4
482255,40,37,3,22,1
482255,40,37,3,23,1
482255,21,20,1,24,1
482255,19,17,2,25,1
482255,19,17,2,40,1
482255,2,2,0,41,4
482255,2,2,0,42,1
482255,2,2,0,43,1
482255,2,2,0,45,1
482255,2,2,0,60,1
482264,323,118,205,1,4
482264,323,118,205,2,1
482264,323,118,205,3,1
482264,23,11,12,4,1
482264,300,107,193,5,1
482264,300,107,193,20,1
482264,5,2,3,21,4
482264,5,2,3,22,1
482264,5,2,3,23,1
482264,2,1,1,24,1
482264,3,1,2,25,1
482264,3,1,2,40,1
482264,318,116,202,41,4
482264,318,116,202,42,1
482264,318,116,202,43,1
482264,21,10,11,44,1
482264,297,106,191,45,1
482264,297,106,191,60,1
482273,196,123,73,1,4
482273,196,123,73,2,1
482273,196,123,73,3,1
482273,15,11,4,4,1
482273,181,112,69,5,1
482273,181,112,69,20,1
482273,5,5,0,21,4
482273,5,5,0,22,1
482273,5,5,0,23,1
482273,2,2,0,24,1
482273,3,3,0,25,1
482273,3,3,0,40,1
482273,191,118,73,41,4
482273,191,118,73,42,1
482273,191,118,73,43,1
482273,13,9,4,44,1
482273,178,109,69,45,1
482273,178,109,69,60,1
482307,120,46,74,1,4
482307,120,46,74,2,1
482307,120,46,74,3,1
482307,11,6,5,4,1
482307,109,40,69,5,1
482307,40,13,27,19,1
482307,69,27,42,20,1
482307,3,3,0,21,4
482307,3,3,0,22,1
482307,3,3,0,23,1
482307,3,3,0,25,1
482307,3,3,0,40,1
482307,117,43,74,41,4
482307,117,43,74,42,1
482307,117,43,74,43,1
482307,11,6,5,44,1
482307,106,37,69,45,1
482307,40,13,27,59,1
482307,66,24,42,60,1
482316,158,54,104,1,4
482316,158,54,104,2,1
482316,158,54,104,3,1
482316,24,10,14,4,1
482316,134,44,90,5,1
482316,73,25,48,19,1
482316,61,19,42,20,1
482316,4,4,0,21,4
482316,4,4,0,22,1
482316,4,4,0,23,1
482316,4,4,0,25,1
482316,3,3,0,39,1
482316,1,1,0,40,1
482316,154,50,104,41,4
482316,154,50,104,42,1
482316,154,50,104,43,1
482316,24,10,14,44,1
482316,130,40,90,45,1
482316,70,22,48,59,1
482316,60,18,42,60,1
482325,173,35,138,1,4
482325,173,35,138,2,1
482325,173,35,138,3,1
482325,26,5,21,4,1
482325,147,30,117,5,1
482325,67,14,53,19,1
482325,80,16,64,20,1
482325,18,8,10,21,4
482325,18,8,10,22,1
482325,18,8,10,23,1
482325,2,1,1,24,1
482325,16,7,9,25,1
482325,7,3,4,39,1
482325,9,4,5,40,1
482325,155,27,128,41,4
482325,155,27,128,42,1
482325,155,27,128,43,1
482325,24,4,20,44,1
482325,131,23,108,45,1
482325,60,11,49,59,1
482325,71,12,59,60,1
482334,197,58,139,1,4
482334,197,58,139,2,1
482334,197,58,139,3,1
482334,42,14,28,4,1
482334,155,44,111,5,1
482334,78,16,62,19,1
482334,77,28,49,20,1
482334,3,1,2,21,4
482334,3,1,2,22,1
482334,3,1,2,23,1
482334,3,1,2,25,1
482334,1,0,1,39,1
482334,2,1,1,40,1
482334,194,57,137,41,4
482334,194,57,137,42,1
482334,194,57,137,43,1
482334,42,14,28,44,1
482334,152,43,109,45,1
482334,77,16,61,59,1
482334,75,27,48,60,1
482343,149,44,105,1,4
482343,149,44,105,2,1
482343,149,44,105,3,1
482343,22,9,13,4,1
482343,127,35,92,5,1
482343,33,8,25,19,1
482343,94,27,67,20,1
482343,2,1,1,21,4
482343,2,1,1,22,1
482343,2,1,1,23,1
482343,2,1,1,25,1
482343,1,1,0,39,1
482343,1,0,1,40,1
482343,147,43,104,41,4
482343,147,43,104,42,1
482343,147,43,104,43,1
482343,22,9,13,44,1
482343,125,34,91,45,1
482343,32,7,25,59,1
482343,93,27,66,60,1
482352,90,25,65,1,4
482352,90,25,65,2,1
482352,90,25,65,3,1
482352,13,7,6,4,1
482352,77,18,59,5,1
482352,28,10,18,19,1
482352,49,8,41,20,1
482352,1,0,1,21,4
482352,1,0,1,22,1
482352,1,0,1,23,1
482352,1,0,1,25,1
482352,1,0,1,40,1
482352,89,25,64,41,4
482352,89,25,64,42,1
482352,89,25,64,43,1
482352,13,7,6,44,1
482352,76,18,58,45,1
482352,28,10,18,59,1
482352,48,8,40,60,1
482361,282,63,219,1,4
482361,282,63,219,2,1
482361,281,63,218,3,1
482361,24,8,16,4,1
482361,257,55,202,5,1
482361,1,0,1,11,1
482361,73,19,54,19,1
482361,184,36,148,20,1
482361,42,10,32,21,4
482361,42,10,32,22,1
482361,42,10,32,23,1
482361,42,10,32,25,1
482361,7,3,4,39,1
482361,35,7,28,40,1
482361,240,53,187,41,4
482361,240,53,187,42,1
482361,239,53,186,43,1
482361,24,8,16,44,1
482361,215,45,170,45,1
482361,1,0,1,51,1
482361,66,16,50,59,1
482361,149,29,120,60,1
482370,198,37,161,1,4
482370,198,37,161,2,1
482370,198,37,161,3,1
482370,19,3,16,4,1
482370,179,34,145,5,1
482370,59,16,43,19,1
482370,120,18,102,20,1
482370,3,1,2,21,4
482370,3,1,2,22,1
482370,3,1,2,23,1
482370,3,1,2,25,1
482370,1,1,0,39,1
482370,2,0,2,40,1
482370,195,36,159,41,4
482370,195,36,159,42,1
482370,195,36,159,43,1
482370,19,3,16,44,1
482370,176,33,143,45,1
482370,58,15,43,59,1
482370,118,18,100,60,1
482389,46,18,28,1,4
482389,46,18,28,2,1
482389,46,18,28,3,1
482389,12,5,7,4,1
482389,34,13,21,5,1
482389,23,9,14,19,1
482389,11,4,7,20,1
482389,46,18,28,41,4
482389,46,18,28,42,1
482389,46,18,28,43,1
482389,12,5,7,44,1
482389,34,13,21,45,1
482389,23,9,14,59,1
482389,11,4,7,60,1
482398,415,181,234,1,4
482398,415,181,234,2,1
482398,415,181,234,3,1
482398,134,67,67,4,1
482398,281,114,167,5,1
482398,110,36,74,19,1
482398,171,78,93,20,1
482398,326,148,178,21,4
482398,326,148,178,22,1
482398,326,148,178,23,1
482398,104,53,51,24,1
482398,222,95,127,25,1
482398,79,28,51,39,1
482398,143,67,76,40,1
482398,89,33,56,41,4
482398,89,33,56,42,1
482398,89,33,56,43,1
482398,30,14,16,44,1
482398,59,19,40,45,1
482398,31,8,23,59,1
482398,28,11,17,60,1
482413,2127,1336,791,1,4
482413,1402,962,440,2,1
482413,1398,959,439,3,1
482413,114,72,42,4,1
482413,1284,887,397,5,1
482413,4,3,1,11,1
482413,725,374,351,12,3
482413,362,232,130,19,1
482413,922,655,267,20,1
482413,1162,770,392,21,4
482413,931,641,290,22,1
482413,931,641,290,23,1
482413,88,54,34,24,1
482413,843,587,256,25,1
482413,231,129,102,32,3
482413,269,175,94,39,1
482413,574,412,162,40,1
482413,965,566,399,41,4
482413,471,321,150,42,1
482413,467,318,149,43,1
482413,26,18,8,44,1
482413,441,300,141,45,1
482413,4,3,1,51,1
482413,494,245,249,52,3
482413,93,57,36,59,1
482413,348,243,105,60,1
482422,1565,1022,543,1,4
482422,1221,831,390,2,1
482422,1203,827,376,3,1
482422,116,91,25,4,1
482422,1087,736,351,5,1
482422,18,4,14,11,1
482422,344,191,153,12,3
482422,292,195,97,19,1
482422,795,541,254,20,1
482422,626,437,189,21,4
482422,592,418,174,22,1
482422,592,418,174,23,1
482422,76,59,17,24,1
482422,516,359,157,25,1
482422,34,19,15,32,3
482422,166,113,53,39,1
482422,350,246,104,40,1
482422,939,585,354,41,4
482422,629,413,216,42,1
482422,611,409,202,43,1
482422,40,32,8,44,1
482422,571,377,194,45,1
482422,18,4,14,51,1
482422,310,172,138,52,3
482422,126,82,44,59,1
482422,445,295,150,60,1
482431,9156,5503,3653,1,4
482431,7469,4592,2877,2,1
482431,7436,4577,2859,3,1
482431,549,327,222,4,1
482431,6887,4250,2637,5,1
482431,33,15,18,11,1
482431,1687,911,776,12,3
482431,1744,1043,701,19,1
482431,5143,3207,1936,20,1
482431,4109,2572,1537,21,4
482431,3714,2354,1360,22,1
482431,3709,2350,1359,23,1
482431,311,178,133,24,1
482431,3398,2172,1226,25,1
482431,5,4,1,31,1
482431,395,218,177,32,3
482431,1019,624,395,39,1
482431,2379,1548,831,40,1
482431,5047,2931,2116,41,4
482431,3755,2238,1517,42,1
482431,3727,2227,1500,43,1
482431,238,149,89,44,1
482431,3489,2078,1411,45,1
482431,28,11,17,51,1
482431,1292,693,599,52,3
482431,725,419,306,59,1
482431,2764,1659,1105,60,1
482440,1116,679,437,1,4
482440,869,552,317,2,1
482440,865,551,314,3,1
482440,25,18,7,4,1
482440,840,533,307,5,1
482440,4,1,3,11,1
482440,247,127,120,12,3
482440,262,160,102,19,1
482440,578,373,205,20,1
482440,351,217,134,21,4
482440,317,198,119,22,1
482440,317,198,119,23,1
482440,12,7,5,24,1
482440,305,191,114,25,1
482440,34,19,15,32,3
482440,119,73,46,39,1
482440,186,118,68,40,1
482440,765,462,303,41,4
482440,552,354,198,42,1
482440,548,353,195,43,1
482440,13,11,2,44,1
482440,535,342,193,45,1
482440,4,1,3,51,1
482440,213,108,105,52,3
482440,143,87,56,59,1
482440,392,255,137,60,1
482459,3252,1872,1380,1,4
482459,2390,1431,959,2,1
482459,2383,1428,955,3,1
482459,130,79,51,4,1
482459,2253,1349,904,5,1
482459,7,3,4,11,1
482459,862,441,421,12,3
482459,593,351,242,19,1
482459,1660,998,662,20,1
482459,1330,845,485,21,4
482459,1132,739,393,22,1
482459,1131,739,392,23,1
482459,63,41,22,24,1
482459,1068,698,370,25,1
482459,1,0,1,31,1
482459,198,106,92,32,3
482459,316,208,108,39,1
482459,752,490,262,40,1
482459,1922,1027,895,41,4
482459,1258,692,566,42,1
482459,1252,689,563,43,1
482459,67,38,29,44,1
482459,1185,651,534,45,1
482459,6,3,3,51,1
482459,664,335,329,52,3
482459,277,143,134,59,1
482459,908,508,400,60,1
482468,3731,1616,2115,1,4
482468,2729,1226,1503,2,1
482468,2692,1214,1478,3,1
482468,147,69,78,4,1
482468,2545,1145,1400,5,1
482468,37,12,25,11,1
482468,1002,390,612,12,3
482468,745,323,422,19,1
482468,1800,822,978,20,1
482468,1272,595,677,21,4
482468,1057,512,545,22,1
482468,1031,501,530,23,1
482468,58,28,30,24,1
482468,973,473,500,25,1
482468,26,11,15,31,1
482468,215,83,132,32,3
482468,331,153,178,39,1
482468,642,320,322,40,1
482468,2459,1021,1438,41,4
482468,1672,714,958,42,1
482468,1661,713,948,43,1
482468,89,41,48,44,1
482468,1572,672,900,45,1
482468,11,1,10,51,1
482468,787,307,480,52,3
482468,414,170,244,59,1
482468,1158,502,656,60,1
482477,26851,12381,14470,1,4
482477,20366,9822,10544,2,1
482477,20112,9690,10422,3,1
482477,1428,731,697,4,1
482477,18684,8959,9725,5,1
482477,254,132,122,11,1
482477,6485,2559,3926,12,3
482477,5627,2507,3120,19,1
482477,13057,6452,6605,20,1
482477,7571,3686,3885,21,4
482477,6370,3250,3120,22,1
482477,6269,3184,3085,23,1
482477,512,253,259,24,1
482477,5757,2931,2826,25,1
482477,101,66,35,31,1
482477,1201,436,765,32,3
482477,2057,1005,1052,39,1
482477,3700,1926,1774,40,1
482477,19280,8695,10585,41,4
482477,13996,6572,7424,42,1
482477,13843,6506,7337,43,1
482477,916,478,438,44,1
482477,12927,6028,6899,45,1
482477,153,66,87,51,1
482477,5284,2123,3161,52,3
482477,3570,1502,2068,59,1
482477,9357,4526,4831,60,1
482486,467,225,242,1,4
482486,263,151,112,2,1
482486,262,151,111,3,1
482486,21,16,5,4,1
482486,241,135,106,5,1
482486,1,0,1,11,1
482486,204,74,130,12,3
482486,64,32,32,19,1
482486,177,103,74,20,1
482486,127,73,54,21,4
482486,87,53,34,22,1
482486,87,53,34,23,1
482486,9,7,2,24,1
482486,78,46,32,25,1
482486,40,20,20,32,3
482486,31,17,14,39,1
482486,47,29,18,40,1
482486,340,152,188,41,4
482486,176,98,78,42,1
482486,175,98,77,43,1
482486,12,9,3,44,1
482486,163,89,74,45,1
482486,1,0,1,51,1
482486,164,54,110,52,3
482486,33,15,18,59,1
482486,130,74,56,60,1
482495,78,43,35,1,4
482495,66,38,28,2,1
482495,66,38,28,3,1
482495,8,4,4,4,1
482495,58,34,24,5,1
482495,12,5,7,12,3
482495,16,11,5,19,1
482495,42,23,19,20,1
482495,29,19,10,21,4
482495,27,17,10,22,1
482495,27,17,10,23,1
482495,3,2,1,24,1
482495,24,15,9,25,1
482495,2,2,0,32,3
482495,7,7,0,39,1
482495,17,8,9,40,1
482495,49,24,25,41,4
482495,39,21,18,42,1
482495,39,21,18,43,1
482495,5,2,3,44,1
482495,34,19,15,45,1
482495,10,3,7,52,3
482495,9,4,5,59,1
482495,25,15,10,60,1
482501,137,62,75,1,4
482501,63,32,31,2,1
482501,63,32,31,3,1
482501,1,0,1,4,1
482501,62,32,30,5,1
482501,74,30,44,12,3
482501,11,8,3,19,1
482501,51,24,27,20,1
482501,42,25,17,21,4
482501,29,22,7,22,1
482501,29,22,7,23,1
482501,1,0,1,24,1
482501,28,22,6,25,1
482501,13,3,10,32,3
482501,7,6,1,39,1
482501,21,16,5,40,1
482501,95,37,58,41,4
482501,34,10,24,42,1
482501,34,10,24,43,1
482501,34,10,24,45,1
482501,61,27,34,52,3
482501,4,2,2,59,1
482501,30,8,22,60,1
482510,304,136,168,1,4
482510,185,97,88,2,1
482510,184,97,87,3,1
482510,13,8,5,4,1
482510,171,89,82,5,1
482510,1,0,1,11,1
482510,119,39,80,12,3
482510,50,21,29,19,1
482510,121,68,53,20,1
482510,81,37,44,21,4
482510,52,29,23,22,1
482510,52,29,23,23,1
482510,6,4,2,24,1
482510,46,25,21,25,1
482510,29,8,21,32,3
482510,19,11,8,39,1
482510,27,14,13,40,1
482510,223,99,124,41,4
482510,133,68,65,42,1
482510,132,68,64,43,1
482510,7,4,3,44,1
482510,125,64,61,45,1
482510,1,0,1,51,1
482510,90,31,59,52,3
482510,31,10,21,59,1
482510,94,54,40,60,1
482529,466,250,216,1,4
482529,290,168,122,2,1
482529,284,163,121,3,1
482529,12,6,6,4,1
482529,272,157,115,5,1
482529,6,5,1,11,1
482529,176,82,94,12,3
482529,76,44,32,19,1
482529,196,113,83,20,1
482529,129,67,62,21,4
482529,91,50,41,22,1
482529,91,50,41,23,1
482529,5,3,2,24,1
482529,86,47,39,25,1
482529,38,17,21,32,3
482529,33,19,14,39,1
482529,53,28,25,40,1
482529,337,183,154,41,4
482529,199,118,81,42,1
482529,193,113,80,43,1
482529,7,3,4,44,1
482529,186,110,76,45,1
482529,6,5,1,51,1
482529,138,65,73,52,3
482529,43,25,18,59,1
482529,143,85,58,60,1
482538,1130,629,501,1,4
482538,812,487,325,2,1
482538,807,482,325,3,1
482538,49,35,14,4,1
482538,758,447,311,5,1
482538,5,5,0,11,1
482538,318,142,176,12,3
482538,200,109,91,19,1
482538,558,338,220,20,1
482538,404,244,160,21,4
482538,347,224,123,22,1
482538,347,224,123,23,1
482538,28,21,7,24,1
482538,319,203,116,25,1
482538,57,20,37,32,3
482538,99,57,42,39,1
482538,220,146,74,40,1
482538,726,385,341,41,4
482538,465,263,202,42,1
482538,460,258,202,43,1
482538,21,14,7,44,1
482538,439,244,195,45,1
482538,5,5,0,51,1
482538,261,122,139,52,3
482538,101,52,49,59,1
482538,338,192,146,60,1
482547,440,243,197,1,4
482547,293,167,126,2,1
482547,292,167,125,3,1
482547,18,10,8,4,1
482547,274,157,117,5,1
482547,1,0,1,11,1
482547,147,76,71,12,3
482547,81,39,42,19,1
482547,193,118,75,20,1
482547,162,90,72,21,4
482547,128,72,56,22,1
482547,128,72,56,23,1
482547,8,4,4,24,1
482547,120,68,52,25,1
482547,34,18,16,32,3
482547,40,21,19,39,1
482547,80,47,33,40,1
482547,278,153,125,41,4
482547,165,95,70,42,1
482547,164,95,69,43,1
482547,10,6,4,44,1
482547,154,89,65,45,1
482547,1,0,1,51,1
482547,113,58,55,52,3
482547,41,18,23,59,1
482547,113,71,42,60,1
482556,1725,1178,547,1,4
482556,1458,1038,420,2,1
482556,1452,1035,417,3,1
482556,170,130,40,4,1
482556,1282,905,377,5,1
482556,6,3,3,11,1
482556,267,140,127,12,3
482556,265,177,88,19,1
482556,1017,728,289,20,1
482556,790,555,235,21,4
482556,718,512,206,22,1
482556,718,512,206,23,1
482556,103,75,28,24,1
482556,615,437,178,25,1
482556,72,43,29,32,3
482556,159,109,50,39,1
482556,456,328,128,40,1
482556,935,623,312,41,4
482556,740,526,214,42,1
482556,734,523,211,43,1
482556,67,55,12,44,1
482556,667,468,199,45,1
482556,6,3,3,51,1
482556,195,97,98,52,3
482556,106,68,38,59,1
482556,561,400,161,60,1
482565,737,310,427,1,4
482565,495,222,273,2,1
482565,495,222,273,3,1
482565,25,11,14,4,1
482565,470,211,259,5,1
482565,242,88,154,12,3
482565,146,57,89,19,1
482565,324,154,170,20,1
482565,250,110,140,21,4
482565,192,96,96,22,1
482565,192,96,96,23,1
482565,13,4,9,24,1
482565,179,92,87,25,1
482565,58,14,44,32,3
482565,69,32,37,39,1
482565,110,60,50,40,1
482565,487,200,287,41,4
482565,303,126,177,42,1
482565,303,126,177,43,1
482565,12,7,5,44,1
482565,291,119,172,45,1
482565,184,74,110,52,3
482565,77,25,52,59,1
482565,214,94,120,60,1
482574,3578,1870,1708,1,4
482574,2822,1542,1280,2,1
482574,2762,1511,1251,3,1
482574,213,146,67,4,1
482574,2549,1365,1184,5,1
482574,60,31,29,11,1
482574,756,328,428,12,3
482574,737,351,386,19,1
482574,1812,1014,798,20,1
482574,1310,753,557,21,4
482574,1150,686,464,22,1
482574,1113,665,448,23,1
482574,118,85,33,24,1
482574,995,580,415,25,1
482574,37,21,16,31,1
482574,160,67,93,32,3
482574,343,181,162,39,1
482574,652,399,253,40,1
482574,2268,1117,1151,41,4
482574,1672,856,816,42,1
482574,1649,846,803,43,1
482574,95,61,34,44,1
482574,1554,785,769,45,1
482574,23,10,13,51,1
482574,596,261,335,52,3
482574,394,170,224,59,1
482574,1160,615,545,60,1
482583,184,95,89,1,4
482583,130,68,62,2,1
482583,130,68,62,3,1
482583,7,3,4,4,1
482583,123,65,58,5,1
482583,54,27,27,12,3
482583,43,19,24,19,1
482583,80,46,34,20,1
482583,80,42,38,21,4
482583,66,33,33,22,1
482583,66,33,33,23,1
482583,4,1,3,24,1
482583,62,32,30,25,1
482583,14,9,5,32,3
482583,23,11,12,39,1
482583,39,21,18,40,1
482583,104,53,51,41,4
482583,64,35,29,42,1
482583,64,35,29,43,1
482583,3,2,1,44,1
482583,61,33,28,45,1
482583,40,18,22,52,3
482583,20,8,12,59,1
482583,41,25,16,60,1
482592,149,94,55,1,4
482592,88,57,31,2,1
482592,88,57,31,3,1
482592,1,0,1,4,1
482592,87,57,30,5,1
482592,61,37,24,12,3
482592,13,8,5,19,1
482592,74,49,25,20,1
482592,67,46,21,21,4
482592,48,36,12,22,1
482592,48,36,12,23,1
482592,48,36,12,25,1
482592,19,10,9,32,3
482592,9,6,3,39,1
482592,39,30,9,40,1
482592,82,48,34,41,4
482592,40,21,19,42,1
482592,40,21,19,43,1
482592,1,0,1,44,1
482592,39,21,18,45,1
482592,42,27,15,52,3
482592,4,2,2,59,1
482592,35,19,16,60,1
482608,1481,830,651,1,4
482608,1114,658,456,2,1
482608,1110,657,453,3,1
482608,112,65,47,4,1
482608,998,592,406,5,1
482608,4,1,3,11,1
482608,367,172,195,12,3
482608,255,139,116,19,1
482608,743,453,290,20,1
482608,502,322,180,21,4
482608,425,278,147,22,1
482608,425,278,147,23,1
482608,59,35,24,24,1
482608,366,243,123,25,1
482608,77,44,33,32,3
482608,118,64,54,39,1
482608,248,179,69,40,1
482608,979,508,471,41,4
482608,689,380,309,42,1
482608,685,379,306,43,1
482608,53,30,23,44,1
482608,632,349,283,45,1
482608,4,1,3,51,1
482608,290,128,162,52,3
482608,137,75,62,59,1
482608,495,274,221,60,1
482617,452,198,254,1,4
482617,281,137,144,2,1
482617,281,137,144,3,1
482617,24,13,11,4,1
482617,257,124,133,5,1
482617,171,61,110,12,3
482617,79,37,42,19,1
482617,178,87,91,20,1
482617,136,70,66,21,4
482617,85,48,37,22,1
482617,85,48,37,23,1
482617,3,1,2,24,1
482617,82,47,35,25,1
482617,51,22,29,32,3
482617,39,23,16,39,1
482617,43,24,19,40,1
482617,316,128,188,41,4
482617,196,89,107,42,1
482617,196,89,107,43,1
482617,21,12,9,44,1
482617,175,77,98,45,1
482617,120,39,81,52,3
482617,40,14,26,59,1
482617,135,63,72,60,1
482635,3382,1910,1472,1,4
482635,2486,1472,1014,2,1
482635,2485,1472,1013,3,1
482635,120,78,42,4,1
482635,2365,1394,971,5,1
482635,1,0,1,11,1
482635,896,438,458,12,3
482635,592,349,243,19,1
482635,1773,1045,728,20,1
482635,1347,833,514,21,4
482635,1122,715,407,22,1
482635,1122,715,407,23,1
482635,54,38,16,24,1
482635,1068,677,391,25,1
482635,225,118,107,32,3
482635,339,218,121,39,1
482635,729,459,270,40,1
482635,2035,1077,958,41,4
482635,1364,757,607,42,1
482635,1363,757,606,43,1
482635,66,40,26,44,1
482635,1297,717,580,45,1
482635,1,0,1,51,1
482635,671,320,351,52,3
482635,253,131,122,59,1
482635,1044,586,458,60,1
482644,150,106,44,1,4
482644,93,70,23,2,1
482644,92,69,23,3,1
482644,1,0,1,4,1
482644,91,69,22,5,1
482644,1,1,0,11,1
482644,57,36,21,12,3
482644,15,10,5,19,1
482644,76,59,17,20,1
482644,38,30,8,21,4
482644,36,29,7,22,1
482644,36,29,7,23,1
482644,36,29,7,25,1
482644,2,1,1,32,3
482644,6,5,1,39,1
482644,30,24,6,40,1
482644,112,76,36,41,4
482644,57,41,16,42,1
482644,56,40,16,43,1
482644,1,0,1,44,1
482644,55,40,15,45,1
482644,1,1,0,51,1
482644,55,35,20,52,3
482644,9,5,4,59,1
482644,46,35,11,60,1
482653,1328,824,504,1,4
482653,783,501,282,2,1
482653,783,501,282,3,1
482653,28,17,11,4,1
482653,755,484,271,5,1
482653,545,323,222,12,3
482653,197,115,82,19,1
482653,558,369,189,20,1
482653,516,329,187,21,4
482653,404,270,134,22,1
482653,404,270,134,23,1
482653,20,13,7,24,1
482653,384,257,127,25,1
482653,112,59,53,32,3
482653,124,74,50,39,1
482653,260,183,77,40,1
482653,812,495,317,41,4
482653,379,231,148,42,1
482653,379,231,148,43,1
482653,8,4,4,44,1
482653,371,227,144,45,1
482653,433,264,169,52,3
482653,73,41,32,59,1
482653,298,186,112,60,1
482662,673,406,267,1,4
482662,466,310,156,2,1
482662,466,310,156,3,1
482662,21,15,6,4,1
482662,445,295,150,5,1
482662,207,96,111,12,3
482662,136,79,57,19,1
482662,309,216,93,20,1
482662,275,183,92,21,4
482662,237,161,76,22,1
482662,237,161,76,23,1
482662,9,8,1,24,1
482662,228,153,75,25,1
482662,38,22,16,32,3
482662,79,48,31,39,1
482662,149,105,44,40,1
482662,398,223,175,41,4
482662,229,149,80,42,1
482662,229,149,80,43,1
482662,12,7,5,44,1
482662,217,142,75,45,1
482662,169,74,95,52,3
482662,57,31,26,59,1
482662,160,111,49,60,1
482671,304,151,153,1,4
482671,148,74,74,2,1
482671,148,74,74,3,1
482671,6,2,4,4,1
482671,142,72,70,5,1
482671,156,77,79,12,3
482671,55,29,26,19,1
482671,87,43,44,20,1
482671,83,38,45,21,4
482671,57,29,28,22,1
482671,57,29,28,23,1
482671,3,1,2,24,1
482671,54,28,26,25,1
482671,26,9,17,32,3
482671,28,15,13,39,1
482671,26,13,13,40,1
482671,221,113,108,41,4
482671,91,45,46,42,1
482671,91,45,46,43,1
482671,3,1,2,44,1
482671,88,44,44,45,1
482671,130,68,62,52,3
482671,27,14,13,59,1
482671,61,30,31,60,1
482680,15455,6775,8680,1,4
482680,14851,6591,8260,2,1
482680,14502,6463,8039,3,1
482680,3297,1468,1829,4,1
482680,11205,4995,6210,5,1
482680,349,128,221,11,1
482680,604,184,420,12,3
482680,1136,546,590,19,1
482680,10069,4449,5620,20,1
482680,10205,4646,5559,21,4
482680,10022,4589,5433,22,1
482680,9942,4567,5375,23,1
482680,2799,1239,1560,24,1
482680,7143,3328,3815,25,1
482680,80,22,58,31,1
482680,183,57,126,32,3
482680,732,367,365,39,1
482680,6411,2961,3450,40,1
482680,5250,2129,3121,41,4
482680,4829,2002,2827,42,1
482680,4560,1896,2664,43,1
482680,498,229,269,44,1
482680,4062,1667,2395,45,1
482680,269,106,163,51,1
482680,421,127,294,52,3
482680,404,179,225,59,1
482680,3658,1488,2170,60,1
482699,2579,995,1584,1,4
482699,2579,995,1584,2,1
482699,2459,945,1514,3,1
482699,974,416,558,4,1
482699,1485,529,956,5,1
482699,120,50,70,11,1
482699,119,45,74,19,1
482699,1366,484,882,20,1
482699,1877,773,1104,21,4
482699,1877,773,1104,22,1
482699,1836,751,1085,23,1
482699,878,382,496,24,1
482699,958,369,589,25,1
482699,41,22,19,31,1
482699,84,38,46,39,1
482699,874,331,543,40,1
482699,702,222,480,41,4
482699,702,222,480,42,1
482699,623,194,429,43,1
482699,96,34,62,44,1
482699,527,160,367,45,1
482699,79,28,51,51,1
482699,35,7,28,59,1
482699,492,153,339,60,1
482705,8479,3604,4875,1,4
482705,3519,1685,1834,2,1
482705,2124,981,1143,3,1
482705,2124,981,1143,5,1
482705,1395,704,691,11,1
482705,4960,1919,3041,12,3
482705,2124,981,1143,20,1
482705,1727,833,894,21,4
482705,1072,571,501,22,1
482705,1072,571,501,31,1
482705,655,262,393,32,3
482705,6752,2771,3981,41,4
482705,2447,1114,1333,42,1
482705,2124,981,1143,43,1
482705,2124,981,1143,45,1
482705,323,133,190,51,1
482705,4305,1657,2648,52,3
482705,2124,981,1143,60,1
482857,5418,2485,2933,1,4
482857,5418,2485,2933,2,1
482857,4888,2252,2636,3,1
482857,2161,1164,997,4,1
482857,2727,1088,1639,5,1
482857,530,233,297,11,1
482857,2295,925,1370,19,1
482857,432,163,269,20,1
482857,2452,1400,1052,21,4
482857,2452,1400,1052,22,1
482857,2387,1371,1016,23,1
482857,1313,815,498,24,1
482857,1074,556,518,25,1
482857,65,29,36,31,1
482857,967,519,448,39,1
482857,107,37,70,40,1
482857,2966,1085,1881,41,4
482857,2966,1085,1881,42,1
482857,2501,881,1620,43,1
482857,848,349,499,44,1
482857,1653,532,1121,45,1
482857,465,204,261,51,1
482857,1328,406,922,59,1
482857,325,126,199,60,1
482954,308,107,201,1,4
482954,308,107,201,2,1
482954,308,107,201,3,1
482954,64,23,41,4,1
482954,244,84,160,5,1
482954,78,16,62,19,1
482954,166,68,98,20,1
482954,308,107,201,21,4
482954,308,107,201,22,1
482954,308,107,201,23,1
482954,64,23,41,24,1
482954,244,84,160,25,1
482954,78,16,62,39,1
482954,166,68,98,40,1
482963,140,32,108,1,4
482963,140,32,108,2,1
482963,140,32,108,3,1
482963,31,7,24,4,1
482963,109,25,84,5,1
482963,109,25,84,20,1
482963,140,32,108,21,4
482963,140,32,108,22,1
482963,140,32,108,23,1
482963,31,7,24,24,1
482963,109,25,84,25,1
482963,109,25,84,40,1
482990,162,33,129,1,4
482990,162,33,129,2,1
482990,162,33,129,3,1
482990,73,15,58,4,1
482990,89,18,71,5,1
482990,89,18,71,20,1
482990,162,33,129,21,4
482990,162,33,129,22,1
482990,162,33,129,23,1
482990,73,15,58,24,1
482990,89,18,71,25,1
482990,89,18,71,40,1
483009,73,15,58,1,4
483009,73,15,58,2,1
483009,73,15,58,3,1
483009,43,10,33,4,1
483009,30,5,25,5,1
483009,30,5,25,20,1
483009,73,15,58,21,4
483009,73,15,58,22,1
483009,73,15,58,23,1
483009,43,10,33,24,1
483009,30,5,25,25,1
483009,30,5,25,40,1
483018,186,68,118,1,4
483018,186,68,118,2,1
483018,185,68,117,3,1
483018,91,35,56,4,1
483018,94,33,61,5,1
483018,1,0,1,11,1
483018,7,3,4,19,1
483018,87,30,57,20,1
483018,185,68,117,21,4
483018,185,68,117,22,1
483018,185,68,117,23,1
483018,91,35,56,24,1
483018,94,33,61,25,1
483018,7,3,4,39,1
483018,87,30,57,40,1
483018,1,0,1,41,4
483018,1,0,1,42,1
483018,1,0,1,51,1
483036,2404,893,1511,1,4
483036,1751,681,1070,2,1
483036,1747,681,1066,3,1
483036,1747,681,1066,5,1
483036,4,0,4,11,1
483036,653,212,441,12,3
483036,463,172,291,19,1
483036,1284,509,775,20,1
483036,557,214,343,21,4
483036,419,166,253,22,1
483036,419,166,253,23,1
483036,419,166,253,25,1
483036,138,48,90,32,3
483036,103,45,58,39,1
483036,316,121,195,40,1
483036,1847,679,1168,41,4
483036,1332,515,817,42,1
483036,1328,515,813,43,1
483036,1328,515,813,45,1
483036,4,0,4,51,1
483036,515,164,351,52,3
483036,360,127,233,59,1
483036,968,388,580,60,1
483045,7796,3028,4768,1,4
483045,7796,3028,4768,2,1
483045,7146,2754,4392,3,1
483045,1855,892,963,4,1
483045,5291,1862,3429,5,1
483045,650,274,376,11,1
483045,72,29,43,19,1
483045,5219,1833,3386,20,1
483045,3191,1253,1938,21,4
483045,3191,1253,1938,22,1
483045,3182,1247,1935,23,1
483045,848,396,452,24,1
483045,2334,851,1483,25,1
483045,9,6,3,31,1
483045,25,12,13,39,1
483045,2309,839,1470,40,1
483045,4605,1775,2830,41,4
483045,4605,1775,2830,42,1
483045,3964,1507,2457,43,1
483045,1007,496,511,44,1
483045,2957,1011,1946,45,1
483045,641,268,373,51,1
483045,47,17,30,59,1
483045,2910,994,1916,60,1
483054,35,31,4,1,4
483054,35,31,4,2,1
483054,35,31,4,3,1
483054,14,13,1,4,1
483054,21,18,3,5,1
483054,21,18,3,20,1
483054,25,21,4,21,4
483054,25,21,4,22,1
483054,25,21,4,23,1
483054,6,5,1,24,1
483054,19,16,3,25,1
483054,19,16,3,40,1
483054,10,10,0,41,4
483054,10,10,0,42,1
483054,10,10,0,43,1
483054,8,8,0,44,1
483054,2,2,0,45,1
483054,2,2,0,60,1
483106,101,3,98,1,4
483106,101,3,98,2,1
483106,101,3,98,3,1
483106,21,0,21,4,1
483106,80,3,77,5,1
483106,80,3,77,20,1
483106,61,2,59,21,4
483106,61,2,59,22,1
483106,61,2,59,23,1
483106,16,0,16,24,1
483106,45,2,43,25,1
483106,45,2,43,40,1
483106,40,1,39,41,4
483106,40,1,39,42,1
483106,40,1,39,43,1
483106,5,0,5,44,1
483106,35,1,34,45,1
483106,35,1,34,60,1
483124,10268,3679,6589,1,4
483124,8227,3159,5068,2,1
483124,8227,3159,5068,3,1
483124,1301,613,688,4,1
483124,6926,2546,4380,5,1
483124,2041,520,1521,12,3
483124,2265,908,1357,19,1
483124,4661,1638,3023,20,1
483124,4632,1732,2900,21,4
483124,4240,1624,2616,22,1
483124,4240,1624,2616,23,1
483124,1135,524,611,24,1
483124,3105,1100,2005,25,1
483124,392,108,284,32,3
483124,1021,377,644,39,1
483124,2084,723,1361,40,1
483124,5636,1947,3689,41,4
483124,3987,1535,2452,42,1
483124,3987,1535,2452,43,1
483124,166,89,77,44,1
483124,3821,1446,2375,45,1
483124,1649,412,1237,52,3
483124,1244,531,713,59,1
483124,2577,915,1662,60,1
483212,3949,1519,2430,1,4
483212,3949,1519,2430,2,1
483212,3050,1091,1959,3,1
483212,787,335,452,4,1
483212,2263,756,1507,5,1
483212,899,428,471,11,1
483212,385,121,264,19,1
483212,1878,635,1243,20,1
483212,1871,762,1109,21,4
483212,1871,762,1109,22,1
483212,1818,742,1076,23,1
483212,605,275,330,24,1
483212,1213,467,746,25,1
483212,53,20,33,31,1
483212,214,72,142,39,1
483212,999,395,604,40,1
483212,2078,757,1321,41,4
483212,2078,757,1321,42,1
483212,1232,349,883,43,1
483212,182,60,122,44,1
483212,1050,289,761,45,1
483212,846,408,438,51,1
483212,171,49,122,59,1
483212,879,240,639,60,1
